date;barcode;name;count;price;discount;total;buy_price;margin;
2021-01-11 12:38:30;8999999034061;ZWITSAL BAT NAT HAIR&BODY  300ML;1;28700;0;28700;26125;2575;
2021-01-11 12:38:30;8999999706661;PEPSODENT TB DBL CARE SENSITIVE;3;11500;0;34500;31200;3300;
2021-01-11 12:38:30;8999999008475;SUNLIGHT LIME NEW REF 1600ML;1;33000;0;33000;29800;3200;
2021-01-11 12:40:31;8992747180225;VIXAL PEMB PORS BIRU 720ML;1;18000;0;18000;16940;1060;
2021-01-11 12:50:41;8998009020186;BBUAVITA GUAVA 250ML;9;6500;0;58500;53550;4950;
2021-01-11 12:50:41;8998009020520;BUAVITA MINI GUAVA 125ML;8;5800;0;46400;42000;4400;
2021-01-11 12:50:41;8999999042936;ZWITSAL BB SPA GIFT BOX;1;110000;0;110000;99715;10285;
2021-01-11 16:54:02;8999999706111;PEPSODENT WHITE 25G;1;2000;0;2000;1450;550;
2021-01-11 16:54:02;8999999049508;REXONA WMN RO SHOWER CLEAN 45 ML;1;15000;0;15000;13500;1500;
2021-01-11 16:54:02;8999999036690;LUX TS MAGICAL ORCHID;1;3500;0;3500;2800;700;
2021-01-11 19:12:28;8999999528935;CITRA HBL NATURAL GLOWING WHITE 120ML;1;12000;0;12000;10080;1920;
2021-01-11 19:12:28;8999999048181;SUNSILK BLK SHINE 170ML;1;20000;0;20000;18150;1850;
2021-01-11 19:12:28;8999999027261;LIFEBUOY BW LEMONFRESH LD REFF 450 ML;1;25000;0;25000;22110;2890;
2021-01-11 19:14:50;8999999027261;LIFEBUOY BW LEMONFRESH LD REFF 450 ML;1;25000;0;25000;22110;2890;
2021-01-11 19:14:50;8999999528935;CITRA HBL NATURAL GLOWING WHITE 120ML;1;12000;0;12000;10080;1920;
2021-01-11 19:14:50;8999999048181;SUNSILK BLK SHINE 170ML;1;20000;0;20000;18150;1850;
2021-01-11 19:17:01;8999999524722;SUNLIGHT LIME NEW PCH 435ML;1;10000;0;10000;9100;900;
2021-01-11 19:17:01;8999999706173;PEPSODENT WHITE 120G;1;6700;0;6700;5940;760;
2021-01-11 19:30:13;8999999552497;ZWITSAL KIDS SHP BLUE  CLN&FRSH 180 ML;1;15000;0;15000;13695;1305;
2021-01-11 19:39:05;8999999552503;ZWITSAL KIDS SHP PINK SOFT&MSTR 180 ML;1;15000;0;15000;13695;1305;
2021-01-11 19:39:05;8991102385091;WFR TANGO CKLT 7G;1;8300;0;8300;7455;845;
2021-01-12 16:49:21;8999999042646;RINSO MOLTO PERFUME ESSENCE LIQ 40ML;1;11000;0;11000;9633;1367;
2021-01-12 17:05:16;8999999042592;RINSO MOLTO PERFUME ESSENSE LIQ 4OML;1;5500;0;5500;4817;683;
2021-01-12 17:36:47;8998009020520;BUAVITA MINI GUAVA 125ML;2;5800;0;11600;10500;1100;
2021-01-13 20:09:40;8999999710880;PEPSODENT ACTION123 HERBAL 75G;1;7500;0;7500;6650;850;
2021-01-13 20:09:40;8999999520151;PEPSODENT TB FAMILY SOFT;1;2100;0;2100;1900;200;
2021-01-15 16:26:43;8999999544409;MOLTO DETERGEN CARE PURPLE PCH 700ML;1;20500;0;20500;18570;1930;
2021-01-15 20:15:08;8999999514006;BANGO MANIS 60ML;2;3000;0;6000;4800;1200;
2021-01-17 15:03:37;8998009020520;BUAVITA MINI GUAVA 125ML;2;5800;0;11600;10500;1100;
2021-01-17 15:04:12;8999999035532;VASELINE NIGHT REPAIR 200ML;1;33800;0;33800;30855;2945;
2021-01-17 15:09:35;8998866202619;SEDAAP MIE KOREAN SPICY SOUP BAG 77 GR;1;2300;0;2300;2027;273;
2021-01-17 15:09:35;8998866202343;NOODLE SEDAAP MIE KOREAN SPICY 87 GR;1;2500;0;2500;2023;477;
2021-01-18 12:59:50;8999999401238;RINSO ANTI NODA 770G;1;21200;0;21200;19338;1862;
2021-01-18 21:20:51;8991102303309;WFR TANGO SBJ 176G;1;9200;0;9200;8336;864;
2021-01-19 00:14:33;8999999706111;PEPSODENT WHITE 25G;1;2000;0;2000;1450;550;
2021-01-19 00:14:33;8999999520151;PEPSODENT TB FAMILY SOFT;1;2100;0;2100;1900;200;
2021-01-19 10:08:49;8996001600269;LE MINERAL 600ML;3;3000;0;9000;5064;3936;
2021-01-19 17:45:53;8998866202770;SEDAAP MIE GORENG SALERO PADANG 86 GR;2;2300;0;4600;4046;554;
2021-01-19 19:56:43;001;PASEO SMART FACIAL SF 250S GT;1;10000;0;10000;8700;1300;
2021-01-20 09:09:47;8991102987875;WFR TANGO POUCH CKL 115G;1;7000;0;7000;6273;727;
2021-01-20 09:09:47;8997025911706;HATARI SHP MARGARINE;1;5000;0;5000;4763;237;
2021-01-20 15:50:42;8998866200646;KOPI TOP MURNI;1;11000;0;11000;9600;1400;
2021-01-20 17:39:53;BMCC;BIMURA POTATO CINCIN 250G;1;10000;0;10000;9300;700;
2021-01-20 17:39:53;8999999053048;PONDS FACIAL FOAM 100G;1;27000;0;27000;24900;2100;
2021-01-20 19:03:15;8999999530266;LIFEBUOY MATCHA GREENTEA 100ML;1;10500;0;10500;9405;1095;
2021-01-20 19:03:15;8998866201469;POTABEE REGULER BBQ BEEF 68 GR;1;8000;0;8000;7200;800;
2021-01-20 22:13:03;8998866202435;JAPOTA UMAMI JAPANESE SEAWEED 35GR;1;5000;0;5000;4150;850;
2021-01-20 23:31:05;8992753720606;OMELA 490G;1;12000;0;12000;10531;1469;
2021-01-20 23:42:36;8999999552442;FAIR&LOVELY MV SRM SHEET MASK 20 MG;1;8500;0;8500;7500;1000;
2021-01-21 09:34:19;8991102384841;WFR TANGO LONG CKLT 130G;1;4200;0;4200;3773;427;
2021-01-21 10:16:38;8998866611220;FRES&NATURAL PUTIH 100ML;1;11500;0;11500;10310;1190;
2021-01-21 12:06:27;8993365125032;MADU TJ SUPER 500G;2;43000;0;86000;81260;4740;
2021-01-21 12:06:27;8991102303309;WFR TANGO SBJ 176G;2;9200;0;18400;16672;1728;
2021-01-21 12:06:27;8991102300544;WFR TANGO VNL 176G;2;9200;0;18400;16672;1728;
2021-01-21 12:06:27;8991004011906;KOPI BORONG;3;10000;0;30000;24999;5001;
2021-01-21 12:09:01;089686010824;INDOMIE GORENG SPESIAL;1;2700;0;2700;2452;248;
2021-01-21 12:20:50;089686060027;POP MIE AYAM JUMBO;2;4200;0;8400;7666;734;
2021-01-21 12:23:59;8996001355008;BENG-BENG SP20G;1;29200;0;29200;26500;2700;
2021-01-21 12:23:59;8998866106979;SIKAT GIGI;1;6000;0;6000;5000;1000;
2021-01-21 12:49:22;8999999554286;SAHAJA PMBRSH LANTAI KNTM BUNGA JERUK 350ML;1;5000;0;5000;4450;550;
2021-01-21 12:50:47;8999999554286;SAHAJA PMBRSH LANTAI KNTM BUNGA JERUK 350ML;1;5000;0;5000;4450;550;
2021-01-21 12:58:19;8992753100101;BKM FULL CREAM GOLD 370;4;15000;0;60000;56000;4000;
2021-01-21 13:29:31;BR;BERAS 10L;1;86500;0;86500;85000;1500;
2021-01-21 13:32:16;001;PASEO SMART FACIAL SF 250S GT;2;10000;0;20000;17400;2600;
2021-01-21 13:52:22;GL;GULA 1 LITER;5;10500;0;52500;50000;2500;
2021-01-21 14:05:43;GL;GULA 1 LITER;60;10500;0;630000;600000;30000;
2021-01-21 14:05:43;8998866501026;MINYAK GORENG SEDAAP POUCH 1 L;60;14500;0;870000;846600;23400;
2021-01-21 14:09:41;GL;GULA 1 LITER;1;10500;0;10500;10000;500;
2021-01-21 14:20:09;8998866108126;POSH HIJAB WINTER MAGIC 150ML;1;19500;0;19500;17500;2000;
2021-01-21 14:20:09;8999999059903;PONDS AGE MIRACLE DAY CREAM 10G;1;28500;0;28500;25850;2650;
2021-01-21 14:20:09;8999999706081;PEPSODENT WHITE 75G;1;4300;0;4300;3850;450;
2021-01-21 14:20:09;8999999525088;MOLTO AIO BLUE SPK 250ML;1;9800;0;9800;8910;890;
2021-01-21 14:20:09;8999999052959;PONDS WHITE BEAUTY FACIAL FOAM 50G;1;17000;0;17000;15600;1400;
2021-01-21 14:24:36;8992775311615;CHOCOLATOS;1;12000;0;12000;9983;2017;
2021-01-21 14:24:36;8996001355008;BENG-BENG SP20G;1;29200;0;29200;26500;2700;
2021-01-21 14:24:36;8997231980039;O`JELLY KONYAKU (MAXI APPLE STRAWBERRY);1;5000;0;5000;4620;380;
2021-01-21 14:24:36;8998866200301;NOODLE SEDAAP GORENG  90 GR;2;2500;0;5000;4046;954;
2021-01-21 14:24:36;089686043204;INDOMIE MIE ACEH;1;2700;0;2700;2452;248;
2021-01-21 14:24:36;8851019230573;POCKY STRAWBERRY 21G;1;5000;0;5000;3001;1999;
2021-01-21 14:24:36;8991111109121;JB POWDER BLOSSOM 75+25G;1;6000;0;6000;5430;570;
2021-01-21 14:24:36;8991001503114;CHACHA MILK CHOCOLATE 35G;1;5500;0;5500;4900;600;
2021-01-21 14:24:36;8992775001042;PILUS GARUDA MI GORENG;1;5500;0;5500;4713;787;
2021-01-21 14:24:36;8991001111883;SILVERQQUEEN CHUNKYBAR 33G;1;8000;0;8000;7150;850;
2021-01-21 14:24:36;8991111101316;JB OIL 50ML;1;9500;0;9500;8700;800;
2021-01-21 14:35:18;GL;GULA 1 LITER;1;10500;0;10500;10000;500;
2021-01-21 14:43:18;8991102303309;WFR TANGO SBJ 176G;2;9200;0;18400;16672;1728;
2021-01-21 14:43:18;BMCC;BIMURA POTATO CINCIN 250G;1;10000;0;10000;9300;700;
2021-01-21 14:43:18;8991102281416;PERMEN MINTZ PPMINT;1;4500;0;4500;4000;500;
2021-01-21 14:43:18;8998866108119;PO0SH HIJAB PURPLE WISH 150ML;1;19500;0;19500;17500;2000;
2021-01-21 14:43:18;8991111101422;JB POWDER 200G;1;11700;0;11700;10660;1040;
2021-01-21 14:43:18;8999999520175;REXONA WMN RO INVISIBLE ANTIBACT 45 ML;1;16500;0;16500;14900;1600;
2021-01-21 14:45:49;8991102385091;WFR TANGO CKLT 7G;1;8300;0;8300;7455;845;
2021-01-21 14:45:49;8996001370063;CHOKI-CHOKI;1;18200;0;18200;16500;1700;
2021-01-21 14:45:49;8992775311325;GERY SNACK&SEREAL 100G;2;7000;0;14000;11784;2216;
2021-01-21 14:46:41;8992775001691;GARUDA ROSTA WAGYU BEEF;1;8000;0;8000;7176;824;
2021-01-21 14:47:49;SMC;BIMURA MAKARONI CINCIN 250G;2;10000;0;20000;18600;1400;
2021-01-21 14:49:43;8998866202466;JAPOTA HAPPY HONEY BUTTER;1;5000;0;5000;4150;850;
2021-01-21 14:49:43;BTS;BIMURA TARO SEAWEED 250G;1;10000;0;10000;9300;700;
2021-01-21 14:49:43;8999999049423;REXONA MEN RO SPORT DEFENSE 45 ML;1;15000;0;15000;13550;1450;
2021-01-21 15:00:12;8851019510132;POCKY;1;7300;0;7300;7000;300;
2021-01-21 15:00:12;8996001320136;KOPIKO CAPP CANDY;1;6200;0;6200;5600;600;
2021-01-21 15:11:32;8999999719401;VASELINE HW UV LIGHTENING PJ 400ML;1;43800;0;43800;39734;4066;
2021-01-21 15:11:32;8999999049447;REXONA WMN RO ADVANCED WHITE 45 ML;1;16500;0;16500;14900;1600;
2021-01-21 15:11:32;8999999048501;SUNSILK RFR ANTI DDRF 170ML;1;22200;0;22200;20020;2180;
2021-01-21 15:13:27;8991001111883;SILVERQQUEEN CHUNKYBAR 33G;1;8000;0;8000;7150;850;
2021-01-21 15:20:54;8996001320136;KOPIKO CAPP CANDY;1;6200;0;6200;5600;600;
2021-01-21 15:20:54;BPO;BIMURA POTATO ORIGINAL 250G;1;10000;0;10000;9300;700;
2021-01-21 15:20:54;8998866103985;CIPT SIKP;1;3000;0;3000;2552;448;
2021-01-21 15:20:54;8999999706081;PEPSODENT WHITE 75G;1;4300;0;4300;3850;450;
2021-01-21 15:20:54;8999999719401;VASELINE HW UV LIGHTENING PJ 400ML;1;43800;0;43800;39734;4066;
2021-01-21 15:20:54;8999999037765;PEPSODENT WHITE 225G;1;11800;0;11800;10750;1050;
2021-01-21 15:20:54;8999999524722;SUNLIGHT LIME NEW PCH 435ML;1;10000;0;10000;9100;900;
2021-01-21 15:20:54;8999999048167;SUNSILK SHP BLACK SHINE 9ML;1;10500;0;10500;9300;1200;
2021-01-21 15:22:21;BTS;BIMURA TARO SEAWEED 250G;1;10000;0;10000;9300;700;
2021-01-21 15:22:21;SMC;BIMURA MAKARONI CINCIN 250G;1;10000;0;10000;9300;700;
2021-01-21 15:23:23;8999999031602;SARI MURNI 20X1.6G;1;6000;0;6000;5400;600;
2021-01-21 15:23:23;8998866610070;SOKLIN SOFTERGEN 280G PURPLE;1;5000;0;5000;4425;575;
2021-01-21 15:23:23;BPO;BIMURA POTATO ORIGINAL 250G;1;10000;0;10000;9300;700;
2021-01-21 15:41:42;8993470411433;JOGER CLASSIC;1;1000;0;1000;850;150;
2021-01-21 16:08:27;8999999528829;CITRA SAKURA FAIR UV 120ML;1;11200;0;11200;10082;1118;
2021-01-21 16:15:24;SMC;BIMURA MAKARONI CINCIN 250G;2;10000;0;20000;18600;1400;
2021-01-21 16:16:50;8997025911058;HATARI SHP KELAPA;5;5000;0;25000;23815;1185;
2021-01-21 16:22:31;8991001005007;TOP BLACK WHITE;4;22000;0;88000;78720;9280;
2021-01-21 16:22:31;8991001903570;TOP CHOCOLATE;2;22000;0;44000;39360;4640;
2021-01-21 16:22:31;8991001121400;SILVERQUEEN ALMOND 65G;4;15000;0;60000;52800;7200;
2021-01-21 16:22:31;8992775312469;GERY SALUT COKELAT;1;11000;0;11000;9983;1017;
2021-01-21 17:04:53;8851019230573;POCKY STRAWBERRY 21G;1;5000;0;5000;3001;1999;
2021-01-21 18:08:27;089686010107;INDOMIE KALDU AYAM;2;2500;0;5000;4310;690;
2021-01-21 18:08:27;8998866602389;GIV UNGU KOTAK 76G;1;2000;0;2000;1820;180;
2021-01-21 18:08:27;GL;GULA 1 LITER;2;10500;0;21000;20000;1000;
2021-01-21 18:11:28;8998866501033;MINYAK GORENG SEDAAP POUCH 2L;2;28500;0;57000;55492;1508;
2021-01-21 18:15:05;8851019230573;POCKY STRAWBERRY 21G;2;5000;0;10000;6002;3998;
2021-01-21 19:09:23;8998866202060;PTABEE AYAM BAKAR PEDAS 35 GREXT15;1;4800;0;4800;4150;650;
2021-01-21 19:23:54;001;PASEO SMART FACIAL SF 250S GT;1;10000;0;10000;8700;1300;
2021-01-21 19:23:54;8999999540159;VASELINE REPAIRING JELLY ALOE 50ML;1;23000;0;23000;21333;1667;
2021-01-21 19:23:54;8992959974018;SFX SIRIH 36CM 12+1;1;12000;0;12000;10686;1314;
2021-01-21 19:23:54;8992959117590;SFX DS REG FLOW WING 20;1;12000;0;12000;11250;750;
2021-01-21 20:18:07;8998866202244;EKOMIE BUMBU KALDU AYAM;2;1000;0;2000;1720;280;
2021-01-21 20:28:03;8991001502933;CHACHA TUBE;1;7500;0;7500;6400;1100;
2021-01-21 20:28:03;8851019230566;POCKY CHOCO 22G;1;5000;0;5000;3001;1999;
2021-01-21 20:28:03;8851019510132;POCKY;1;7300;0;7300;7000;300;
2021-01-21 20:59:27;8992775311615;CHOCOLATOS;1;12000;0;12000;9983;2017;
2021-01-21 20:59:27;8996001350850;SUPER STAR SNAPS;1;16300;0;16300;14800;1500;
2021-01-21 20:59:27;8998866201483;POTABEE REGULER GRILLED SEAWEED 35GR;1;4800;0;4800;4150;650;
2021-01-21 20:59:27;8991001780133;TWISTER BLACK;1;5000;0;5000;4600;400;
2021-01-21 20:59:27;8992753182206;FF MILKY CKLT 180ML;1;4500;0;4500;3250;1250;
2021-01-21 20:59:27;8851019230566;POCKY CHOCO 22G;1;5000;0;5000;3001;1999;
2021-01-21 20:59:27;8851019210117;POCKY CHOCOLATE 47G;1;7300;0;7300;5671;1629;
2021-01-21 20:59:27;8991102987875;WFR TANGO POUCH CKL 115G;2;7000;0;14000;12546;1454;
2021-01-21 20:59:27;8992775311325;GERY SNACK&SEREAL 100G;1;7000;0;7000;5892;1108;
2021-01-21 20:59:27;8991001503114;CHACHA MILK CHOCOLATE 35G;2;5500;0;11000;9800;1200;
2021-01-21 21:01:21;8992388111145;MIE ABC SELERA PEDAS- SUP TOMAT PEDAS;2;2500;0;5000;4046;954;
2021-01-21 21:01:21;8998866202312;NOODLE SEDAAP TASTY BAKMI AYAM 129 GR;1;5000;0;5000;4167;833;
2021-01-21 21:01:21;8996001600146;TEH PUCUK HARUM 350ML;1;3000;0;3000;2314;686;
2021-01-21 21:14:03;8997213204900;INLITE 30W;1;110000;0;110000;105000;5000;
2021-01-21 23:57:50;8992753100101;BKM FULL CREAM GOLD 370;2;15000;0;30000;28000;2000;
2021-01-22 07:50:16;8993470411433;JOGER CLASSIC;1;1000;0;1000;850;150;
2021-01-22 07:56:08;8996001355237;SUPER STAR;1;11000;0;11000;9900;1100;
2021-01-22 07:56:08;8995333060703;TERIGU KOMPAS;2;10500;0;21000;19632;1368;
2021-01-22 07:56:08;8998866608008;KECAP MANIS SEDAAP BOTOL 135 ML;1;6300;0;6300;5615;685;
2021-01-22 07:56:08;11;PASEO SMART FHSTD PERF 6P 12S;1;5000;0;5000;4264;736;
2021-01-22 07:56:08;8997002060168;KRP SINGKOG PDS PANDA DUO;1;8000;0;8000;7300;700;
2021-01-22 08:00:32;8997013790108;BIMURA KACANG TELUR 25G;1;1000;0;1000;875;125;
2021-01-22 08:58:40;001;PASEO SMART FACIAL SF 250S GT;3;10000;0;30000;26100;3900;
2021-01-22 08:58:40;8992753100101;BKM FULL CREAM GOLD 370;1;15000;0;15000;14000;1000;
2021-01-22 08:58:40;089686061024;POP MIE MINI SOTO RL;4;3000;0;12000;10808;1192;
2021-01-22 08:59:19;8999999031602;SARI MURNI 20X1.6G;1;6000;0;6000;5400;600;
2021-01-22 12:02:04;8998866202244;EKOMIE BUMBU KALDU AYAM;1;1000;0;1000;860;140;
2021-01-22 13:13:10;8996001600146;TEH PUCUK HARUM 350ML;1;3000;0;3000;2314;686;
2021-01-22 13:14:19;8998866202770;SEDAAP MIE GORENG SALERO PADANG 86 GR;1;2300;0;2300;2023;277;
2021-01-22 16:11:11;8998866201377;KRISBEE FRIES KENTANG GORENG 68 GR;2;5500;0;11000;9240;1760;
2021-01-22 16:11:11;8991001502933;CHACHA TUBE;1;7500;0;7500;6400;1100;
2021-01-22 17:26:51;8999999707835;CLOSEUP GREEN 65G;1;7000;0;7000;6000;1000;
2021-01-22 17:26:51;8999999034023;VASELINE MEN ANTI ACNE 50G;1;17000;0;17000;15400;1600;
2021-01-22 17:44:28;8998866202060;PTABEE AYAM BAKAR PEDAS 35 GREXT15;1;4800;0;4800;4150;650;
2021-01-22 17:46:14;8998866202770;SEDAAP MIE GORENG SALERO PADANG 86 GR;1;2300;0;2300;2023;277;
2021-01-22 19:41:42;8998866201889;KRISBEE PILLOW STRAWBERRY ICE CREAM 120GR;1;8200;0;8200;7250;950;
2021-01-22 19:41:42;8999999001124;LIFEBUOY MILD CARE REF 250ML;1;15000;0;15000;13550;1450;
2021-01-22 19:41:42;8998009010569;ULTRA CHO 200;1;4700;0;4700;3830;870;
2021-01-22 19:41:42;8996001351918;ZUPER KEJU CHOCO;1;17000;0;17000;15500;1500;
2021-01-22 19:42:13;8991001780133;TWISTER BLACK;1;5000;0;5000;4600;400;
2021-01-22 20:56:53;8999999033132;LIFEBUOY PERAWATAN RMBT RNTK 170ML;1;16500;0;16500;14950;1550;
2021-01-22 20:56:53;8991102989428;WFR TANGO LONG CKLT 24G GTG;1;7500;0;7500;6714;786;
2021-01-22 20:56:53;8999999055752;FAIR&LOVELY MVIT FC FOAM 9 G;2;3500;0;7000;4900;2100;
2021-01-22 20:59:36;SBR;MINYAK GORENG SABRINA POUCH 2L;24;26753;0;642072;642072;0;
2021-01-22 21:04:45;MNY;MINYAK GORENG SEDAAP POUCH 2L;45;33297;0;1498365;1498365;0;
2021-01-22 22:17:54;8998866501026;MINYAK GORENG SEDAAP POUCH 1 L;12;14500;0;174000;169320;4680;
2021-01-22 22:20:31;8998866200301;NOODLE SEDAAP GORENG  90 GR;1;2500;0;2500;2023;477;
2021-01-22 22:20:31;8998866200325;NOODLE SEDAAP MIE SOTO;1;2200;0;2200;1952;248;
2021-01-22 22:20:31;8996001305041;ROMA SANDWICH CKLT;1;7000;0;7000;5000;2000;
2021-01-22 22:30:49;8998898853100;SUSU JAHE;1;13000;0;13000;11800;1200;
2021-01-23 08:39:39;8997025914059;HATARI SEE HONG;1;5000;0;5000;4763;237;
2021-01-23 08:39:39;8999999556341;MOLTO EDP PINK ROSE 20ML;1;1000;0;1000;800;200;
2021-01-23 08:39:39;001;PASEO SMART FACIAL SF 250S GT;1;10000;0;10000;8700;1300;
2021-01-23 10:48:40;8998866611725;EKONOMI PENCUCI PIRING  LIQ 290ML;1;5000;0;5000;4200;800;
2021-01-23 11:03:47;8998866202305;KECAP MANIS SEDAAP SPC BOTOL 135ML;1;6800;0;6800;6150;650;
2021-01-23 11:28:21;8992761111533;SPRITE SLIM CAM250ML;1;4800;0;4800;3750;1050;
2021-01-23 14:58:07;8992753101207;BENDERA KENTAL MANIS 370G;1;11500;0;11500;9700;1800;
2021-01-23 16:31:44;8992957220186;COKLAT RUSA;1;2000;0;2000;1700;300;
2021-01-23 16:49:04;8995150101696;M+SUSU ORIGINAL;1;5000;0;5000;4000;1000;
2021-01-23 16:54:03;8991001780133;TWISTER BLACK;2;5000;0;10000;9200;800;
2021-01-23 16:54:03;8991111101408;JB POWSER 50G;1;3500;0;3500;3000;500;
2021-01-23 17:02:15;8999999045913;LIFEBUOY MILDCARE 110GR;1;4000;0;4000;3500;500;
2021-01-23 17:09:45;8999999045913;LIFEBUOY MILDCARE 110GR;3;4000;0;12000;10500;1500;
2021-01-23 17:56:47;8997231980039;O`JELLY KONYAKU (MAXI APPLE STRAWBERRY);1;5000;0;5000;4620;380;
2021-01-23 17:57:58;8998866202237;NOODLE SEDAAP TASTY AYAM GEPREK 124 GR;1;5000;0;5000;4167;833;
2021-01-23 18:09:20;8998866501033;MINYAK GORENG SEDAAP POUCH 2L;1;28500;0;28500;27746;754;
2021-01-23 18:09:20;8992753720606;OMELA 490G;1;12000;0;12000;10531;1469;
2021-01-23 18:13:31;8991102384841;WFR TANGO LONG CKLT 130G;1;4200;0;4200;3773;427;
2021-01-24 08:50:32;8991102380805;FULLO  CKL PCK 8G;1;10000;0;10000;9000;1000;
2021-01-24 08:50:32;8996001304143;SLAI OLAI NANAS;1;12000;0;12000;9900;2100;
2021-01-24 08:50:32;8850507002968;A1 KING TRUCK;1;16500;0;16500;15500;1000;
2021-01-24 09:51:36;8993365122536;MADU TJ SUPER 250G;2;25000;0;50000;45560;4440;
2021-01-24 09:52:53;8997021870328;HOT IN CREAM 120ML;1;18500;0;18500;17000;1500;
2021-01-24 09:54:02;8998866610070;SOKLIN SOFTERGEN 280G PURPLE;1;5000;0;5000;4425;575;
2021-01-24 09:56:24;34678;SENDAL JEPIT;1;14000;0;14000;13500;500;
2021-01-24 10:00:27;ARD;SENDAL ARDILES;1;15000;0;15000;13500;1500;
2021-01-24 10:00:27;8999999502393;ROYCO FDS CHICKEN 8G;1;5000;0;5000;4500;500;
2021-01-24 15:18:33;GL;GULA 1 LITER;3;10500;0;31500;34500;-3000;
2021-01-24 16:29:41;8886020033431;KAPUR AJAIB BAGUS;2;3000;0;6000;5400;600;
2021-01-24 16:29:41;8998866201711;KRISBEE KRUNCHY JAGUNG BAKAR MENTEGA 75 GR;2;5000;0;10000;8800;1200;
2021-01-24 16:29:41;8998866201483;POTABEE REGULER GRILLED SEAWEED 35GR;2;4800;0;9600;8300;1300;
2021-01-24 16:29:41;8996001338056;TAMARIN;2;5600;0;11200;10200;1000;
2021-01-24 16:31:27;GL;GULA 1 LITER;2;11500;0;23000;21000;2000;
2021-01-24 17:36:51;8998866202770;SEDAAP MIE GORENG SALERO PADANG 86 GR;2;2300;0;4600;4046;554;
2021-01-24 17:52:30;GL;GULA 1 LITER;2;11500;0;23000;21000;2000;
2021-01-24 17:52:30;001;PASEO SMART FACIAL SF 250S GT;1;10000;0;10000;8700;1300;
2021-01-24 17:52:30;8991001502933;CHACHA TUBE;1;7500;0;7500;6400;1100;
2021-01-24 17:52:30;8992959117583;SFX DS REG FLOW WING 20;1;5000;0;5000;4288;712;
2021-01-24 19:38:49;KR;KRESEK;1;100;0;100;99;1;
2021-01-24 19:38:49;8998866608312;GIV PAPAYA KOTAK 76GR;1;2000;0;2000;1820;180;
2021-01-24 19:38:49;8998866803694;SOKLIN SOFTERGENT PURPLE BAG 770 & PIRING;1;18000;0;18000;16055;1945;
2021-01-24 19:44:34;ARG;ARGUS 220ML;1;14500;0;14500;12500;2000;
2021-01-24 20:57:52;123;BETREI JAM;1;5500;0;5500;5000;500;
2021-01-24 20:59:36;001;PASEO SMART FACIAL SF 250S GT;1;10000;0;10000;8700;1300;
2021-01-24 21:18:09;8998866202244;EKOMIE BUMBU KALDU AYAM;5;1000;0;5000;4300;700;
2021-01-24 21:18:09;GL;GULA 1 LITER;1;11500;0;11500;10500;1000;
2021-01-24 21:18:09;8997025911058;HATARI SHP KELAPA;1;5000;0;5000;4763;237;
2021-01-24 22:10:20;8999999030179;PEPSODENT ACTION 123 COMPLETE 75G;1;6700;0;6700;5170;1530;
2021-01-24 22:10:20;8999999024772;VASELINE HW PERFECT 10 100 ML;1;19000;0;19000;17600;1400;
2021-01-24 22:36:44;089686010343;INDOME SOTO MIE;2;2600;0;5200;4734;466;
2021-01-24 22:36:44;8998866200882;NOODLE SUKSESMIE GORENG AYAM KRMS 133GR;2;3500;0;7000;6000;1000;
2021-01-25 09:53:53;8991102384841;WFR TANGO LONG CKLT 130G;1;4200;0;4200;3773;427;
2021-01-25 09:56:02;8996001600375;LE MINERAL 330ML;1;2000;0;2000;1417;583;
2021-01-25 10:13:43;8998898847109;KOPI JAHE;2;1500;0;3000;2360;640;
2021-01-25 11:22:49;8998866202770;SEDAAP MIE GORENG SALERO PADANG 86 GR;1;2300;0;2300;2023;277;
2021-01-25 11:25:58;8998866200325;NOODLE SEDAAP MIE SOTO;1;2200;0;2200;1952;248;
2021-01-25 11:37:03;8992957220087;COKLAT SINGA;1;2000;0;2000;1700;300;
2021-01-25 11:37:03;8991001111883;SILVERQQUEEN CHUNKYBAR 33G;1;8000;0;8000;7150;850;
2021-01-25 11:39:40;8996001600269;LE MINERAL 600ML;2;3000;0;6000;3376;2624;
2021-01-25 11:40:47;8991102384841;WFR TANGO LONG CKLT 130G;1;4200;0;4200;3773;427;
2021-01-25 11:40:47;8996001600269;LE MINERAL 600ML;1;3000;0;3000;1688;1312;
2021-01-25 12:27:18;089686010107;INDOMIE KALDU AYAM;2;2500;0;5000;4310;690;
2021-01-25 12:56:17;8851019230573;POCKY STRAWBERRY 21G;1;5000;0;5000;3001;1999;
2021-01-25 12:56:17;8851019230566;POCKY CHOCO 22G;1;5000;0;5000;3001;1999;
2021-01-25 14:54:36;089686010107;INDOMIE KALDU AYAM;6;2500;0;15000;12930;2070;
2021-01-25 17:22:50;8992959117514;SFX NON WING 20;1;10000;0;10000;9091;909;
2021-01-25 18:18:25;8851019230566;POCKY CHOCO 22G;2;5000;0;10000;6002;3998;
2021-01-25 18:18:25;8991001121400;SILVERQUEEN ALMOND 65G;1;15000;0;15000;13200;1800;
2021-01-25 19:09:48;8998866200325;NOODLE SEDAAP MIE SOTO;1;2200;0;2200;1952;248;
2021-01-25 20:25:13;8999999524722;SUNLIGHT LIME NEW PCH 435ML;1;10000;0;10000;9100;900;
2021-01-25 21:24:53;8999999555122;MOLTO K-ROMANCE 20ML;6;1000;0;6000;4800;1200;
2021-01-25 21:24:53;8999999502393;ROYCO FDS CHICKEN 8G;1;5000;0;5000;4500;500;
2021-01-25 21:24:53;8995333060703;TERIGU KOMPAS;1;10500;0;10500;9816;684;
2021-01-25 21:44:13;8996001600146;TEH PUCUK HARUM 350ML;1;3000;0;3000;2314;686;
2021-01-25 21:44:13;8992696523081;MILO UHT 110ML;1;2500;0;2500;1962;538;
2021-01-25 21:52:59;GL;GULA 1 LITER;4;11500;0;46000;42000;4000;
2021-01-25 21:52:59;8991004011906;KOPI BORONG;2;10000;0;20000;16666;3334;
2021-01-25 21:52:59;8995333032113;TERIGU GATOT KACA 1 KG;1;8500;0;8500;8012;488;
2021-01-25 21:52:59;8996001355237;SUPER STAR;1;11000;0;11000;9900;1100;
2021-01-26 12:14:34;8998866202435;JAPOTA UMAMI JAPANESE SEAWEED 35GR;1;5000;0;5000;4150;850;
2021-01-26 13:09:39;8993470411433;JOGER CLASSIC;1;1000;0;1000;850;150;
2021-01-26 16:10:25;8993470411433;JOGER CLASSIC;1;1000;0;1000;850;150;
2021-01-26 16:10:25;8998866202732;MILKU STROBERI 200ML;1;3000;0;3000;2375;625;
2021-01-26 16:13:11;8998866202732;MILKU STROBERI 200ML;1;3000;0;3000;2375;625;
2021-01-26 16:37:09;8992957220087;COKLAT SINGA;1;2000;0;2000;1700;300;
2021-01-26 16:46:59;8851019230573;POCKY STRAWBERRY 21G;1;5000;0;5000;3001;1999;
2021-01-26 16:47:00;8997231980039;O`JELLY KONYAKU (MAXI APPLE STRAWBERRY);1;5000;0;5000;4620;380;
2021-01-26 16:47:00;8851019210193;POCKY CHOCO BANANA 47G;1;7300;0;7300;5671;1629;
2021-01-26 16:47:00;8998866201483;POTABEE REGULER GRILLED SEAWEED 35GR;1;4800;0;4800;4150;650;
2021-01-26 16:47:00;8998866202435;JAPOTA UMAMI JAPANESE SEAWEED 35GR;1;5000;0;5000;4150;850;
2021-01-26 17:23:40;8996001305041;ROMA SANDWICH CKLT;1;7000;0;7000;5000;2000;
2021-01-26 17:24:08;8999999514006;BANGO MANIS 60ML;1;3000;0;3000;2400;600;
2021-01-26 17:29:37;8998866200325;NOODLE SEDAAP MIE SOTO;1;2200;0;2200;1952;248;
2021-01-26 19:24:38;8998866103985;CIPT SIKP;1;3000;0;3000;2552;448;
2021-01-26 19:35:21;8998866103985;CIPT SIKP;1;3000;0;3000;2552;448;
2021-01-26 19:35:21;8999999534097;PEPSODENT PGB FCM 75G;1;4300;0;4300;3850;450;
2021-01-26 19:35:21;8999999533717;CITRA TS FRESH WHITE 70G;1;2200;0;2200;1900;300;
2021-01-26 19:35:21;GL;GULA 1 LITER;1;11500;0;11500;10500;1000;
2021-01-26 19:35:21;8999999502003;SARIMURNI RL RB 1,8G;2;1500;0;3000;57960;-54960;
2021-01-26 19:35:21;8992388111206;MIE ABC SELERA PEDAS-GULAI AYAM PEDAS;1;2500;0;2500;2022;478;
2021-01-26 19:35:21;8998866200578;NOODLE SEDAAP KARI KENTAL SPC 75 GR;1;2300;0;2300;1952;348;
2021-01-26 20:54:39;8993470411433;JOGER CLASSIC;2;1000;0;2000;1700;300;
2021-01-27 10:20:51;8996001600665;COOL TIME;1;3200;0;3200;2750;450;
2021-01-27 11:05:01;8991001121400;SILVERQUEEN ALMOND 65G;1;15000;0;15000;13200;1800;
2021-01-27 11:23:06;GL;GULA 1 LITER;1;11500;0;11500;10500;1000;
2021-01-27 12:14:03;GL;GULA 1 LITER;3;11500;0;34500;31500;3000;
2021-01-27 12:14:03;8998866600538;SOKLIN FLOORCLENER PINK 400ML;1;6000;0;6000;5025;975;
2021-01-27 12:14:03;8999999042646;RINSO MOLTO ROSE FRESH LIQ 40ML;2;5500;0;11000;9634;1366;
2021-01-27 12:14:03;8934868015031;REXONA DEO LOTION ICE COOL;12;4600;0;55200;46800;8400;
2021-01-27 12:22:49;8997025914059;HATARI SEE HONG;2;5000;0;10000;9526;474;
2021-01-27 12:22:49;8992628022156;BIMOLI KLASIK TOUCH 1 LT;2;15500;0;31000;28282;2718;
2021-01-27 12:22:49;089686010107;INDOMIE KALDU AYAM;5;2500;0;12500;10775;1725;
2021-01-27 12:22:49;GL;GULA 1 LITER;3;11500;0;34500;31500;3000;
2021-01-27 12:22:49;8999999045265;RINSO MOLTO ROSE FRESH PWD 770GR;1;21600;0;21600;19338;2262;
2021-01-27 12:22:49;8998898101447;TOLAK ANGIN 12;1;35000;0;35000;32496;2504;
2021-01-27 12:22:49;8999999504656;SARI MURNI 20X1.8G;1;5000;0;5000;4200;800;
2021-01-27 12:22:49;8992753101207;BENDERA KENTAL MANIS 370G;2;11500;0;23000;19400;3600;
2021-01-27 12:22:49;8999999710873;PEPSODENT ACTION123 HERBAL 120G;2;11400;0;22800;20800;2000;
2021-01-27 12:22:49;8996001600269;LE MINERAL 600ML;1;3000;0;3000;1688;1312;
2021-01-27 13:37:31;8992628022156;BIMOLI KLASIK TOUCH 1 LT;1;15500;0;15500;14141;1359;
2021-01-27 13:37:31;8998008151065;MIWON 100 GR;1;3300;0;3300;2996;304;
2021-01-27 14:22:00;8997231980039;O`JELLY KONYAKU (MAXI APPLE STRAWBERRY);1;5000;0;5000;4620;380;
2021-01-27 14:46:26;8999999710880;PEPSODENT ACTION123 HERBAL 75G;1;7500;0;7500;6650;850;
2021-01-27 14:54:49;8851019230573;POCKY STRAWBERRY 21G;1;5000;0;5000;3001;1999;
2021-01-27 14:54:49;8991001503114;CHACHA MILK CHOCOLATE 35G;1;5500;0;5500;4900;600;
2021-01-27 16:10:35;8992775001691;GARUDA ROSTA WAGYU BEEF;1;8000;0;8000;7176;824;
2021-01-27 19:29:45;8999999502003;SARIMURNI RL RB 1,8G;1;5000;0;5000;1207;3793;
2021-01-27 19:29:45;8999999504656;SARI MURNI 20X1.8G;1;5000;0;5000;4200;800;
2021-01-27 19:29:45;8992696521797;MILO ACTVGO SCT 22G;10;1500;0;15000;19440;-4440;
2021-01-27 19:29:45;8996001600269;LE MINERAL 600ML;1;3000;0;3000;1688;1312;
2021-01-27 19:29:45;8999999560584;LUX TS VELVET JASMINE 110G;1;4000;0;4000;3100;900;
2021-01-27 19:29:45;8991102384841;WFR TANGO LONG CKLT 130G;1;4200;0;4200;3773;427;
2021-01-27 19:29:45;8992775310212;GERY PASTA COKELAT;1;18000;0;18000;16029;1971;
2021-01-27 19:45:23;8992388112401;MIE ABC SELERA PEDAS- GORENG AYAM PEDAS LIMAU;1;2600;0;2600;2368;232;
2021-01-27 19:45:23;8992388111206;MIE ABC SELERA PEDAS-GULAI AYAM PEDAS;1;2500;0;2500;2022;478;
2021-01-27 19:45:23;8998866200301;NOODLE SEDAAP GORENG  90 GR;1;2500;0;2500;2023;477;
2021-01-27 19:45:23;8996001600399;LE MINERAL 1500ML;1;5000;0;5000;4042;958;
2021-01-27 19:56:03;8999999059323;LIFEBOUY LEMONFRESH DG 75G;3;3000;0;9000;7500;1500;
2021-01-27 20:41:21;8998866202725;MILKU COKLAT PREMIUM 200ML;1;3000;0;3000;2375;625;
2021-01-27 20:55:53;8998866501033;MINYAK GORENG SEDAAP POUCH 2L;2;28500;0;57000;55492;1508;
2021-01-27 21:06:39;8992696404441;BEAR BRAND 189ML;3;8500;0;25500;23661;1839;
2021-01-27 21:06:39;8996001304143;SLAI OLAI NANAS;1;12000;0;12000;9900;2100;
2021-01-27 21:06:39;8999999059323;LIFEBOUY LEMONFRESH DG 75G;2;3000;0;6000;5000;1000;
2021-01-27 21:16:25;8998898819106;KOPI KKB GINGSENG;1;12500;0;12500;11050;1450;
2021-01-27 21:18:23;8994867007161;ROKOK PENA GOLD 20;1;17000;0;17000;15000;2000;
2021-01-27 22:16:21;8998866202732;MILKU STROBERI 200ML;1;3000;0;3000;2375;625;
2021-01-28 07:41:24;8997025914059;HATARI SEE HONG;1;5000;0;5000;4763;237;
2021-01-28 09:16:09;SKT;SIKAT CUCI;1;6000;0;6000;5000;1000;
2021-01-28 09:16:10;8997025911706;HATARI SHP MARGARINE;1;5000;0;5000;4763;237;
2021-01-28 10:05:25;8998866201483;POTABEE REGULER GRILLED SEAWEED 35GR;1;4800;0;4800;4150;650;
2021-01-28 10:05:25;8996001600375;LE MINERAL 330ML;1;2000;0;2000;1417;583;
2021-01-28 12:43:08;8993470411433;JOGER CLASSIC;1;1000;0;1000;850;150;
2021-01-28 14:08:19;089686010824;INDOMIE GORENG SPESIAL;1;2700;0;2700;2452;248;
2021-01-28 14:08:19;8998866202343;NOODLE SEDAAP MIE KOREAN SPICY 87 GR;1;2500;0;2500;2023;477;
2021-01-28 14:08:19;8991102989428;WFR TANGO LONG CKLT 24G GTG;1;7500;0;7500;6714;786;
2021-01-28 14:46:38;8998866202725;MILKU COKLAT PREMIUM 200ML;1;3000;0;3000;2375;625;
2021-01-28 14:47:20;089686010107;INDOMIE KALDU AYAM;2;2500;0;5000;4310;690;
2021-01-28 16:26:14;8998866202404;NOODLE SEDAAP MIE KOREAN SPICY CHICKEN CUP;1;4500;0;4500;3917;583;
2021-01-28 16:26:14;8998866202312;NOODLE SEDAAP TASTY BAKMI AYAM 129 GR;1;5000;0;5000;4167;833;
2021-01-28 16:47:55;8999999031602;SARI MURNI 20X1.6G;1;6000;0;6000;5400;600;
2021-01-28 17:08:19;8996001355237;SUPER STAR;1;11000;0;11000;9900;1100;
2021-01-28 17:08:19;8850507002968;A1 KING TRUCK;2;16500;0;33000;31000;2000;
2021-01-28 18:16:20;8992761002039;FANTA STRAWBERRY PET 390 ML;1;5500;0;5500;4300;1200;
2021-01-28 18:19:14;8991001111883;SILVERQUEEN CHUNKYBAR 33G;1;8000;0;8000;7150;850;
2021-01-28 18:29:04;6949586607033;SILET ALSHABAB;1;8500;0;8500;7500;1000;
2021-01-28 18:32:48;8999999034702;PONDS MEN ACNE SOLUTION 50G;1;18500;0;18500;17160;1340;
2021-01-28 18:33:52;8999999030186;PEPSODENT ACTION 123 COMPLETE 190G;1;14000;0;14000;13200;800;
2021-01-28 18:33:52;8999999520151;PEPSODENT TB FAMILY SOFT;1;2100;0;2100;1900;200;
2021-01-28 18:57:31;8996001302323;MALKIST ABON;1;6500;0;6500;4800;1700;
2021-01-28 18:57:31;8992957220117;COKLAT BERUANG;1;2000;0;2000;1700;300;
2021-01-28 18:57:52;GL;GULA 1 LITER;2;11500;0;23000;21000;2000;
2021-01-28 18:59:45;8998866603409;RAPIKA UNGU POUCH 400ML;1;5000;0;5000;4500;500;
2021-01-28 18:59:45;8998866603522;SOKLIN FLOORCLENER UNGU 400ML;1;6000;0;6000;5025;975;
2021-01-28 18:59:45;8999999524838;SUNLIGHT MINT POUCH 755ML;1;17000;0;17000;15400;1600;
2021-01-28 18:59:45;8999999555450;VIXAL PEMB PORS BIRU 190ML;1;5000;0;5000;4200;800;
2021-01-28 18:59:45;8999999710880;PEPSODENT ACTION123 HERBAL 75G;2;7500;0;15000;13300;1700;
2021-01-28 18:59:45;8999999525590;PEPSODENT TB KIDS;2;12900;0;25800;23400;2400;
2021-01-28 19:08:32;8999999401221;RINSO ANTI NODA CLASSIC 430G;1;10800;0;10800;9806;994;
2021-01-28 19:08:32;GL;GULA 1 LITER;2;11500;0;23000;21000;2000;
2021-01-28 19:17:34;8851019510132;POCKY;1;7300;0;7300;7000;300;
2021-01-28 20:15:47;8998866607315;SOKLIN SOFTERGENT SAKURA 770G & PIRING;1;18000;0;18000;16055;1945;
2021-01-28 20:15:47;8998866202060;PTABEE AYAM BAKAR PEDAS 35 GREXT15;1;4800;0;4800;4150;650;
2021-01-28 20:15:47;8998866201483;POTABEE REGULER GRILLED SEAWEED 35GR;2;4800;0;9600;8300;1300;
2021-01-28 20:15:47;8999999706173;PEPSODENT WHITE 120G;1;6700;0;6700;5940;760;
2021-01-28 20:15:47;8999999059323;LIFEBOUY LEMONFRESH DG 75G;2;3000;0;6000;5000;1000;
2021-01-28 20:15:47;8998009020186;BUAVITA GUAVA 250ML;1;6600;0;6600;5950;650;
2021-01-28 20:15:47;8996001302347;SARI GANDUM FAM;1;8200;0;8200;7100;1100;
2021-01-28 20:15:47;8991102987639;WFR TANGO LONG VNL 130G;1;4200;0;4200;3773;427;
2021-01-28 20:15:47;8999999529291;MOLTO PURE SACHET 10ML;1;6000;0;6000;4800;1200;
2021-01-28 20:15:47;8999999555122;MOLTO K-ROMANCE 20ML;6;1000;0;6000;4800;1200;
2021-01-28 20:15:47;8850507002968;A1 KING TRUCK;1;16500;0;16500;15500;1000;
2021-01-28 20:15:47;ARD;SENDAL ARDILES;1;15000;0;15000;13500;1500;
2021-01-28 20:15:47;8999999559861;AXE DARK POCKET FRAG 17ML;1;10000;0;10000;8000;2000;
2021-01-28 20:17:39;8886020033431;KAPUR AJAIB ANTI KECOA DAN NYAMUK;2;3000;0;6000;5400;600;
2021-01-28 21:10:12;8998866610438;SOKLIN SOFTERGENT RED BAG 770G & PIRING;1;18000;0;18000;16055;1945;
2021-01-28 21:26:55;GL;GULA 1 LITER;3;11500;0;34500;31500;3000;
2021-01-29 09:02:31;8996001318430;BETTER 1000;1;1000;0;1000;820;180;
2021-01-29 09:02:31;8998866202244;EKOMIE BUMBU KALDU AYAM;1;1000;0;1000;860;140;
2021-01-29 09:55:47;8996001600375;LE MINERAL 330ML;1;2000;0;2000;1417;583;
2021-01-29 10:21:19;8998866201490;POTABEE REGULER GRILLED SEAWED 68 GR;1;8000;0;8000;7200;800;
2021-01-29 11:03:30;9556001004673;MILO NESTLE MALAYSIA ACTIVE GO;1;85000;0;85000;80000;5000;
2021-01-29 11:03:30;8992761122331;FRESTEA APPEL 500ML;1;6500;0;6500;4708;1792;
2021-01-29 12:04:33;8992628022156;BIMOLI KLASIK TOUCH 1 LT;1;15500;0;15500;14141;1359;
2021-01-29 12:06:46;8998009020186;BUAVITA GUAVA 250ML;1;6600;0;6600;5950;650;
2021-01-29 12:14:38;8996001302347;SARI GANDUM FAM;1;8200;0;8200;7100;1100;
2021-01-29 12:17:56;8992761166038;MMP ORANGE 300ML;1;5000;0;5000;3750;1250;
2021-01-29 12:40:12;34678;SENDAL JEPIT;1;14000;0;14000;13500;500;
2021-01-29 12:40:12;GL;GULA 1 LITER;1;11500;0;11500;10500;1000;
2021-01-29 12:40:12;8995333032113;TERIGU GATOT KACA 1 KG;1;8500;0;8500;8012;488;
2021-01-29 12:40:12;9556040040038;SUSU F&N;1;33000;0;33000;33000;0;
2021-01-29 12:40:12;8991001111883;SILVERQUEEN CHUNKYBAR 33G;1;8000;0;8000;7150;850;
2021-01-29 13:15:43;8998866202770;SEDAAP MIE GORENG SALERO PADANG 86 GR;2;2300;0;4600;4046;554;
2021-01-29 13:15:43;8993470411433;JOGER CLASSIC;1;1000;0;1000;850;150;
2021-01-29 13:17:07;8998866200882;SUKSESMIE GORENG AYAM KRMS 133GR;1;3500;0;3500;3000;500;
2021-01-29 13:19:08;8992957220087;COKLAT SINGA;1;2000;0;2000;1700;300;
2021-01-29 13:23:01;8992388111145;MIE ABC SELERA PEDAS- SUP TOMAT PEDAS;1;2500;0;2500;2023;477;
2021-01-29 13:23:01;8992388111206;MIE ABC SELERA PEDAS-GULAI AYAM PEDAS;1;2500;0;2500;2022;478;
2021-01-29 13:23:01;8998866202244;EKOMIE BUMBU KALDU AYAM;1;1000;0;1000;860;140;
2021-01-29 13:31:20;089686061079;POP MIE MINI AY BAWANG RL;1;3000;0;3000;2702;298;
2021-01-29 13:31:20;8993470411433;JOGER CLASSIC;1;1000;0;1000;850;150;
2021-01-29 13:33:33;8999999559540;LIFEBUOY BW LEMONFRESH 90ML;1;5000;0;5000;4000;1000;
2021-01-29 16:52:53;8997231980039;O`JELLY KONYAKU (MAXI APPLE STRAWBERRY);1;5000;0;5000;4620;380;
2021-01-29 16:57:32;GL;GULA 1 LITER;2;11500;0;23000;21000;2000;
2021-01-29 16:57:32;8992753102204;BKM COKLAT 370G;1;11300;0;11300;9500;1800;
2021-01-29 16:57:32;8991102987639;WFR TANGO LONG VNL 130G;1;4200;0;4200;3773;427;
2021-01-29 16:57:32;8991102384841;WFR TANGO LONG CKLT 130G;1;4200;0;4200;3773;427;
2021-01-29 18:12:14;BB;PASEO SMARTY FACIAL TRAVEL PACK 50S GT;1;2000;0;2000;1800;200;
2021-01-29 18:12:14;089686043273;INDOMIE SAMBAL RICA;1;2700;0;2700;2452;248;
2021-01-29 18:12:14;8992388112401;MIE ABC SELERA PEDAS- GORENG AYAM PEDAS LIMAU;1;2600;0;2600;2368;232;
2021-01-29 19:56:59;8992761166038;MMP ORANGE 300ML;1;5000;0;5000;3750;1250;
2021-01-29 20:07:14;8992959117583;SFX DS REG FLOW WING 20;1;5000;0;5000;4288;712;
2021-01-29 20:09:55;8996001301142;ROMA KELAPA;2;8000;0;16000;13256;2744;
2021-01-29 20:09:55;8998866200325;NOODLE SEDAAP MIE SOTO;3;2200;0;6600;5856;744;
2021-01-29 20:09:55;8992753100101;BKM FULL CREAM GOLD 370;1;15000;0;15000;14000;1000;
2021-01-29 20:09:55;8998866200301;NOODLE SEDAAP GORENG  90 GR;1;2500;0;2500;2023;477;
2021-01-29 20:09:55;8998866200578;NOODLE SEDAAP KARI KENTAL SPC 75 GR;1;2300;0;2300;1952;348;
2021-01-29 21:12:29;9556001004673;MILO NESTLE MALAYSIA ACTIVE GO;1;85000;0;85000;80000;5000;
2021-01-29 22:42:42;ARG;ARGUS 220ML;1;14500;0;14500;12500;2000;
2021-01-29 23:05:40;8998989110167;SURYA GUDANG GARAM 16 FILTER;1;24000;0;24000;22100;1900;
2021-01-29 23:21:46;8992761002022;SPRITE PET 390ML;1;5500;0;5500;4300;1200;
2021-01-29 23:22:29;8996001355817;BENG-BENG MAXX;1;27000;0;27000;24500;2500;
2021-01-29 23:22:29;8992761166038;MMP ORANGE 300ML;1;5000;0;5000;3750;1250;
2021-01-29 23:22:29;8992761111533;SPRITE SLIM CAM250ML;1;4800;0;4800;3750;1050;
2021-01-29 23:30:28;8998866200820;NOODLE SEDAAP MIE AYAM BAWANG TLR CUP 77 GR;1;4300;0;4300;3650;650;
2021-01-30 07:21:48;11222;LEM KOREA;1;9000;0;9000;8000;1000;
2021-01-30 08:49:13;8998866803694;SOKLIN SOFTERGENT PURPLE BAG 770 & PIRING;1;18000;0;18000;16055;1945;
2021-01-30 10:05:57;GL;GULA 1 LITER;3;11500;0;34500;31500;3000;
2021-01-30 10:05:57;8999999720940;CLEAR STYLING CREAM 100G;1;12000;0;12000;10615;1385;
2021-01-30 10:05:57;8996001350850;SUPER STAR SNAPS;1;16300;0;16300;14800;1500;
2021-01-30 11:38:36;8992761147143;SPRITE WATERLYMO 425ML;1;5500;0;5500;4300;1200;
2021-01-30 11:40:56;089686010107;INDOMIE KALDU AYAM;2;2500;0;5000;4310;690;
2021-01-30 11:40:56;8998866201377;KRISBEE FRIES KENTANG GORENG 68 GR;1;5500;0;5500;4620;880;
2021-01-30 11:40:56;089686043204;INDOMIE MIE ACEH;1;2700;0;2700;2452;248;
2021-01-30 11:40:56;8997231980039;O`JELLY KONYAKU (MAXI APPLE STRAWBERRY);1;5000;0;5000;4620;380;
2021-01-30 12:53:33;8992761002039;FANTA STRAWBERRY PET 390 ML;1;5500;0;5500;4300;1200;
2021-01-30 12:56:42;8999999048181;SUNSILK BLK SHINE 170ML;1;20000;0;20000;18150;1850;
2021-01-30 12:56:42;8998866610438;SOKLIN SOFTERGENT RED BAG 770G & PIRING;1;18000;0;18000;16055;1945;
2021-01-30 13:00:05;8996001302347;SARI GANDUM FAM;1;8200;0;8200;7100;1100;
2021-01-30 13:00:05;089686060102;POP MIE PEDE GLEDEEK;2;5000;0;10000;8900;1100;
2021-01-30 13:00:05;089686060027;POP MIE AYAM JUMBO;2;4200;0;8400;7666;734;
2021-01-30 13:00:05;089686060126;POP MIE BASO JUMBO;2;4200;0;8400;7666;734;
2021-01-30 13:01:46;8996001355008;BENG-BENG SP20G;1;29200;0;29200;26500;2700;
2021-01-30 13:01:46;8992761111540;FANTA STRAWBERY SLIM CAM 250ML;1;5000;0;5000;3750;1250;
2021-01-30 13:02:11;8997025914332;HATARI CREAM CRECKERS;4;5000;0;20000;19052;948;
2021-01-30 15:45:55;8992959077207;HN PANTS L 30;1;50000;0;50000;45455;4545;
2021-01-30 15:45:55;8997002060168;KRP SINGKOG PDS PANDA DUO;1;8000;0;8000;7300;700;
2021-01-30 15:45:55;8997011700123;BIHUN JAGUNG 300GR;1;5200;0;5200;4738;462;
2021-01-30 15:45:55;8992775001820;CHOCOLATOS WAFER CREAM;1;17500;0;17500;15761;1739;
2021-01-30 16:32:47;8992957220063;COKLAT BANGO;1;2000;0;2000;1700;300;
2021-01-30 16:32:47;8992957220186;COKLAT RUSA;1;2000;0;2000;1700;300;
2021-01-30 16:58:07;GL;GULA 1 LITER;1;11500;0;11500;10500;1000;
2021-01-30 16:58:07;8992628022156;BIMOLI KLASIK TOUCH 1 LT;1;15500;0;15500;14141;1359;
2021-01-30 16:58:57;8992761145033;FANTA STRAW PET 250ML;1;3500;0;3500;2417;1083;
2021-01-30 17:09:56;GL;GULA 1 LITER;2;11500;0;23000;21000;2000;
2021-01-30 17:09:56;8998866501026;MINYAK GORENG SEDAAP POUCH 1 L;1;14500;0;14500;14110;390;
2021-01-30 17:09:56;8999999195656;SARI WANGI 50X1.85;1;10000;0;10000;8700;1300;
2021-01-30 17:16:22;8992761002039;FANTA STRAWBERRY PET 390 ML;1;5500;0;5500;4300;1200;
2021-01-30 17:21:30;8992761166038;MMP ORANGE 300ML;3;5000;0;15000;11250;3750;
2021-01-30 17:21:30;8992761002022;SPRITE PET 390ML;1;5500;0;5500;4300;1200;
2021-01-30 17:34:00;8991102380805;FULLO  CKL PCK 8G;1;10000;0;10000;9000;1000;
2021-01-30 17:34:00;8998866202725;MILKU COKLAT PREMIUM 200ML;1;3000;0;3000;2375;625;
2021-01-30 17:34:00;8992388111145;MIE ABC SELERA PEDAS- SUP TOMAT PEDAS;1;2500;0;2500;2023;477;
2021-01-30 17:34:00;8992388111206;MIE ABC SELERA PEDAS-GULAI AYAM PEDAS;1;2500;0;2500;2022;478;
2021-01-30 17:34:00;8851019230573;POCKY STRAWBERRY 21G;1;5000;0;5000;3001;1999;
2021-01-30 17:34:00;8998866803694;SOKLIN SOFTERGENT PURPLE BAG 770 & PIRING;1;18000;0;18000;16055;1945;
2021-01-30 17:34:00;8999999516208;ROYCO FDS CHICKEN NEW 230G;1;9000;0;9000;8200;800;
2021-01-30 17:34:00;8992694247255;ZWITSAL BATH NAT HAIR&BODY 200ML;1;20500;0;20500;18810;1690;
2021-01-30 17:34:00;8999999529291;MOLTO PURE SACHET 10ML;2;6000;0;12000;9600;2400;
2021-01-30 17:34:00;8999999524722;SUNLIGHT LIME NEW PCH 435ML;1;10000;0;10000;9100;900;
2021-01-30 17:35:01;8992959953075;SWEETY BRONZE M9;1;17000;0;17000;15190;1810;
2021-01-30 18:01:48;8998866500708;FLORIDINA ORANGE;1;3000;0;3000;2500;500;
2021-01-30 18:01:48;8998866202060;PTABEE AYAM BAKAR PEDAS 35 GREXT15;1;4800;0;4800;4150;650;
2021-01-30 18:09:04;8993470411433;JOGER CLASSIC;2;1000;0;2000;1700;300;
2021-01-30 19:05:58;8851019230573;POCKY STRAWBERRY 21G;1;5000;0;5000;3001;1999;
2021-01-30 19:20:53;8992761164539;NUTRIBOOST ORANGE 300ML;1;6500;0;6500;5300;1200;
2021-01-30 19:23:05;8991004011906;KOPI BORONG;1;10000;0;10000;8333;1667;
2021-01-30 19:57:22;8997021870892;HOT IN CREAM STRONG 120G;1;18500;0;18500;17000;1500;
2021-01-30 20:49:22;8991001780133;TWISTER BLACK;1;5000;0;5000;4600;400;
2021-01-30 21:17:24;8998866200882;SUKSESMIE GORENG AYAM KRMS 133GR;1;3500;0;3500;3000;500;
2021-01-30 21:17:24;8998866613262;SUKSESMIE SOTO 111 GR;1;3500;0;3500;2770;730;
2021-01-30 21:17:24;8998866202619;SEDAAP MIE KOREAN SPICY SOUP BAG 77 GR;1;2300;0;2300;2027;273;
2021-01-30 21:17:24;8998866202343;NOODLE SEDAAP MIE KOREAN SPICY 87 GR;1;2500;0;2500;2023;477;
2021-01-30 21:17:24;8992388111206;MIE ABC SELERA PEDAS-GULAI AYAM PEDAS;1;2500;0;2500;2022;478;
2021-01-30 21:17:24;GL;GULA 1 LITER;1;11500;0;11500;10500;1000;
2021-01-30 21:17:24;8995333060772;TERIGU GATOT KACA 500GR;1;4500;0;4500;4065;435;
2021-01-30 21:17:24;8998866501033;MINYAK GORENG SEDAAP POUCH 2L;1;28500;0;28500;27746;754;
2021-01-30 21:17:24;8999999504656;SARI MURNI 20X1.8G;1;5000;0;5000;4200;800;
2021-01-30 21:17:24;8998866602273;HERSPROTEX SOFTCARE MAX;1;3500;0;3500;2950;550;
2021-01-30 21:17:24;8998866671736;CREAM EKONOMI 455G;2;5500;0;11000;9500;1500;
2021-01-30 21:17:24;8998866609043;DAIA SOFTENER GUSSET 565G;1;10000;0;10000;8700;1300;
2021-01-30 21:17:24;8998866611701;EKONOMI PENCUCI PIRING  LIQ 132ML;1;2000;0;2000;1337;663;
2021-01-30 21:17:24;8991111109121;JB POWDER BLOSSOM 75+25G;1;6000;0;6000;5430;570;
2021-01-30 21:17:24;8998866611206;FRES&NATURAL BLACK 100ML;1;11500;0;11500;10310;1190;
2021-01-30 21:17:24;8999999520151;PEPSODENT TB FAMILY SOFT;4;2100;0;8400;7600;800;
2021-01-30 21:17:24;8998866103985;CIPT SIKP;1;3000;0;3000;2552;448;
2021-01-30 21:17:24;8934868015031;REXONA DEO LOTION ICE COOL;2;4600;0;9200;7800;1400;
2021-01-30 21:17:24;8999999529833;CLEAR SHP ICM UNISEX 9 ML;1;10500;0;10500;9300;1200;
2021-01-30 21:17:24;8998866108003;EMERON HJB CLEANFRESH 10ML;1;5000;0;5000;4185;815;
2021-01-30 21:17:24;8999999554286;SAHAJA PMBRSH LANTAI KNTM BUNGA JERUK 350ML;1;5000;0;5000;4450;550;
2021-01-30 21:17:24;8999999706180;PEPSODENT WHITE 190GR;1;10000;0;10000;9350;650;
2021-01-30 21:17:24;8999999001124;LIFEBUOY MILD CARE REF 250ML;1;15000;0;15000;13550;1450;
2021-01-30 21:17:24;8999999030179;PEPSODENT ACTION 123 COMPLETE 75G;1;6700;0;6700;5170;1530;
2021-01-30 21:17:24;8999999719395;VASELINE HW UV LIGHTENING 100ML;1;12900;0;12900;11805;1095;
2021-01-30 21:17:24;8998866602556;NUVO FAMILY MERAH 76G;2;2000;0;4000;3640;360;
2021-01-30 21:17:24;8999999533724;CITRA TS PEARLY WHITE CNT 70G;2;2300;0;4600;3800;800;
2021-01-30 21:17:24;8999999533717;CITRA TS FRESH WHITE 70G;2;2200;0;4400;3800;600;
2021-01-30 21:17:24;8996001302347;SARI GANDUM FAM;1;8200;0;8200;7100;1100;
2021-01-30 21:17:24;8996001301142;ROMA KELAPA;1;8000;0;8000;6628;1372;
2021-01-30 21:17:24;8991102987639;WFR TANGO LONG VNL 130G;1;4200;0;4200;3773;427;
2021-01-30 21:17:24;8992753101207;BENDERA KENTAL MANIS 370G;1;11500;0;11500;9700;1800;
2021-01-30 21:17:24;8991102380805;FULLO  CKL PCK 8G;1;10000;0;10000;9000;1000;
2021-01-30 21:17:24;8992775001820;CHOCOLATOS WAFER CREAM;1;17500;0;17500;15761;1739;
2021-01-30 21:21:49;089686010107;INDOMIE KALDU AYAM;4;2500;0;10000;8620;1380;
2021-01-30 21:34:29;8992761145026;SPRITE PET 250ML;1;3500;0;3500;2417;1083;
2021-01-30 21:59:51;8998866202619;SEDAAP MIE KOREAN SPICY SOUP BAG 77 GR;2;2300;0;4600;4054;546;
2021-01-30 21:59:51;8998866200301;NOODLE SEDAAP GORENG  90 GR;1;2500;0;2500;2023;477;
2021-01-30 21:59:51;8998866200882;SUKSESMIE GORENG AYAM KRMS 133GR;1;3500;0;3500;3000;500;
2021-01-30 22:18:58;089686010343;INDOME SOTO MIE;2;2600;0;5200;4734;466;
2021-01-30 22:46:13;ARG;ARGUS 220ML;1;14500;0;14500;12500;2000;
2021-01-30 22:50:12;8998989300261;GUDANG GARAM SURYA 12 FILTER;1;18000;0;18000;16450;1550;
2021-01-30 22:50:12;123124;KOREK BIASA;1;2000;0;2000;1800;200;
2021-01-30 23:24:14;8994867000179;ROKOK PENA MILD 16;1;14500;0;14500;13000;1500;
2021-01-30 23:47:53;8992761166205;FRESTEA GREEN HONEY 350ML;1;4500;0;4500;3000;1500;
2021-01-30 23:47:53;8992761164539;NUTRIBOOST ORANGE 300ML;1;6500;0;6500;5300;1200;
2021-01-31 07:57:52;8997013790092;BIMURA KERUPUK BAWANG 25G;1;1000;0;1000;874;126;
2021-01-31 07:57:52;8996001318911;BETTER ISI 4;1;2000;0;2000;1700;300;
2021-01-31 08:25:37;8993470411433;JOGER CLASSIC;4;1000;0;4000;3400;600;
2021-01-31 08:25:37;8997013790092;BIMURA KERUPUK BAWANG 25G;1;1000;0;1000;874;126;
2021-01-31 08:31:33;8996001318911;BETTER ISI 4;1;2000;0;2000;1700;300;
2021-01-31 08:43:43;8990800004563;MENTOS 40X50 BUAH IND;1;5700;0;5700;5150;550;
2021-01-31 08:50:15;8991102987875;WFR TANGO POUCH CKL 115G;1;7000;0;7000;6273;727;
2021-01-31 08:50:15;GL;GULA 1 LITER;2;11500;0;23000;21000;2000;
2021-01-31 08:57:13;BR;BERAS 10L;1;86500;0;86500;85000;1500;
2021-01-31 08:57:13;8999999524722;SUNLIGHT LIME NEW PCH 435ML;1;10000;0;10000;9100;900;
2021-01-31 08:57:13;8998866610223;DAIA VIOLET BAG 850G & PIRING;1;18000;0;18000;15627;2373;
2021-01-31 08:57:13;8992753101207;BENDERA KENTAL MANIS 370G;1;11500;0;11500;9700;1800;
2021-01-31 08:57:13;8992628022156;BIMOLI KLASIK TOUCH 1 LT;1;15500;0;15500;14141;1359;
2021-01-31 08:57:13;8991102987875;WFR TANGO POUCH CKL 115G;1;7000;0;7000;6273;727;
2021-01-31 08:57:13;8993470411433;JOGER CLASSIC;1;1000;0;1000;850;150;
2021-01-31 09:47:58;8992761166205;FRESTEA GREEN HONEY 350ML;1;4500;0;4500;3000;1500;
2021-01-31 10:18:10;8998989300261;GUDANG GARAM SURYA 12 FILTER;1;18000;0;18000;16450;1550;
2021-01-31 10:22:34;8995333060703;TERIGU KOMPAS 1KG;1;10500;0;10500;9816;684;
2021-01-31 11:06:18;GL;GULA 1 LITER;5;11500;0;57500;52500;5000;
2021-01-31 11:06:18;8998989110167;SURYA GUDANG GARAM 16 FILTER;1;24000;0;24000;22100;1900;
2021-01-31 11:18:01;8998866200561;EKOMIE SUPER 600GR;2;10000;0;20000;17230;2770;
2021-01-31 12:10:21;8998989300261;GUDANG GARAM SURYA 12 FILTER;1;18000;0;18000;16450;1550;
2021-01-31 12:12:25;GL;GULA 1 LITER;2;11500;0;23000;21000;2000;
2021-01-31 12:54:40;8992761164539;NUTRIBOOST ORANGE 300ML;1;6500;0;6500;5300;1200;
2021-01-31 12:54:40;8996001304129;SLAI OLAI STROBERI;1;12000;0;12000;9900;2100;
2021-01-31 12:54:40;8992957220186;COKLAT RUSA;1;2000;0;2000;1700;300;
2021-01-31 12:54:40;8992957220063;COKLAT BANGO;1;2000;0;2000;1700;300;
2021-01-31 13:48:19;8992959117590;SFX DS REG FLOW WING 20;1;12000;0;12000;11250;750;
2021-01-31 13:48:19;8991102994422;TANGO WALUT CHOCOBNN 18G;1;8200;0;8200;7272;928;
2021-01-31 13:48:19;8999999538453;SUNSILK SHP SOFT AND  SMOOTH 55 ML;1;4500;0;4500;3750;750;
2021-01-31 13:49:56;8996001600399;LE MINERAL 1500ML;1;5000;0;5000;4042;958;
2021-01-31 13:49:56;BB;PASEO SMARTY FACIAL TRAVEL PACK 50S GT;1;2000;0;2000;1800;200;
2021-01-31 13:53:21;8998866202664;POTABEE WAGYU BEEF STEAK 68 GR;2;8000;0;16000;14400;1600;
2021-01-31 13:53:21;8998866202053;POTABEE AYAM BAKAR PEDAS 68GR;1;8000;0;8000;7200;800;
2021-01-31 13:53:21;8998866201377;KRISBEE FRIES KENTANG GORENG 68 GR;1;5500;0;5500;4620;880;
2021-01-31 13:53:21;8996001302323;MALKIST ABON;1;6500;0;6500;4800;1700;
2021-01-31 13:53:21;8992761139018;ADES 600ML;1;3500;0;3500;2292;1208;
2021-01-31 13:53:21;8992761002022;SPRITE PET 390ML;1;5500;0;5500;4300;1200;
2021-01-31 13:53:21;8992761166205;FRESTEA GREEN HONEY 350ML;1;4500;0;4500;3000;1500;
2021-01-31 16:09:54;8998866201865;KRISBEE PILLOW CHOCOLAVA 120 GR;1;8200;0;8200;7250;950;
2021-01-31 16:52:45;8999999549305;VASELINE SUPERFOOD CRANBERRY 200ML;1;26000;0;26000;23940;2060;
2021-01-31 16:52:45;8992696523081;MILO UHT 110ML;2;2500;0;5000;3924;1076;
2021-01-31 16:52:45;8992761122331;FRESTEA APPEL 500ML;1;6500;0;6500;4708;1792;
2021-01-31 16:52:45;8992388133017;NU MILK TEA ORI 330ML;1;5000;0;5000;4604;396;
2021-01-31 16:52:45;8999999549138;CLEAR HIJAB AD SHP HF TMT 160ML;1;25000;0;25000;23870;1130;
2021-01-31 16:56:27;8998989110167;SURYA GUDANG GARAM 16 FILTER;1;24000;0;24000;22100;1900;
2021-01-31 17:36:40;8995333060703;TERIGU KOMPAS 1KG;1;10500;0;10500;9816;684;
2021-01-31 17:40:26;8992775311325;GERY SNACK&SEREAL 100G;1;7000;0;7000;5892;1108;
2021-01-31 17:40:26;8851019230573;POCKY STRAWBERRY 21G;1;5000;0;5000;3001;1999;
2021-01-31 17:42:23;8991102385091;WFR TANGO CKLT 7G;1;8300;0;8300;7455;845;
2021-01-31 17:46:11;8992959002032;SWEETY SILVER PANTS L 36;1;72000;0;72000;68182;3818;
2021-01-31 18:04:49;8994867000179;ROKOK PENA MILD 16;1;14500;0;14500;13000;1500;
2021-01-31 18:25:41;8992761166052;FRESTEA MELATI 350ML;1;4500;0;4500;3000;1500;
2021-01-31 18:53:00;8992761139018;ADES 600ML;1;3500;0;3500;2292;1208;
2021-01-31 18:54:39;8991001502933;CHACHA TUBE;1;7500;0;7500;6400;1100;
2021-01-31 19:13:51;8998866201469;POTABEE REGULER BBQ BEEF 68 GR;1;8000;0;8000;7200;800;
2021-01-31 19:33:03;8992959953327;SWEETY BRONZE L52;1;85000;0;85000;80304;4696;
2021-01-31 19:49:11;8991001502933;CHACHA TUBE;1;7500;0;7500;6400;1100;
2021-01-31 20:33:45;8992696404441;BEAR BRAND 189ML;1;8500;0;8500;7887;613;
2021-01-31 20:35:07;8996001600399;LE MINERAL 1500ML;2;5000;0;10000;8084;1916;
2021-01-31 20:41:41;8992761139018;ADES 600ML;1;3500;0;3500;2292;1208;
2021-01-31 20:41:41;8999999554903;DOVE SHP TOTAL HAIRFALL TRMT 11ML;1;10500;0;10500;9300;1200;
2021-01-31 20:41:41;8998866201490;POTABEE REGULER GRILLED SEAWED 68 GR;1;8000;0;8000;7200;800;
2021-01-31 20:41:41;8992388133017;NU MILK TEA ORI 330ML;1;5000;0;5000;4604;396;
2021-01-31 20:41:41;8992761145026;SPRITE PET 250ML;1;3500;0;3500;2417;1083;
2021-01-31 21:05:25;8996001357088;ASTOR SINGLE 18GR;1;10800;0;10800;9800;1000;
2021-01-31 21:06:25;8998989300261;GUDANG GARAM SURYA 12 FILTER;1;18000;0;18000;16450;1550;
2021-01-31 21:07:16;8992761111533;SPRITE SLIM CAM250ML;1;5000;0;5000;3750;1250;
2021-01-31 21:35:25;8992761145026;SPRITE PET 250ML;1;3500;0;3500;2417;1083;
2021-01-31 21:38:03;8851019230566;POCKY CHOCO 22G;1;5000;0;5000;3001;1999;
2021-01-31 21:38:03;8996001350850;SUPER STAR SNAPS;1;16300;0;16300;14800;1500;
2021-01-31 21:38:03;8992761166038;MMP ORANGE 300ML;1;5000;0;5000;3750;1250;
2021-01-31 21:39:48;8992761111533;SPRITE SLIM CAM250ML;1;5000;0;5000;3750;1250;
2021-01-31 21:39:48;8992957220087;COKLAT SINGA;1;2000;0;2000;1700;300;
2021-01-31 21:41:42;8992761111533;SPRITE SLIM CAM250ML;1;5000;0;5000;3750;1250;
2021-01-31 22:06:14;8992761145033;FANTA STRAW PET 250ML;1;3500;0;3500;2417;1083;
2021-01-31 22:06:14;8992775211410;PILUS GARUDA PEDAS;1;5500;0;5500;4713;787;
2021-01-31 22:44:07;8993470411433;JOGER CLASSIC;1;1000;0;1000;850;150;
2021-01-31 22:44:45;8992775001691;GARUDA ROSTA WAGYU BEEF;3;8000;0;24000;21528;2472;
2021-01-31 22:52:32;8998989110167;SURYA GUDANG GARAM 16 FILTER;1;24000;0;24000;22100;1900;
2021-02-01 00:11:20;8992761139018;ADES 600ML;3;3500;0;10500;6876;3624;
2021-02-01 00:11:20;8992388133017;NU MILK TEA ORI 330ML;1;5000;0;5000;4604;396;
2021-02-01 07:24:24;GL;GULA 1 LITER;2;11500;0;23000;21000;2000;
2021-02-01 07:24:24;8998866501033;MINYAK GORENG SEDAAP POUCH 2L;1;28500;0;28500;27746;754;
2021-02-01 08:43:03;8998989121163;SURYA PRO MERAH;1;20000;0;20000;18600;1400;
2021-02-01 08:43:03;089686010824;INDOMIE GORENG SPESIAL;2;2700;0;5400;4904;496;
2021-02-01 10:14:16;089686011494;INDOMIE SOTO PADANG;1;2600;0;2600;2317;283;
2021-02-01 10:14:16;8998866200325;NOODLE SEDAAP MIE SOTO;1;2200;0;2200;1952;248;
2021-02-01 10:14:16;8998866202770;SEDAAP MIE GORENG SALERO PADANG 86 GR;1;2300;0;2300;2023;277;
2021-02-01 10:14:16;8998866200578;NOODLE SEDAAP KARI KENTAL SPC 75 GR;1;2300;0;2300;1952;348;
2021-02-01 11:37:09;8998989110167;SURYA GUDANG GARAM 16 FILTER;1;24000;0;24000;22100;1900;
2021-02-01 12:52:03;8992388133017;NU MILK TEA ORI 330ML;1;5000;0;5000;4604;396;
2021-02-01 14:07:43;8996001318911;BETTER ISI 4;1;2000;0;2000;1700;300;
2021-02-01 14:07:43;8996001301579;MALKIST CKLT KELAPA PACK;1;11000;0;11000;9900;1100;
2021-02-01 14:38:47;8998989300261;GUDANG GARAM SURYA 12 FILTER;1;18000;0;18000;16450;1550;
2021-02-01 14:52:52;8998866201889;KRISBEE PILLOW STRAWBERRY ICE CREAM 120GR;1;8200;0;8200;7250;950;
2021-02-01 14:52:52;8851019210117;POCKY CHOCOLATE 47G;1;7300;0;7300;5671;1629;
2021-02-01 17:06:35;9556040040038;SUSU F&N;1;33000;0;33000;30000;3000;
2021-02-01 17:06:35;8934868015031;REXONA DEO LOTION ICE COOL;1;4600;0;4600;3900;700;
2021-02-01 17:06:35;8999999042387;rexona;1;4600;0;4600;2500;2100;
2021-02-01 17:06:35;8999999059323;LIFEBOUY LEMONFRESH DG 75G;2;3000;0;6000;5000;1000;
2021-02-01 17:06:35;8998866610278;DAIA VIOLET GUSSET 565G;1;10000;0;10000;8700;1300;
2021-02-01 17:09:27;8998866610223;DAIA VIOLET BAG 850G & PIRING;1;18000;0;18000;15627;2373;
2021-02-01 17:14:44;8992753100101;BKM FULL CREAM GOLD 370;2;15000;0;30000;28000;2000;
2021-02-01 17:58:33;8998866202237;NOODLE SEDAAP TASTY AYAM GEPREK 124 GR;1;5000;0;5000;4167;833;
2021-02-01 17:58:33;8993470411433;JOGER CLASSIC;2;1000;0;2000;1700;300;
2021-02-01 17:58:33;8998866202732;MILKU STROBERI 200ML;1;3000;0;3000;2375;625;
2021-02-01 18:21:37;8992696404441;BEAR BRAND 189ML;5;8500;0;42500;39435;3065;
2021-02-01 18:21:37;8997013790092;BIMURA KERUPUK BAWANG 25G;2;1000;0;2000;1748;252;
2021-02-01 18:22:48;8998866201490;POTABEE REGULER GRILLED SEAWED 68 GR;1;8000;0;8000;7200;800;
2021-02-01 18:22:48;8992761122331;FRESTEA APPEL 500ML;2;6500;0;13000;9416;3584;
2021-02-01 18:32:06;8998866202725;MILKU COKLAT PREMIUM 200ML;3;3000;0;9000;7125;1875;
2021-02-01 18:32:06;8998866202732;MILKU STROBERI 200ML;3;3000;0;9000;7125;1875;
2021-02-01 18:32:06;8998866202053;POTABEE AYAM BAKAR PEDAS 68GR;1;8000;0;8000;7200;800;
2021-02-01 18:32:06;8991001121400;SILVERQUEEN ALMOND 65G;1;15000;0;15000;13200;1800;
2021-02-01 18:32:06;8998866106979;CIPTADENT TB CHARCOAL PROTEC;1;6000;0;6000;5250;750;
2021-02-01 18:32:06;8999999710866;soklin;1;18000;0;18000;17500;500;
2021-02-01 18:32:06;8999999529604;CLEAR SHP COMPLETE CARE MEN 160ML;1;24800;0;24800;22700;2100;
2021-02-01 18:32:06;GL;GULA 1 LITER;1;11500;0;11500;10500;1000;
2021-02-01 18:39:39;8998866202732;MILKU STROBERI 200ML;1;3000;0;3000;2375;625;
2021-02-01 18:59:13;8851019230566;POCKY CHOCO 22G;1;5000;0;5000;3001;1999;
2021-02-01 19:00:21;8998866201865;KRISBEE PILLOW CHOCOLAVA 120 GR;1;8200;0;8200;7250;950;
2021-02-01 19:00:21;8992761111533;SPRITE SLIM CAM250ML;2;5000;0;10000;7500;2500;
2021-02-01 19:04:00;8999999045920;LIFEBUOY TS TOTAL 10 110GR;4;3500;0;14000;14000;0;
2021-02-01 19:04:00;8999999534769;PEPSODENT ACTION123 CHARCOAL 160G;1;16800;0;16800;15345;1455;
2021-02-01 19:04:00;8998866501026;MINYAK GORENG SEDAAP POUCH 1 L;1;14500;0;14500;14110;390;
2021-02-01 19:04:00;GL;GULA 1 LITER;2;11500;0;23000;21000;2000;
2021-02-01 19:04:00;8999999059781;SUNLIGHT LIME NEW POUCH 210ML;1;5000;0;5000;4300;700;
2021-02-01 19:04:00;8999999031602;SARI MURNI 20X1.6G;1;6000;0;6000;5400;600;
2021-02-01 19:04:00;8999999007768;FAIR&LOVELY MULTIVITAMIN  CREAM 9 ML;1;4500;0;4500;38400;-33900;
2021-02-01 19:04:00;8998866107495;ZINC HAIRFALL TREATH SHT 10ML;1;5000;0;5000;4500;500;
2021-02-01 19:04:36;8998866106535;EMERON LOVELY NAT GREEN 200ML;1;6000;0;6000;5075;925;
2021-02-01 19:04:36;8998866106467;POSH LOVE SONG 150ML;1;19500;0;19500;17500;2000;
2021-02-01 19:24:36;8992761122331;FRESTEA APPEL 500ML;1;6500;0;6500;4708;1792;
2021-02-01 19:24:36;8998866201865;KRISBEE PILLOW CHOCOLAVA 120 GR;1;8200;0;8200;7250;950;
2021-02-01 19:25:25;8991001780133;TWISTER BLACK;1;5000;0;5000;4600;400;
2021-02-01 19:34:54;089686061024;POP MIE MINI SOTO RL;1;3000;0;3000;2702;298;
2021-02-01 19:34:54;089686061079;POP MIE MINI AY BAWANG RL;2;3000;0;6000;5404;596;
2021-02-01 19:35:57;8992761145026;SPRITE PET 250ML;1;3500;0;3500;2417;1083;
2021-02-01 20:23:07;8992388133345;NU MILK TEA TEH TARIK 330ML;1;5000;0;5000;4604;396;
2021-02-01 20:28:04;BB;PASEO SMARTY FACIAL TRAVEL PACK 50S GT;1;2000;0;2000;1800;200;
2021-02-01 20:32:07;8998009010569;ULTRA CHO 200;1;4700;0;4700;3830;870;
2021-02-01 21:18:53;8998866608824;KECAP MANIS SEDAAP BTL PLTSK 620ML;1;26000;0;26000;23460;2540;
2021-02-01 21:18:53;8999999706661;PEPSODENT TB DBL CARE SENSITIVE;1;11500;0;11500;10400;1100;
2021-02-01 21:18:53;8999999706180;PEPSODENT WHITE 190GR;1;10000;0;10000;9350;650;
2021-02-01 21:25:22;8992761139018;ADES 600ML;1;3500;0;3500;2292;1208;
2021-02-01 21:53:48;8992761166038;MMP ORANGE 300ML;1;5000;0;5000;3750;1250;
2021-02-01 21:56:27;8994867006997;ROKOK PENA BOLD 20BTG;1;17000;0;17000;15000;2000;
2021-02-01 21:56:27;8992761145019;COCA COLA PET 250ML;1;3500;0;3500;2417;1083;
2021-02-01 21:56:27;8992761145033;FANTA STRAW PET 250ML;1;3500;0;3500;2417;1083;
2021-02-01 22:04:11;8992775001042;PILUS GARUDA MI GORENG;1;5500;0;5500;4713;787;
2021-02-01 23:20:02;089686010343;INDOME SOTO MIE;1;2600;0;2600;2367;233;
2021-02-02 09:05:02;8998866201490;POTABEE REGULER GRILLED SEAWED 68 GR;1;8000;0;8000;7200;800;
2021-02-02 09:05:02;8851019230566;POCKY CHOCO 22G;1;5000;0;5000;3001;1999;
2021-02-02 09:05:02;8996001600375;LE MINERAL 330ML;2;2000;0;4000;2834;1166;
2021-02-02 09:05:02;8996001318911;BETTER ISI 4;1;2000;0;2000;1700;300;
2021-02-02 10:21:54;8998989500166;GUDANG GARAM MERAH BESAR 16KS;2;17000;0;34000;30600;3400;
2021-02-02 10:21:54;8998989500128;GUDANG GARAM MERAH KECIL 12KS;1;13000;0;13000;11900;1100;
2021-02-02 10:22:59;ARG;ARGUS 220ML;1;14500;0;14500;12500;2000;
2021-02-02 10:27:40;8998898847109;KOPI JAHE;1;1500;0;1500;11800;-10300;
2021-02-02 10:27:40;8998866200837;NOODLE SEDAAPMIE SOTO CUP 81 GR;1;4500;0;4500;3650;850;
2021-02-02 10:54:44;089686061079;POP MIE MINI AY BAWANG RL;2;3000;0;6000;5404;596;
2021-02-02 11:15:38;8998866202725;MILKU COKLAT PREMIUM 200ML;1;3000;0;3000;2375;625;
2021-02-02 11:26:56;8997025911706;HATARI SHP MARGARINE;2;5000;0;10000;9526;474;
2021-02-02 11:27:11;GL;GULA 1 LITER;1;11500;0;11500;10500;1000;
2021-02-02 11:33:48;8991111101422;JB POWDER 200G;1;11700;0;11700;10660;1040;
2021-02-02 11:33:48;8999999529628;CLEAR COMP SOFT CARE 160ML;1;23400;0;23400;21400;2000;
2021-02-02 12:06:43;8992761139018;ADES 600ML;2;3500;0;7000;4584;2416;
2021-02-02 12:11:33;8992761166038;MMP ORANGE 300ML;1;5000;0;5000;3750;1250;
2021-02-02 12:12:33;8992761145033;FANTA STRAW PET 250ML;3;3500;0;10500;7251;3249;
2021-02-02 12:12:33;8992761145026;SPRITE PET 250ML;1;3500;0;3500;2417;1083;
2021-02-02 12:12:33;8992761166052;FRESTEA MELATI 350ML;1;4500;0;4500;3000;1500;
2021-02-02 14:34:20;8995333060703;TERIGU KOMPAS 1KG;1;10500;0;10500;9816;684;
2021-02-02 14:44:27;8992761002039;FANTA STRAWBERRY PET 390 ML;1;5500;0;5500;4300;1200;
2021-02-02 16:21:53;8992761139018;ADES 600ML;1;3500;0;3500;2292;1208;
2021-02-02 16:27:56;8997013790108;BIMURA KACANG TELUR 25G;1;1000;0;1000;875;125;
2021-02-02 16:45:18;8997013790108;BIMURA KACANG TELUR 25G;1;1000;0;1000;875;125;
2021-02-02 16:56:47;8993470279651;JOGER CHOCKY BAR;1;1000;0;1000;867;133;
2021-02-02 17:01:10;8998866202725;MILKU COKLAT PREMIUM 200ML;1;3000;0;3000;2375;625;
2021-02-02 17:03:40;8998866202732;MILKU STROBERI 200ML;1;3000;0;3000;2375;625;
2021-02-02 17:34:10;8993470279651;JOGER CHOCKY BAR;2;1000;0;2000;1734;266;
2021-02-02 17:46:39;8993470279651;JOGER CHOCKY BAR;1;1000;0;1000;867;133;
2021-02-02 18:33:34;089686061024;POP MIE MINI SOTO RL;2;3000;0;6000;5404;596;
2021-02-02 18:33:34;089686061079;POP MIE MINI AY BAWANG RL;2;3000;0;6000;5404;596;
2021-02-02 18:34:18;8998989300261;GUDANG GARAM SURYA 12 FILTER;1;18000;0;18000;16450;1550;
2021-02-02 19:00:29;8997025911706;HATARI SHP MARGARINE;1;5000;0;5000;4763;237;
2021-02-02 19:15:49;089686060027;POP MIE AYAM JUMBO;1;4500;0;4500;3833;667;
2021-02-02 19:44:10;GL;GULA 1 LITER;3;11500;0;34500;31500;3000;
2021-02-02 20:16:54;GL;GULA 1 LITER;1;11500;0;11500;10500;1000;
2021-02-02 20:20:04;8993470279651;JOGER CHOCKY BAR;2;1000;0;2000;1734;266;
2021-02-02 20:26:58;8998866202244;EKOMIE BUMBU KALDU AYAM;5;1000;0;5000;4300;700;
2021-02-02 20:46:07;8999999033217;LIFEBUOY SHP ANTI KETEMBE 170ML;1;16500;0;16500;14950;1550;
2021-02-02 20:58:01;8999999504656;SARI MURNI 20X1.8G;1;5000;0;5000;4200;800;
2021-02-02 20:58:58;8991663000723;KOREK;1;2000;0;2000;1500;500;
2021-02-02 21:00:30;123124;KOREK BIASA;1;2000;0;2000;1800;200;
2021-02-02 21:53:45;8998989110167;SURYA GUDANG GARAM 16 FILTER;2;24000;0;48000;44200;3800;
2021-02-02 22:07:26;8998866202732;MILKU STROBERI 200ML;1;3000;0;3000;2375;625;
2021-02-02 22:17:40;8998866201490;POTABEE REGULER GRILLED SEAWED 68 GR;1;8000;0;8000;7200;800;
2021-02-02 22:23:10;8993470279651;JOGER CHOCKY BAR;5;1000;0;5000;4335;665;
2021-02-02 22:23:10;8993470411433;JOGER CLASSIC;7;1000;0;7000;5950;1050;
2021-02-02 22:23:10;8991001503114;CHACHA MILK CHOCOLATE 35G;1;5500;0;5500;4900;600;
2021-02-02 22:29:05;8998866202770;SEDAAP MIE GORENG SALERO PADANG 86 GR;1;2500;0;2500;2023;477;
2021-02-02 22:29:05;8998866200325;NOODLE SEDAAP MIE SOTO;1;2200;0;2200;1952;248;
2021-02-02 22:29:05;089686010107;INDOMIE KALDU AYAM;1;2500;0;2500;2155;345;
2021-02-02 22:29:05;089686011494;INDOMIE SOTO PADANG;1;2600;0;2600;2317;283;
2021-02-02 23:19:13;8851019230566;POCKY CHOCO 22G;1;5000;0;5000;3001;1999;
2021-02-02 23:47:15;089686043204;INDOMIE MIE ACEH;2;2700;0;5400;4904;496;
2021-02-02 23:47:15;8998866202770;SEDAAP MIE GORENG SALERO PADANG 86 GR;1;2500;0;2500;2023;477;
2021-02-02 23:47:15;8998866202732;MILKU STROBERI 200ML;2;3000;0;6000;4750;1250;
2021-02-02 23:50:22;8998866202725;MILKU COKLAT PREMIUM 200ML;2;3000;0;6000;4750;1250;
2021-02-03 00:08:05;8992761145026;SPRITE PET 250ML;3;3500;0;10500;7251;3249;
2021-02-03 00:08:45;8998866201711;KRISBEE KRUNCHY JAGUNG BAKAR MENTEGA 75 GR;1;5000;0;5000;4400;600;
2021-02-03 00:09:44;8998866201711;KRISBEE KRUNCHY JAGUNG BAKAR MENTEGA 75 GR;3;5000;0;15000;13200;1800;
2021-02-03 00:09:44;8998866201452;POTABEE REGULER BBQ BEEF 35GR;1;4800;0;4800;4150;650;
2021-02-03 00:10:38;8997013790108;BIMURA KACANG TELUR 25G;3;1000;0;3000;2625;375;
2021-02-03 09:01:40;ARG;ARGUS 220ML;1;14500;0;14500;12500;2000;
2021-02-03 09:08:35;8998866202664;POTABEE WAGYU BEEF STEAK 68 GR;1;8000;0;8000;7200;800;
2021-02-03 09:21:25;8992761166205;FRESTEA GREEN HONEY 350ML;4;4500;0;18000;12000;6000;
2021-02-03 09:21:25;8992761139018;ADES 600ML;4;3500;0;14000;9168;4832;
2021-02-03 09:21:25;8991001121400;SILVERQUEEN ALMOND 65G;1;15000;0;15000;13200;1800;
2021-02-03 09:23:17;8998866501033;MINYAK GORENG SEDAAP POUCH 2L;1;28500;0;28500;27746;754;
2021-02-03 10:49:14;9556001025272;NESCAFE LATTE 240ML;1;8000;0;8000;7437;563;
2021-02-03 10:49:42;8992696523081;MILO UHT 110ML;2;2500;0;5000;3924;1076;
2021-02-03 11:09:06;089686061024;POP MIE MINI SOTO RL;1;3000;0;3000;2702;298;
2021-02-03 11:09:06;089686061079;POP MIE MINI AY BAWANG RL;1;3000;0;3000;2702;298;
2021-02-03 11:55:16;8992957220063;COKLAT BANGO;1;2000;0;2000;1700;300;
2021-02-03 11:55:16;8991001780133;TWISTER BLACK;1;5000;0;5000;4600;400;
2021-02-03 11:55:16;8996001600146;TEH PUCUK HARUM 350ML;3;3000;0;9000;6942;2058;
2021-02-03 11:55:16;8998866200851;NOODLE SEDAAP MIE BAKSO SPESIAL CUP 77 GR;1;4500;0;4500;3650;850;
2021-02-03 11:55:16;8998866200837;NOODLE SEDAAPMIE SOTO CUP 81 GR;1;4500;0;4500;3650;850;
2021-02-03 13:05:08;8997013790108;BIMURA KACANG TELUR 25G;5;1000;0;5000;4375;625;
2021-02-03 13:05:08;8996001318430;BETTER 1000;2;1000;0;2000;1640;360;
2021-02-03 13:05:08;8998898810721;KKB ENER-G C1000;1;8000;0;8000;6690;1310;
2021-02-03 13:05:08;8992753031900;BKM SCT PUTIH 40G;1;7500;0;7500;6900;600;
2021-02-03 14:00:07;8997025914059;HATARI SEE HONG;2;5000;0;10000;9526;474;
2021-02-03 14:00:07;8998866202725;MILKU COKLAT PREMIUM 200ML;1;3000;0;3000;2375;625;
2021-02-03 14:00:07;8998009020186;BUAVITA GUAVA 250ML;1;6600;0;6600;5950;650;
2021-02-03 14:06:32;8998866202664;POTABEE WAGYU BEEF STEAK 68 GR;1;8000;0;8000;7200;800;
2021-02-03 14:06:32;8998866202435;JAPOTA UMAMI JAPANESE SEAWEED 35GR;1;5000;0;5000;4150;850;
2021-02-03 14:49:15;8993470279651;JOGER CHOCKY BAR;2;1000;0;2000;1734;266;
2021-02-03 14:49:15;8991001111883;SILVERQUEEN CHUNKYBAR 33G;1;8000;0;8000;7150;850;
2021-02-03 14:56:47;8992761166038;MMP ORANGE 300ML;2;5000;0;10000;7500;2500;
2021-02-03 15:01:37;8998989110167;SURYA GUDANG GARAM 16 FILTER;1;24000;0;24000;22100;1900;
2021-02-03 16:55:15;GL;GULA 1 LITER;1;11500;0;11500;10500;1000;
2021-02-03 17:06:57;089686041705;INDOMIE GORENG JUMBO;1;3500;0;3500;3143;357;
2021-02-03 17:24:54;8999999516208;ROYCO FDS CHICKEN NEW 230G;1;9000;0;9000;8200;800;
2021-02-03 17:24:54;8999999537180;CLEAR SHP LEMON FRESH 9 ML;1;10500;0;10500;9300;1200;
2021-02-03 17:27:13;8998866201452;POTABEE REGULER BBQ BEEF 35GR;2;4800;0;9600;8300;1300;
2021-02-03 19:32:45;8998866202725;MILKU COKLAT PREMIUM 200ML;1;3000;0;3000;2375;625;
2021-02-03 19:32:45;8993470279651;JOGER CHOCKY BAR;1;1000;0;1000;867;133;
2021-02-03 21:05:23;8998866200301;NOODLE SEDAAP GORENG  90 GR;1;2500;0;2500;2023;477;
2021-02-03 22:02:25;8992761122331;FRESTEA APPEL 500ML;1;6500;0;6500;4708;1792;
2021-02-03 22:02:25;8996001600146;TEH PUCUK HARUM 350ML;1;3000;0;3000;2314;686;
2021-02-03 22:02:25;8992761145026;SPRITE PET 250ML;1;3500;0;3500;2417;1083;
2021-02-03 22:51:28;8998866105507;EMERON LOVELY NOURIST&BRIGHT 100ML;2;4300;0;8600;7600;1000;
2021-02-03 22:51:28;8999999007768;FAIR&LOVELY MULTIVITAMIN  CREAM 9 ML;1;4500;0;4500;3200;1300;
2021-02-03 22:51:28;8993470279651;JOGER CHOCKY BAR;4;1000;0;4000;3468;532;
2021-02-03 22:51:28;8998866608718;DAIA SOFTENER PINK;1;5000;0;5000;4450;550;
2021-02-03 22:51:28;8999999195656;SARI WANGI 50X1.85;1;10000;0;10000;8700;1300;
2021-02-03 22:51:28;8996001301142;ROMA KELAPA;1;8000;0;8000;6628;1372;
2021-02-03 22:51:28;8993470671752;JOGER STICK DUO KACANG;1;1000;0;1000;850;150;
2021-02-03 22:54:24;8991102987899;WFR TANGO POUCH VNL 115G;1;7000;0;7000;6273;727;
2021-02-03 22:54:24;089686011036;INDOMIE GORENG PEDAS;1;2700;0;2700;2452;248;
2021-02-03 22:54:24;089686010824;INDOMIE GORENG SPESIAL;1;2700;0;2700;2452;248;
2021-02-03 22:54:24;089686010107;INDOMIE KALDU AYAM;1;2500;0;2500;2155;345;
2021-02-03 22:54:24;8997013790108;BIMURA KACANG TELUR 25G;2;1000;0;2000;1750;250;
2021-02-04 08:58:35;8997025911706;HATARI SHP MARGARINE;1;5000;0;5000;4763;237;
2021-02-04 09:31:26;GL;GULA 1 LITER;1;11500;0;11500;10500;1000;
2021-02-04 09:33:03;8992761147143;SPRITE WATERLYMON 425ML;1;5500;0;5500;4300;1200;
2021-02-04 09:58:49;8998989300261;GUDANG GARAM SURYA 12 FILTER;1;18000;0;18000;16450;1550;
2021-02-04 11:04:52;8996001600375;LE MINERAL 330ML;5;2000;0;10000;7085;2915;
2021-02-04 11:04:52;8992957220087;COKLAT SINGA;5;2000;0;10000;8500;1500;
2021-02-04 11:09:45;8992775001042;PILUS GARUDA MI GORENG;1;5500;0;5500;4713;787;
2021-02-04 11:19:53;8992761002039;FANTA STRAWBERRY PET 390 ML;1;5500;0;5500;4300;1200;
2021-02-04 11:19:53;8992761002022;SPRITE PET 390ML;1;5500;0;5500;4300;1200;
2021-02-04 13:23:13;8998866202244;EKOMIE BUMBU KALDU AYAM;2;1000;0;2000;1720;280;
2021-02-04 13:23:30;8997013790108;BIMURA KACANG TELUR 25G;1;1000;0;1000;875;125;
2021-02-04 13:39:22;8992696523081;MILO UHT 110ML;1;2500;0;2500;1962;538;
2021-02-04 13:43:03;8993470279651;JOGER CHOCKY BAR;1;1000;0;1000;867;133;
2021-02-04 14:11:58;8996001600146;TEH PUCUK HARUM 350ML;1;3000;0;3000;2314;686;
2021-02-04 14:11:58;8992775311325;GERY SNACK&SEREAL 100G;1;7000;0;7000;5892;1108;
2021-02-04 14:11:58;8991102987899;WFR TANGO POUCH VNL 115G;1;7000;0;7000;6273;727;
2021-02-04 14:11:58;8997013790108;BIMURA KACANG TELUR 25G;1;1000;0;1000;875;125;
2021-02-04 14:11:58;8997013790092;BIMURA KERUPUK BAWANG 25G;2;1000;0;2000;1748;252;
2021-02-04 14:24:50;8992761139018;ADES 600ML;1;3500;0;3500;2292;1208;
2021-02-04 14:24:50;8997013790108;BIMURA KACANG TELUR 25G;1;1000;0;1000;875;125;
2021-02-04 14:44:50;089686041705;INDOMIE GORENG JUMBO;2;3500;0;7000;6286;714;
2021-02-04 14:45:07;8998866201841;GOLDA DOLCE LATTE 200ML;1;3000;0;3000;2500;500;
2021-02-04 15:35:34;8991102987875;WFR TANGO POUCH CKL 115G;1;7000;0;7000;6273;727;
2021-02-04 15:35:34;8997021870137;FRESH CARE SPLASH FRUITY 10ML;1;12000;0;12000;10000;2000;
2021-02-04 16:13:36;8997210107877;VORTEX SMART 3;1;10000;0;10000;9500;500;
2021-02-04 16:41:11;8998866500708;FLORIDINA ORANGE;1;3000;0;3000;2500;500;
2021-02-04 16:41:11;8998866202237;NOODLE SEDAAP TASTY AYAM GEPREK 124 GR;1;5000;0;5000;4167;833;
2021-02-04 16:41:11;8998866202312;NOODLE SEDAAP TASTY BAKMI AYAM 129 GR;1;5000;0;5000;4167;833;
2021-02-04 16:41:11;8993470279651;JOGER CHOCKY BAR;1;1000;0;1000;867;133;
2021-02-04 16:44:58;8998989110167;SURYA GUDANG GARAM 16 FILTER;1;24000;0;24000;22100;1900;
2021-02-04 16:47:09;8992761122331;FRESTEA APPEL 500ML;1;6500;0;6500;4708;1792;
2021-02-04 16:53:14;8999999401252;RINSO ANTI NODA CLASSIC 1.8KG;1;44800;0;44800;40726;4074;
2021-02-04 16:53:14;8934868015024;REXONA DEO LOTION FREE SPIRIT 9G;12;4600;0;55200;46800;8400;
2021-02-04 16:53:14;8999999537180;CLEAR SHP LEMON FRESH 9 ML;1;10500;0;10500;9300;1200;
2021-02-04 16:53:14;8998866608329;CREAM EKONOMI PUTIH 455G;1;5500;0;5500;4750;750;
2021-02-04 18:09:55;8992753102204;BKM COKLAT 370G;1;11300;0;11300;9500;1800;
2021-02-04 19:41:14;8999999390198;SUNLIGHT LIME NEW POUCH 755ML;1;17000;0;17000;15400;1600;
2021-02-04 20:43:59;8997013790092;BIMURA KERUPUK BAWANG 25G;1;1000;0;1000;874;126;
2021-02-04 20:43:59;8991001503114;CHACHA MILK CHOCOLATE 35G;1;5500;0;5500;4900;600;
2021-02-04 21:50:48;8999999008475;SUNLIGHT LIME NEW REF 1600ML;1;33000;0;33000;29800;3200;
2021-02-04 21:59:38;8998989300261;GUDANG GARAM SURYA 12 FILTER;1;18000;0;18000;16450;1550;
2021-02-04 22:27:05;ARG;ARGUS 220ML;1;14500;0;14500;12500;2000;
2021-02-04 22:31:59;8998866610261;POWDET DAIA SOFTENER BAG 290 GR;1;5000;0;5000;4450;550;
2021-02-04 22:31:59;8998866808729;ROYALE SOFT WHITE;1;5000;0;5000;4500;500;
2021-02-04 22:52:04;ARG;ARGUS 220ML;1;14500;0;14500;12500;2000;
2021-02-04 23:10:54;8996001301142;ROMA KELAPA;1;8000;0;8000;6628;1372;
2021-02-04 23:10:54;8997013790108;BIMURA KACANG TELUR 25G;2;1000;0;2000;1750;250;
2021-02-05 08:54:09;ARG;ARGUS 220ML;1;14500;0;14500;12500;2000;
2021-02-05 09:46:55;BB;PASEO SMARTY FACIAL TRAVEL PACK 50S GT;1;2000;0;2000;1800;200;
2021-02-05 10:39:44;GL;GULA 1 LITER;1;11500;0;11500;10500;1000;
2021-02-05 10:55:13;8998866200844;NOODLE SEDAAP MIE KARI SPESIAL CUP 81 GR;1;4500;0;4500;3650;850;
2021-02-05 10:55:13;8997013790108;BIMURA KACANG TELUR 25G;2;1000;0;2000;1750;250;
2021-02-05 10:55:13;8997013790092;BIMURA KERUPUK BAWANG 25G;2;1000;0;2000;1748;252;
2021-02-05 10:55:13;8991001111883;SILVERQUEEN CHUNKYBAR 33G;2;8000;0;16000;14300;1700;
2021-02-05 10:55:13;8992775001042;PILUS GARUDA MI GORENG;1;5500;0;5500;4713;787;
2021-02-05 12:09:59;8997013790108;BIMURA KACANG TELUR 25G;6;1000;0;6000;5250;750;
2021-02-05 14:20:02;8998866202770;SEDAAP MIE GORENG SALERO PADANG 86 GR;2;2500;0;5000;4046;954;
2021-02-05 14:28:10;8999999549305;VASELINE SUPERFOOD CRANBERRY 200ML;1;26000;0;26000;23940;2060;
2021-02-05 16:10:41;089686010107;INDOMIE KALDU AYAM;1;2500;0;2500;2155;345;
2021-02-05 16:10:41;8996001304990;SARI GANDUM 115G;1;6000;0;6000;5100;900;
2021-02-05 16:10:41;8998866202770;SEDAAP MIE GORENG SALERO PADANG 86 GR;2;2500;0;5000;4046;954;
2021-02-05 16:10:41;089686043204;INDOMIE MIE ACEH;1;2700;0;2700;2452;248;
2021-02-05 16:53:31;8992761166205;FRESTEA GREEN HONEY 350ML;1;4500;0;4500;3000;1500;
2021-02-05 18:51:53;8992761002039;FANTA STRAWBERRY PET 390 ML;1;5500;0;5500;4300;1200;
2021-02-05 18:55:32;8991111101507;JB POWDER BLOSSOM 50G;1;3500;0;3500;3000;500;
2021-02-05 18:55:32;8999999059323;LIFEBOUY LEMONFRESH DG 75G;1;3000;0;3000;2500;500;
2021-02-05 18:56:38;8997013790092;BIMURA KERUPUK BAWANG 25G;3;1000;0;3000;2622;378;
2021-02-05 19:43:13;8992775002087;GARUDA TING-TING 84G;1;6000;0;6000;4924;1076;
2021-02-05 19:43:13;8992761002039;FANTA STRAWBERRY PET 390 ML;1;5500;0;5500;4300;1200;
2021-02-05 19:43:13;8998866201889;KRISBEE PILLOW STRAWBERRY ICE CREAM 120GR;1;8200;0;8200;7250;950;
2021-02-05 19:43:13;8998866202404;NOODLE SEDAAP MIE KOREAN SPICY CHICKEN CUP;1;5000;0;5000;3917;1083;
2021-02-05 19:43:13;8992761145033;FANTA STRAW PET 250ML;3;3500;0;10500;7251;3249;
2021-02-05 19:43:13;8992761145026;SPRITE PET 250ML;1;3500;0;3500;2417;1083;
2021-02-05 19:43:13;8992761145019;COCA COLA PET 250ML;1;3500;0;3500;2417;1083;
2021-02-05 19:43:13;8992957220186;COKLAT RUSA;2;2000;0;4000;3400;600;
2021-02-05 19:48:12;8992761145026;SPRITE PET 250ML;1;3500;0;3500;2417;1083;
2021-02-05 20:16:37;8998989100120;GUDANG GARAM MINI;1;18000;0;18000;16600;1400;
2021-02-05 20:16:37;8998989300261;GUDANG GARAM SURYA 12 FILTER;1;18000;0;18000;16450;1550;
2021-02-05 20:33:38;8851019510132;POCKY;1;7300;0;7300;7000;300;
2021-02-05 20:33:38;8991001111883;SILVERQUEEN CHUNKYBAR 33G;1;8000;0;8000;7150;850;
2021-02-05 20:47:28;089686067002;POP MIE PDS DOWER RS AYAM;1;5000;0;5000;4450;550;
2021-02-05 20:47:28;089686010343;INDOMIE SOTO MIE;2;2600;0;5200;4734;466;
2021-02-05 20:47:28;8999999195656;SARI WANGI 50X1.85;1;10000;0;10000;8700;1300;
2021-02-05 20:47:28;8997013790108;BIMURA KACANG TELUR 25G;1;1000;0;1000;875;125;
2021-02-05 21:30:32;8992761166205;FRESTEA GREEN HONEY 350ML;2;4500;0;9000;6000;3000;
2021-02-05 22:43:03;8992761002022;SPRITE PET 390ML;1;5500;0;5500;4300;1200;
2021-02-05 23:00:36;089686010343;INDOMIE SOTO MIE;1;2600;0;2600;2367;233;
2021-02-05 23:00:36;089686010107;INDOMIE KALDU AYAM;1;2500;0;2500;2155;345;
2021-02-05 23:34:00;8992696404441;BEAR BRAND 189ML;6;8500;0;51000;47322;3678;
2021-02-05 23:34:00;8996001600375;LE MINERAL 330ML;6;2000;0;12000;8502;3498;
2021-02-05 23:34:00;8991102300544;WFR TANGO VNL 176G;2;9200;0;18400;16672;1728;
2021-02-06 08:30:56;8998866608725;DAIA SOFTENER BAG 850G;1;18000;0;18000;15627;2373;
2021-02-06 08:30:56;8998866601436;PODET DAIA BUNGA BAG 850GR & PIRING;1;17300;0;17300;15627;1673;
2021-02-06 08:30:56;8998866501033;MINYAK GORENG SEDAAP POUCH 2L;1;28500;0;28500;27746;754;
2021-02-06 08:37:14;8992753631209;OMELA 370;2;9500;0;19000;16800;2200;
2021-02-06 08:58:40;8999999516208;ROYCO FDS CHICKEN NEW 230G;1;9000;0;9000;8200;800;
2021-02-06 08:58:40;8991102385091;WFR TANGO CKLT 7G;1;8300;0;8300;7455;845;
2021-02-06 08:58:40;8998866692601;SOKLIN FLOORCLENER HIJAU 450ML;1;7000;0;7000;6385;615;
2021-02-06 08:58:40;8998866107457;POSH SUMMER LOVE 150ML;1;19500;0;19500;17500;2000;
2021-02-06 08:58:40;8992959117590;SFX DS REG FLOW WING 20;1;12000;0;12000;11250;750;
2021-02-06 08:58:40;8998866103985;CIPT SIKP;2;3000;0;6000;5104;896;
2021-02-06 08:58:40;8998866202343;NOODLE SEDAAP MIE KOREAN SPICY 87 GR;4;2500;0;10000;8092;1908;
2021-02-06 08:58:40;8998866200301;NOODLE SEDAAP GORENG  90 GR;2;2500;0;5000;4046;954;
2021-02-06 08:58:40;8999999057640;MOLTO EDP BLK PURPLE 20ML;5;1000;0;5000;4000;1000;
2021-02-06 08:58:40;BB;PASEO SMARTY FACIAL TRAVEL PACK 50S GT;1;2000;0;2000;1800;200;
2021-02-06 08:58:40;8998009010569;ULTRA CHO 200;4;4700;0;18800;15320;3480;
2021-02-06 10:33:23;8998989300261;GUDANG GARAM SURYA 12 FILTER;1;18000;0;18000;16450;1550;
2021-02-06 13:14:35;8998866201452;POTABEE REGULER BBQ BEEF 35GR;1;4800;0;4800;4150;650;
2021-02-06 13:14:35;8998866201841;GOLDA DOLCE LATTE 200ML;1;3000;0;3000;2500;500;
2021-02-06 13:18:00;8998989300261;GUDANG GARAM SURYA 12 FILTER;1;18000;0;18000;16450;1550;
2021-02-06 13:18:00;8999999034696;PONDS MEN ENERGY CHARGE 100G;1;29500;0;29500;26620;2880;
2021-02-06 13:53:07;8998866608008;KECAP MANIS SEDAAP BOTOL 135 ML;1;6300;0;6300;5615;685;
2021-02-06 14:05:43;8992761139018;ADES 600ML;2;3500;0;7000;4584;2416;
2021-02-06 14:33:09;GL;GULA 1 LITER;1;11500;0;11500;10500;1000;
2021-02-06 14:52:28;8998898830125;KKB ENER-G ANGGUR;1;5500;0;5500;4824;676;
2021-02-06 14:55:33;8992761166052;FRESTEA MELATI 350ML;1;4500;0;4500;3000;1500;
2021-02-06 15:06:54;8992761147143;SPRITE WATERLYMON 425ML;1;5500;0;5500;4300;1200;
2021-02-06 15:20:25;8996001600146;TEH PUCUK HARUM 350ML;1;3000;0;3000;2314;686;
2021-02-06 15:20:25;8996001304990;SARI GANDUM 115G;1;6000;0;6000;5100;900;
2021-02-06 15:28:07;11222;LEM KOREA;1;9000;0;9000;8000;1000;
2021-02-06 15:30:57;8998866600538;SOKLIN FLOORCLENER PINK 400ML;1;6000;0;6000;5025;975;
2021-02-06 15:30:57;8991102987899;WFR TANGO POUCH VNL 115G;1;7000;0;7000;6273;727;
2021-02-06 15:39:17;8992761164539;NUTRIBOOST ORANGE 300ML;1;6500;0;6500;5300;1200;
2021-02-06 16:38:41;8992696404441;BEAR BRAND 189ML;3;8500;0;25500;23661;1839;
2021-02-06 16:38:41;8991001121400;SILVERQUEEN ALMOND 65G;1;15000;0;15000;13200;1800;
2021-02-06 16:38:41;8997013790108;BIMURA KACANG TELUR 25G;1;1000;0;1000;875;125;
2021-02-06 16:42:34;8992761164539;NUTRIBOOST ORANGE 300ML;1;6500;0;6500;5300;1200;
2021-02-06 16:53:35;8992761122331;FRESTEA APPEL 500ML;1;6500;0;6500;4708;1792;
2021-02-06 17:06:15;GL;GULA 1 LITER;3;11500;0;34500;31500;3000;
2021-02-06 17:44:27;8992959002032;SWEETY SILVER PANTS L 36;1;72000;0;72000;68182;3818;
2021-02-06 17:55:27;8991111101965;JB POWDER 300G;1;12500;0;12500;11250;1250;
2021-02-06 18:13:50;8998866201469;POTABEE REGULER BBQ BEEF 68 GR;1;8000;0;8000;7200;800;
2021-02-06 18:15:06;8992753720804;BKM 490;3;14000;0;42000;37950;4050;
2021-02-06 18:15:06;8998866501033;MINYAK GORENG SEDAAP POUCH 2L;1;28500;0;28500;27746;754;
2021-02-06 18:15:06;8992959508848;SWEETY SILVER PANTS L 18;1;41500;0;41500;37728;3772;
2021-02-06 18:51:57;ARG;ARGUS 220ML;1;14500;0;14500;12500;2000;
2021-02-06 19:15:00;8992696404441;BEAR BRAND 189ML;1;8500;0;8500;7887;613;
2021-02-06 19:58:42;8996001305058;ROMA SANDWICH KACANG;1;7000;0;7000;5000;2000;
2021-02-06 19:58:42;8992959953037;SWEETY BRONZE L1;1;3000;0;3000;2671;329;
2021-02-06 20:13:32;8998989110129;SURYA KECIL MERAH 12KS;1;18000;0;18000;16450;1550;
2021-02-06 20:21:38;8993470671752;JOGER STICK DUO KACANG;1;1000;0;1000;850;150;
2021-02-06 20:24:56;8996001305041;ROMA SANDWICH CKLT;2;7000;0;14000;10000;4000;
2021-02-06 20:24:56;8992753102204;BKM COKLAT 370G;1;11300;0;11300;9500;1800;
2021-02-06 20:24:56;8934868015031;REXONA DEO LOTION ICE COOL;3;4600;0;13800;11700;2100;
2021-02-06 20:24:56;8999999003074;VASELINE ALOE SOOTHE;1;13200;0;13200;11805;1395;
2021-02-06 20:56:43;8998989110167;SURYA GUDANG GARAM 16 FILTER;2;24000;0;48000;44200;3800;
2021-02-06 20:58:32;8998866202053;POTABEE AYAM BAKAR PEDAS 68GR;1;8000;0;8000;7200;800;
2021-02-06 21:03:24;8998989110167;SURYA GUDANG GARAM 16 FILTER;1;24000;0;24000;22100;1900;
2021-02-06 21:05:15;8999999049508;REXONA WMN RO SHOWER CLEAN 45 ML;1;15000;0;15000;13500;1500;
2021-02-06 21:23:34;8999999401221;RINSO ANTI NODA CLASSIC 430G;1;10800;0;10800;9806;994;
2021-02-06 23:02:43;8992761166038;MMP ORANGE 300ML;1;5000;0;5000;3750;1250;
2021-02-06 23:02:43;8992957220186;COKLAT RUSA;2;2000;0;4000;3400;600;
2021-02-06 23:02:43;8992761145033;FANTA STRAW PET 250ML;1;3500;0;3500;2417;1083;
2021-02-06 23:02:43;8997013790108;BIMURA KACANG TELUR 25G;5;1000;0;5000;4375;625;
2021-02-06 23:40:51;8998898819106;KOPI KKB GINGSENG;1;12500;0;12500;11050;1450;
2021-02-07 08:41:28;8992761145019;COCA COLA PET 250ML;6;3500;0;21000;14502;6498;
2021-02-07 10:24:18;8998866202343;NOODLE SEDAAP MIE KOREAN SPICY 87 GR;2;2500;0;5000;4046;954;
2021-02-07 10:28:31;8991001780492;SELAMAT COKLAT;1;13000;0;13000;11800;1200;
2021-02-07 10:28:31;8998009010231;ULTRA CHO 250;1;6000;0;6000;4784;1216;
2021-02-07 10:28:31;8991001111883;SILVERQUEEN CHUNKYBAR 33G;1;8000;0;8000;7150;850;
2021-02-07 10:28:31;8992696523067;MILO ACTVGO UHT 180ML;1;4500;0;4500;3515;985;
2021-02-07 10:28:31;8992775311325;GERY SNACK&SEREAL 100G;2;7000;0;14000;11784;2216;
2021-02-07 10:28:31;8850507002968;A1 KING TRUCK;1;16500;0;16500;15500;1000;
2021-02-07 10:36:37;8998989110167;SURYA GUDANG GARAM 16 FILTER;1;24000;0;24000;22100;1900;
2021-02-07 10:36:37;123124;KOREK BIASA;1;2000;0;2000;1800;200;
2021-02-07 10:48:10;8998866202053;POTABEE AYAM BAKAR PEDAS 68GR;1;8000;0;8000;7200;800;
2021-02-07 10:48:10;8851019210193;POCKY CHOCO BANANA 47G;1;7300;0;7300;5671;1629;
2021-02-07 10:50:59;GL;GULA 1 LITER;2;11500;0;23000;21000;2000;
2021-02-07 10:56:54;8998866888622;GIV MERAH KOTAK 76G;2;2000;0;4000;3640;360;
2021-02-07 10:59:09;8999999707859;CLOSEUP GREEN 160G;1;15000;0;15000;13600;1400;
2021-02-07 10:59:09;JGR;JOGER CHOCKY PASTA;1;20000;0;20000;18190;1810;
2021-02-07 11:01:23;8999999024482;CITRA BW PEARLY WHITE REFF 220ML;1;12000;0;12000;10700;1300;
2021-02-07 11:01:23;8999999710880;PEPSODENT ACTION123 HERBAL 75G;1;7500;0;7500;6650;850;
2021-02-07 11:01:23;8991102385091;WFR TANGO CKLT 7G;1;8300;0;8300;7455;845;
2021-02-07 11:02:22;11;PASEO SMART FHSTD PERF 6P 12S;1;5000;0;5000;4264;736;
2021-02-07 11:19:04;8997013790108;BIMURA KACANG TELUR 25G;1;1000;0;1000;875;125;
2021-02-07 11:33:53;CC;NICE FACIAL KILOAN 900 GR DUO;1;34500;0;34500;31325;3175;
2021-02-07 11:48:19;8992761164539;NUTRIBOOST ORANGE 300ML;1;6500;0;6500;5300;1200;
2021-02-07 12:00:04;8992761122331;FRESTEA APPEL 500ML;1;6500;0;6500;4708;1792;
2021-02-07 13:12:35;8997013790108;BIMURA KACANG TELUR 25G;1;1000;0;1000;875;125;
2021-02-07 13:12:35;8992775110157;GARUDA KACANG KULIT;1;5000;0;5000;3925;1075;
2021-02-07 13:13:07;8998898830125;KKB ENER-G ANGGUR;1;5500;0;5500;4824;676;
2021-02-07 13:56:04;8992761145033;FANTA STRAW PET 250ML;2;3500;0;7000;4834;2166;
2021-02-07 14:22:22;8992761139018;ADES 600ML;1;3500;0;3500;2292;1208;
2021-02-07 14:27:23;8992957220117;COKLAT BERUANG;1;2000;0;2000;1700;300;
2021-02-07 14:27:23;8992957220087;COKLAT SINGA;1;2000;0;2000;1700;300;
2021-02-07 14:27:23;8993470411433;JOGER CLASSIC;1;1000;0;1000;850;150;
2021-02-07 14:27:23;8993470671752;JOGER STICK DUO KACANG;1;1000;0;1000;850;150;
2021-02-07 14:48:45;8998989300391;SURYA PRO PUTIH;1;20000;0;20000;18600;1400;
2021-02-07 14:48:45;123124;KOREK BIASA;1;2000;0;2000;1800;200;
2021-02-07 15:15:10;8992761139018;ADES 600ML;1;3500;0;3500;2292;1208;
2021-02-07 15:42:08;8992761002039;FANTA STRAWBERRY PET 390 ML;1;5500;0;5500;4300;1200;
2021-02-07 16:05:38;8998866202770;SEDAAP MIE GORENG SALERO PADANG 86 GR;1;2500;0;2500;2023;477;
2021-02-07 16:05:38;089686043204;INDOMIE MIE ACEH;1;2700;0;2700;2452;248;
2021-02-07 16:05:38;089686010107;INDOMIE KALDU AYAM;1;2500;0;2500;2155;345;
2021-02-07 16:08:05;123;BETREI JAM;1;5500;0;5500;5000;500;
2021-02-07 16:31:58;8850507002968;A1 KING TRUCK;1;16500;0;16500;15500;1000;
2021-02-07 16:38:47;GL;GULA 1 LITER;10;11500;0;115000;105000;10000;
2021-02-07 16:38:47;8992753101207;BENDERA KENTAL MANIS 370G;2;11500;0;23000;19400;3600;
2021-02-07 16:38:47;8991001780133;TWISTER BLACK;2;5000;0;10000;9200;800;
2021-02-07 16:38:47;9556001004673;MILO NESTLE MALAYSIA ACTIVE GO;1;85000;0;85000;80000;5000;
2021-02-07 16:38:47;8999999195649;SARI WANGI 25X1.86G;1;6000;0;6000;5050;950;
2021-02-07 16:38:47;8992628022156;BIMOLI KLASIK TOUCH 1 LT;2;15500;0;31000;28282;2718;
2021-02-07 17:17:54;ARG;ARGUS 220ML;3;14500;0;43500;37500;6000;
2021-02-07 17:36:10;8999999529550;CLEAR COMPLETE SOFT CARE 80ML;1;11200;0;11200;10120;1080;
2021-02-07 17:36:10;8998866602570;NUVO FAMILY KUNING 76G;2;2000;0;4000;3640;360;
2021-02-07 19:49:14;8992761139018;ADES 600ML;1;3500;0;3500;2292;1208;
2021-02-07 20:15:19;GL;GULA 1 LITER;2;11500;0;23000;21000;2000;
2021-02-07 20:15:19;8999999706661;PEPSODENT TB DBL CARE SENSITIVE;1;11500;0;11500;10400;1100;
2021-02-07 20:15:19;8997210107877;VORTEX SMART 3;1;10000;0;10000;9500;500;
2021-02-07 20:15:19;8991004011906;KOPI BORONG;1;10000;0;10000;8333;1667;
2021-02-07 20:15:19;8991102987899;WFR TANGO POUCH VNL 115G;1;7000;0;7000;6273;727;
2021-02-07 20:23:25;8992761166052;FRESTEA MELATI 350ML;1;4500;0;4500;3000;1500;
2021-02-07 20:31:00;8992761002022;SPRITE PET 390ML;1;5500;0;5500;4300;1200;
2021-02-07 20:31:00;8998989300261;GUDANG GARAM SURYA 12 FILTER;1;18000;0;18000;16450;1550;
2021-02-07 21:05:29;8992761002022;SPRITE PET 390ML;1;5500;0;5500;4300;1200;
2021-02-07 22:01:04;8998866200578;NOODLE SEDAAP KARI KENTAL SPC 75 GR;2;2300;0;4600;3904;696;
2021-02-07 22:01:45;8992761139018;ADES 600ML;1;3500;0;3500;2292;1208;
2021-02-07 22:18:36;8992761139018;ADES 600ML;1;3500;0;3500;2292;1208;
2021-02-07 22:19:34;8996001370063;CHOKI-CHOKI;1;18200;0;18200;16500;1700;
2021-02-07 22:20:58;8992761139018;ADES 600ML;1;3500;0;3500;2292;1208;
2021-02-07 22:22:33;8991001502933;CHACHA TUBE;1;7500;0;7500;6400;1100;
2021-02-07 22:22:33;8993470411433;JOGER CLASSIC;1;1000;0;1000;850;150;
2021-02-07 22:49:30;8998009020186;BUAVITA GUAVA 250ML;2;6600;0;13200;11900;1300;
2021-02-07 22:49:30;8992696404441;BEAR BRAND 189ML;2;8500;0;17000;15774;1226;
2021-02-07 22:49:30;8992761166038;MMP ORANGE 300ML;1;5000;0;5000;3750;1250;
2021-02-07 22:49:30;089686060102;POP MIE PEDE GLEDEEK;2;5000;0;10000;8900;1100;
2021-02-07 22:49:30;089686067002;POP MIE PDS DOWER RS AYAM;1;5000;0;5000;4450;550;
2021-02-07 22:54:43;089686060362;POP MIE SOTO AYAM JUMBO;1;4500;0;4500;3833;667;
2021-02-07 23:05:04;8991102987639;WFR TANGO LONG VNL 130G;2;4500;0;9000;7546;1454;
2021-02-07 23:05:04;8996001304990;SARI GANDUM 115G;1;6000;0;6000;5100;900;
2021-02-07 23:05:04;8992761166038;MMP ORANGE 300ML;1;5000;0;5000;3750;1250;
2021-02-07 23:05:04;8992761145026;SPRITE PET 250ML;1;3500;0;3500;2417;1083;
2021-02-07 23:06:42;8999999052997;PONDS CLEAR SOLUTION FACIAL SCRUB 50G;1;18200;0;18200;16300;1900;
2021-02-07 23:06:42;8999999527372;PONDS MEN LIGHT OIL 50G;1;19000;0;19000;17160;1840;
2021-02-07 23:08:23;8999999538422;CLEAR SHP ICM UNISEX 55 ML;1;4200;0;4200;3750;450;
2021-02-07 23:11:37;089686060461;POP MIE RASA KARI AYAM;1;4500;0;4500;3833;667;
2021-02-07 23:17:12;089686067002;POP MIE PDS DOWER RS AYAM;1;5000;0;5000;4450;550;
2021-02-08 09:22:39;8993470279651;JOGER CHOCKY BAR;1;1000;0;1000;867;133;
2021-02-08 09:22:39;8998866500708;FLORIDINA ORANGE;1;3000;0;3000;2500;500;
2021-02-08 09:23:54;8998866202060;POTABEE AYAM BAKAR PEDAS 35 GR;1;4800;0;4800;4150;650;
2021-02-08 09:25:54;8993470671752;JOGER STICK DUO KACANG;1;1000;0;1000;850;150;
2021-02-08 09:28:36;8999999195649;SARI WANGI 25X1.86G;1;6000;0;6000;5050;950;
2021-02-08 09:35:45;8998866501033;MINYAK GORENG SEDAAP POUCH 2L;1;28500;0;28500;27746;754;
2021-02-08 10:59:04;8992696404441;BEAR BRAND 189ML;4;8500;0;34000;31548;2452;
2021-02-08 10:59:04;8998009020186;BUAVITA GUAVA 250ML;1;6600;0;6600;5950;650;
2021-02-08 10:59:04;8991001502933;CHACHA TUBE;2;7500;0;15000;12800;2200;
2021-02-08 10:59:04;8992957220063;COKLAT BANGO;1;2000;0;2000;1700;300;
2021-02-08 10:59:04;8992761122331;FRESTEA APPEL 500ML;1;6500;0;6500;4708;1792;
2021-02-08 11:57:44;8992761139018;ADES 600ML;1;3500;0;3500;2292;1208;
2021-02-08 11:57:44;8996001600375;LE MINERAL 330ML;1;2000;0;2000;1417;583;
2021-02-08 11:57:44;8996001600269;LE MINERAL 600ML;1;3000;0;3000;1688;1312;
2021-02-08 11:57:44;8998866201469;POTABEE REGULER BBQ BEEF 68 GR;1;8000;0;8000;7200;800;
2021-02-08 13:03:59;8992761122430;FRESTEA GREEN HONEY 500ML;4;6500;0;26000;18832;7168;
2021-02-08 13:03:59;8998989300230;SIGNATURE BESAR;1;20000;0;20000;18600;1400;
2021-02-08 13:28:59;8992761166205;FRESTEA GREEN HONEY 350ML;1;4500;0;4500;3000;1500;
2021-02-08 13:28:59;8992761164539;NUTRIBOOST ORANGE 300ML;1;6500;0;6500;5300;1200;
2021-02-08 13:35:08;8997013790108;BIMURA KACANG TELUR 25G;1;1000;0;1000;875;125;
2021-02-08 14:03:35;8992761002022;SPRITE PET 390ML;1;5500;0;5500;4300;1200;
2021-02-08 14:05:53;8998866201841;GOLDA DOLCE LATTE 200ML;1;3000;0;3000;2500;500;
2021-02-08 14:13:39;8998866200882;SUKSESMIE GORENG AYAM KRMS 133GR;1;3500;0;3500;3000;500;
2021-02-08 18:00:39;8996001600146;TEH PUCUK HARUM 350ML;1;3000;0;3000;2314;686;
2021-02-08 18:47:04;8992761145033;FANTA STRAW PET 250ML;2;3500;0;7000;4834;2166;
2021-02-08 18:47:04;8998866202619;SEDAAP MIE KOREAN SPICY SOUP BAG 77 GR;1;2300;0;2300;2027;273;
2021-02-08 18:55:29;8998866200325;NOODLE SEDAAP MIE SOTO;2;2200;0;4400;3904;496;
2021-02-08 19:13:32;GL;GULA 1 LITER;1;11500;0;11500;10500;1000;
2021-02-08 19:13:32;8993470279651;JOGER CHOCKY BAR;1;1000;0;1000;867;133;
2021-02-08 20:23:47;8999999524722;SUNLIGHT LIME NEW PCH 435ML;1;10000;0;10000;9100;900;
2021-02-08 20:34:30;BR;BERAS 10L;1;86500;0;86500;85000;1500;
2021-02-08 20:50:04;8998989110167;SURYA GUDANG GARAM 16 FILTER;2;24000;0;48000;44200;3800;
2021-02-08 21:10:34;11;PASEO SMART FHSTD PERF 6P 12S;1;5000;0;5000;4264;736;
2021-02-08 21:10:34;089686010107;INDOMIE KALDU AYAM;1;2500;0;2500;2155;345;
2021-02-08 21:10:34;089686010343;INDOMIE SOTO MIE;2;2600;0;5200;4734;466;
2021-02-08 21:10:34;8999908204202;MY BABY MINYAK TELON 60ML;1;15000;0;15000;13545;1455;
2021-02-08 22:32:04;8994867000179;ROKOK PENA MILD 16;1;14500;0;14500;13000;1500;
2021-02-09 11:26:28;8998989500128;GUDANG GARAM MERAH KECIL 12KS;1;13000;0;13000;11900;1100;
2021-02-09 11:27:44;8998866610278;DAIA VIOLET GUSSET 565G;1;10000;0;10000;8700;1300;
2021-02-09 11:33:02;8850507001152;MOTU ATV;1;10000;0;10000;8000;2000;
2021-02-09 11:34:04;8992761002039;FANTA STRAWBERRY PET 390 ML;1;5500;0;5500;4300;1200;
2021-02-09 12:21:59;8850507001152;MOTU ATV;1;10000;0;10000;8000;2000;
2021-02-09 12:21:59;8850507002951;BONCHA EGG SQUISHY;1;12000;0;12000;10841;1159;
2021-02-09 12:31:57;8992761122331;FRESTEA APPEL 500ML;1;6500;0;6500;4708;1792;
2021-02-09 12:58:39;089686011036;INDOMIE GORENG PEDAS;1;2700;0;2700;2452;248;
2021-02-09 13:17:51;8992959117569;SFX DS REG FLOW NW 8;1;4000;0;4000;3530;470;
2021-02-09 13:52:41;8992957220087;COKLAT SINGA;3;2000;0;6000;5100;900;
2021-02-09 13:52:41;8992694242502;ZWITZAL SOAP CALSSIC 70G;1;3800;0;3800;3410;390;
2021-02-09 13:52:41;8992761166038;MMP ORANGE 300ML;1;5000;0;5000;3750;1250;
2021-02-09 14:03:47;8998866202244;EKOMIE BUMBU KALDU AYAM;1;1000;0;1000;860;140;
2021-02-09 16:25:59;8999999195656;SARI WANGI 50X1.85;1;10000;0;10000;8700;1300;
2021-02-09 16:41:20;8998866200882;SUKSESMIE GORENG AYAM KRMS 133GR;1;3500;0;3500;3000;500;
2021-02-09 16:41:20;8998866613262;SUKSESMIE SOTO 111 GR;1;3500;0;3500;2770;730;
2021-02-09 16:41:20;8993470279651;JOGER CHOCKY BAR;3;1000;0;3000;2601;399;
2021-02-09 17:21:52;8991001780492;SELAMAT COKLAT;1;13000;0;13000;11800;1200;
2021-02-09 17:21:52;8991102381024;FULLO VNL PCK;1;10000;0;10000;9000;1000;
2021-02-09 17:21:52;8998866200561;EKOMIE SUPER 600GR;1;10000;0;10000;8615;1385;
2021-02-09 17:21:52;8992696521797;MILO ACTVGO SCT 22G;11;2200;0;24200;21384;2816;
2021-02-09 19:23:23;8996001600375;LE MINERAL 330ML;1;2000;0;2000;1417;583;
2021-02-09 19:38:38;8996001600146;TEH PUCUK HARUM 350ML;1;3000;0;3000;2314;686;
2021-02-09 20:01:39;8992761145019;COCA COLA PET 250ML;1;3500;0;3500;2417;1083;
2021-02-09 20:16:42;8992753102204;BKM COKLAT 370G;1;11300;0;11300;9500;1800;
2021-02-09 20:23:42;8991004011906;KOPI BORONG;1;10000;0;10000;8333;1667;
2021-02-09 20:53:37;8992761145026;SPRITE PET 250ML;1;3500;0;3500;2417;1083;
2021-02-09 21:39:12;8992957220087;COKLAT SINGA;3;2000;0;6000;5100;900;
2021-02-09 21:50:54;8992761139018;ADES 600ML;1;3500;0;3500;2292;1208;
2021-02-09 22:29:33;8992761111533;SPRITE SLIM CAM250ML;1;5000;0;5000;3750;1250;
2021-02-09 22:43:31;8998989121163;SURYA PRO MERAH;1;20000;0;20000;18600;1400;
2021-02-09 22:43:31;8992761145033;FANTA STRAW PET 250ML;4;3500;0;14000;9668;4332;
2021-02-09 23:18:02;ARG;ARGUS 220ML;1;14500;0;14500;12500;2000;
2021-02-09 23:22:46;8996001600269;LE MINERAL 600ML;24;1854;0;44496;40512;3984;
2021-02-09 23:24:40;9999;ISOLASI LAKBAN;1;8000;0;8000;6500;1500;
2021-02-10 09:22:49;8998866501033;MINYAK GORENG SEDAAP POUCH 2L;1;28500;0;28500;27746;754;
2021-02-10 13:04:21;8992761111533;SPRITE SLIM CAM250ML;1;5000;0;5000;3750;1250;
2021-02-10 13:42:54;8992761122331;FRESTEA APPEL 500ML;1;6500;0;6500;4708;1792;
2021-02-10 14:20:00;8991001121615;SILVERQUEEN NUT;1;15000;0;15000;13200;1800;
2021-02-10 14:20:00;8992959974018;SFX SIRIH 36CM 12+1;1;12000;0;12000;10686;1314;
2021-02-10 15:44:48;8850507002951;BONCHA EGG SQUISHY;1;12000;0;12000;10841;1159;
2021-02-10 16:07:51;8992761166038;MMP ORANGE 300ML;1;5000;0;5000;3750;1250;
2021-02-10 16:14:33;8850507002951;BONCHA EGG SQUISHY;1;12000;0;12000;10841;1159;
2021-02-10 17:14:08;8998009020186;BUAVITA GUAVA 250ML;2;6600;0;13200;11900;1300;
2021-02-10 17:20:55;8992959953075;SWEETY BRONZE M9;1;17000;0;17000;15190;1810;
2021-02-10 17:20:55;8998866200301;NOODLE SEDAAP GORENG  90 GR;2;2500;0;5000;4046;954;
2021-02-10 17:20:55;089686010107;INDOMIE KALDU AYAM;2;2500;0;5000;4310;690;
2021-02-10 17:20:55;8997013790092;BIMURA KERUPUK BAWANG 25G;2;1000;0;2000;1748;252;
2021-02-10 17:32:49;8991102281430;PERMEN MINTZ DUOMINT;1;4500;0;4500;4000;500;
2021-02-10 17:32:49;8998898847109;KOPI JAHE;1;13000;0;13000;11800;1200;
2021-02-10 17:32:49;089686067002;POP MIE PDS DOWER RS AYAM;1;5000;0;5000;4450;550;
2021-02-10 17:32:49;8993379152017;SABUN CUCI SURYA 200G;1;3000;0;3000;2281;719;
2021-02-10 17:43:50;8992761145033;FANTA STRAW PET 250ML;1;3500;0;3500;2417;1083;
2021-02-10 17:43:50;8992761166205;FRESTEA GREEN HONEY 350ML;1;4500;0;4500;3000;1500;
2021-02-10 17:43:50;089686061079;POP MIE MINI AY BAWANG RL;2;3000;0;6000;5404;596;
2021-02-10 18:09:46;089686010107;INDOMIE KALDU AYAM;2;2500;0;5000;4310;690;
2021-02-10 18:19:17;8992761166038;MMP ORANGE 300ML;1;5000;0;5000;3750;1250;
2021-02-10 19:03:02;8998866202244;EKOMIE BUMBU KALDU AYAM;5;1000;0;5000;4300;700;
2021-02-10 19:12:56;8992775310212;GERY PASTA COKELAT;1;18000;0;18000;16029;1971;
2021-02-10 19:12:56;8999999552503;ZWITSAL KIDS SHP PINK SOFT&MSTR 180 ML;1;15000;0;15000;13695;1305;
2021-02-10 19:12:56;8991001503114;CHACHA MILK CHOCOLATE 35G;1;5500;0;5500;4900;600;
2021-02-10 19:12:56;8991001503107;CHACHA PEANUT 35GR;1;5500;0;5500;4900;600;
2021-02-10 19:12:56;8993470411433;JOGER CLASSIC;1;1000;0;1000;850;150;
2021-02-10 19:26:04;089686060126;POP MIE BASO JUMBO;3;4500;0;13500;11499;2001;
2021-02-10 19:26:04;8998866200813;NOODLE SEDAAP MIE GORENG CUP 85 GR;2;4500;0;9000;7834;1166;
2021-02-10 19:26:04;8998866200820;NOODLE SEDAAP MIE AYAM BAWANG TLR CUP 77 GR;1;4500;0;4500;3650;850;
2021-02-10 19:26:04;089686060027;POP MIE AYAM JUMBO;1;4500;0;4500;3833;667;
2021-02-10 19:26:04;089686060362;POP MIE SOTO AYAM JUMBO;3;4500;0;13500;11499;2001;
2021-02-10 19:26:04;8991102989428;WFR TANGO LONG CKLT 24G GTG;1;7500;0;7500;6714;786;
2021-02-10 19:26:04;8991001121615;SILVERQUEEN NUT;1;15000;0;15000;13200;1800;
2021-02-10 19:26:04;8996001304990;SARI GANDUM 115G;1;6000;0;6000;5100;900;
2021-02-10 19:27:06;8998898830125;KKB ENER-G ANGGUR;1;5500;0;5500;4824;676;
2021-02-10 19:58:41;MG;MINYAK GOSOK SAFERTABAT;1;28000;0;28000;25000;3000;
2021-02-10 21:43:07;8998866608718;DAIA SOFTENER PINK;2;5000;0;10000;8900;1100;
2021-02-10 21:43:07;8992753100101;BKM FULL CREAM GOLD 370;1;15000;0;15000;14000;1000;
2021-02-10 21:43:07;8991001111883;SILVERQUEEN CHUNKYBAR 33G;1;8000;0;8000;7150;850;
2021-02-10 21:51:03;8998989110167;SURYA GUDANG GARAM 16 FILTER;1;24000;0;24000;22100;1900;
2021-02-11 07:19:44;9556001004673;MILO NESTLE MALAYSIA ACTIVE GO;1;85000;0;85000;80000;5000;
2021-02-11 08:54:59;8996001600375;LE MINERAL 330ML;2;2000;0;4000;2834;1166;
2021-02-11 09:04:18;8998866501033;MINYAK GORENG SEDAAP POUCH 2L;1;28500;0;28500;27746;754;
2021-02-11 09:04:18;JGR;JOGER CHOCKY PASTA;1;20000;0;20000;18190;1810;
2021-02-11 09:58:25;GL;GULA 1 LITER;8;11500;0;92000;84000;8000;
2021-02-11 10:09:50;8998009020186;BUAVITA GUAVA 250ML;1;6600;0;6600;5950;650;
2021-02-11 13:28:39;8991111109107;JB POWDER BEDTIME 75+25g;1;6000;0;6000;5440;560;
2021-02-11 13:28:39;8998866602563;NUVO FAMILY HIJAU 76G;1;2000;0;2000;1820;180;
2021-02-11 13:28:39;8998866610742;NOVO FAMILY PINK 76G;1;2000;0;2000;1820;180;
2021-02-11 13:28:39;8997021300092;LARISSA BAWANG 250GR;1;5500;0;5500;5125;375;
2021-02-11 13:28:39;8993379152017;SABUN CUCI SURYA 200G;2;3000;0;6000;4562;1438;
2021-02-11 13:36:46;GL;GULA 1 LITER;3;11500;0;34500;31500;3000;
2021-02-11 13:36:46;8996001350423;ZUPER KEJU;1;9200;0;9200;8360;840;
2021-02-11 13:36:46;8991102989428;WFR TANGO LONG CKLT 24G GTG;1;7500;0;7500;6714;786;
2021-02-11 13:36:46;8999999195656;SARI WANGI 50X1.85;1;10000;0;10000;8700;1300;
2021-02-11 13:36:46;8992775311615;CHOCOLATOS;1;12000;0;12000;9983;2017;
2021-02-11 13:36:46;8992388133017;NU MILK TEA ORI 330ML;1;5000;0;5000;4604;396;
2021-02-11 13:38:32;8991001780133;TWISTER BLACK;1;5000;0;5000;4600;400;
2021-02-11 14:49:02;8998866610223;DAIA VIOLET BAG 850G & PIRING;1;18000;0;18000;15627;2373;
2021-02-11 14:49:02;8992775311325;GERY SNACK&SEREAL 100G;1;7000;0;7000;5892;1108;
2021-02-11 14:49:02;8851019230566;POCKY CHOCO 22G;1;5000;0;5000;3001;1999;
2021-02-11 14:49:02;8992696523081;MILO UHT 110ML;2;2500;0;5000;3924;1076;
2021-02-11 14:49:02;8992696521629;DNCO COKLT UHT 180ML;1;5000;0;5000;3533;1467;
2021-02-11 14:51:16;8998866602273;HERSPROTEX SOFTCARE MAX;1;3500;0;3500;2950;550;
2021-02-11 14:51:16;8997001245887;TERIGU KITA 1KG;1;9500;0;9500;8500;1000;
2021-02-11 14:51:16;8997025914332;HATARI CREAM CRECKERS;2;5000;0;10000;9526;474;
2021-02-11 14:51:16;8998866604703;RAPIKA BIANG PINK 250MLBTL;1;8500;0;8500;7650;850;
2021-02-11 14:53:20;8997210107877;VORTEX SMART 3;1;10000;0;10000;9500;500;
2021-02-11 14:53:20;8991111152073;LISTERINE GREEN TEA 100ML;1;8000;0;8000;7600;400;
2021-02-11 14:53:20;8992775001660;WAFER CREAM COKLAT TABUR KEJU;1;19000;0;19000;17721;1279;
2021-02-11 14:53:20;8999999034733;PONDS MEN WHITE BOOST 100G;1;29500;0;29500;26620;2880;
2021-02-11 14:53:20;8999999525811;MOLTO AIO BLUE PCH 720;1;26800;0;26800;23900;2900;
2021-02-11 14:53:20;8992747180225;VIXAL PEMB PORS BIRU 720ML;1;18000;0;18000;16940;1060;
2021-02-11 14:57:34;089686011494;INDOMIE SOTO PADANG;4;2600;0;10400;9268;1132;
2021-02-11 14:57:34;8999999710880;PEPSODENT ACTION123 HERBAL 75G;1;7500;0;7500;6650;850;
2021-02-11 14:57:34;8999999559557;LUX BW MAGICAL ORCHID 85ML;1;5000;0;5000;4000;1000;
2021-02-11 14:57:34;8999999502393;ROYCO FDS CHICKEN 8G;2;5000;0;10000;9000;1000;
2021-02-11 14:57:34;GL;GULA 1 LITER;3;11500;0;34500;31500;3000;
2021-02-11 14:59:41;8996001304020;SLAI OLAI NANAS;1;8500;0;8500;7700;800;
2021-02-11 14:59:41;8995333060703;TERIGU KOMPAS 1KG;2;10500;0;21000;19632;1368;
2021-02-11 14:59:41;8999999045265;RINSO MOLTO ROSE FRESH PWD 770GR;1;21600;0;21600;19338;2262;
2021-02-11 14:59:41;8999999525675;MOLTO HYGIENE 720ML;1;28000;0;28000;25150;2850;
2021-02-11 14:59:41;8999999524838;SUNLIGHT MINT POUCH 755ML;1;17000;0;17000;15400;1600;
2021-02-11 14:59:41;8999999049478;REXONA WMN RO NATURALS BIO 45 ML;1;16500;0;16500;14900;1600;
2021-02-11 14:59:41;8998009010590;ULTRA CHO 125;2;3000;0;6000;4856;1144;
2021-02-11 15:03:11;8992696523081;MILO UHT 110ML;1;2500;0;2500;1962;538;
2021-02-11 15:36:05;8994867000179;ROKOK PENA MILD 16;1;14500;0;14500;13000;1500;
2021-02-11 15:36:05;8992761002015;COCA COLA PET 390ML;1;5500;0;5500;4333;1167;
2021-02-11 16:05:43;8993470279651;JOGER CHOCKY BAR;2;1000;0;2000;1734;266;
2021-02-11 16:55:49;8996001320051;KOPIKO COFFE CANDY;1;6200;0;6200;5600;600;
2021-02-11 16:57:46;8993470279651;JOGER CHOCKY BAR;1;1000;0;1000;867;133;
2021-02-11 17:11:32;8996001304020;SLAI OLAI NANAS;1;8500;0;8500;7700;800;
2021-02-11 17:11:32;8998866613262;SUKSESMIE SOTO 111 GR;2;3500;0;7000;5540;1460;
2021-02-11 17:11:32;8999999524722;SUNLIGHT LIME NEW PCH 435ML;1;10000;0;10000;9100;900;
2021-02-11 17:11:32;8995333060703;TERIGU KOMPAS 1KG;1;10500;0;10500;9816;684;
2021-02-11 17:11:32;8996001320051;KOPIKO COFFE CANDY;1;6200;0;6200;5600;600;
2021-02-11 17:11:32;8992628022156;BIMOLI KLASIK TOUCH 1 LT;1;15500;0;15500;14141;1359;
2021-02-11 17:21:28;8992628022156;BIMOLI KLASIK TOUCH 1 LT;1;15500;0;15500;14141;1359;
2021-02-11 17:21:28;8992753631209;OMELA 370;2;9500;0;19000;16800;2200;
2021-02-11 17:22:12;GL;GULA 1 LITER;1;11500;0;11500;10500;1000;
2021-02-11 17:25:59;8992696523067;MILO ACTVGO UHT 180ML;1;4500;0;4500;3515;985;
2021-02-11 19:17:50;8998866501033;MINYAK GORENG SEDAAP POUCH 2L;1;28500;0;28500;27746;754;
2021-02-11 19:17:50;JGR;JOGER CHOCKY PASTA;1;20000;0;20000;18190;1810;
2021-02-11 20:43:41;8992761145033;FANTA STRAW PET 250ML;1;3500;0;3500;2417;1083;
2021-02-11 21:35:12;8998866603522;SOKLIN FLOORCLENER UNGU 400ML;1;6000;0;6000;5025;975;
2021-02-11 21:35:12;8999999551223;RINSO ACTIVE FRESH LIQ 700ML;1;19500;0;19500;17900;1600;
2021-02-11 22:54:02;8992761166052;FRESTEA MELATI 350ML;1;4500;0;4500;3000;1500;
2021-02-12 00:17:56;8993470279651;JOGER CHOCKY BAR;3;1000;0;3000;2601;399;
2021-02-12 09:01:27;8998866200325;NOODLE SEDAAP MIE SOTO;2;2200;0;4400;3904;496;
2021-02-12 09:49:49;8992957220087;COKLAT SINGA;1;2000;0;2000;1700;300;
2021-02-12 09:49:49;8993470279651;JOGER CHOCKY BAR;1;1000;0;1000;867;133;
2021-02-12 09:49:49;8998898830125;KKB ENER-G ANGGUR;1;5500;0;5500;4824;676;
2021-02-12 10:01:46;8996001600269;LE MINERAL 600ML;24;1875;0;45000;40512;4488;
2021-02-12 10:12:49;8996001318980;BETTER 120G;2;6000;0;12000;10200;1800;
2021-02-12 10:12:49;8996001304990;SARI GANDUM 115G;1;6000;0;6000;5100;900;
2021-02-12 10:20:30;8997013790092;BIMURA KERUPUK BAWANG 25G;2;1000;0;2000;1748;252;
2021-02-12 10:20:30;8998866102605;KODOMO TB REG 2IN1;1;7500;0;7500;6600;900;
2021-02-12 10:20:30;8992696521629;DNCO COKLT UHT 180ML;1;5000;0;5000;3533;1467;
2021-02-12 10:20:30;8998009020186;BUAVITA GUAVA 250ML;1;6600;0;6600;5950;650;
2021-02-12 10:20:30;8998866201711;KRISBEE KRUNCHY JAGUNG BAKAR MENTEGA 75 GR;1;5500;0;5500;4400;1100;
2021-02-12 10:20:30;8998866202732;MILKU STROBERI 200ML;1;3000;0;3000;2375;625;
2021-02-12 10:20:30;8993379200886;SABUN HARMONY ORANGE 70G;1;2000;0;2000;1652;348;
2021-02-12 10:20:30;8998866608718;DAIA SOFTENER PINK;1;5000;0;5000;4450;550;
2021-02-12 10:20:30;8999999401023;MOLTO PEWANGI PINK 820ML;1;12500;0;12500;11275;1225;
2021-02-12 10:20:30;8999999052959;PONDS WHITE BEAUTY FACIAL FOAM 50G;1;17000;0;17000;15600;1400;
2021-02-12 10:20:30;8999999004248;CITRA NATURAL WHITE SCRUB 200ML;1;16200;0;16200;14550;1650;
2021-02-12 10:48:46;8992761145026;SPRITE PET 250ML;1;3500;0;3500;2417;1083;
2021-02-12 11:45:12;8992761139018;ADES 600ML;1;3500;0;3500;2292;1208;
2021-02-12 12:03:12;8996001600375;LE MINERAL 330ML;1;2000;0;2000;1417;583;
2021-02-12 12:27:14;8992761166038;MMP ORANGE 300ML;1;5000;0;5000;3750;1250;
2021-02-12 12:39:27;8998866200813;NOODLE SEDAAP MIE GORENG CUP 85 GR;1;4500;0;4500;3917;583;
2021-02-12 13:32:34;8998866202770;SEDAAP MIE GORENG SALERO PADANG 86 GR;2;2500;0;5000;4046;954;
2021-02-12 13:32:34;8998866201841;GOLDA DOLCE LATTE 200ML;1;3000;0;3000;2500;500;
2021-02-12 13:32:34;8998866202732;MILKU STROBERI 200ML;1;3000;0;3000;2375;625;
2021-02-12 14:23:51;089686043204;INDOMIE MIE ACEH;1;2700;0;2700;2452;248;
2021-02-12 14:59:19;8998898830125;KKB ENER-G ANGGUR;1;5500;0;5500;4824;676;
2021-02-12 15:01:58;8992761145033;FANTA STRAW PET 250ML;1;3500;0;3500;2417;1083;
2021-02-12 15:24:55;GL;GULA 1 LITER;3;11500;0;34500;31500;3000;
2021-02-12 15:24:55;8996001338056;TAMARIN;1;5600;0;5600;5100;500;
2021-02-12 17:29:08;089686067002;POP MIE PDS DOWER RS AYAM;1;5000;0;5000;4450;550;
2021-02-12 17:29:08;089686060461;POP MIE RASA KARI AYAM;2;4500;0;9000;7666;1334;
2021-02-12 17:29:08;8996001305058;ROMA SANDWICH KACANG;1;7000;0;7000;5000;2000;
2021-02-12 17:29:08;8996001370063;CHOKI-CHOKI;1;18200;0;18200;16500;1700;
2021-02-12 17:30:48;8998866201933;MINYAK GORENG SEDAAP 5 L;1;71500;0;71500;70230;1270;
2021-02-12 17:32:39;8990800020013;MENTOS MINT HALAL IND;1;5700;0;5700;5150;550;
2021-02-12 17:32:39;8991102281416;PERMEN MINTZ PPMINT;1;4500;0;4500;4000;500;
2021-02-12 17:37:35;8996001318980;BETTER 120G;1;6000;0;6000;5100;900;
2021-02-12 18:12:07;8992761139018;ADES 600ML;1;3500;0;3500;2292;1208;
2021-02-12 18:40:47;8996001304990;SARI GANDUM 115G;1;6000;0;6000;5100;900;
2021-02-12 19:39:44;8998866501033;MINYAK GORENG SEDAAP POUCH 2L;1;28500;0;28500;27746;754;
2021-02-12 21:40:41;8998866501033;MINYAK GORENG SEDAAP POUCH 2L;1;28500;0;28500;27746;754;
2021-02-12 21:43:55;8996001600269;LE MINERAL 600ML;4;3000;0;12000;6752;5248;
2021-02-12 21:44:50;8998989110167;SURYA GUDANG GARAM 16 FILTER;2;24000;0;48000;44200;3800;
2021-02-12 21:48:31;8998866202343;NOODLE SEDAAP MIE KOREAN SPICY 87 GR;1;2500;0;2500;2023;477;
2021-02-12 22:31:40;8992761145026;SPRITE PET 250ML;1;3500;0;3500;2417;1083;
2021-02-13 10:49:36;8996001318911;BETTER ISI 4;2;2000;0;4000;3400;600;
2021-02-13 10:49:36;GL;GULA 1 LITER;5;11500;0;57500;52500;5000;
2021-02-13 10:49:36;8998866202671;NOODLE SEDAAP MIE KOREAN SPICY SOUP CUP;2;5000;0;10000;7834;2166;
2021-02-13 10:49:36;8996001301142;ROMA KELAPA;3;8000;0;24000;19884;4116;
2021-02-13 10:49:36;8996001302323;MALKIST ABON;4;6500;0;26000;19200;6800;
2021-02-13 10:49:36;8998989110167;SURYA GUDANG GARAM 16 FILTER;1;24000;0;24000;22100;1900;
2021-02-13 11:56:27;8998866202725;MILKU COKLAT PREMIUM 200ML;1;3000;0;3000;2375;625;
2021-02-13 11:56:27;8998866202732;MILKU STROBERI 200ML;1;3000;0;3000;2375;625;
2021-02-13 12:24:30;8996001320136;KOPIKO CAPP CANDY;1;6200;0;6200;5600;600;
2021-02-13 12:24:30;8996001355237;SUPER STAR;1;11000;0;11000;9900;1100;
2021-02-13 12:43:44;8998989100120;GUDANG GARAM MINI;1;18000;0;18000;16600;1400;
2021-02-13 13:22:14;711844610095;LARISSA UDANG 500 GR;1;11000;0;11000;9790;1210;
2021-02-13 14:37:02;8992761166052;FRESTEA MELATI 350ML;1;4500;0;4500;3000;1500;
2021-02-13 14:37:02;8997013790108;BIMURA KACANG TELUR 25G;1;1000;0;1000;875;125;
2021-02-13 16:43:47;8998866200301;NOODLE SEDAAP GORENG  90 GR;1;2500;0;2500;2023;477;
2021-02-13 16:43:47;8992388111145;MIE ABC SELERA PEDAS- SUP TOMAT PEDAS;1;2500;0;2500;2023;477;
2021-02-13 16:50:28;089686041705;INDOMIE GORENG JUMBO;1;3500;0;3500;3143;357;
2021-02-13 16:50:28;8992775610008;TING-TING GARUDA 2.5G;1;7500;0;7500;6296;1204;
2021-02-13 17:33:57;8999999045920;LIFEBUOY TS TOTAL 10 110GR;1;4000;0;4000;3500;500;
2021-02-13 17:33:57;8996001305249;ROMA KELAPA CREAM;1;6800;0;6800;5514;1286;
2021-02-13 17:33:57;8996001302347;SARI GANDUM FAM;1;8200;0;8200;7100;1100;
2021-02-13 17:33:57;8996001304013;SLAI OLAI PACK;2;8500;0;17000;15400;1600;
2021-02-13 17:33:57;8999999529710;CLEAR COOL SPORT MNTL 160ML;1;24800;0;24800;22700;2100;
2021-02-13 17:33:57;6907992823904;JD CRU;1;8000;0;8000;6800;1200;
2021-02-13 17:33:57;8999999030186;PEPSODENT ACTION 123 COMPLETE 190G;1;14000;0;14000;13200;800;
2021-02-13 17:33:57;6907992823652;JDDD;1;6000;0;6000;5000;1000;
2021-02-13 17:57:09;6907992823645;JD COCONUT BLISS;1;4000;0;4000;3500;500;
2021-02-13 17:57:09;6907992823942;JD JUJUBE;2;4500;0;9000;7600;1400;
2021-02-13 18:12:37;089686010190;INDOMIE KARI AYAM;2;2800;0;5600;5044;556;
2021-02-13 18:12:37;8998899001920;BAYGON MAX;1;4000;0;4000;3500;500;
2021-02-13 18:15:39;8997013790108;BIMURA KACANG TELUR 25G;3;1000;0;3000;2625;375;
2021-02-13 18:20:53;8991001121615;SILVERQUEEN NUT;6;15000;0;90000;79200;10800;
2021-02-13 18:30:00;8992761145026;SPRITE PET 250ML;2;3500;0;7000;4834;2166;
2021-02-13 19:18:14;8998898830125;KKB ENER-G ANGGUR;1;5500;0;5500;4824;676;
2021-02-13 19:27:57;GL;GULA 1 LITER;1;11500;0;11500;10500;1000;
2021-02-13 19:27:57;8991102303309;WFR TANGO SBJ 176G;1;9200;0;9200;8336;864;
2021-02-13 19:27:57;089686011036;INDOMIE GORENG PEDAS;2;2700;0;5400;4904;496;
2021-02-13 19:27:57;8995333060703;TERIGU KOMPAS 1KG;1;10500;0;10500;9816;684;
2021-02-13 19:27:57;8992628022156;BIMOLI KLASIK TOUCH 1 LT;1;15500;0;15500;14141;1359;
2021-02-13 19:34:37;8996001600375;LE MINERAL 330ML;1;2000;0;2000;1417;583;
2021-02-13 20:08:04;8996001318980;BETTER 120G;1;6000;0;6000;5100;900;
2021-02-13 22:20:36;8992761145026;SPRITE PET 250ML;1;3500;0;3500;2417;1083;
2021-02-13 22:52:55;8999999500665;RINSO MOLTO ROSE FRESH PWD 1,8KG;1;44700;0;44700;40726;3974;
2021-02-13 23:50:03;8992761145019;COCA COLA PET 250ML;1;3500;0;3500;2417;1083;
2021-02-13 23:50:03;8992761145026;SPRITE PET 250ML;1;3500;0;3500;2417;1083;
2021-02-14 08:33:47;8998866202053;POTABEE AYAM BAKAR PEDAS 68GR;2;8000;0;16000;14400;1600;
2021-02-14 10:24:58;8998989110167;SURYA GUDANG GARAM 16 FILTER;1;24000;0;24000;22100;1900;
2021-02-14 10:59:55;GL;GULA 1 LITER;40;11500;0;460000;420000;40000;
2021-02-14 10:59:55;8994867000179;ROKOK PENA MILD 16;2;14500;0;29000;26000;3000;
2021-02-14 11:05:07;8992761139018;ADES 600ML;1;3500;0;3500;2292;1208;
2021-02-14 11:13:19;6907992825076;JD WATERMELON APPLE;1;2000;0;2000;1700;300;
2021-02-14 11:35:48;GL;GULA 1 LITER;2;11500;0;23000;21000;2000;
2021-02-14 11:35:48;8991004011906;KOPI BORONG;1;10000;0;10000;8333;1667;
2021-02-14 11:35:48;8995333000822;TERIGU KOMPAS SOFT 500GR;1;5500;0;5500;4967;533;
2021-02-14 11:35:48;8992770061034;SAJIKU;1;2000;0;2000;1500;500;
2021-02-14 12:35:46;8993470671752;JOGER STICK DUO KACANG;1;1000;0;1000;850;150;
2021-02-14 13:06:15;6907992823966;JD BLUEBERRY;1;3500;0;3500;3000;500;
2021-02-14 13:31:15;6907992823966;JD BLUEBERRY;3;3500;0;10500;9000;1500;
2021-02-14 13:31:15;8993470671752;JOGER STICK DUO KACANG;1;1000;0;1000;850;150;
2021-02-14 13:31:15;8993470411433;JOGER CLASSIC;2;1000;0;2000;1700;300;
2021-02-14 13:33:11;8992761002015;COCA COLA PET 390ML;1;5500;0;5500;4333;1167;
2021-02-14 13:58:07;089686010107;INDOMIE KALDU AYAM;3;2500;0;7500;6465;1035;
2021-02-14 13:58:07;089686010824;INDOMIE GORENG SPESIAL;2;2700;0;5400;4904;496;
2021-02-14 13:58:07;089686010343;INDOMIE SOTO MIE;1;2600;0;2600;2367;233;
2021-02-14 15:05:58;8999999031930;PEPSODENT TB TRIPLE CLEAN;1;3500;0;3500;2850;650;
2021-02-14 15:05:59;6907992824963;JD CHOCO BLAST;1;3000;0;3000;2600;400;
2021-02-14 15:05:59;8992775311325;GERY SNACK&SEREAL 100G;1;7000;0;7000;5892;1108;
2021-02-14 15:05:59;8999999055769;FAIR&LOVELY MVIT FC FOAM 50 G;1;12500;0;12500;11180;1320;
2021-02-14 15:05:59;8999999544126;FAIR&LOVELY BB CREAM 15 MG;1;20000;0;20000;17625;2375;
2021-02-14 15:05:59;6907992823621;JD CREAMY YOGURT;1;4000;0;4000;2600;1400;
2021-02-14 15:42:00;6907992823867;JD CRUNCHY CHOCOLATE MALT;1;5500;0;5500;4700;800;
2021-02-14 15:42:00;6907992823874;JD CRUNCHY CHOCO BLUEBERRY;1;5500;0;5500;4700;800;
2021-02-14 16:02:18;089686010107;INDOMIE KALDU AYAM;1;2500;0;2500;2155;345;
2021-02-14 17:30:22;8998866200882;SUKSESMIE GORENG AYAM KRMS 133GR;1;3500;0;3500;3000;500;
2021-02-14 17:59:11;8998009020186;BUAVITA GUAVA 250ML;1;6600;0;6600;5950;650;
2021-02-14 17:59:11;8997013790108;BIMURA KACANG TELUR 25G;2;1000;0;2000;1750;250;
2021-02-14 18:25:04;8992761139018;ADES 600ML;1;3500;0;3500;2292;1208;
2021-02-14 18:25:04;8992761166052;FRESTEA MELATI 350ML;1;4500;0;4500;3000;1500;
2021-02-14 18:25:04;8992957220087;COKLAT SINGA;1;2000;0;2000;1700;300;
2021-02-14 18:50:10;8998009020186;BUAVITA GUAVA 250ML;1;6600;0;6600;5950;650;
2021-02-14 19:01:23;8998989500166;GUDANG GARAM MERAH BESAR 16KS;2;17000;0;34000;30600;3400;
2021-02-14 19:01:23;8998866200301;NOODLE SEDAAP GORENG  90 GR;2;2500;0;5000;4046;954;
2021-02-14 19:01:23;089686010107;INDOMIE KALDU AYAM;3;2500;0;7500;6465;1035;
2021-02-14 19:01:23;GL;GULA 1 LITER;1;11500;0;11500;10500;1000;
2021-02-14 19:01:23;8998866608459;POWDET DAIA PUTIH BAG 290GR;2;5000;0;10000;8900;1100;
2021-02-14 19:01:23;8991004011906;KOPI BORONG;1;10000;0;10000;8333;1667;
2021-02-14 19:06:05;8999999195656;SARI WANGI 50X1.85;1;10000;0;10000;8700;1300;
2021-02-14 19:29:14;GL;GULA 1 LITER;3;11500;0;34500;31500;3000;
2021-02-14 19:58:46;8992753102204;BKM COKLAT 370G;1;11300;0;11300;9500;1800;
2021-02-14 19:58:46;8996001301142;ROMA KELAPA;1;8000;0;8000;6628;1372;
2021-02-14 19:58:46;8998866202732;MILKU STROBERI 200ML;1;3000;0;3000;2375;625;
2021-02-14 21:40:01;8992761145019;COCA COLA PET 250ML;1;3500;0;3500;2417;1083;
2021-02-14 21:40:01;8992761145033;FANTA STRAW PET 250ML;2;3500;0;7000;4834;2166;
2021-02-14 21:40:01;8998989121163;SURYA PRO MERAH;1;20000;0;20000;18600;1400;
2021-02-14 21:40:01;8992957220186;COKLAT RUSA;2;2000;0;4000;3400;600;
2021-02-14 21:40:01;8992957220117;COKLAT BERUANG;2;2000;0;4000;3400;600;
2021-02-14 21:49:42;6907992823942;JD JUJUBE;1;4500;0;4500;3800;700;
2021-02-14 21:53:51;8994867007161;ROKOK PENA GOLD 20;1;17000;0;17000;15000;2000;
2021-02-14 21:53:51;8992775311325;GERY SNACK&SEREAL 100G;1;7000;0;7000;5892;1108;
2021-02-14 22:05:55;8998866500135;HERSPROTEX SOFTCARE WINGS;1;5500;0;5500;4820;680;
2021-02-14 23:46:28;8998989300261;GUDANG GARAM SURYA 12 FILTER;1;18000;0;18000;16450;1550;
2021-02-14 23:46:28;089686010824;INDOMIE GORENG SPESIAL;1;2700;0;2700;2452;248;
2021-02-14 23:47:45;GL;GULA 1 LITER;1;11500;0;11500;10500;1000;
2021-02-15 00:19:42;76164217;MARLBORO MERAH;1;30000;0;30000;27700;2300;
2021-02-15 08:57:38;8998866501033;MINYAK GORENG SEDAAP POUCH 2L;2;28500;0;57000;55492;1508;
2021-02-15 08:57:38;8998866610070;SOKLIN SOFTERGEN 280G PURPLE;1;5000;0;5000;4425;575;
2021-02-15 08:57:38;089686010824;INDOMIE GORENG SPESIAL;1;2700;0;2700;2452;248;
2021-02-15 10:10:19;8997213203095;INLITE 7W;1;34000;0;34000;31000;3000;
2021-02-15 10:18:27;089686060362;POP MIE SOTO AYAM JUMBO;1;4500;0;4500;3833;667;
2021-02-15 10:34:49;8993470671752;JOGER STICK DUO KACANG;1;1000;0;1000;850;150;
2021-02-15 11:31:23;8998866202732;MILKU STROBERI 200ML;2;3000;0;6000;4750;1250;
2021-02-15 11:54:04;6907992823645;JD COCONUT BLISS;1;4000;0;4000;3500;500;
2021-02-15 11:54:22;6907992823850;CHOCO CIRLE;1;5000;0;5000;4700;300;
2021-02-15 11:57:49;6907992823676;JD PEACH;1;2000;0;2000;1700;300;
2021-02-15 11:57:49;6907992823843;JD MOCHA CRISPY;2;5000;0;10000;8800;1200;
2021-02-15 12:01:54;GL;GULA 1 LITER;1;11500;0;11500;10500;1000;
2021-02-15 12:01:54;8998866201933;MINYAK GORENG SEDAAP 5 L;1;71500;0;71500;70230;1270;
2021-02-15 12:09:31;089686060126;POP MIE BASO JUMBO;1;4500;0;4500;3833;667;
2021-02-15 14:01:19;8998898829129;KKB ENER-G JERUK;1;5500;0;5500;4824;676;
2021-02-15 14:01:51;8998898830125;KKB ENER-G ANGGUR;1;5500;0;5500;4824;676;
2021-02-15 14:01:51;8997013790108;BIMURA KACANG TELUR 25G;2;1000;0;2000;1750;250;
2021-02-15 16:31:43;SWAL;SENDAL SWALLOW;1;18000;0;18000;16500;1500;
2021-02-15 16:48:26;8998866201377;KRISBEE FRIES KENTANG GORENG 68 GR;1;5500;0;5500;4620;880;
2021-02-15 16:48:52;8998989300261;GUDANG GARAM SURYA 12 FILTER;1;18000;0;18000;16450;1550;
2021-02-15 16:58:56;8996001301142;ROMA KELAPA;1;8000;0;8000;6628;1372;
2021-02-15 17:35:50;8992761002022;SPRITE PET 390ML;1;5500;0;5500;4300;1200;
2021-02-15 17:47:45;8993470279651;JOGER CHOCKY BAR;2;1000;0;2000;1734;266;
2021-02-15 17:47:45;8992761145019;COCA COLA PET 250ML;1;3500;0;3500;2417;1083;
2021-02-15 18:10:23;8999999035495;VASELINE INSTA FAIR 190ML;1;33100;0;33100;30855;2245;
2021-02-15 18:10:23;8999999035532;VASELINE NIGHT REPAIR 200ML;1;33800;0;33800;30855;2945;
2021-02-15 18:17:02;8991111152080;LISTERINE NATURAL GREEN TEA 250ML;1;21500;0;21500;19550;1950;
2021-02-15 18:20:51;8992959117590;SFX DS REG FLOW WING 20;1;12000;0;12000;11250;750;
2021-02-15 18:20:51;TUSTEL;TUSUK TELINGA;1;1000;0;1000;833;167;
2021-02-15 18:26:57;8992761139018;ADES 600ML;1;3500;0;3500;2292;1208;
2021-02-15 18:26:57;8998866200844;NOODLE SEDAAP MIE KARI SPESIAL CUP 81 GR;1;4500;0;4500;3650;850;
2021-02-15 19:08:58;8998866200882;SUKSESMIE GORENG AYAM KRMS 133GR;1;3500;0;3500;3000;500;
2021-02-15 19:08:58;8992957220087;COKLAT SINGA;1;2000;0;2000;1700;300;
2021-02-15 19:11:27;8999999007782;FAIR&LOVELY MULTIVITAMIN CREAM 25 MG;1;16500;0;16500;14905;1595;
2021-02-15 19:11:27;8999999544126;FAIR&LOVELY BB CREAM 15 MG;1;20000;0;20000;17625;2375;
2021-02-15 19:23:04;GL;GULA 1 LITER;1;11500;0;11500;10500;1000;
2021-02-15 19:23:04;8998866501026;MINYAK GORENG SEDAAP POUCH 1 L;1;14500;0;14500;14110;390;
2021-02-15 19:23:04;SNTN;SANTAN;1;2000;0;2000;1500;500;
2021-02-15 19:23:04;8999999552503;ZWITSAL KIDS SHP PINK SOFT&MSTR 180 ML;1;15000;0;15000;13695;1305;
2021-02-15 19:26:46;8992761139018;ADES 600ML;1;3500;0;3500;2292;1208;
2021-02-15 19:26:46;8997013790108;BIMURA KACANG TELUR 25G;1;1000;0;1000;875;125;
2021-02-15 19:29:11;8998989100120;GUDANG GARAM MINI;1;18000;0;18000;16600;1400;
2021-02-15 20:21:32;8992775311325;GERY SNACK&SEREAL 100G;1;7000;0;7000;5892;1108;
2021-02-15 21:09:23;8992696404441;BEAR BRAND 189ML;1;8500;0;8500;7887;613;
2021-02-15 21:25:27;6907992823621;JD CREAMY YOGURT;1;3000;0;3000;2600;400;
2021-02-15 22:00:03;8998989300261;GUDANG GARAM SURYA 12 FILTER;1;18000;0;18000;16450;1550;
2021-02-15 23:03:41;8992761139018;ADES 600ML;2;3500;0;7000;4584;2416;
2021-02-15 23:54:06;8992222010221;TANCHO TREATMENT;1;15000;0;15000;13000;2000;
2021-02-16 07:48:09;8996001357088;ASTOR SINGLE 18GR;1;10800;0;10800;9800;1000;
2021-02-16 07:48:09;8998866200578;NOODLE SEDAAP KARI KENTAL SPC 75 GR;1;2300;0;2300;1952;348;
2021-02-16 07:48:09;8998866202053;POTABEE AYAM BAKAR PEDAS 68GR;1;8000;0;8000;7200;800;
2021-02-16 09:57:14;8995333000822;TERIGU KOMPAS SOFT 500GR;1;5500;0;5500;4967;533;
2021-02-16 09:58:22;8993470279651;JOGER CHOCKY BAR;1;1000;0;1000;867;133;
2021-02-16 10:16:06;8998989500166;GUDANG GARAM MERAH BESAR 16KS;1;17000;0;17000;15300;1700;
2021-02-16 10:51:23;089686010107;INDOMIE KALDU AYAM;2;2500;0;5000;4310;690;
2021-02-16 11:05:35;8996001370063;CHOKI-CHOKI;1;18200;0;18200;16500;1700;
2021-02-16 12:04:27;8992759120264;LARISST 220;2;12000;0;24000;18400;5600;
2021-02-16 12:06:53;8999909096004;SAMPOERNA 16 FILTER;1;24000;0;24000;23000;1000;
2021-02-16 12:09:45;76164217;MARLBORO MERAH;1;30000;0;30000;27700;2300;
2021-02-16 12:21:05;8992753631209;OMELA 370;3;9500;0;28500;25200;3300;
2021-02-16 12:21:05;6907992823867;JD CRUNCHY CHOCOLATE MALT;1;5500;0;5500;4700;800;
2021-02-16 12:21:05;6907992823843;JD MOCHA CRISPY;2;5000;0;10000;8800;1200;
2021-02-16 12:26:19;6907992823843;JD MOCHA CRISPY;1;5000;0;5000;4400;600;
2021-02-16 12:26:19;8992753184002;FF MILKY STRW 115G;2;3000;0;6000;4356;1644;
2021-02-16 12:26:19;6907992823829;JD MILKY MILK;2;3000;0;6000;5200;800;
2021-02-16 12:26:19;6907992823874;JD CRUNCHY CHOCO BLUEBERRY;2;5500;0;11000;9400;1600;
2021-02-16 12:26:19;6907992823966;JD BLUEBERRY;1;3500;0;3500;3000;500;
2021-02-16 13:21:01;8996001600375;LE MINERAL 330ML;10;2000;0;20000;14170;5830;
2021-02-16 13:21:01;GL;GULA 1 LITER;1;11500;0;11500;10500;1000;
2021-02-16 14:18:26;8992759120264;LARISST 220;1;12000;0;12000;9200;2800;
2021-02-16 15:03:43;8992761145026;SPRITE PET 250ML;1;3500;0;3500;2417;1083;
2021-02-16 15:03:43;8992957220087;COKLAT SINGA;2;2000;0;4000;3400;600;
2021-02-16 15:44:05;8998989300261;GUDANG GARAM SURYA 12 FILTER;1;18000;0;18000;16450;1550;
2021-02-16 15:52:10;8992761139018;ADES 600ML;1;3500;0;3500;2292;1208;
2021-02-16 17:35:11;8998866202244;EKOMIE BUMBU KALDU AYAM;4;1000;0;4000;3440;560;
2021-02-16 17:35:11;8999999524722;SUNLIGHT LIME NEW PCH 435ML;1;10000;0;10000;9100;900;
2021-02-16 17:35:11;8992628022156;BIMOLI KLASIK TOUCH 1 LT;1;16000;0;16000;14350;1650;
2021-02-16 17:39:52;GL;GULA 1 LITER;1;11500;0;11500;10500;1000;
2021-02-16 17:39:52;8993470671752;JOGER STICK DUO KACANG;3;1000;0;3000;2550;450;
2021-02-16 17:54:07;8998866201452;POTABEE REGULER BBQ BEEF 35GR;1;4800;0;4800;4150;650;
2021-02-16 18:05:35;8996001600375;LE MINERAL 330ML;2;2000;0;4000;2834;1166;
2021-02-16 18:09:54;8992745120469;HIT SPRAY ORRG 415+35ML;1;27500;0;27500;25500;2000;
2021-02-16 18:09:54;8992775001820;CHOCOLATOS WAFER CREAM;1;17500;0;17500;15761;1739;
2021-02-16 18:13:38;8998866202732;MILKU STROBERI 200ML;1;3000;0;3000;2375;625;
2021-02-16 18:19:42;8998866200882;SUKSESMIE GORENG AYAM KRMS 133GR;1;3500;0;3500;3000;500;
2021-02-16 18:42:30;8998866200578;NOODLE SEDAAP KARI KENTAL SPC 75 GR;2;2300;0;4600;3904;696;
2021-02-16 19:24:48;089686060102;POP MIE PEDE GLEDEEK;1;5000;0;5000;4450;550;
2021-02-16 19:50:56;8992696422735;DNCO CKLT UHT 110ML;1;2500;0;2500;2041;459;
2021-02-16 19:50:56;8992696523081;MILO UHT 110ML;1;2500;0;2500;1962;538;
2021-02-16 19:59:29;8997018250218;JAHE MERAH;2;1000;0;2000;1666;334;
2021-02-16 20:19:47;8998866202435;JAPOTA UMAMI JAPANESE SEAWEED 35GR;1;5000;0;5000;4150;850;
2021-02-16 20:19:47;8998866201483;POTABEE REGULER GRILLED SEAWEED 35GR;1;5000;0;5000;4150;850;
2021-02-16 20:27:10;8992761166038;MMP ORANGE 300ML;2;5000;0;10000;7500;2500;
2021-02-16 20:32:23;8998866202435;JAPOTA UMAMI JAPANESE SEAWEED 35GR;1;5000;0;5000;4150;850;
2021-02-16 20:39:12;8998989110167;SURYA GUDANG GARAM 16 FILTER;1;24000;0;24000;22100;1900;
2021-02-16 21:46:28;9556040040038;SUSU F&N;1;33000;0;33000;30000;3000;
2021-02-16 21:46:28;8992388133345;NU MILK TEA TEH TARIK 330ML;1;5000;0;5000;4604;396;
2021-02-16 21:46:56;8992759120264;LARISST 220;1;12000;0;12000;9200;2800;
2021-02-16 21:46:56;8993324850449;BABY LOVE COTTON BUDS;1;5000;0;5000;4500;500;
2021-02-16 21:52:45;8998866202732;MILKU STROBERI 200ML;1;3000;0;3000;2375;625;
2021-02-16 22:08:34;8998989110167;SURYA GUDANG GARAM 16 FILTER;1;24000;0;24000;22100;1900;
2021-02-16 22:18:03;8998866202244;EKOMIE BUMBU KALDU AYAM;1;1000;0;1000;860;140;
2021-02-16 22:18:03;8998866202343;NOODLE SEDAAP MIE KOREAN SPICY 87 GR;1;2500;0;2500;2023;477;
2021-02-16 22:18:03;8998866202619;SEDAAP MIE KOREAN SPICY SOUP BAG 77 GR;1;2300;0;2300;2027;273;
2021-02-16 22:18:03;8992388112401;MIE ABC SELERA PEDAS- GORENG AYAM PEDAS LIMAU;1;2600;0;2600;2368;232;
2021-02-16 22:18:03;8992388111206;MIE ABC SELERA PEDAS-GULAI AYAM PEDAS;1;2500;0;2500;2022;478;
2021-02-16 22:24:09;8998989500166;GUDANG GARAM MERAH BESAR 16KS;2;17000;0;34000;30600;3400;
2021-02-16 22:25:04;GL;GULA 1 LITER;1;11500;0;11500;10500;1000;
2021-02-16 22:26:07;8998866613262;SUKSESMIE SOTO 111 GR;1;3500;0;3500;2770;730;
2021-02-16 22:33:30;8997013790108;BIMURA KACANG TELUR 25G;2;1000;0;2000;1750;250;
2021-02-16 22:35:24;8999908284907;MY BABY MINYAK TELON 90ML;1;25000;0;25000;22700;2300;
2021-02-16 22:44:57;8998899001920;BAYGON MAX;1;4000;0;4000;3500;500;
2021-02-17 09:14:08;8995333060703;TERIGU KOMPAS 1KG;1;10500;0;10500;9816;684;
2021-02-17 09:34:30;ARG;ARGUS 220ML;1;14500;0;14500;12500;2000;
2021-02-17 09:34:30;8992759120264;LARISST 220;1;12000;0;12000;9200;2800;
2021-02-17 09:34:30;TUSTEL;TUSUK TELINGA;1;1000;0;1000;833;167;
2021-02-17 09:42:46;76164217;MARLBORO MERAH;1;30000;0;30000;27700;2300;
2021-02-17 09:50:53;8992753631209;OMELA 370;1;9500;0;9500;8400;1100;
2021-02-17 10:48:55;PT;POTO-POTO SINJAI;1;6000;0;6000;5000;1000;
2021-02-17 10:48:55;KRP;KERUPUK BAWANG SINJAI;1;6000;0;6000;5000;1000;
2021-02-17 10:48:55;8999999538446;SUNSILK SHP BLKSHINE 55 ML3750;1;4500;0;4500;3750;750;
2021-02-17 11:10:00;JGR SHN;JOGER SHINY SACHET;1;500;0;500;405;95;
2021-02-17 11:22:47;8998989300261;GUDANG GARAM SURYA 12 FILTER;1;18000;0;18000;16450;1550;
2021-02-17 11:25:56;8998989121163;SURYA PRO MERAH;1;20000;0;20000;18600;1400;
2021-02-17 11:25:56;8994867007161;ROKOK PENA GOLD 20;1;17000;0;17000;15000;2000;
2021-02-17 14:03:52;GL;GULA 1 LITER;2;11500;0;23000;21000;2000;
2021-02-17 14:03:52;8998866200301;NOODLE SEDAAP GORENG  90 GR;4;2500;0;10000;8092;1908;
2021-02-17 14:03:52;8999801700030;SUSU FOYU;1;11500;0;11500;10450;1050;
2021-02-17 14:03:52;8998866602570;NUVO FAMILY KUNING 76G;1;2000;0;2000;1820;180;
2021-02-17 14:03:52;8998866606158;NUVO ACTIVE COOL 110G;1;3000;0;3000;2600;400;
2021-02-17 14:03:52;BTS;BIMURA TARO SEAWEED 250G;1;10000;0;10000;9300;700;
2021-02-17 14:03:52;8850507001152;MOTU ATV;1;10000;0;10000;8000;2000;
2021-02-17 14:03:52;8995333060703;TERIGU KOMPAS 1KG;1;10500;0;10500;9816;684;
2021-02-17 14:03:52;8998866104043;ZINC HAIRFALL TRETH BTL 70ML;1;8500;0;8500;7550;950;
2021-02-17 14:41:22;8998009010231;ULTRA CHO 250;1;6000;0;6000;4784;1216;
2021-02-17 14:41:22;8997013790108;BIMURA KACANG TELUR 25G;4;1000;0;4000;3500;500;
2021-02-17 14:52:59;8998866202312;NOODLE SEDAAP TASTY BAKMI AYAM 129 GR;1;5000;0;5000;4167;833;
2021-02-17 15:05:24;8992957220087;COKLAT SINGA;3;2000;0;6000;5100;900;
2021-02-17 15:13:16;8992761166038;MMP ORANGE 300ML;2;5000;0;10000;7500;2500;
2021-02-17 16:05:20;8998989100120;GUDANG GARAM MINI;1;18000;0;18000;16600;1400;
2021-02-17 16:07:11;8998898830125;KKB ENER-G ANGGUR;1;5500;0;5500;4824;676;
2021-02-17 16:26:52;GL;GULA 1 LITER;1;11500;0;11500;10500;1000;
2021-02-17 16:26:52;8993365140363;MASU KURMA TJ 250G;1;22500;0;22500;20570;1930;
2021-02-17 16:26:52;8993365122536;MADU TJ SUPER 250G;1;25000;0;25000;22780;2220;
2021-02-17 16:26:52;8996001355008;BENG-BENG SP20G;1;29000;0;29000;26500;2500;
2021-02-17 16:26:52;089686010190;INDOMIE KARI AYAM;5;2800;0;14000;12610;1390;
2021-02-17 16:26:52;8999999059781;SUNLIGHT LIME NEW POUCH 210ML;1;5000;0;5000;4300;700;
2021-02-17 16:26:52;8996001301579;MALKIST CKLT KELAPA PACK;1;11000;0;11000;9900;1100;
2021-02-17 16:26:52;8999999195649;SARI WANGI 25X1.86G;1;6000;0;6000;5050;950;
2021-02-17 16:26:52;8998866608718;DAIA SOFTENER PINK;1;5000;0;5000;4450;550;
2021-02-17 16:26:52;8992628022156;BIMOLI KLASIK TOUCH 1 LT;1;16000;0;16000;14350;1650;
2021-02-17 16:29:33;8998866202312;NOODLE SEDAAP TASTY BAKMI AYAM 129 GR;1;5000;0;5000;4167;833;
2021-02-17 16:35:31;6907992823959;JD HAWTHORN BERRY;1;2000;0;2000;1700;300;
2021-02-17 16:36:06;6907992823935;JD SWEETCORN;1;3500;0;3500;3000;500;
2021-02-17 16:36:06;6907992823911;JD CRUNCHY HONEYDEW MELON;1;8000;0;8000;6800;1200;
2021-02-17 16:36:06;6907992823904;JD CRUNCHY CHOCOLATE VAN;2;8000;0;16000;13600;2400;
2021-02-17 17:34:41;089686060461;POP MIE RASA KARI AYAM;2;4500;0;9000;7666;1334;
2021-02-17 17:34:41;8998866608084;KECAP MANIS SEDAAP POUCH 550ML;1;19000;0;19000;17000;2000;
2021-02-17 17:34:41;8992628022156;BIMOLI KLASIK TOUCH 1 LT;1;16000;0;16000;14350;1650;
2021-02-17 17:34:41;8998866200844;NOODLE SEDAAP MIE KARI SPESIAL CUP 81 GR;1;4500;0;4500;3650;850;
2021-02-17 17:34:41;8998866200837;NOODLE SEDAAPMIE SOTO CUP 81 GR;1;4500;0;4500;3650;850;
2021-02-17 17:34:41;089686060362;POP MIE SOTO AYAM JUMBO;2;4500;0;9000;7666;1334;
2021-02-17 17:34:41;8998866200851;NOODLE SEDAAP MIE BAKSO SPESIAL CUP 77 GR;1;4500;0;4500;3650;850;
2021-02-17 17:34:41;8998866200301;NOODLE SEDAAP GORENG  90 GR;2;2500;0;5000;4046;954;
2021-02-17 17:34:41;8992761145026;SPRITE PET 250ML;1;3500;0;3500;2417;1083;
2021-02-17 17:34:41;8999999528218;CITRA NATURAL WHITE BTL 220ML;1;17000;0;17000;15450;1550;
2021-02-17 17:34:41;8994037703749;WENIS JERUK;1;8000;0;8000;6500;1500;
2021-02-17 17:35:24;JGR SHN;JOGER SHINY SACHET;2;500;0;1000;874;126;
2021-02-17 18:30:43;6907992823843;JD MOCHA CRISPY;1;5000;0;5000;4400;600;
2021-02-17 18:38:15;8998866200325;NOODLE SEDAAP MIE SOTO;2;2200;0;4400;3904;496;
2021-02-17 19:15:01;8991102989428;WFR TANGO LONG CKLT 24G GTG;1;1000;0;1000;672;328;
2021-02-17 19:37:20;8998866200882;SUKSESMIE GORENG AYAM KRMS 133GR;1;3500;0;3500;3000;500;
2021-02-17 19:37:20;6907992823669;JD MILKY STRAW;1;3000;0;3000;2600;400;
2021-02-17 19:39:28;8998989110167;SURYA GUDANG GARAM 16 FILTER;1;24000;0;24000;22100;1900;
2021-02-17 20:37:49;8998866202343;NOODLE SEDAAP MIE KOREAN SPICY 87 GR;1;2500;0;2500;2023;477;
2021-02-17 20:51:37;8998989110167;SURYA GUDANG GARAM 16 FILTER;1;24000;0;24000;22100;1900;
2021-02-17 21:29:06;8992761166038;MMP ORANGE 300ML;1;5000;0;5000;3750;1250;
2021-02-17 21:29:06;8992957220025;GOLDEN CITY MINI;1;3000;0;3000;2500;500;
2021-02-17 21:29:06;8992957220087;COKLAT SINGA;1;2000;0;2000;1700;300;
2021-02-17 21:58:17;089686041705;INDOMIE GORENG JUMBO;1;3500;0;3500;3143;357;
2021-02-17 21:58:17;8850507000094;POLICE BONCHA;1;2000;0;2000;800;1200;
2021-02-17 22:16:36;8999909982000;SAMPOERNA 12 FILTER;1;18000;0;18000;16200;1800;
2021-02-17 22:32:10;8992959953037;SWEETY BRONZE L1;2;3000;0;6000;5342;658;
2021-02-17 22:36:47;8996001600665;COOL TIME;1;3200;0;3200;2750;450;
2021-02-17 22:40:42;8992761145026;SPRITE PET 250ML;1;3500;0;3500;2417;1083;
2021-02-18 09:48:27;8991001503107;CHACHA PEANUT 35GR;1;5500;0;5500;4900;600;
2021-02-18 09:48:27;JGR SHN;JOGER SHINY SACHET;2;500;0;1000;874;126;
2021-02-18 09:48:27;8991102989428;WFR TANGO LONG CKLT 24G GTG;1;1000;0;1000;672;328;
2021-02-18 10:57:36;8992761166038;MMP ORANGE 300ML;1;5000;0;5000;3750;1250;
2021-02-18 12:21:17;8998989500166;GUDANG GARAM MERAH BESAR 16KS;2;17000;0;34000;30600;3400;
2021-02-18 12:21:48;8998866201841;GOLDA DOLCE LATTE 200ML;1;3000;0;3000;2500;500;
2021-02-18 12:26:27;8999909010567;234 16 FILTER;1;23000;0;23000;21500;1500;
2021-02-18 12:57:44;BTS;BIMURA TARO SEAWEED 250G;1;10000;0;10000;9300;700;
2021-02-18 12:59:56;8992761002022;SPRITE PET 390ML;1;5500;0;5500;4300;1200;
2021-02-18 13:30:44;8992745120469;HIT SPRAY ORRG 415+35ML;1;27500;0;27500;25500;2000;
2021-02-18 13:59:29;123;BETREI JAM;1;5500;0;5500;5000;500;
2021-02-18 14:24:18;6907992823591;JD STRAW MILKSHAKE;1;5000;0;5000;4300;700;
2021-02-18 15:26:27;8992761164539;NUTRIBOOST ORANGE 300ML;1;8500;0;8500;5300;3200;
2021-02-18 15:29:47;8998866200325;NOODLE SEDAAP MIE SOTO;2;2200;0;4400;3904;496;
2021-02-18 18:15:02;8992628510158;SIMAS PALMIA;1;6500;0;6500;4832;1668;
2021-02-18 18:22:46;6907992823935;JD SWEETCORN;1;3500;0;3500;3000;500;
2021-02-18 19:10:29;8998866202732;MILKU STROBERI 200ML;1;3000;0;3000;2375;625;
2021-02-18 19:32:16;8998989110167;SURYA GUDANG GARAM 16 FILTER;2;24000;0;48000;44200;3800;
2021-02-18 19:32:16;123124;KOREK BIASA;1;2000;0;2000;1800;200;
2021-02-18 19:58:46;8998866202244;EKOMIE BUMBU KALDU AYAM;5;1000;0;5000;4300;700;
2021-02-18 20:15:31;8992696404441;BEAR BRAND 189ML;1;8500;0;8500;7887;613;
2021-02-18 23:04:01;8992388133345;NU MILK TEA TEH TARIK 330ML;1;5000;0;5000;4604;396;
2021-02-18 23:04:14;76239878;MARLBORO GOLD;1;30000;0;30000;27700;2300;
2021-02-18 23:26:31;8998989300261;GUDANG GARAM SURYA 12 FILTER;1;18000;0;18000;16450;1550;
2021-02-18 23:26:31;089686010343;INDOMIE SOTO MIE;2;2600;0;5200;4734;466;
2021-02-18 23:56:40;089686021127;INTER MIE KALDU;2;1000;0;2000;1626;374;
2021-02-19 10:35:26;8998866200646;KOPI TOP MURNI;1;11000;0;11000;9600;1400;
2021-02-19 10:35:26;JGR SHN;JOGER SHINY SACHET;3;500;0;1500;1311;189;
2021-02-19 10:35:26;8998009020520;BUAVITA MINI GUAVA 125ML;2;5800;0;11600;10500;1100;
2021-02-19 10:35:26;8997013790092;BIMURA KERUPUK BAWANG 25G;1;1000;0;1000;874;126;
2021-02-19 10:35:26;8996001305249;ROMA KELAPA CREAM;1;6800;0;6800;5514;1286;
2021-02-19 10:35:26;8996001305041;ROMA SANDWICH CKLT;1;7000;0;7000;5000;2000;
2021-02-19 10:35:26;8992761139018;ADES 600ML;1;3500;0;3500;2292;1208;
2021-02-19 10:35:26;8999999037765;PEPSODENT WHITE 225G;1;12000;0;12000;10750;1250;
2021-02-19 10:35:26;GL;GULA 1 LITER;1;11500;0;11500;10500;1000;
2021-02-19 10:47:31;GL;GULA 1 LITER;4;11500;0;46000;42000;4000;
2021-02-19 10:47:31;8995333032113;TERIGU GATOT KACA 1 KG;1;8500;0;8500;8012;488;
2021-02-19 10:47:31;8999801700030;SUSU FOYU;1;11500;0;11500;10450;1050;
2021-02-19 12:16:52;34678;SENDAL JEPIT;1;14000;0;14000;13500;500;
2021-02-19 12:32:58;ARD;SENDAL ARDILES;1;15000;0;15000;13500;1500;
2021-02-19 12:32:58;JGR SHN;JOGER SHINY SACHET;10;500;0;5000;4370;630;
2021-02-19 12:33:22;8992761139018;ADES 600ML;2;3500;0;7000;4584;2416;
2021-02-19 14:06:19;8996001304020;SLAI OLAI NANAS;1;8500;0;8500;7700;800;
2021-02-19 14:16:23;8998866604963;POWDET DAIA LEMON 290GR;1;5000;0;5000;4450;550;
2021-02-19 14:41:13;8992761139018;ADES 600ML;1;3500;0;3500;2292;1208;
2021-02-19 14:48:55;8998898830125;KKB ENER-G ANGGUR;1;5500;0;5500;4824;676;
2021-02-19 14:49:24;8992761139018;ADES 600ML;1;3500;0;3500;2292;1208;
2021-02-19 14:53:16;8998866613262;SUKSESMIE SOTO 111 GR;1;3500;0;3500;2770;730;
2021-02-19 14:53:16;089686048704;SARIMIE GORENG AYAM KCP ISI 2;1;3500;0;3500;3120;380;
2021-02-19 14:53:16;089686041705;INDOMIE GORENG JUMBO;2;3500;0;7000;6286;714;
2021-02-19 15:03:15;GL;GULA 1 LITER;1;11500;0;11500;10500;1000;
2021-02-19 15:38:20;8992761002022;SPRITE PET 390ML;1;5500;0;5500;4300;1200;
2021-02-19 15:38:20;JGR SHN;JOGER SHINY SACHET;2;500;0;1000;874;126;
2021-02-19 16:07:01;8992761139018;ADES 600ML;1;3500;0;3500;2292;1208;
2021-02-19 16:19:59;8998866200578;NOODLE SEDAAP KARI KENTAL SPC 75 GR;1;2300;0;2300;1952;348;
2021-02-19 16:19:59;8992761139018;ADES 600ML;1;3500;0;3500;2292;1208;
2021-02-19 16:21:13;GL;GULA 1 LITER;2;11500;0;23000;21000;2000;
2021-02-19 16:21:13;8999999516208;ROYCO FDS CHICKEN NEW 230G;3;9000;0;27000;24600;2400;
2021-02-19 16:21:52;8996001301579;MALKIST CKLT KELAPA PACK;1;11000;0;11000;9900;1100;
2021-02-19 16:33:38;8992959930120;CONFIDENCE CLASSIC NIGHT XL6;1;42000;0;42000;38182;3818;
2021-02-19 16:33:38;8999999003067;VASELINE SPF24 100ML;1;19500;0;19500;17600;1900;
2021-02-19 16:38:15;089686021127;INTER MIE KALDU;1;1000;0;1000;813;187;
2021-02-19 17:55:27;6907992824963;JD CHOCO BLAST;1;3000;0;3000;2600;400;
2021-02-19 17:55:27;6907992823676;JD PEACH;1;2000;0;2000;1700;300;
2021-02-19 17:55:27;6907992823942;JD JUJUBE;1;4500;0;4500;3800;700;
2021-02-19 17:55:27;8992957220087;COKLAT SINGA;2;2000;0;4000;3400;600;
2021-02-19 17:55:27;JGR SHN;JOGER SHINY SACHET;1;500;0;500;437;63;
2021-02-19 18:18:01;6907992823959;JD HAWTHORN BERRY;1;2000;0;2000;1700;300;
2021-02-19 18:18:24;6907992825076;JD WATERMELON APPLE;1;2000;0;2000;1700;300;
2021-02-19 18:37:20;6907992823935;JD SWEETCORN;1;3500;0;3500;3000;500;
2021-02-19 19:20:25;8992959077207;HN PANTS L 30;1;50000;0;50000;45455;4545;
2021-02-19 19:20:25;8886020033431;KAPUR AJAIB ANTI KECOA DAN NYAMUK;1;3000;0;3000;2700;300;
2021-02-19 19:20:26;ARD;SENDAL ARDILES;1;15000;0;15000;13500;1500;
2021-02-19 19:54:55;8991002103764;GOOD DAY CPUCINO 10X25G;2;1500;0;3000;2790;210;
2021-02-19 19:54:55;8996001600399;LE MINERAL 1500ML;1;5000;0;5000;4042;958;
2021-02-19 20:05:40;8998866202244;EKOMIE BUMBU KALDU AYAM;5;1000;0;5000;4300;700;
2021-02-19 20:05:40;8999999514006;BANGO MANIS 60ML;1;3000;0;3000;2400;600;
2021-02-19 20:33:14;8996001318980;BETTER 120G;1;6000;0;6000;5100;900;
2021-02-19 20:33:14;8993365131538;MADU TJ MURNI 150G;1;14800;0;14800;13430;1370;
2021-02-19 20:33:14;8996001305041;ROMA SANDWICH CKLT;1;7000;0;7000;5000;2000;
2021-02-19 20:33:14;8998866611220;FRES&NATURAL PUTIH 100ML;1;11500;0;11500;10310;1190;
2021-02-19 20:33:14;8991102987899;WFR TANGO POUCH VNL 115G;1;7000;0;7000;6273;727;
2021-02-19 20:33:14;8991102300544;WFR TANGO VNL 176G;1;9200;0;9200;8336;864;
2021-02-19 21:14:49;9556001004673;MILO NESTLE MALAYSIA ACTIVE GO;1;85000;0;85000;80000;5000;
2021-02-19 21:14:49;8996001600269;LE MINERAL 600ML;1;3000;0;3000;1688;1312;
2021-02-19 21:19:54;8999909982000;SAMPOERNA 12 FILTER;1;18000;0;18000;16200;1800;
2021-02-19 21:22:59;089686021127;INTER MIE KALDU;2;1000;0;2000;1626;374;
2021-02-19 22:06:02;8999999560423;DOVE SUPER SHAMPOO 125ML;1;18500;0;18500;17000;1500;
2021-02-19 22:10:05;8993072153595;LARISST COTTON 35G;1;5000;0;5000;3300;1700;
2021-02-19 22:40:30;GL;GULA 1 LITER;3;11500;0;34500;31500;3000;
2021-02-19 22:40:30;8996200900092;HEROCYN 85GR;1;13000;0;13000;11650;1350;
2021-02-19 22:40:30;8993176110081;MINYAK KAYU PUTIH 30ML;1;12000;0;12000;9091;2909;
2021-02-19 23:20:01;8998989300261;GUDANG GARAM SURYA 12 FILTER;1;18000;0;18000;16450;1550;
2021-02-20 00:00:04;8998866200301;NOODLE SEDAAP GORENG  90 GR;1;2500;0;2500;2023;477;
2021-02-20 00:00:04;8998866202619;SEDAAP MIE KOREAN SPICY SOUP BAG 77 GR;1;2300;0;2300;2027;273;
2021-02-20 00:13:00;JGR SHN;JOGER SHINY SACHET;1;500;0;500;437;63;
2021-02-20 10:37:19;8998989500166;GUDANG GARAM MERAH BESAR 16KS;2;17000;0;34000;30600;3400;
2021-02-20 12:13:36;6907992823621;JD CREAMY YOGURT;1;3000;0;3000;2600;400;
2021-02-20 12:13:36;8992761166052;FRESTEA MELATI 350ML;1;4500;0;4500;3000;1500;
2021-02-20 12:58:03;8996001318911;BETTER ISI 4;2;2000;0;4000;3400;600;
2021-02-20 12:58:03;8998866202312;NOODLE SEDAAP TASTY BAKMI AYAM 129 GR;1;5000;0;5000;4167;833;
2021-02-20 13:30:09;8992761002015;COCA COLA PET 390ML;2;5500;0;11000;8666;2334;
2021-02-20 13:58:40;089686067002;POP MIE PDS DOWER RS AYAM;1;5000;0;5000;4450;550;
2021-02-20 13:58:40;8998866200301;NOODLE SEDAAP GORENG  90 GR;1;2500;0;2500;2023;477;
2021-02-20 13:58:40;8999999059781;SUNLIGHT LIME NEW POUCH 210ML;1;5000;0;5000;4300;700;
2021-02-20 15:50:49;6907992823942;JD JUJUBE;1;4500;0;4500;3800;700;
2021-02-20 15:50:49;8997013790108;BIMURA KACANG TELUR 25G;1;1000;0;1000;875;125;
2021-02-20 15:50:49;JGR SHN;JOGER SHINY SACHET;1;500;0;500;437;63;
2021-02-20 16:00:54;8992959508879;SWEETY SILVER PANTS L 7;3;16800;0;50400;45684;4716;
2021-02-20 16:00:54;8996001304020;SLAI OLAI NANAS;1;8500;0;8500;7700;800;
2021-02-20 16:00:54;8992775002087;GARUDA TING-TING 84G;1;6000;0;6000;4924;1076;
2021-02-20 16:00:54;8998866202053;POTABEE AYAM BAKAR PEDAS 68GR;1;8000;0;8000;7200;800;
2021-02-20 16:20:20;8992696523081;MILO UHT 110ML;1;2500;0;2500;1962;538;
2021-02-20 16:31:26;8996001600269;LE MINERAL 600ML;1;3000;0;3000;1688;1312;
2021-02-20 16:31:26;8850507000094;POLICE BONCHA;1;2000;0;2000;800;1200;
2021-02-20 16:49:35;8992761139018;ADES 600ML;1;3500;0;3500;2292;1208;
2021-02-20 16:49:35;JGR SHN;JOGER SHINY SACHET;3;500;0;1500;1311;189;
2021-02-20 18:02:11;GL;GULA 1 LITER;1;11500;0;11500;10500;1000;
2021-02-20 18:09:22;8992959953327;SWEETY BRONZE L52;1;85000;0;85000;80304;4696;
2021-02-20 18:09:22;8998866607315;SOKLIN SOFTERGENT SAKURA 770G & PIRING;1;18000;0;18000;16055;1945;
2021-02-20 18:09:22;8999999037765;PEPSODENT WHITE 225G;1;12000;0;12000;10750;1250;
2021-02-20 18:09:22;8999999049492;REXONA WMN RO POWDER DRY 45 ML;1;15000;0;15000;13500;1500;
2021-02-20 18:09:22;8996001355237;SUPER STAR;1;11000;0;11000;9900;1100;
2021-02-20 18:14:46;6907992823676;JD PEACH;1;2000;0;2000;1700;300;
2021-02-20 18:18:20;8991102989428;WFR TANGO LONG CKLT 24G GTG;1;1000;0;1000;672;328;
2021-02-20 19:04:26;8999999059781;SUNLIGHT LIME NEW POUCH 210ML;1;5000;0;5000;4300;700;
2021-02-20 19:05:03;6907992825076;JD WATERMELON APPLE;4;2000;0;8000;6800;1200;
2021-02-20 19:05:03;6907992823676;JD PEACH;1;2000;0;2000;1700;300;
2021-02-20 19:25:58;8992761145033;FANTA STRAW PET 250ML;4;3500;0;14000;9668;4332;
2021-02-20 19:25:58;8997013790108;BIMURA KACANG TELUR 25G;10;1000;0;10000;8750;1250;
2021-02-20 19:25:58;8999909010567;234 16 FILTER;1;23000;0;23000;21500;1500;
2021-02-20 19:38:28;8997021870328;HOT IN CREAM 120ML;1;18500;0;18500;17000;1500;
2021-02-20 19:38:28;8993571003827;CAP 19 BEDAK SALICYL MENTHOL 100G;1;8000;0;8000;7000;1000;
2021-02-20 20:24:35;8998866610261;POWDET DAIA SOFTENER BAG 290 GR;1;5000;0;5000;4450;550;
2021-02-20 21:14:00;8998989300261;GUDANG GARAM SURYA 12 FILTER;1;18000;0;18000;16450;1550;
2021-02-20 21:14:00;8996001355237;SUPER STAR;1;11000;0;11000;9900;1100;
2021-02-20 21:17:17;8991102989428;WFR TANGO LONG CKLT 24G GTG;1;1000;0;1000;672;328;
2021-02-20 21:17:17;GL;GULA 1 LITER;1;11500;0;11500;10500;1000;
2021-02-20 21:28:38;GL;GULA 1 LITER;1;11500;0;11500;10500;1000;
2021-02-20 21:34:26;8995333000822;TERIGU KOMPAS SOFT 500GR;1;5500;0;5500;4967;533;
2021-02-20 21:34:51;GL;GULA 1 LITER;2;11500;0;23000;21000;2000;
2021-02-21 11:11:20;8999999514006;BANGO MANIS 60ML;1;3000;0;3000;2400;600;
2021-02-21 11:11:20;8995333060703;TERIGU KOMPAS 1KG;1;10500;0;10500;9816;684;
2021-02-21 11:11:20;GL;GULA 1 LITER;1;11500;0;11500;10500;1000;
2021-02-21 11:11:20;8996001600269;LE MINERAL 600ML;1;3000;0;3000;1688;1312;
2021-02-21 11:11:20;8996001600399;LE MINERAL 1500ML;1;5000;0;5000;4042;958;
2021-02-21 11:11:20;8998989300261;GUDANG GARAM SURYA 12 FILTER;1;18000;0;18000;16450;1550;
2021-02-21 11:11:20;8998866201469;POTABEE REGULER BBQ BEEF 68 GR;1;8000;0;8000;7200;800;
2021-02-21 11:29:23;6907992825076;JD WATERMELON APPLE;1;2000;0;2000;1700;300;
2021-02-21 11:55:48;JGR SHN;JOGER SHINY SACHET;1;500;0;500;437;63;
2021-02-21 13:50:00;8997011700123;BIHUN JAGUNG 300GR;1;5200;0;5200;4738;462;
2021-02-21 14:07:30;8998898830125;KKB ENER-G ANGGUR;1;5500;0;5500;4824;676;
2021-02-21 14:07:30;8997013790108;BIMURA KACANG TELUR 25G;3;1000;0;3000;2625;375;
2021-02-21 16:31:23;8992753101207;BENDERA KENTAL MANIS 370G;2;11500;0;23000;19400;3600;
2021-02-21 17:20:15;6907992823652;JD CHOCOLATE MILKSHAKE;1;6000;0;6000;5200;800;
2021-02-21 17:20:15;6907992825076;JD WATERMELON APPLE;1;2000;0;2000;1700;300;
2021-02-21 17:36:14;8992761139018;ADES 600ML;1;3500;0;3500;2292;1208;
2021-02-21 17:36:14;8992761122331;FRESTEA APPEL 500ML;1;6500;0;6500;4708;1792;
2021-02-21 18:40:43;6907992823935;JD SWEETCORN;2;3500;0;7000;6000;1000;
2021-02-21 19:22:34;8999909010567;234 16 FILTER;1;23000;0;23000;21500;1500;
2021-02-21 19:22:34;8997013790108;BIMURA KACANG TELUR 25G;1;1000;0;1000;875;125;
2021-02-21 20:07:14;8998989110167;SURYA GUDANG GARAM 16 FILTER;1;24000;0;24000;22100;1900;
2021-02-21 20:08:53;8992761166212;FRESTEA APPLE 350ML;1;4500;0;4500;3000;1500;
2021-02-21 20:08:53;8992761166229;FRESTEA MARKISA 350ML;1;4500;0;4500;3000;1500;
2021-02-21 20:09:33;8993470671752;JOGER STICK DUO KACANG;1;1000;0;1000;850;150;
2021-02-21 20:37:16;8992761139018;ADES 600ML;1;3500;0;3500;2292;1208;
2021-02-21 21:17:14;GL;GULA 1 LITER;1;11500;0;11500;10500;1000;
2021-02-21 21:17:14;8999999706173;PEPSODENT WHITE 120G;1;6700;0;6700;5940;760;
2021-02-21 21:17:14;8992775002087;GARUDA TING-TING 84G;1;6000;0;6000;4924;1076;
2021-02-21 21:17:14;8998866501026;MINYAK GORENG SEDAAP POUCH 1 L;1;15500;0;15500;14110;1390;
2021-02-21 21:17:14;8996001304013;SLAI OLAI PACK;1;8500;0;8500;7700;800;
2021-02-21 21:17:14;8998866103985;CIPT SIKP;1;3000;0;3000;2552;448;
2021-02-21 21:17:14;8997021870151;FRESH CARE STRONG 110ML;1;12000;0;12000;10000;2000;
2021-02-21 21:17:14;8996001312353;MALKIST KELAPA KOPYOR;1;6700;0;6700;5400;1300;
2021-02-21 21:17:14;8998866200882;SUKSESMIE GORENG AYAM KRMS 133GR;1;3500;0;3500;3000;500;
2021-02-21 21:17:14;089686021141;INTER MIE SOTO;2;1000;0;2000;1708;292;
2021-02-21 21:17:14;8998866200578;NOODLE SEDAAP KARI KENTAL SPC 75 GR;1;2300;0;2300;1952;348;
2021-02-21 21:17:14;8998866613262;SUKSESMIE SOTO 111 GR;1;3500;0;3500;2770;730;
2021-02-21 21:17:14;089686021127;INTER MIE KALDU;2;1000;0;2000;1626;374;
2021-02-21 21:17:14;8998866202343;NOODLE SEDAAP MIE KOREAN SPICY 87 GR;2;2500;0;5000;4046;954;
2021-02-21 21:17:14;8997021300092;LARISSA BAWANG 250GR;1;5500;0;5500;5125;375;
2021-02-21 21:17:14;8998898853100;SUSU JAHE;1;13000;0;13000;11800;1200;
2021-02-21 21:17:14;8999999529840;CLEAR SHP SPR FRSH APPLE 9 AML;1;10500;0;10500;9300;1200;
2021-02-21 21:17:14;8998866610261;POWDET DAIA SOFTENER BAG 290 GR;1;5000;0;5000;4450;550;
2021-02-21 21:17:14;8998866600101;CREAM EKONOMI LEMON 455G;1;5500;0;5500;4750;750;
2021-02-21 21:17:14;8998866613002;CREAM EKONOMI PINK 455G;1;5500;0;5500;4750;750;
2021-02-21 21:25:54;8991002103764;GOOD DAY CPUCINO 10X25G;10;1500;0;15000;13950;1050;
2021-02-21 22:01:59;8998866202404;NOODLE SEDAAP MIE KOREAN SPICY CHICKEN CUP;1;5000;0;5000;3917;1083;
2021-02-21 23:02:28;8998989300261;GUDANG GARAM SURYA 12 FILTER;1;18000;0;18000;16450;1550;
2021-02-21 23:20:11;089686017748;SARIMIE GORENG ISI 2;1;3500;0;3500;3120;380;
2021-02-21 23:24:13;8996200900023;HEROCYN 150GR;1;18000;0;18000;16400;1600;
2021-02-21 23:24:59;8998989300261;GUDANG GARAM SURYA 12 FILTER;1;18000;0;18000;16450;1550;
2021-02-22 10:52:20;8998866693578;SOKLIN FLOORCLENER PINK 900ML;1;14000;0;14000;12436;1564;
2021-02-22 10:52:20;8998899400334;BAYGON ORANGE BLOSSOM;1;38000;0;38000;35000;3000;
2021-02-22 10:52:20;8998899002132;BAY FRESH LEMON 320ML;1;18500;0;18500;16700;1800;
2021-02-22 10:52:20;8999999001155;LIFEBUOY BW TOTAL10 300ML;1;24000;0;24000;21550;2450;
2021-02-22 10:52:20;8996200900023;HEROCYN 150GR;1;18000;0;18000;16400;1600;
2021-02-22 10:52:20;8998898101447;TOLAK ANGIN 12;1;35000;0;35000;32496;2504;
2021-02-22 10:52:20;ARD;SENDAL ARDILES;1;15000;0;15000;13500;1500;
2021-02-22 10:52:20;8992761166038;MMP ORANGE 300ML;1;5000;0;5000;3750;1250;
2021-02-22 10:52:20;8999999037765;PEPSODENT WHITE 225G;1;12000;0;12000;10750;1250;
2021-02-22 11:25:09;8992775311325;GERY SNACK&SEREAL 100G;1;7000;0;7000;5892;1108;
2021-02-22 11:25:09;8998866202664;POTABEE WAGYU BEEF STEAK 68 GR;1;8000;0;8000;7200;800;
2021-02-22 11:25:09;8998866202732;MILKU STROBERI 200ML;2;3000;0;6000;4750;1250;
2021-02-22 11:46:46;8998866202732;MILKU STROBERI 200ML;1;3000;0;3000;2375;625;
2021-02-22 11:46:46;8996001304990;SARI GANDUM 115G;1;6000;0;6000;5100;900;
2021-02-22 13:03:23;8998989500166;GUDANG GARAM MERAH BESAR 16KS;2;17000;0;34000;30600;3400;
2021-02-22 13:03:55;8992946511790;SHINZUI 85G;1;5000;0;5000;3475;1525;
2021-02-22 14:16:51;8999908284907;MY BABY MINYAK TELON 90ML;1;25000;0;25000;22700;2300;
2021-02-22 16:30:19;8999999030179;PEPSODENT ACTION 123 COMPLETE 75G;1;6700;0;6700;5170;1530;
2021-02-22 16:30:19;8996001304990;SARI GANDUM 115G;1;6000;0;6000;5100;900;
2021-02-22 16:43:05;8992761145026;SPRITE PET 250ML;1;3500;0;3500;2417;1083;
2021-02-22 16:43:05;JGR SHN;JOGER SHINY SACHET;3;500;0;1500;1311;189;
2021-02-22 17:22:22;8850507000094;POLICE BONCHA;1;2000;0;2000;800;1200;
2021-02-22 17:22:22;8998009010590;ULTRA CHO 125;1;3000;0;3000;2428;572;
2021-02-22 17:22:22;8996001305041;ROMA SANDWICH CKLT;1;7000;0;7000;5000;2000;
2021-02-22 17:59:42;8995333060703;TERIGU KOMPAS 1KG;1;10500;0;10500;9816;684;
2021-02-22 19:07:48;ARG;ARGUS 220ML;1;14500;0;14500;12500;2000;
2021-02-22 19:07:48;8998989110167;SURYA GUDANG GARAM 16 FILTER;1;24000;0;24000;22100;1900;
2021-02-22 19:10:26;JGR SHN;JOGER SHINY SACHET;1;500;0;500;437;63;
2021-02-22 19:20:43;8992761145033;FANTA STRAW PET 250ML;1;3500;0;3500;2417;1083;
2021-02-22 19:23:48;8998866201377;KRISBEE FRIES KENTANG GORENG 68 GR;1;5500;0;5500;4620;880;
2021-02-22 19:23:48;JGR SHN;JOGER SHINY SACHET;2;500;0;1000;874;126;
2021-02-22 19:28:14;8998866201964;MINYAK GORENG SABRINA 2L POUCH;1;28000;0;28000;26753;1247;
2021-02-22 19:28:14;8991102989428;WFR TANGO LONG CKLT 24G GTG;2;1000;0;2000;1344;656;
2021-02-22 19:40:10;8992761122331;FRESTEA APPEL 500ML;1;6500;0;6500;4708;1792;
2021-02-22 19:40:10;8992761145026;SPRITE PET 250ML;1;3500;0;3500;2417;1083;
2021-02-22 19:44:55;8998866200578;NOODLE SEDAAP KARI KENTAL SPC 75 GR;1;2300;0;2300;1952;348;
2021-02-22 19:45:26;JGR SHN;JOGER SHINY SACHET;1;500;0;500;437;63;
2021-02-22 19:50:50;8994037703749;WENIS JERUK;1;8000;0;8000;6500;1500;
2021-02-22 19:59:07;8998989300261;GUDANG GARAM SURYA 12 FILTER;1;18000;0;18000;16450;1550;
2021-02-22 20:14:56;8995333032113;TERIGU GATOT KACA 1 KG;3;8500;0;25500;24036;1464;
2021-02-22 20:14:56;8993379210854;SABUN HARMONY 70G;2;2000;0;4000;3304;696;
2021-02-22 20:14:56;8998866601429;POWDET DAIA BUNGA BAG 290GR;1;5000;0;5000;4450;550;
2021-02-22 21:15:05;8998899001920;BAYGON MAX;1;4000;0;4000;3500;500;
2021-02-22 21:15:19;8718291206453;PHILIPS 15 W;1;48000;0;48000;45000;3000;
2021-02-22 21:44:27;089686010190;INDOMIE KARI AYAM;1;2800;0;2800;2522;278;
2021-02-22 21:44:27;089686011494;INDOMIE SOTO PADANG;1;2600;0;2600;2317;283;
2021-02-22 21:49:51;8999909096004;SAMPOERNA 16 FILTER;1;24000;0;24000;23000;1000;
2021-02-22 21:49:51;8999909982000;SAMPOERNA 12 FILTER;1;18000;0;18000;16200;1800;
2021-02-22 22:20:40;8992761002039;FANTA STRAWBERRY PET 390 ML;4;5500;0;22000;17200;4800;
2021-02-22 22:25:24;8999999502003;SARIMURNI RL RB 1,8G;1;1500;0;1500;1207;293;
2021-02-22 23:04:45;8998989110167;SURYA GUDANG GARAM 16 FILTER;1;24000;0;24000;22100;1900;
2021-02-23 11:30:43;8992628022156;BIMOLI KLASIK TOUCH 1 LT;1;16000;0;16000;14350;1650;
2021-02-23 11:32:24;RAINBOW;MINICOCO RAINBOW;2;500;0;1000;900;100;
2021-02-23 11:44:10;8992753631209;OMELA 370;1;9500;0;9500;8400;1100;
2021-02-23 11:51:01;ATIRA;MIE KREMES ATIRA;1;500;0;500;425;75;
2021-02-23 11:52:53;8992753720606;OMELA 490G;1;12000;0;12000;10531;1469;
2021-02-23 12:41:56;8992761166212;FRESTEA APPLE 350ML;1;4500;0;4500;3000;1500;
2021-02-23 12:48:36;8998866202770;SEDAAP MIE GORENG SALERO PADANG 86 GR;1;2500;0;2500;2023;477;
2021-02-23 13:33:09;GL;GULA 1 LITER;3;11500;0;34500;31500;3000;
2021-02-23 13:33:09;8996001351895;ZUPERRR KEJU SUSU;1;10000;0;10000;8000;2000;
2021-02-23 13:36:26;8992761166205;FRESTEA GREEN HONEY 350ML;2;4500;0;9000;6000;3000;
2021-02-23 13:44:09;GL;GULA 1 LITER;1;11500;0;11500;10500;1000;
2021-02-23 13:50:14;8995333060772;TERIGU GATOT KACA 500GR;1;4500;0;4500;4065;435;
2021-02-23 15:36:16;8992761166212;FRESTEA APPLE 350ML;2;4500;0;9000;6000;3000;
2021-02-23 15:46:47;8998866501026;MINYAK GORENG SEDAAP POUCH 1 L;1;15500;0;15500;14110;1390;
2021-02-23 15:48:37;089686011494;INDOMIE SOTO PADANG;1;2600;0;2600;2317;283;
2021-02-23 15:58:18;8998989300261;GUDANG GARAM SURYA 12 FILTER;1;18000;0;18000;16450;1550;
2021-02-23 15:58:18;8991102989428;WFR TANGO LONG CKLT 24G GTG;1;1000;0;1000;672;328;
2021-02-23 15:58:18;8991102989534;WFR TANGO LONG VNL 24G GTG;1;1000;0;1000;672;328;
2021-02-23 16:53:57;8992957214307;SAFARI MECES;1;5500;0;5500;4500;1000;
2021-02-23 16:56:59;8998989300261;GUDANG GARAM SURYA 12 FILTER;1;18000;0;18000;16450;1550;
2021-02-23 16:56:59;8992957220025;GOLDEN CITY MINI;1;3000;0;3000;2500;500;
2021-02-23 16:56:59;8934868015031;REXONA DEO LOTION ICE COOL;1;4600;0;4600;3900;700;
2021-02-23 16:56:59;COKLAT;COKLAT COIN;4;500;0;2000;1600;400;
2021-02-23 17:02:04;8991111109138;JB POWDER BLOSSOM 150+50G;1;10000;0;10000;9210;790;
2021-02-23 17:02:04;8991111101507;JB POWDER BLOSSOM 50G;1;3500;0;3500;3000;500;
2021-02-23 17:33:14;8998866107457;POSH SUMMER LOVE 150ML;1;19500;0;19500;17500;2000;
2021-02-23 17:33:14;COKLAT;COKLAT COIN;1;500;0;500;400;100;
2021-02-23 19:25:14;8992775110157;GARUDA KACANG KULIT;1;5000;0;5000;3925;1075;
2021-02-23 19:25:14;8992761139018;ADES 600ML;1;3500;0;3500;2292;1208;
2021-02-23 19:34:15;8992761122331;FRESTEA APPEL 500ML;1;6500;0;6500;4708;1792;
2021-02-23 19:34:15;089686021219;INTER MIE GORENG;1;1000;0;1000;885;115;
2021-02-23 19:34:15;8997013790108;BIMURA KACANG TELUR 25G;1;1000;0;1000;875;125;
2021-02-23 19:34:15;6907992823966;JD BLUEBERRY;1;3500;0;3500;3000;500;
2021-02-23 19:34:15;8992775110157;GARUDA KACANG KULIT;1;5000;0;5000;3925;1075;
2021-02-23 21:33:37;COKLAT;COKLAT COIN;1;500;0;500;400;100;
2021-02-23 22:19:46;8998989300261;GUDANG GARAM SURYA 12 FILTER;1;18000;0;18000;16450;1550;
2021-02-23 22:46:35;8992761145033;FANTA STRAW PET 250ML;3;3500;0;10500;7251;3249;
2021-02-23 22:46:35;8998989300261;GUDANG GARAM SURYA 12 FILTER;1;18000;0;18000;16450;1550;
2021-02-23 22:48:07;8999909010567;234 16 FILTER;1;23000;0;23000;21500;1500;
2021-02-23 22:50:54;8999801700030;SUSU FOYU;1;11500;0;11500;10450;1050;
2021-02-23 23:53:34;8998866600101;CREAM EKONOMI LEMON 455G;1;5500;0;5500;4750;750;
2021-02-23 23:53:34;8934868015024;REXONA DEO LOTION FREE SPIRIT 9G;1;4600;0;4600;3900;700;
2021-02-24 00:06:32;089686011036;INDOMIE GORENG PEDAS;1;2700;0;2700;2452;248;
2021-02-24 00:30:29;8992761166205;FRESTEA GREEN HONEY 350ML;1;4500;0;4500;3000;1500;
2021-02-24 09:08:39;8992761139018;ADES 600ML;1;3500;0;3500;2292;1208;
2021-02-24 10:59:19;8997002060168;KRP SINGKOG PDS PANDA DUO;5;8000;0;40000;36500;3500;
2021-02-24 10:59:19;8991111102832;JB POWDER BEDTIME 300G;1;14500;0;14500;13120;1380;
2021-02-24 10:59:19;CC;NICE FACIAL KILOAN 900 GR DUO;1;34500;0;34500;31325;3175;
2021-02-24 10:59:19;8997011700123;BIHUN JAGUNG 300GR;5;5200;0;26000;23690;2310;
2021-02-24 11:05:07;8998989300261;GUDANG GARAM SURYA 12 FILTER;1;18000;0;18000;16450;1550;
2021-02-24 11:05:07;8991102989428;WFR TANGO LONG CKLT 24G GTG;1;1000;0;1000;672;328;
2021-02-24 11:05:07;8991102989534;WFR TANGO LONG VNL 24G GTG;1;1000;0;1000;672;328;
2021-02-24 11:39:47;6907992823621;JD CREAMY YOGURT;1;3000;0;3000;2600;400;
2021-02-24 11:39:59;8996001318911;BETTER ISI 4;2;2000;0;4000;3400;600;
2021-02-24 12:46:28;8998898829129;KKB ENER-G JERUK;1;5500;0;5500;4824;676;
2021-02-24 12:56:38;8992761139018;ADES 600ML;1;3500;0;3500;2292;1208;
2021-02-24 12:56:38;8996001338056;TAMARIN;1;5600;0;5600;5100;500;
2021-02-24 14:50:32;8993324850449;BABY LOVE COTTON BUDS;1;5000;0;5000;4500;500;
2021-02-24 15:09:53;8998866201377;KRISBEE FRIES KENTANG GORENG 68 GR;1;5500;0;5500;4620;880;
2021-02-24 15:09:53;8992761139018;ADES 600ML;1;3500;0;3500;2292;1208;
2021-02-24 15:13:25;8996001600146;TEH PUCUK HARUM 350ML;1;3000;0;3000;2314;686;
2021-02-24 15:13:25;8999999195656;SARI WANGI 50X1.85;1;10000;0;10000;8700;1300;
2021-02-24 16:33:51;8996001318980;BETTER 120G;2;6000;0;12000;10200;1800;
2021-02-24 16:33:51;8992775110157;GARUDA KACANG KULIT;4;5000;0;20000;15700;4300;
2021-02-24 16:33:51;8992775211434;PILUS GARUDA SAPI PANGGANG;2;5500;0;11000;9426;1574;
2021-02-24 16:33:51;8991102300544;WFR TANGO VNL 176G;1;9200;0;9200;8336;864;
2021-02-24 16:33:51;8992775001691;GARUDA ROSTA WAGYU BEEF;1;8000;0;8000;7176;824;
2021-02-24 16:33:51;8996001308042;SARI GANDUM BOX;1;22000;0;22000;20500;1500;
2021-02-24 16:35:18;8999999034023;VASELINE MEN ANTI ACNE 50G;1;17000;0;17000;15400;1600;
2021-02-24 17:07:57;8996001318911;BETTER ISI 4;1;2000;0;2000;1700;300;
2021-02-24 17:07:57;8996001318430;BETTER 1000;1;1000;0;1000;820;180;
2021-02-24 17:07:57;8997021870052;FRESH CARE GREEN TEA 10ML;1;12000;0;12000;10000;2000;
2021-02-24 17:26:42;8998866201377;KRISBEE FRIES KENTANG GORENG 68 GR;2;5500;0;11000;9240;1760;
2021-02-24 17:26:42;6907992823973;JD PINEAPPLE;1;5000;0;5000;4300;700;
2021-02-24 17:26:42;6907992823966;JD BLUEBERRY;1;3500;0;3500;3000;500;
2021-02-24 17:26:42;8991001502933;CHACHA TUBE;1;7500;0;7500;6400;1100;
2021-02-24 17:47:58;COKLAT;COKLAT COIN;1;500;0;500;400;100;
2021-02-24 17:52:36;8992761145019;COCA COLA PET 250ML;1;3500;0;3500;2417;1083;
2021-02-24 18:09:54;8998866202343;NOODLE SEDAAP MIE KOREAN SPICY 87 GR;1;2500;0;2500;2023;477;
2021-02-24 18:09:54;COKLAT;COKLAT COIN;2;500;0;1000;800;200;
2021-02-24 18:09:54;JGR SHN;JOGER SHINY SACHET;1;500;0;500;437;63;
2021-02-24 19:02:44;089686010824;INDOMIE GORENG SPESIAL;2;2700;0;5400;4904;496;
2021-02-24 19:11:24;8999908204202;MY BABY MINYAK TELON 60ML;1;15000;0;15000;13545;1455;
2021-02-24 19:11:24;8992775110157;GARUDA KACANG KULIT;1;5000;0;5000;3925;1075;
2021-02-24 19:18:45;8998866200301;NOODLE SEDAAP GORENG  90 GR;4;2500;0;10000;8092;1908;
2021-02-24 19:18:45;8998866202619;SEDAAP MIE KOREAN SPICY SOUP BAG 77 GR;1;2300;0;2300;2027;273;
2021-02-24 19:18:45;089686048704;SARIMIE GORENG AYAM KCP ISI 2;1;3500;0;3500;3120;380;
2021-02-24 19:23:26;8996001318911;BETTER ISI 4;1;2000;0;2000;1700;300;
2021-02-24 19:23:26;BTS;BIMURA TARO SEAWEED 250G;1;10000;0;10000;9300;700;
2021-02-24 19:23:26;8998009010569;ULTRA CHO 200;1;5000;0;5000;3830;1170;
2021-02-24 19:23:26;8996001600146;TEH PUCUK HARUM 350ML;1;3000;0;3000;2314;686;
2021-02-24 19:37:19;8996001355817;BENG-BENG MAXX;1;27000;0;27000;24500;2500;
2021-02-24 19:37:19;8996001355008;BENG-BENG SP20G;1;29000;0;29000;26500;2500;
2021-02-24 19:37:19;8992775610008;TING-TING GARUDA 2.5G;1;7500;0;7500;6296;1204;
2021-02-24 19:40:25;8996001350423;ZUPER KEJU;2;9200;0;18400;16720;1680;
2021-02-24 19:55:06;8991001502933;CHACHA TUBE;1;7500;0;7500;6400;1100;
2021-02-24 19:56:33;GL;GULA 1 LITER;3;11500;0;34500;31500;3000;
2021-02-24 20:58:46;8998866201964;MINYAK GORENG SABRINA 2L POUCH;1;28000;0;28000;26753;1247;
2021-02-24 21:31:29;8992761002039;FANTA STRAWBERRY PET 390 ML;1;5500;0;5500;4300;1200;
2021-02-24 21:31:29;8996001305249;ROMA KELAPA CREAM;1;6800;0;6800;5514;1286;
2021-02-24 21:31:29;8991102385091;WFR TANGO CKLT 7G;1;8300;0;8300;7455;845;
2021-02-24 22:20:05;ARD;SENDAL ARDILES;1;15000;0;15000;13500;1500;
2021-02-24 22:20:05;8996001600665;COOL TIME;1;3500;0;3500;2750;750;
2021-02-24 22:53:36;8996001301142;ROMA KELAPA;1;8000;0;8000;6628;1372;
2021-02-24 22:53:36;PT;POTO-POTO SINJAI;2;6000;0;12000;10000;2000;
2021-02-24 23:00:36;8998989300261;GUDANG GARAM SURYA 12 FILTER;1;18000;0;18000;16450;1550;
2021-02-25 00:50:48;8998989300261;GUDANG GARAM SURYA 12 FILTER;1;18000;0;18000;16450;1550;
2021-02-25 00:53:32;8997028590014;ARGUS 220ML;1;500;0;500;302;198;
2021-02-25 10:35:51;8998866610261;POWDET DAIA SOFTENER BAG 290 GR;1;5000;0;5000;4450;550;
2021-02-25 10:35:51;8998866108317;EMERON HJB ANTDNDF 10ML;1;1000;0;1000;4185;-3185;
2021-02-25 10:35:51;8999999045616;MOLTO AIO PINK SCH;3;1000;0;3000;2400;600;
2021-02-25 10:35:51;8998989500166;GUDANG GARAM MERAH BESAR 16KS;2;17000;0;34000;30600;3400;
2021-02-25 10:35:51;RAINBOW;MINICOCO RAINBOW;2;500;0;1000;900;100;
2021-02-25 10:53:09;8998866202619;SEDAAP MIE KOREAN SPICY SOUP BAG 77 GR;1;2300;0;2300;2027;273;
2021-02-25 10:53:09;8998866202770;SEDAAP MIE GORENG SALERO PADANG 86 GR;1;2500;0;2500;2023;477;
2021-02-25 11:20:24;18997210107584;GUNTING MONTANA;1;20000;0;20000;15000;5000;
2021-02-25 11:25:46;GL;GULA 1 LITER;1;11500;0;11500;10500;1000;
2021-02-25 11:28:48;8999999544416;MOLTO CARE;1;20000;0;20000;18570;1430;
2021-02-25 12:41:31;8997011700123;BIHUN JAGUNG 300GR;1;5200;0;5200;4738;462;
2021-02-25 14:33:07;8999999559854;AXE BLACK POCKET FRAG 17ML;1;10000;0;10000;8000;2000;
2021-02-25 14:33:07;JGR SHN;JOGER SHINY SACHET;10;500;0;5000;4370;630;
2021-02-25 14:56:50;8996001600146;TEH PUCUK HARUM 350ML;1;3000;0;3000;2314;686;
2021-02-25 14:56:50;PUDING;VITA PUDDING;1;5000;0;5000;3750;1250;
2021-02-25 14:56:50;ARD;SENDAL ARDILES;1;15000;0;15000;13500;1500;
2021-02-25 17:02:54;8992761139018;ADES 600ML;1;3500;0;3500;2292;1208;
2021-02-25 17:02:54;JGR SHN;JOGER SHINY SACHET;3;500;0;1500;1311;189;
2021-02-25 17:17:27;8992761139018;ADES 600ML;1;3500;0;3500;2292;1208;
2021-02-25 17:17:27;8992775311325;GERY SNACK&SEREAL 100G;2;7000;0;14000;11784;2216;
2021-02-25 17:26:07;8992761166212;FRESTEA APPLE 350ML;1;4500;0;4500;3000;1500;
2021-02-25 18:31:04;SNTN;SANTAN BUBUK;2;2000;0;4000;3000;1000;
2021-02-25 18:38:30;8999999059316;LIFEBOUY TS MILDCARE 75G;1;3000;0;3000;2500;500;
2021-02-25 20:14:42;8998866202244;EKOMIE BUMBU KALDU AYAM;1;1000;0;1000;860;140;
2021-02-25 20:14:42;COKLAT;COKLAT COIN;2;500;0;1000;800;200;
2021-02-25 20:22:18;GL;GULA 1 LITER;1;11500;0;11500;10500;1000;
2021-02-25 20:41:29;GL;GULA 1 LITER;3;11500;0;34500;31500;3000;
2021-02-25 20:46:47;8992957214307;SAFARI MECES;1;5500;0;5500;4500;1000;
2021-02-25 20:47:44;COKLAT;COKLAT COIN;1;500;0;500;400;100;
2021-02-25 20:50:03;GL;GULA 1 LITER;1;11500;0;11500;10500;1000;
2021-02-25 21:24:47;8998866202343;NOODLE SEDAAP MIE KOREAN SPICY 87 GR;1;2500;0;2500;2023;477;
2021-02-25 21:24:47;8998866200578;NOODLE SEDAAP KARI KENTAL SPC 75 GR;1;2300;0;2300;1952;348;
2021-02-25 21:24:47;8998866200325;NOODLE SEDAAP MIE SOTO;1;2200;0;2200;1952;248;
2021-02-25 21:24:47;8998866202619;SEDAAP MIE KOREAN SPICY SOUP BAG 77 GR;2;2300;0;4600;4054;546;
2021-02-26 12:19:24;8995333032113;TERIGU GATOT KACA 1 KG;1;8500;0;8500;8012;488;
2021-02-26 12:19:24;8992628510158;SIMAS PALMIA;1;6000;0;6000;4832;1168;
2021-02-26 12:19:24;RAINBOW;MINICOCO RAINBOW;2;500;0;1000;900;100;
2021-02-26 12:19:24;COKLAT;COKLAT COIN;2;500;0;1000;800;200;
2021-02-26 12:19:24;8993379255152;PIZZI DISHWASHING 800ML LIME;1;13000;0;13000;12312;688;
2021-02-26 12:46:58;8999999502003;SARIMURNI RL RB 1,8G;2;1500;0;3000;2414;586;
2021-02-26 12:50:21;RAINBOW;MINICOCO RAINBOW;3;500;0;1500;1350;150;
2021-02-26 13:07:08;8992388133345;NU MILK TEA TEH TARIK 330ML;1;5000;0;5000;4604;396;
2021-02-26 13:07:08;8995333032113;TERIGU GATOT KACA 1 KG;1;8500;0;8500;8012;488;
2021-02-26 13:08:03;8998989300308;SIGNATURE KECIL;1;15000;0;15000;13700;1300;
2021-02-26 14:41:39;8998898810721;KKB ENER-G C1000;1;8000;0;8000;6690;1310;
2021-02-26 14:59:29;8992761145026;SPRITE PET 250ML;4;3500;0;14000;9668;4332;
2021-02-26 14:59:29;8996001304136;SLAI OLAI BLUEBERRY;1;12000;0;12000;9900;2100;
2021-02-26 14:59:29;8999909096004;SAMPOERNA 16 FILTER;1;24000;0;24000;23000;1000;
2021-02-26 14:59:29;6907992823843;JD MOCHA CRISPY;1;5000;0;5000;4400;600;
2021-02-26 14:59:29;6907992823829;JD MILKY MILK;1;3000;0;3000;2600;400;
2021-02-26 14:59:29;8996001308042;SARI GANDUM BOX;1;22000;0;22000;20500;1500;
2021-02-26 15:12:27;8992761166038;MMP ORANGE 300ML;1;5000;0;5000;3750;1250;
2021-02-26 16:05:00;8999999030186;PEPSODENT ACTION 123 COMPLETE 190G;1;14000;0;14000;13200;800;
2021-02-26 16:05:00;8996001600146;TEH PUCUK HARUM 350ML;1;3000;0;3000;2314;686;
2021-02-26 16:05:00;8998009020520;BUAVITA MINI GUAVA 125ML;1;5800;0;5800;5250;550;
2021-02-26 16:18:12;8999999710873;PEPSODENT ACTION123 HERBAL 120G;1;11400;0;11400;10400;1000;
2021-02-26 16:18:12;8992628020152;BIMOLI POUCH 2L;1;30000;0;30000;28983;1017;
2021-02-26 16:18:12;8999999524722;SUNLIGHT LIME NEW PCH 435ML;1;10000;0;10000;9100;900;
2021-02-26 16:18:56;8992775211410;PILUS GARUDA PEDAS;1;5500;0;5500;4713;787;
2021-02-26 16:18:56;8992775002087;GARUDA TING-TING 84G;1;6000;0;6000;4924;1076;
2021-02-26 16:21:58;8999999045265;RINSO MOLTO ROSE FRESH PWD 770GR;1;21600;0;21600;19338;2262;
2021-02-26 16:21:58;8999999524807;SUNLIGHT HABBATUSSAUDA POUCH 755ML;1;17000;0;17000;15400;1600;
2021-02-26 16:21:58;8992761111540;FANTA STRAWBERY SLIM CAM 250ML;2;5000;0;10000;7500;2500;
2021-02-26 16:21:58;8999999528850;CITRA NAT GLOW WHITE 60ML;1;6200;0;6200;5625;575;
2021-02-26 16:21:58;8992761166038;MMP ORANGE 300ML;2;5000;0;10000;7500;2500;
2021-02-26 16:21:58;089686010824;INDOMIE GORENG SPESIAL;5;2700;0;13500;12260;1240;
2021-02-26 17:10:14;GL;GULA 1 LITER;3;11500;0;34500;31500;3000;
2021-02-26 17:10:14;8999999195649;SARI WANGI 25X1.86G;1;6000;0;6000;5050;950;
2021-02-26 17:10:14;8996001304013;SLAI OLAI PACK;1;8500;0;8500;7700;800;
2021-02-26 17:10:14;8991001780126;SELAMAT CKLAT 60G;2;5000;0;10000;8600;1400;
2021-02-26 17:11:16;8996001318911;BETTER ISI 4;1;2000;0;2000;1700;300;
2021-02-26 17:14:47;BTS;BIMURA TARO SEAWEED 250G;1;10000;0;10000;9300;700;
2021-02-26 17:14:47;SNTN;SANTAN BUBUK;1;2500;0;2500;1500;1000;
2021-02-26 17:14:47;8992957214307;SAFARI MECES;1;5500;0;5500;4500;1000;
2021-02-26 17:14:47;8998866202619;SEDAAP MIE KOREAN SPICY SOUP BAG 77 GR;1;2300;0;2300;2027;273;
2021-02-26 17:14:47;8998866202343;NOODLE SEDAAP MIE KOREAN SPICY 87 GR;1;2500;0;2500;2023;477;
2021-02-26 17:14:47;8991102989534;WFR TANGO LONG VNL 24G GTG;3;1000;0;3000;2016;984;
2021-02-26 17:17:59;BTS;BIMURA TARO SEAWEED 250G;1;10000;0;10000;9300;700;
2021-02-26 17:35:19;8992957220063;COKLAT BANGO;1;2000;0;2000;1700;300;
2021-02-26 17:40:08;8995150101696;M+SUSU ORIGINAL;1;5000;0;5000;4000;1000;
2021-02-26 17:40:08;8992388133345;NU MILK TEA TEH TARIK 330ML;1;5000;0;5000;4604;396;
2021-02-26 17:58:32;8999909010567;234 16 FILTER;1;23000;0;23000;21500;1500;
2021-02-26 18:27:50;8992388133345;NU MILK TEA TEH TARIK 330ML;1;5000;0;5000;4604;396;
2021-02-26 18:30:43;8992388133345;NU MILK TEA TEH TARIK 330ML;1;5000;0;5000;4604;396;
2021-02-26 19:05:44;8997011700123;BIHUN JAGUNG 300GR;1;5200;0;5200;4738;462;
2021-02-26 19:08:29;8999909096004;SAMPOERNA 16 FILTER;1;24000;0;24000;23000;1000;
2021-02-26 19:20:49;8996001600146;TEH PUCUK HARUM 350ML;2;3000;0;6000;4628;1372;
2021-02-26 20:04:42;8999999557355;ZWITSAL BABY BOTTLE CLEANER 135 ML;1;5000;0;5000;4000;1000;
2021-02-26 20:18:33;8999999195649;SARI WANGI 25X1.86G;1;6000;0;6000;5050;950;
2021-02-26 20:18:33;8998866201452;POTABEE REGULER BBQ BEEF 35GR;1;4800;0;4800;4150;650;
2021-02-26 20:18:34;8998866201483;POTABEE REGULER GRILLED SEAWEED 35GR;1;5000;0;5000;4150;850;
2021-02-26 20:18:34;8998866202435;JAPOTA UMAMI JAPANESE SEAWEED 35GR;1;5000;0;5000;4150;850;
2021-02-26 20:18:34;ARD;SENDAL ARDILES;1;15000;0;15000;13500;1500;
2021-02-26 20:18:34;8999801700030;SUSU FOYU;2;11500;0;23000;20900;2100;
2021-02-26 20:18:34;BTS;BIMURA TARO SEAWEED 250G;1;10000;0;10000;9300;700;
2021-02-26 20:18:34;8995333000822;TERIGU KOMPAS SOFT 500GR;1;5500;0;5500;4967;533;
2021-02-26 20:18:34;8998866200837;NOODLE SEDAAPMIE SOTO CUP 81 GR;1;4500;0;4500;3650;850;
2021-02-26 20:18:34;8998866200851;NOODLE SEDAAP MIE BAKSO SPESIAL CUP 77 GR;1;4500;0;4500;3650;850;
2021-02-26 20:18:34;8992775001820;CHOCOLATOS WAFER CREAM;1;17500;0;17500;15761;1739;
2021-02-26 20:18:34;8996001350515;ZUPERRR KEJU CHOCO;1;10000;0;10000;8000;2000;
2021-02-26 20:18:34;8998866201377;KRISBEE FRIES KENTANG GORENG 68 GR;1;5500;0;5500;4620;880;
2021-02-26 20:18:34;8999999059781;SUNLIGHT LIME NEW POUCH 210ML;1;5000;0;5000;4300;700;
2021-02-26 20:18:34;8998866610711;NOVO ACTIVE CLEAN 110G;2;3000;0;6000;5200;800;
2021-02-26 20:18:34;8998866612180;SOKLIN SOFTERGEN 280G SAKURA;3;5000;0;15000;13275;1725;
2021-02-26 20:18:34;GL;GULA 1 LITER;1;11500;0;11500;10500;1000;
2021-02-26 20:26:50;8998009020520;BUAVITA MINI GUAVA 125ML;2;5800;0;11600;10500;1100;
2021-02-26 20:29:10;8998866202060;POTABEE AYAM BAKAR PEDAS 35 GR;1;5000;0;5000;4150;850;
2021-02-26 20:29:10;8996001304990;SARI GANDUM 115G;2;6000;0;12000;10200;1800;
2021-02-26 20:29:10;8996001305058;ROMA SANDWICH KACANG;1;7000;0;7000;5000;2000;
2021-02-26 20:29:10;8998866202725;MILKU COKLAT PREMIUM 200ML;1;3000;0;3000;2375;625;
2021-02-26 20:53:31;BTS;BIMURA TARO SEAWEED 250G;1;10000;0;10000;9300;700;
2021-02-26 20:53:31;8998866608046;KECAP MANIS SEDAAP POUCH 225ML;1;8300;0;8300;7375;925;
2021-02-26 21:32:25;8998866201841;GOLDA DOLCE LATTE 200ML;2;3000;0;6000;5000;1000;
2021-02-26 22:11:19;8998866202619;SEDAAP MIE KOREAN SPICY SOUP BAG 77 GR;1;2300;0;2300;2027;273;
2021-02-27 10:31:25;8998866608718;DAIA SOFTENER PINK;1;5000;0;5000;4450;550;
2021-02-27 10:31:25;8996001338056;TAMARIN;1;5600;0;5600;5100;500;
2021-02-27 10:31:25;8996001600375;LE MINERAL 330ML;1;2000;0;2000;1417;583;
2021-02-27 10:31:25;8992957214307;SAFARI MECES;1;5500;0;5500;4500;1000;
2021-02-27 10:31:25;SWAL;SENDAL SWALLOW;1;18000;0;18000;16500;1500;
2021-02-27 10:42:37;8999999537180;CLEAR SHP LEMON FRESH 9 ML;1;10500;0;10500;9300;1200;
2021-02-27 10:42:37;8999999531478;MOLTO BLACK;1;5500;0;5500;6;5494;
2021-02-27 10:50:42;8997013790108;BIMURA KACANG TELUR 25G;3;1000;0;3000;2625;375;
2021-02-27 10:50:42;8998866200578;NOODLE SEDAAP KARI KENTAL SPC 75 GR;1;2300;0;2300;1952;348;
2021-02-27 11:45:10;8998866201483;POTABEE REGULER GRILLED SEAWEED 35GR;1;5000;0;5000;4150;850;
2021-02-27 11:45:10;8998866202435;JAPOTA UMAMI JAPANESE SEAWEED 35GR;1;5000;0;5000;4150;850;
2021-02-27 11:53:41;6907992825076;JD WATERMELON APPLE;1;2000;0;2000;1700;300;
2021-02-27 11:53:41;6907992823959;JD HAWTHORN BERRY;1;2000;0;2000;1700;300;
2021-02-27 11:53:41;6907992823966;JD BLUEBERRY;1;3500;0;3500;3000;500;
2021-02-27 13:09:20;8998989110167;SURYA GUDANG GARAM 16 FILTER;1;24000;0;24000;22100;1900;
2021-02-27 13:09:20;8998866692663;SOKLIN FLOORCLENER KUNING 450ML;1;7000;0;7000;6385;615;
2021-02-27 13:40:18;8999909096004;SAMPOERNA 16 FILTER;1;24000;0;24000;23000;1000;
2021-02-27 14:28:05;8992957220087;COKLAT SINGA;1;2000;0;2000;1700;300;
2021-02-27 14:36:28;089686010190;INDOMIE KARI AYAM;2;2800;0;5600;5044;556;
2021-02-27 14:56:18;9556001025272;NESCAFE LATTE 240ML;1;8500;0;8500;7437;1063;
2021-02-27 14:58:14;GL;GULA 1 LITER;1;11500;0;11500;10500;1000;
2021-02-27 16:23:51;8996001305249;ROMA KELAPA CREAM;1;6800;0;6800;5514;1286;
2021-02-27 16:51:32;8992775311615;CHOCOLATOS;1;12000;0;12000;9983;2017;
2021-02-27 16:51:32;8998866202053;POTABEE AYAM BAKAR PEDAS 68GR;1;8000;0;8000;7200;800;
2021-02-27 16:51:32;6907992823966;JD BLUEBERRY;1;3500;0;3500;3000;500;
2021-02-27 16:51:32;6907992823607;JD CHOCO CAPTAIN;1;5500;0;5500;4700;800;
2021-02-27 16:51:32;8999999544409;MOLTO DETERGEN CARE PURPLE PCH 700ML;1;20500;0;20500;18570;1930;
2021-02-27 16:51:32;8992388112401;MIE ABC SELERA PEDAS- GORENG AYAM PEDAS LIMAU;1;2600;0;2600;2368;232;
2021-02-27 16:51:32;8998866200844;NOODLE SEDAAP MIE KARI SPESIAL CUP 81 GR;1;4500;0;4500;3650;850;
2021-02-27 17:03:15;8998866500708;FLORIDINA ORANGE;1;3000;0;3000;2500;500;
2021-02-27 17:05:18;8850507002968;A1 KING TRUCK;1;16500;0;16500;15500;1000;
2021-02-27 17:47:58;8999908284907;MY BABY MINYAK TELON 90ML;1;25000;0;25000;22700;2300;
2021-02-27 17:47:58;8992959508862;SWEETY SILVER PANTS M 8;1;16800;0;16800;15229;1571;
2021-02-27 18:22:45;8996001304990;SARI GANDUM 115G;1;6000;0;6000;5100;900;
2021-02-27 18:22:45;8996001301579;MALKIST CKLT KELAPA PACK;1;11000;0;11000;9900;1100;
2021-02-27 18:22:45;8992761002022;SPRITE PET 390ML;1;5500;0;5500;4300;1200;
2021-02-27 18:24:32;8992761166052;FRESTEA MELATI 350ML;1;4500;0;4500;3000;1500;
2021-02-27 19:30:00;8998866200578;NOODLE SEDAAP KARI KENTAL SPC 75 GR;2;2300;0;4600;3904;696;
2021-02-27 19:45:47;8997028590014;ARGUS 220ML;2;500;0;1000;604;396;
2021-02-27 20:01:58;COKLAT;COKLAT COIN;4;500;0;2000;1600;400;
2021-02-27 22:41:51;8992736980164;SASA TEPUNG KENTUCKY 80G;1;3000;0;3000;2181;819;
2021-02-27 22:41:51;8999999192150;ROYCO FDS CHICKEN 100GR;1;5000;0;5000;4300;700;
2021-02-27 22:41:51;8992736025162;SASA TEPUNG PISANG GORENG;1;5000;0;5000;4455;545;
2021-02-27 22:41:51;089686821086;ICHI OCHA MELATI;1;3000;0;3000;2250;750;
2021-02-27 22:41:51;FUZO;KUACI FUZO;2;1000;0;2000;1700;300;
2021-02-27 22:41:51;8998866500708;FLORIDINA ORANGE;1;3000;0;3000;2500;500;
2021-02-27 22:43:16;8996001600146;TEH PUCUK HARUM 350ML;1;3000;0;3000;2314;686;
2021-02-27 22:43:16;8992775211434;PILUS GARUDA SAPI PANGGANG;1;5500;0;5500;4713;787;
2021-02-27 22:43:16;JGR SHN;JOGER SHINY SACHET;3;500;0;1500;1311;189;
2021-02-27 23:01:30;089686010343;INDOMIE SOTO MIE;1;2600;0;2600;2367;233;
2021-02-27 23:01:30;089686011036;INDOMIE GORENG PEDAS;1;2700;0;2700;2452;248;
2021-02-28 11:35:18;8998989110167;SURYA GUDANG GARAM 16 FILTER;1;24000;0;24000;22100;1900;
2021-02-28 11:35:18;8996001338056;TAMARIN;1;5600;0;5600;5100;500;
2021-02-28 11:35:18;8999999195649;SARI WANGI 25X1.86G;1;6000;0;6000;5050;950;
2021-02-28 11:35:18;8999999401221;RINSO ANTI NODA CLASSIC 430G;1;10800;0;10800;9806;994;
2021-02-28 11:35:18;8992957220025;GOLDEN CITY MINI;1;3000;0;3000;2500;500;
2021-02-28 11:35:18;8998866611701;EKONOMI PENCUCI PIRING  LIQ 132ML;1;2000;0;2000;1337;663;
2021-02-28 11:35:18;8998866202770;SEDAAP MIE GORENG SALERO PADANG 86 GR;1;2500;0;2500;2023;477;
2021-02-28 11:35:18;8999999559533;LIFEBUOY BW TOTAL 10 90ML;1;5000;0;5000;4000;1000;
2021-02-28 11:35:18;COKLAT;COKLAT COIN;4;500;0;2000;1600;400;
2021-02-28 11:35:18;8999909010567;234 16 FILTER;1;23000;0;23000;21500;1500;
2021-02-28 11:35:18;8992696520103;DNCO CKLT FORT SCH 39G;1;3000;0;3000;2647;353;
2021-02-28 11:35:18;8991111111964;C&C FACIAL WASH 50ML;1;12000;0;12000;10870;1130;
2021-02-28 11:52:17;8992736424293;SASA BUMBU NASI GORENG 20G;2;2000;0;4000;2272;1728;
2021-02-28 11:52:17;8992696404441;BEAR BRAND 189ML;1;8500;0;8500;7887;613;
2021-02-28 12:03:01;8998989500166;GUDANG GARAM MERAH BESAR 16KS;1;17000;0;17000;15300;1700;
2021-02-28 12:03:01;123124;KOREK BIASA;1;2000;0;2000;1800;200;
2021-02-28 12:25:58;089686011036;INDOMIE GORENG PEDAS;1;2700;0;2700;2452;248;
2021-02-28 12:32:07;COKLAT;COKLAT COIN;6;500;0;3000;2400;600;
2021-02-28 12:32:07;6907992823676;JD PEACH;1;2000;0;2000;1700;300;
2021-02-28 12:52:47;8995333060703;TERIGU KOMPAS 1KG;2;10500;0;21000;19632;1368;
2021-02-28 12:52:47;BTS;BIMURA TARO SEAWEED 250G;1;10000;0;10000;9300;700;
2021-02-28 12:52:47;8992959953136;SWEETY BRONZE L20;1;40000;0;40000;36770;3230;
2021-02-28 12:52:47;BR;BERAS 10L;2;86500;0;173000;170000;3000;
2021-02-28 12:52:47;8999999555122;MOLTO K-ROMANCE 20ML;2;1000;0;2000;1600;400;
2021-02-28 12:52:47;8991111153148;LISTERINE SIWAK 250ML;1;21500;0;21500;19550;1950;
2021-02-28 12:52:47;8998866609487;SOKLIN SOFTERGEN 280G;2;5000;0;10000;8850;1150;
2021-02-28 12:52:47;8992745120469;HIT SPRAY ORRG 415+35ML;1;27500;0;27500;25500;2000;
2021-02-28 12:52:47;8999999519100;LUX VELVET JASMINE 3PC 110G;1;11200;0;11200;10160;1040;
2021-02-28 12:52:47;8998866888622;GIV MERAH KOTAK 76G;2;2000;0;4000;3640;360;
2021-02-28 12:52:47;8992946511790;SHINZUI 85G;3;5000;0;15000;10425;4575;
2021-02-28 12:52:47;ARD;SENDAL ARDILES;1;15000;0;15000;13500;1500;
2021-02-28 13:02:25;8992959508831;SWEETY SILVER PANTS 18;1;36800;0;36800;33466;3334;
2021-02-28 13:02:25;8998866200578;NOODLE SEDAAP KARI KENTAL SPC 75 GR;3;2300;0;6900;5856;1044;
2021-02-28 13:02:25;GL;GULA 1 LITER;2;11500;0;23000;21000;2000;
2021-02-28 13:02:25;8992628020152;BIMOLI POUCH 2L;1;30000;0;30000;28983;1017;
2021-02-28 13:02:25;8994867000162;ROKOK PUNDIMAS KRETEK16;5;10000;0;50000;43000;7000;
2021-02-28 13:02:25;8991102989312;WFR TANGO SBJ 7G;2;8300;0;16600;14910;1690;
2021-02-28 13:02:25;8992753101207;BENDERA KENTAL MANIS 370G;1;11500;0;11500;9700;1800;
2021-02-28 13:02:25;8992959953174;SWEETY BRONZE M34+2;1;58000;0;58000;53182;4818;
2021-02-28 13:02:25;8999908204202;MY BABY MINYAK TELON 60ML;1;15000;0;15000;13545;1455;
2021-02-28 13:44:25;8997011700123;BIHUN JAGUNG 300GR;1;5200;0;5200;4738;462;
2021-02-28 15:00:40;8994867000179;ROKOK PENA MILD 16;1;14500;0;14500;13000;1500;
2021-02-28 15:00:40;6907992823874;JD CRUNCHY CHOCO BLUEBERRY;1;5500;0;5500;4700;800;
2021-02-28 15:00:40;6907992823867;JD CRUNCHY CHOCOLATE MALT;1;5500;0;5500;4700;800;
2021-02-28 15:00:40;8998866202244;EKOMIE BUMBU KALDU AYAM;1;1000;0;1000;860;140;
2021-02-28 15:00:40;8999999502393;ROYCO FDS CHICKEN 8G;1;5000;0;5000;4500;500;
2021-02-28 16:06:11;8996001600641;TORA CAPPUCINO;1;3500;0;3500;2750;750;
2021-02-28 16:06:11;JGR SHN;JOGER SHINY SACHET;3;500;0;1500;1311;189;
2021-02-28 16:14:36;8999999528218;CITRA NATURAL WHITE BTL 220ML;1;17000;0;17000;15450;1550;
2021-02-28 16:14:36;8999999529550;CLEAR COMPLETE SOFT CARE 80ML;1;11200;0;11200;10120;1080;
2021-02-28 16:24:37;GL;GULA 1 LITER;1;11500;0;11500;10500;1000;
2021-02-28 16:38:04;8998866201889;KRISBEE PILLOW STRAWBERRY ICE CREAM 120GR;1;8000;0;8000;7250;750;
2021-02-28 16:39:57;8992628020152;BIMOLI POUCH 2L;1;30000;0;30000;28983;1017;
2021-02-28 16:41:03;8998989100120;GUDANG GARAM MINI;1;3500;0;3500;16600;-13100;
2021-02-28 17:25:29;8999801700030;SUSU FOYU;1;11500;0;11500;10450;1050;
2021-02-28 17:32:53;8992775211410;PILUS GARUDA PEDAS;1;5500;0;5500;4713;787;
2021-02-28 17:32:53;8996001600641;TORA CAPPUCINO;1;3500;0;3500;2750;750;
2021-02-28 17:32:53;8996001600610;TORA MILKY LATTE 180ML;1;3500;0;3500;2750;750;
2021-02-28 17:32:53;COKLAT;COKLAT COIN;4;500;0;2000;1600;400;
2021-02-28 17:34:58;8998866202244;EKOMIE BUMBU KALDU AYAM;2;1000;0;2000;1720;280;
2021-02-28 19:49:21;8997013790108;BIMURA KACANG TELUR 25G;2;1000;0;2000;1750;250;
2021-02-28 19:49:21;8991102989534;WFR TANGO LONG VNL 24G GTG;3;1000;0;3000;2016;984;
2021-02-28 19:49:21;089686010190;INDOMIE KARI AYAM;1;2800;0;2800;2522;278;
2021-02-28 19:49:21;089686010343;INDOMIE SOTO MIE;2;2600;0;5200;4734;466;
2021-02-28 19:49:21;089686010824;INDOMIE GORENG SPESIAL;2;2700;0;5400;4904;496;
2021-02-28 19:50:43;8992761139018;ADES 600ML;1;3500;0;3500;2292;1208;
2021-02-28 19:50:43;8996001600269;LE MINERAL 600ML;1;3000;0;3000;1688;1312;
2021-02-28 19:52:55;8998866500708;FLORIDINA ORANGE;1;3000;0;3000;2500;500;
2021-02-28 19:52:55;COKLAT;COKLAT COIN;1;500;0;500;400;100;
2021-02-28 19:52:55;FUZO;KUACI FUZO;1;1000;0;1000;850;150;
2021-02-28 20:05:36;089686011494;INDOMIE SOTO PADANG;1;2600;0;2600;2317;283;
2021-02-28 20:05:36;8998866202244;EKOMIE BUMBU KALDU AYAM;2;1000;0;2000;1720;280;
2021-02-28 20:05:36;6907992824963;JD CHOCO BLAST;1;3000;0;3000;2600;400;
2021-02-28 20:05:36;6907992823669;JD MILKY STRAW;1;3000;0;3000;2600;400;
2021-02-28 20:05:36;ATIRA;MIE KREMES ATIRA;3;500;0;1500;1275;225;
2021-02-28 20:36:58;8991002103764;GOOD DAY CPUCINO 10X25G;4;1500;0;6000;5580;420;
2021-02-28 20:45:15;8992696405417;DNCO  SHC 27G;1;3000;0;3000;2647;353;
2021-02-28 20:45:15;8996001305249;ROMA KELAPA CREAM;1;6800;0;6800;5514;1286;
2021-02-28 20:45:15;8997028590014;ARGUS 220ML;1;500;0;500;302;198;
2021-02-28 21:31:43;8991111109121;JB POWDER BLOSSOM 75+25G;1;6000;0;6000;5430;570;
2021-02-28 22:33:39;ARG;ARGUS 220ML;1;14500;0;14500;12500;2000;
2021-02-28 22:45:31;089686010343;INDOMIE SOTO MIE;2;2600;0;5200;4734;466;
2021-02-28 23:00:04;8992761145026;SPRITE PET 250ML;3;3500;0;10500;7251;3249;
2021-02-28 23:00:04;8992761145033;FANTA STRAW PET 250ML;4;3500;0;14000;9668;4332;
2021-02-28 23:00:04;8992761145019;COCA COLA PET 250ML;3;3500;0;10500;7251;3249;
2021-02-28 23:00:04;8992761139018;ADES 600ML;2;3500;0;7000;4584;2416;
2021-02-28 23:23:58;8998866202770;SEDAAP MIE GORENG SALERO PADANG 86 GR;1;2500;0;2500;2023;477;
2021-02-28 23:23:58;ATIRA;MIE KREMES ATIRA;3;500;0;1500;1275;225;
2021-02-28 23:23:58;FUZO;KUACI FUZO;1;1000;0;1000;850;150;
2021-03-01 10:42:42;GL;GULA 1 LITER;2;11500;0;23000;21000;2000;
2021-03-01 10:42:42;8992984920110;CUKA DAPUR DUA BELIBIS;1;4500;0;4500;3250;1250;
2021-03-01 10:42:42;8998866608008;KECAP MANIS SEDAAP BOTOL 135 ML;1;6300;0;6300;5615;685;
2021-03-01 10:42:42;8995102703534;TERASI DUO 6 GR;1;4000;0;4000;3720;280;
2021-03-01 10:42:42;8999999502393;ROYCO FDS CHICKEN 8G;1;5000;0;5000;4500;500;
2021-03-01 10:42:42;8998866202060;POTABEE AYAM BAKAR PEDAS 35 GR;1;5000;0;5000;4150;850;
2021-03-01 10:42:42;8991102989534;WFR TANGO LONG VNL 24G GTG;1;1000;0;1000;672;328;
2021-03-01 10:43:26;8992761166212;FRESTEA APPLE 350ML;1;4500;0;4500;3000;1500;
2021-03-01 11:05:01;089686821086;ICHI OCHA MELATI;1;3000;0;3000;2250;750;
2021-03-01 11:46:55;8996001600146;TEH PUCUK HARUM 350ML;1;3000;0;3000;2314;686;
2021-03-01 12:00:40;8996001600146;TEH PUCUK HARUM 350ML;1;3000;0;3000;2314;686;
2021-03-01 12:11:51;8999999504656;SARI MURNI 20X1.8G;1;5000;0;5000;4200;800;
2021-03-01 12:25:36;8992775312414;GERY CHOCO HEZELNUT;1;11000;0;11000;9983;1017;
2021-03-01 12:25:36;8999999401221;RINSO ANTI NODA CLASSIC 430G;1;10800;0;10800;9806;994;
2021-03-01 12:25:36;089686834055;FREISS JERUK;1;11000;0;11000;8750;2250;
2021-03-01 12:52:02;8997011700123;BIHUN JAGUNG 300GR;1;5200;0;5200;4738;462;
2021-03-01 12:53:39;8999999390198;SUNLIGHT LIME NEW POUCH 755ML;1;17000;0;17000;15400;1600;
2021-03-01 12:53:39;8995333060703;TERIGU KOMPAS 1KG;1;10500;0;10500;9816;684;
2021-03-01 13:02:21;8998866611152;CREAM EKONOMI VIOLET 455G;1;5500;0;5500;4750;750;
2021-03-01 13:02:21;8998866609029;DAIA PUTIH GUSSWET 565G;1;10000;0;10000;8700;1300;
2021-03-01 13:02:21;8999999710873;PEPSODENT ACTION123 HERBAL 120G;1;11400;0;11400;10400;1000;
2021-03-01 13:02:21;8998866501033;MINYAK GORENG SEDAAP POUCH 2L;1;29000;0;29000;27746;1254;
2021-03-01 13:02:21;8992959117583;SFX DS REG FLOW WING 20;1;5000;0;5000;4288;712;
2021-03-01 13:02:21;GL;GULA 1 LITER;2;11500;0;23000;21000;2000;
2021-03-01 13:02:21;8718291206491;PHILIPS 20 W;1;65000;0;65000;60000;5000;
2021-03-01 14:08:45;GL;GULA 1 LITER;10;11500;0;115000;105000;10000;
2021-03-01 14:08:45;8992628020152;BIMOLI POUCH 2L;3;30000;0;90000;86949;3051;
2021-03-01 14:28:13;8992759120264;LARISST 220;1;12000;0;12000;9200;2800;
2021-03-01 14:28:13;8998866201469;POTABEE REGULER BBQ BEEF 68 GR;1;8000;0;8000;7200;800;
2021-03-01 14:53:46;8993176110074;MINYAK KAYU PUTIH 60ML;1;20000;0;20000;17333;2667;
2021-03-01 14:53:46;8998866501026;MINYAK GORENG SEDAAP POUCH 1 L;1;15500;0;15500;14110;1390;
2021-03-01 14:58:38;8991102281430;PERMEN MINTZ DUOMINT;1;4500;0;4500;4000;500;
2021-03-01 14:58:38;8851019510132;POCKY;1;7300;0;7300;7000;300;
2021-03-01 14:58:38;089686010343;INDOMIE SOTO MIE;2;2600;0;5200;4734;466;
2021-03-01 15:23:37;8993176110074;MINYAK KAYU PUTIH 60ML;1;20000;0;20000;17333;2667;
2021-03-01 15:23:37;POTO;KERUPUK PANJANG;1;5000;0;5000;4000;1000;
2021-03-01 16:34:57;9556001174659;MILO ACT GO 240ML;1;8500;0;8500;7437;1063;
2021-03-01 16:34:57;8991115012021;BB STRAWBERRY CREAM;1;8500;0;8500;7600;900;
2021-03-01 17:01:19;8993365140363;MASU KURMA TJ 250G;1;22500;0;22500;20570;1930;
2021-03-01 17:08:36;8992761166212;FRESTEA APPLE 350ML;1;4500;0;4500;3000;1500;
2021-03-01 17:08:36;8992775712603;MYTEA POCI OOLONG;1;5000;0;5000;4410;590;
2021-03-01 17:16:02;ARD;SENDAL ARDILES;1;15000;0;15000;13500;1500;
2021-03-01 17:21:48;8999999024482;CITRA BW PEARLY WHITE REFF 220ML;1;12000;0;12000;10700;1300;
2021-03-01 17:21:48;8999999538446;SUNSILK SHP BLKSHINE 55 ML3750;1;4500;0;4500;3750;750;
2021-03-01 17:21:48;8999999034726;PONDS MEN WHITE BOOST 50G;1;18500;0;18500;17160;1340;
2021-03-01 17:55:21;8992696404441;BEAR BRAND 189ML;1;8500;0;8500;7887;613;
2021-03-01 17:56:11;8992761166229;FRESTEA MARKISA 350ML;1;4500;0;4500;3000;1500;
2021-03-01 17:56:11;9556040040038;SUSU F&N;1;33000;0;33000;30000;3000;
2021-03-01 17:56:11;8996001600146;TEH PUCUK HARUM 350ML;1;3000;0;3000;2314;686;
2021-03-01 18:05:56;6907992823669;JD MILKY STRAW;1;3000;0;3000;2600;400;
2021-03-01 18:05:56;COKLAT;COKLAT COIN;4;500;0;2000;1600;400;
2021-03-01 18:34:12;8992761122430;FRESTEA GREEN HONEY 500ML;1;6500;0;6500;4708;1792;
2021-03-01 18:34:12;8996001600146;TEH PUCUK HARUM 350ML;2;3000;0;6000;4628;1372;
2021-03-01 19:15:26;9556001047175;NESCAFE ORI 240ML;1;8500;0;8500;7337;1163;
2021-03-01 19:15:26;8992775110157;GARUDA KACANG KULIT;1;5000;0;5000;3925;1075;
2021-03-01 19:15:26;8992761166212;FRESTEA APPLE 350ML;1;4500;0;4500;3000;1500;
2021-03-01 19:27:19;GL;GULA 1 LITER;2;11500;0;23000;21000;2000;
2021-03-01 19:27:19;8995333032113;TERIGU GATOT KACA 1 KG;1;8500;0;8500;8012;488;
2021-03-01 19:52:21;8992761166212;FRESTEA APPLE 350ML;1;4500;0;4500;3000;1500;
2021-03-01 19:52:53;8992761139018;ADES 600ML;1;3500;0;3500;2292;1208;
2021-03-01 20:59:59;8992753102303;BKM SCT CKLT 40G;1;7500;0;7500;6900;600;
2021-03-01 20:59:59;8991102384841;WFR TANGO LONG CKLT 130G;2;5000;0;10000;7546;2454;
2021-03-01 21:00:09;8992761139018;ADES 600ML;1;3500;0;3500;2292;1208;
2021-03-01 21:02:54;8992761139018;ADES 600ML;1;3500;0;3500;2292;1208;
2021-03-01 21:40:08;8998899001920;BAYGON MAX;1;4000;0;4000;3500;500;
2021-03-01 22:01:07;8998989300261;GUDANG GARAM SURYA 12 FILTER;1;18000;0;18000;16450;1550;
2021-03-01 22:03:39;8998989110167;SURYA GUDANG GARAM 16 FILTER;1;24000;0;24000;22100;1900;
2021-03-01 22:03:39;ARD;SENDAL ARDILES;1;15000;0;15000;13500;1500;
2021-03-01 22:03:39;ATIRA;MIE KREMES ATIRA;2;500;0;1000;850;150;
2021-03-01 22:33:36;6907992823829;JD MILKY MILK;1;3000;0;3000;2600;400;
2021-03-01 22:33:36;ATIRA;MIE KREMES ATIRA;9;500;0;4500;3825;675;
2021-03-01 22:36:10;8995333032113;TERIGU GATOT KACA 1 KG;2;8500;0;17000;16024;976;
2021-03-01 22:36:10;GL;GULA 1 LITER;2;11500;0;23000;21000;2000;
2021-03-01 22:36:10;8999999390198;SUNLIGHT LIME NEW POUCH 755ML;1;17000;0;17000;15400;1600;
2021-03-01 23:04:01;BRS;BERAS BUMN 10KG;1;128000;0;128000;90000;38000;
2021-03-01 23:28:25;8991102230308;BLASTER PINK;1;5000;0;5000;3106;1894;
2021-03-01 23:28:25;8998899001920;BAYGON MAX;1;4000;0;4000;3500;500;
2021-03-01 23:28:25;FUZO;KUACI FUZO;1;1000;0;1000;850;150;
2021-03-02 00:00:48;8991001770301;SELAMAT CLACK VANILA;1;13000;0;13000;11800;1200;
2021-03-02 00:03:46;76164217;MARLBORO MERAH;1;30000;0;30000;27700;2300;
2021-03-02 00:03:46;8997028590014;ARGUS 220ML;3;500;0;1500;906;594;
2021-03-02 00:03:46;6907992823935;JD SWEETCORN;1;3500;0;3500;3000;500;
2021-03-02 10:20:57;GL;GULA 1 LITER;1;11500;0;11500;10500;1000;
2021-03-02 10:20:57;8999999195649;SARI WANGI 25X1.86G;1;6000;0;6000;5050;950;
2021-03-02 10:20:57;FUZO;KUACI FUZO;1;1000;0;1000;850;150;
2021-03-02 10:20:57;6907992825076;JD WATERMELON APPLE;1;2000;0;2000;1700;300;
2021-03-02 10:22:32;GL;GULA 1 LITER;2;11500;0;23000;21000;2000;
2021-03-02 10:22:32;8997012321204;MAXX BUMBU BALADO;1;5000;0;5000;4100;900;
2021-03-02 10:22:32;8998898847109;KOPI JAHE;2;1500;0;3000;23600;-20600;
2021-03-02 10:22:32;6907992825076;JD WATERMELON APPLE;1;2000;0;2000;1700;300;
2021-03-02 11:00:13;RT TWR;ROTI TAWAR JUMBO;1;7000;0;7000;6200;800;
2021-03-02 11:14:45;8998989300261;GUDANG GARAM SURYA 12 FILTER;1;18000;0;18000;16450;1550;
2021-03-02 11:14:45;8998866200301;NOODLE SEDAAP GORENG  90 GR;1;2500;0;2500;2023;477;
2021-03-02 11:14:45;ATIRA;MIE KREMES ATIRA;1;500;0;500;425;75;
2021-03-02 11:25:34;8996001318911;BETTER ISI 4;1;2000;0;2000;1700;300;
2021-03-02 11:31:12;8996001600146;TEH PUCUK HARUM 350ML;1;3000;0;3000;2314;686;
2021-03-02 11:31:12;RT BAKPIA;ROTI BAKPIA;2;1000;0;2000;1500;500;
2021-03-02 12:00:11;8993989311279;CLAS MILD 12;1;16500;0;16500;15700;800;
2021-03-02 12:00:11;RT ISI 6;ROTI ISI 6;1;5000;0;5000;4500;500;
2021-03-02 12:03:52;089686010824;INDOMIE GORENG SPESIAL;1;2700;0;2700;2452;248;
2021-03-02 12:03:52;8998866200301;NOODLE SEDAAP GORENG  90 GR;1;2500;0;2500;2023;477;
2021-03-02 12:50:06;8998866202053;POTABEE AYAM BAKAR PEDAS 68GR;1;8000;0;8000;7200;800;
2021-03-02 12:50:06;8998866500708;FLORIDINA ORANGE;1;3000;0;3000;2500;500;
2021-03-02 12:50:06;8992761166052;FRESTEA MELATI 350ML;1;4500;0;4500;3000;1500;
2021-03-02 12:54:27;8992957214307;SAFARI MECES;1;5500;0;5500;4500;1000;
2021-03-02 13:32:24;8998866201520;KOPI TOP TORAJA MURNI;1;11000;0;11000;9600;1400;
2021-03-02 14:28:32;8992761122430;FRESTEA GREEN HONEY 500ML;2;6500;0;13000;9416;3584;
2021-03-02 15:42:09;8992761166212;FRESTEA APPLE 350ML;1;4500;0;4500;3000;1500;
2021-03-02 15:42:09;8998898829129;KKB ENER-G JERUK;1;5500;0;5500;4824;676;
2021-03-02 16:01:22;RT TWR;ROTI TAWAR JUMBO;3;7000;0;21000;18600;2400;
2021-03-02 16:17:15;8992775712603;MYTEA POCI OOLONG;1;5000;0;5000;4410;590;
2021-03-02 16:33:48;8990800016757;BB TUTI FRUITTY COSMO;1;8500;0;8500;7600;900;
2021-03-02 16:33:48;8996001600146;TEH PUCUK HARUM 350ML;1;3000;0;3000;2314;686;
2021-03-02 16:33:48;8991001111883;SILVERQUEEN CHUNKYBAR 33G;1;8000;0;8000;7150;850;
2021-03-02 16:37:43;6907992824963;JD CHOCO BLAST;1;3000;0;3000;2600;400;
2021-03-02 16:45:52;8999909010567;234 16 FILTER;1;22000;0;22000;21500;500;
2021-03-02 17:23:24;8998866201377;KRISBEE FRIES KENTANG GORENG 68 GR;1;5500;0;5500;4620;880;
2021-03-02 17:23:24;8992775110157;GARUDA KACANG KULIT;1;5000;0;5000;3925;1075;
2021-03-02 17:23:24;8992761122331;FRESTEA APPEL 500ML;1;6500;0;6500;4708;1792;
2021-03-02 17:35:18;8992959508992;SWEETY SILVER PANTS L 28;1;56800;0;56800;51819;4981;
2021-03-02 17:44:47;8998866604932;DAIA LEMON BAG 850G & PIRING;1;18000;0;18000;15627;2373;
2021-03-02 17:44:47;8998866201964;MINYAK GORENG SABRINA 2L POUCH;1;28000;0;28000;26753;1247;
2021-03-02 17:47:35;8999999034061;ZWITSAL BAT NAT HAIR&BODY  300ML;1;28700;0;28700;26125;2575;
2021-03-02 17:50:16;8996001600399;LE MINERAL 1500ML;1;5000;0;5000;4042;958;
2021-03-02 18:02:05;8998866202671;NOODLE SEDAAP MIE KOREAN SPICY SOUP CUP;1;5000;0;5000;3917;1083;
2021-03-02 18:23:30;8998866609043;DAIA SOFTENER GUSSET 565G;1;10000;0;10000;8700;1300;
2021-03-02 18:23:30;8991002103764;GOOD DAY CPUCINO 10X25G;4;1500;0;6000;5580;420;
2021-03-02 18:23:30;089686021127;INTER MIE KALDU;2;1000;0;2000;1626;374;
2021-03-02 18:23:30;8993072254018;MELROSE COTTON BUDS BSR;1;5000;0;5000;4050;950;
2021-03-02 18:23:30;001;PASEO SMART FACIAL SF 250S GT;1;10000;0;10000;9500;500;
2021-03-02 18:23:30;RT ISI 6;ROTI ISI 6;1;5000;0;5000;4500;500;
2021-03-02 18:23:30;8992222010221;TANCHO TREATMENT;2;15000;0;30000;26000;4000;
2021-03-02 18:33:29;RT BAKPIA;ROTI BAKPIA;2;1000;0;2000;1500;500;
2021-03-02 18:34:11;8996001600610;TORA MILKY LATTE 180ML;1;3500;0;3500;2750;750;
2021-03-02 18:34:11;COKLAT;COKLAT COIN;2;500;0;1000;800;200;
2021-03-02 18:34:11;JGR SHN;JOGER SHINY SACHET;1;500;0;500;437;63;
2021-03-02 19:05:32;8998866201865;KRISBEE PILLOW CHOCOLAVA 120 GR;1;8000;0;8000;7250;750;
2021-03-02 19:05:32;8998866202053;POTABEE AYAM BAKAR PEDAS 68GR;2;8000;0;16000;14400;1600;
2021-03-02 19:11:03;GL;GULA 1 LITER;5;11500;0;57500;52500;5000;
2021-03-02 19:30:43;8992761002022;SPRITE PET 390ML;1;5500;0;5500;4300;1200;
2021-03-02 19:30:43;8998898101409;TOLAK ANGIN SIDOMUNCUL;1;3000;0;3000;2708;292;
2021-03-02 20:34:48;GL;GULA 1 LITER;3;11500;0;34500;31500;3000;
2021-03-02 20:34:48;8992628020152;BIMOLI POUCH 2L;1;30000;0;30000;28983;1017;
2021-03-02 20:34:48;8991002105409;KOPI KAPAL API;1;20000;0;20000;18888;1112;
2021-03-02 20:34:48;8999999195656;SARI WANGI 50X1.85;1;10000;0;10000;8700;1300;
2021-03-02 21:48:01;8998866202725;MILKU COKLAT PREMIUM 200ML;1;3000;0;3000;2375;625;
2021-03-02 21:48:01;8850507002968;A1 KING TRUCK;1;16500;0;16500;15500;1000;
2021-03-02 21:48:01;JGR SHN;JOGER SHINY SACHET;5;500;0;2500;2185;315;
2021-03-02 21:48:01;8998866202060;POTABEE AYAM BAKAR PEDAS 35 GR;1;5000;0;5000;4150;850;
2021-03-02 21:48:01;8992696523067;MILO ACTVGO UHT 180ML;4;4500;0;18000;14060;3940;
2021-03-02 22:13:33;RT KJ;ROTI KASUR JUMBO;1;7000;0;7000;6200;800;
2021-03-02 22:13:33;8992761145033;FANTA STRAW PET 250ML;1;3500;0;3500;2417;1083;
2021-03-02 22:13:33;8998866200325;NOODLE SEDAAP MIE SOTO;1;2200;0;2200;1952;248;
2021-03-03 12:04:06;8993989311279;CLAS MILD 12;1;17000;0;17000;15700;1300;
2021-03-03 12:04:06;8998989300261;GUDANG GARAM SURYA 12 FILTER;1;18000;0;18000;16450;1550;
2021-03-03 13:37:17;6907992824963;JD MILKY CHOCOLATE;3;3000;0;9000;7800;1200;
2021-03-03 13:37:42;6907992823843;JD MOCHA CRISPY;1;5000;0;5000;4400;600;
2021-03-03 13:38:39;8998866608459;POWDET DAIA PUTIH BAG 290GR;1;5000;0;5000;4450;550;
2021-03-03 13:46:29;8996001600146;TEH PUCUK HARUM 350ML;4;3000;0;12000;9256;2744;
2021-03-03 13:46:29;089686821086;ICHI OCHA MELATI;1;3000;0;3000;2250;750;
2021-03-03 13:46:29;8992388101085;NU GREEN TEA ORIGINAL 330ML;1;3500;0;3500;2854;646;
2021-03-03 13:46:29;8992388101092;NU GREEN TE HONEY 330ML;1;3500;0;3500;2854;646;
2021-03-03 13:46:29;8997013790108;BIMURA KACANG TELUR 25G;10;1000;0;10000;8750;1250;
2021-03-03 15:01:05;8998866501026;MINYAK GORENG SEDAAP POUCH 1 L;3;15500;0;46500;42330;4170;
2021-03-03 15:01:05;8992753101207;BENDERA KENTAL MANIS 370G;2;11500;0;23000;19400;3600;
2021-03-03 15:01:05;GL;GULA 1 LITER;10;11500;0;115000;105000;10000;
2021-03-03 15:01:05;8998866608084;KECAP MANIS SEDAAP POUCH 550ML;1;19000;0;19000;17000;2000;
2021-03-03 15:01:05;RT TWR;ROTI TAWAR JUMBO;1;7000;0;7000;6200;800;
2021-03-03 15:03:58;8996001600375;LE MINERAL 330ML;1;2000;0;2000;1417;583;
2021-03-03 15:14:08;8992761139018;ADES 600ML;2;3500;0;7000;4584;2416;
2021-03-03 15:26:49;8996001600146;TEH PUCUK HARUM 350ML;1;3000;0;3000;2314;686;
2021-03-03 15:26:49;8998866202619;SEDAAP MIE KOREAN SPICY SOUP BAG 77 GR;2;2300;0;4600;4054;546;
2021-03-03 15:26:49;8997018720018;SIRUP DHT;1;23000;0;23000;20958;2042;
2021-03-03 15:26:49;8996001600641;TORA CAPPUCINO;1;3500;0;3500;2750;750;
2021-03-03 15:26:49;COKLAT;COKLAT COIN;2;500;0;1000;800;200;
2021-03-03 15:26:49;JGR SHN;JOGER SHINY SACHET;10;500;0;5000;4370;630;
2021-03-03 15:32:15;8998866201841;GOLDA DOLCE LATTE 200ML;1;3000;0;3000;2500;500;
2021-03-03 15:48:04;8996001600146;TEH PUCUK HARUM 350ML;1;3000;0;3000;2314;686;
2021-03-03 16:43:50;8998866200325;NOODLE SEDAAP MIE SOTO;2;2200;0;4400;3904;496;
2021-03-03 16:46:43;8996001301579;MALKIST CKLT KELAPA PACK;1;11000;0;11000;9900;1100;
2021-03-03 16:56:54;GL;GULA 1 LITER;3;11500;0;34500;31500;3000;
2021-03-03 17:02:17;FUZO;KUACI FUZO;1;1000;0;1000;850;150;
2021-03-03 17:02:17;COKLAT;COKLAT COIN;10;500;0;5000;4000;1000;
2021-03-03 17:13:28;6907992823935;JD SWEETCORN;2;3500;0;7000;6000;1000;
2021-03-03 17:13:28;6907992823911;JD CRUNCHY HONEYDEW MELON;1;8000;0;8000;6800;1200;
2021-03-03 17:13:28;6907992823904;JD CRUNCHY CHOCOLATE VAN;2;8000;0;16000;13600;2400;
2021-03-03 17:39:02;8992959001875;SWEETY SILVER PANTS S RTG;1;10200;0;10200;9168;1032;
2021-03-03 17:42:54;8992959953013;SWEETY BRONZE S1;1;2000;0;2000;1379;621;
2021-03-03 17:45:58;8997013790108;BIMURA KACANG TELUR 25G;2;1000;0;2000;1750;250;
2021-03-03 17:45:58;8997013790092;BIMURA KERUPUK BAWANG 25G;1;1000;0;1000;874;126;
2021-03-03 17:45:58;ARD;SENDAL ARDILES;1;15000;0;15000;13500;1500;
2021-03-03 17:51:20;8998866500708;FLORIDINA ORANGE;1;3000;0;3000;2500;500;
2021-03-03 18:40:45;089686043273;INDOMIE SAMBAL RICA;1;2700;0;2700;2452;248;
2021-03-03 19:33:29;8998866202725;MILKU COKLAT PREMIUM 200ML;3;3000;0;9000;7125;1875;
2021-03-03 19:33:29;8998866610070;SOKLIN SOFTERGEN 280G PURPLE;1;5000;0;5000;4425;575;
2021-03-03 19:33:29;8998866202770;SEDAAP MIE GORENG SALERO PADANG 86 GR;2;2500;0;5000;4046;954;
2021-03-03 19:33:29;8999999529291;MOLTO PURE SACHET 10ML;1;6000;0;6000;4800;1200;
2021-03-03 19:42:45;8993379200855;SABUN HARMONY STRAWBERRY 70G;2;2000;0;4000;3304;696;
2021-03-03 20:12:52;RT KN;ROTI KASUR NANAS;1;7000;0;7000;6200;800;
2021-03-03 20:12:52;089686011494;INDOMIE SOTO PADANG;1;2600;0;2600;2317;283;
2021-03-03 20:12:52;8998866602273;HERSPROTEX SOFTCARE MAX;1;3500;0;3500;2950;550;
2021-03-03 20:36:28;6907992823843;JD MOCHA CRISPY;1;5000;0;5000;4400;600;
2021-03-03 20:36:28;RT 1000;ROTI 1000;1;1000;0;1000;750;250;
2021-03-03 20:36:28;8992761166038;MMP ORANGE 300ML;1;5000;0;5000;3750;1250;
2021-03-03 20:36:28;8997028590014;ARGUS 220ML;2;500;0;1000;604;396;
2021-03-03 20:36:28;089686017748;SARIMIE GORENG ISI 2;1;3500;0;3500;3120;380;
2021-03-03 20:36:42;8998866500708;FLORIDINA ORANGE;1;3000;0;3000;2500;500;
2021-03-03 20:40:21;089686011494;INDOMIE SOTO PADANG;2;2600;0;5200;4634;566;
2021-03-03 20:42:48;GL;GULA 1 LITER;1;11500;0;11500;10500;1000;
2021-03-03 20:42:48;8995333032113;TERIGU GATOT KACA 1 KG;2;8500;0;17000;16024;976;
2021-03-03 20:42:48;8998898830125;KKB ENER-G ANGGUR;2;5500;0;11000;9648;1352;
2021-03-03 20:48:28;8992761139018;ADES 600ML;1;3500;0;3500;2292;1208;
2021-03-03 21:31:19;8999801700030;SUSU FOYU;1;11000;0;11000;10000;1000;
2021-03-03 22:00:36;8998866202619;SEDAAP MIE KOREAN SPICY SOUP BAG 77 GR;4;2300;0;9200;8108;1092;
2021-03-03 22:27:23;8992959508855;SWEETY SILVER PANTS XL 18;1;47800;0;47800;43353;4447;
2021-03-03 22:28:28;8998866200301;NOODLE SEDAAP GORENG  90 GR;1;2500;0;2500;2023;477;
2021-03-03 22:28:28;089686043204;INDOMIE MIE ACEH;2;2700;0;5400;4904;496;
2021-03-04 10:07:14;8998989500166;GUDANG GARAM MERAH BESAR 16KS;2;17000;0;34000;30600;3400;
2021-03-04 10:07:14;8996001600399;LE MINERAL 1500ML;2;5000;0;10000;8084;1916;
2021-03-04 10:07:14;8994867006997;ROKOK PENA BOLD 20BTG;1;17000;0;17000;15000;2000;
2021-03-04 10:07:14;8998989300261;GUDANG GARAM SURYA 12 FILTER;1;18000;0;18000;16450;1550;
2021-03-04 10:07:14;8998866201841;GOLDA DOLCE LATTE 200ML;1;3000;0;3000;2500;500;
2021-03-04 10:07:14;8993989311279;CLAS MILD 12;1;17000;0;17000;15700;1300;
2021-03-04 10:32:37;8991002105409;KOPI KAPAL API;1;20000;0;20000;18888;1112;
2021-03-04 10:56:20;8999999192150;ROYCO FDS CHICKEN 100GR;4;5000;0;20000;17200;2800;
2021-03-04 11:38:42;8996001318911;BETTER ISI 4;1;2000;0;2000;1700;300;
2021-03-04 12:32:07;PUDING;VITA PUDDING;1;5000;0;5000;3750;1250;
2021-03-04 12:32:07;8992761145033;FANTA STRAW PET 250ML;1;3500;0;3500;2417;1083;
2021-03-04 12:42:55;8998866613262;SUKSESMIE SOTO 111 GR;1;3500;0;3500;2770;730;
2021-03-04 12:42:55;8998866200578;NOODLE SEDAAP KARI KENTAL SPC 75 GR;1;2300;0;2300;1952;348;
2021-03-04 12:42:55;8998866202619;SEDAAP MIE KOREAN SPICY SOUP BAG 77 GR;1;2300;0;2300;2027;273;
2021-03-04 12:42:55;8998866202770;SEDAAP MIE GORENG SALERO PADANG 86 GR;1;2500;0;2500;2023;477;
2021-03-04 12:42:55;8992388111145;MIE ABC SELERA PEDAS- SUP TOMAT PEDAS;1;2500;0;2500;2023;477;
2021-03-04 12:42:55;8998866202343;NOODLE SEDAAP MIE KOREAN SPICY 87 GR;1;2500;0;2500;2023;477;
2021-03-04 12:42:55;RT BAKPIA;ROTI BAKPIA;2;1000;0;2000;1500;500;
2021-03-04 12:42:55;8996001410042;TORABIKA MOKA;1;1500;0;1500;809;691;
2021-03-04 13:21:05;RT CD;ROTI COKLAT DURIAN;1;7000;0;7000;6200;800;
2021-03-04 13:21:05;RT KJ;ROTI KASUR JUMBO;1;7000;0;7000;6200;800;
2021-03-04 13:21:05;089686821086;ICHI OCHA MELATI;1;3000;0;3000;2250;750;
2021-03-04 13:26:01;8998989110167;SURYA GUDANG GARAM 16 FILTER;1;24000;0;24000;22100;1900;
2021-03-04 13:26:01;8993989311279;CLAS MILD 12;1;17000;0;17000;15700;1300;
2021-03-04 13:26:01;8992761139018;ADES 600ML;2;3500;0;7000;4584;2416;
2021-03-04 13:53:17;8998866501033;MINYAK GORENG SEDAAP POUCH 2L;1;29000;0;29000;27746;1254;
2021-03-04 13:53:17;711844150027;ABC NANAS;1;15000;0;15000;12241;2759;
2021-03-04 13:53:17;8998866201711;KRISBEE KRUNCHY JAGUNG BAKAR MENTEGA 75 GR;1;5500;0;5500;4400;1100;
2021-03-04 13:53:17;8992959107515;SFX NON WING 23CM 8;1;4000;0;4000;3288;712;
2021-03-04 13:53:17;8999999524524;MOLTO EDP PINK LUXURY ROSE 800ML;1;29200;0;29200;26600;2600;
2021-03-04 13:53:17;8999999524722;SUNLIGHT LIME NEW PCH 435ML;1;10000;0;10000;9100;900;
2021-03-04 13:53:17;6907992823652;JD CHOCOLATE MILKSHAKE;1;6000;0;6000;5200;800;
2021-03-04 13:53:17;6907992823829;JD MILKY MILK;1;3000;0;3000;2600;400;
2021-03-04 13:53:17;8997013790108;BIMURA KACANG TELUR 25G;1;1000;0;1000;875;125;
2021-03-04 13:53:17;8997013790092;BIMURA KERUPUK BAWANG 25G;1;1000;0;1000;874;126;
2021-03-04 13:53:17;RT 1000;ROTI 1000;2;1000;0;2000;1500;500;
2021-03-04 13:53:17;8992736025162;SASA TEPUNG PISANG GORENG;1;5000;0;5000;4455;545;
2021-03-04 13:53:17;8999999192150;ROYCO FDS CHICKEN 100GR;1;5000;0;5000;4300;700;
2021-03-04 13:53:17;8850507002951;BONCHA EGG SQUISHY;1;12000;0;12000;10841;1159;
2021-03-04 13:53:17;8998866202725;MILKU COKLAT PREMIUM 200ML;1;3000;0;3000;2375;625;
2021-03-04 13:53:17;8992957220087;COKLAT SINGA;1;2000;0;2000;1700;300;
2021-03-04 13:53:17;8992957220063;COKLAT BANGO;1;2000;0;2000;1700;300;
2021-03-04 13:53:17;8999999036638;LUX VELVET JAMINE 75G;1;3500;0;3500;2800;700;
2021-03-04 13:53:17;8850507000094;POLICE BONCHA;1;2000;0;2000;800;1200;
2021-03-04 13:53:17;COKLAT;COKLAT COIN;4;500;0;2000;1600;400;
2021-03-04 13:53:17;8850507001176;HERO RACING;1;12000;0;12000;10600;1400;
2021-03-04 13:58:00;8993365122536;MADU TJ SUPER 250G;1;25000;0;25000;22780;2220;
2021-03-04 13:59:47;8997021870328;HOT IN CREAM 120ML;1;18500;0;18500;17000;1500;
2021-03-04 14:01:53;KRP;KERUPUK BAWANG SINJAI;1;6000;0;6000;5000;1000;
2021-03-04 14:01:53;JGR SHN;JOGER SHINY SACHET;1;500;0;500;437;63;
2021-03-04 14:07:40;RT 1000;ROTI 1000;3;1000;0;3000;2250;750;
2021-03-04 14:54:41;8992761164539;NUTRIBOOST ORANGE 300ML;1;6500;0;6500;5300;1200;
2021-03-04 14:54:41;8992957220087;COKLAT SINGA;2;2000;0;4000;3400;600;
2021-03-04 15:41:45;8992761166038;MMP ORANGE 300ML;2;5000;0;10000;7500;2500;
2021-03-04 15:41:45;8992775001691;GARUDA ROSTA WAGYU BEEF;1;8000;0;8000;7176;824;
2021-03-04 15:58:42;8998866202770;SEDAAP MIE GORENG SALERO PADANG 86 GR;1;2500;0;2500;2023;477;
2021-03-04 15:58:42;8998866202619;SEDAAP MIE KOREAN SPICY SOUP BAG 77 GR;1;2300;0;2300;2027;273;
2021-03-04 15:58:42;089686041705;INDOMIE GORENG JUMBO;1;3500;0;3500;3143;357;
2021-03-04 16:44:21;8992959117590;SFX DS REG FLOW WING 20;1;12000;0;12000;11250;750;
2021-03-04 16:44:21;8997013790108;BIMURA KACANG TELUR 25G;1;1000;0;1000;875;125;
2021-03-04 16:52:31;8997012321204;MAXX BUMBU BALADO;1;5000;0;5000;4100;900;
2021-03-04 16:56:43;8996001600146;TEH PUCUK HARUM 350ML;1;3000;0;3000;2314;686;
2021-03-04 16:56:43;8998989100120;GUDANG GARAM MINI;1;18000;0;18000;16600;1400;
2021-03-04 17:25:36;8993989311279;CLAS MILD 12;1;17000;0;17000;15700;1300;
2021-03-04 17:26:10;ROYCO;ROYCO RASA AYAM;2;500;0;1000;750;250;
2021-03-04 17:46:11;8998009010590;ULTRA CHO 125;1;3000;0;3000;2428;572;
2021-03-04 17:47:19;8998009010590;ULTRA CHO 125;1;3000;0;3000;2428;572;
2021-03-04 17:49:52;8851019510132;POCKY;1;7300;0;7300;7000;300;
2021-03-04 17:49:52;8992775311325;GERY SNACK&SEREAL 100G;1;7000;0;7000;5892;1108;
2021-03-04 17:49:52;8999999048501;SUNSILK RFR ANTI DDRF 170ML;1;22200;0;22200;20020;2180;
2021-03-04 17:53:07;8999909982000;SAMPOERNA 12 FILTER;1;18000;0;18000;16200;1800;
2021-03-04 17:53:07;8992761145033;FANTA STRAW PET 250ML;1;3500;0;3500;2417;1083;
2021-03-04 17:53:37;8998866501026;MINYAK GORENG SEDAAP POUCH 1 L;12;15500;0;186000;169320;16680;
2021-03-04 17:58:03;8999909096004;SAMPOERNA 16 FILTER;1;6000;0;6000;23000;-17000;
2021-03-04 17:58:14;123124;KOREK BIASA;1;2000;0;2000;1800;200;
2021-03-04 18:16:32;8998866202404;NOODLE SEDAAP MIE KOREAN SPICY CHICKEN CUP;1;5000;0;5000;3917;1083;
2021-03-04 18:26:16;8998989300261;GUDANG GARAM SURYA 12 FILTER;1;18000;0;18000;16450;1550;
2021-03-04 18:50:14;089686060102;POP MIE PEDE GLEDEEK;1;5000;0;5000;4450;550;
2021-03-04 18:50:31;8992761111533;SPRITE SLIM CAM250ML;1;5000;0;5000;3750;1250;
2021-03-04 20:34:24;8997025911706;HATARI SHP MARGARINE;1;5000;0;5000;4800;200;
2021-03-04 20:34:24;8992696404441;BEAR BRAND 189ML;1;8500;0;8500;7887;613;
2021-03-04 20:35:13;8996001338056;TAMARIN;1;5600;0;5600;5100;500;
2021-03-04 20:58:55;8997011700123;BIHUN JAGUNG 300GR;1;5200;0;5200;4738;462;
2021-03-04 21:05:58;8992775712603;MYTEA POCI OOLONG;1;5000;0;5000;4410;590;
2021-03-04 21:05:58;8992761164539;NUTRIBOOST ORANGE 300ML;1;6500;0;6500;5300;1200;
2021-03-04 21:05:58;8997013790108;BIMURA KACANG TELUR 25G;1;1000;0;1000;875;125;
2021-03-04 21:05:58;8997028590014;ARGUS 220ML;2;500;0;1000;604;396;
2021-03-04 21:43:42;8999999549480;SUNLIGHT LIME CRM SCH 270G;1;5000;0;5000;4500;500;
2021-03-04 21:57:53;SFX;SOFTEX DAUN SIRIH 1;2;500;0;1000;826;174;
2021-03-04 22:31:55;76164217;MARLBORO MERAH;1;30000;0;30000;27700;2300;
2021-03-05 10:01:00;8995333060703;TERIGU KOMPAS 1KG;1;10500;0;10500;9816;684;
2021-03-05 10:01:00;GL;GULA 1 LITER;3;11500;0;34500;31500;3000;
2021-03-05 10:01:00;8998989110167;SURYA GUDANG GARAM 16 FILTER;1;24000;0;24000;22100;1900;
2021-03-05 10:01:00;123124;KOREK BIASA;1;2000;0;2000;1800;200;
2021-03-05 10:01:00;8998866201841;GOLDA DOLCE LATTE 200ML;1;3000;0;3000;2500;500;
2021-03-05 10:01:00;8992775311615;CHOCOLATOS;1;12000;0;12000;9983;2017;
2021-03-05 10:06:37;8992959953167;SWEETY BRONZE S36;1;48000;0;48000;45682;2318;
2021-03-05 10:06:37;8998989300261;GUDANG GARAM SURYA 12 FILTER;1;18000;0;18000;16450;1550;
2021-03-05 10:06:37;8998898101409;TOLAK ANGIN SIDOMUNCUL;1;3500;0;3500;2708;792;
2021-03-05 10:07:02;8994867000162;ROKOK PUNDIMAS KRETEK16;1;10000;0;10000;8600;1400;
2021-03-05 10:17:22;8998989110167;SURYA GUDANG GARAM 16 FILTER;1;24000;0;24000;22100;1900;
2021-03-05 11:15:24;8992775211434;PILUS GARUDA SAPI PANGGANG;2;5500;0;11000;9426;1574;
2021-03-05 11:15:24;8992775211410;PILUS GARUDA PEDAS;1;5500;0;5500;4713;787;
2021-03-05 11:15:24;8991111101316;JB OIL 50ML;1;9500;0;9500;8700;800;
2021-03-05 11:15:24;8999908204202;MY BABY MINYAK TELON 60ML;1;15000;0;15000;13545;1455;
2021-03-05 11:15:24;8992761002022;SPRITE PET 390ML;1;5500;0;5500;4300;1200;
2021-03-05 11:19:29;8998989300261;GUDANG GARAM SURYA 12 FILTER;1;18000;0;18000;16450;1550;
2021-03-05 11:47:42;ARG;ARGUS 220ML;1;14500;0;14500;12500;2000;
2021-03-05 13:14:04;089686821086;ICHI OCHA MELATI;1;3000;0;3000;2250;750;
2021-03-05 13:14:04;8991102989534;WFR TANGO LONG VNL 24G GTG;3;1000;0;3000;2016;984;
2021-03-05 13:14:04;8997013790108;BIMURA KACANG TELUR 25G;2;1000;0;2000;1750;250;
2021-03-05 13:14:19;RT 1000;ROTI 1000;1;1000;0;1000;750;250;
2021-03-05 13:49:07;8998866202671;NOODLE SEDAAP MIE KOREAN SPICY SOUP CUP;1;5000;0;5000;3917;1083;
2021-03-05 13:50:33;8992761166212;FRESTEA APPLE 350ML;2;4500;0;9000;6000;3000;
2021-03-05 14:26:26;8993072153595;LARISST COTTON 35G;1;5000;0;5000;3300;1700;
2021-03-05 14:26:26;8999999528836;CITRA NOURISH WHT 120ML;1;11800;0;11800;10082;1718;
2021-03-05 14:49:42;089686017748;SARIMIE GORENG ISI 2;1;3500;0;3500;3120;380;
2021-03-05 14:49:42;8992761145033;FANTA STRAW PET 250ML;1;3500;0;3500;2417;1083;
2021-03-05 15:16:58;8996001600146;TEH PUCUK HARUM 350ML;1;3000;0;3000;2314;686;
2021-03-05 15:26:37;RT TWR;ROTI TAWAR JUMBO;1;7000;0;7000;6200;800;
2021-03-05 16:05:08;8992761139018;ADES 600ML;1;3500;0;3500;2292;1208;
2021-03-05 16:05:08;8992761166212;FRESTEA APPLE 350ML;1;4500;0;4500;3000;1500;
2021-03-05 16:05:08;8992957220087;COKLAT SINGA;2;2000;0;4000;3400;600;
2021-03-05 17:26:22;8991004011906;KOPI BORONG;1;10000;0;10000;8333;1667;
2021-03-05 17:26:22;8997025914059;HATARI SEE HONG;1;5000;0;5000;4800;200;
2021-03-05 17:26:22;8991102989534;WFR TANGO LONG VNL 24G GTG;2;1000;0;2000;1344;656;
2021-03-05 17:39:50;8995333032113;TERIGU GATOT KACA 1 KG;1;8500;0;8500;8012;488;
2021-03-05 17:42:53;8998866610261;POWDET DAIA SOFTENER BAG 290 GR;2;5000;0;10000;8900;1100;
2021-03-05 17:42:53;8998866608312;GIV PAPAYA KOTAK 76GR;2;2000;0;4000;3640;360;
2021-03-05 17:42:53;8998866200561;EKOMIE SUPER 600GR;1;10000;0;10000;8615;1385;
2021-03-05 17:42:53;8991004011906;KOPI BORONG;2;10000;0;20000;16666;3334;
2021-03-05 17:42:53;8998866603393;RAPIKA HIJAU POUCH 400ML;1;5000;0;5000;4500;500;
2021-03-05 17:42:53;8999999524722;SUNLIGHT LIME NEW PCH 435ML;1;10000;0;10000;9100;900;
2021-03-05 20:46:35;11222;LEM KOREA;1;9000;0;9000;8000;1000;
2021-03-05 21:09:26;8997028590014;ARGUS 220ML;5;500;0;2500;1510;990;
2021-03-05 21:09:26;6907992823966;JD BLUEBERRY;1;3500;0;3500;3000;500;
2021-03-05 21:09:26;8991102714495;TANGO DRINK COKLAT;1;5000;0;5000;3818;1182;
2021-03-05 21:09:26;RT BAKPIA;ROTI BAKPIA;1;1000;0;1000;750;250;
2021-03-05 21:09:26;8998866200844;NOODLE SEDAAP MIE KARI SPESIAL CUP 81 GR;1;4500;0;4500;3650;850;
2021-03-05 21:16:59;8992870311091;SALONPAS;1;6000;0;6000;4806;1194;
2021-03-05 21:16:59;8997025911706;HATARI SHP MARGARINE;2;5000;0;10000;9600;400;
2021-03-05 21:16:59;GL;GULA 1 LITER;1;11500;0;11500;10500;1000;
2021-03-05 22:22:12;8998866200851;NOODLE SEDAAP MIE BAKSO SPESIAL CUP 77 GR;1;4500;0;4500;3650;850;
2021-03-05 23:26:27;8992753100101;BKM FULL CREAM GOLD 370;1;15500;0;15500;14800;700;
2021-03-05 23:26:27;8992761164546;NUTRIBOOST STRAWBERRY 300ML;1;7000;0;7000;5300;1700;
2021-03-06 10:49:23;089686010343;INDOMIE SOTO MIE;1;2600;0;2600;2367;233;
2021-03-06 10:49:23;8992696405240;DNCO FORT CKLT 400G;1;37000;0;37000;35077;1923;
2021-03-06 10:49:23;8999999710880;PEPSODENT ACTION123 HERBAL 75G;1;7500;0;7500;6650;850;
2021-03-06 10:49:23;8998866612180;SOKLIN SOFTERGEN 280G SAKURA;1;5000;0;5000;4425;575;
2021-03-06 10:49:23;8999999059781;SUNLIGHT LIME NEW POUCH 210ML;1;5000;0;5000;4300;700;
2021-03-06 10:49:23;8999999401023;MOLTO PEWANGI PINK 820ML;1;12500;0;12500;11275;1225;
2021-03-06 10:49:23;8997025911706;HATARI SHP MARGARINE;1;5000;0;5000;4800;200;
2021-03-06 10:49:23;8992628022156;BIMOLI KLASIK TOUCH 1 LT;1;16000;0;16000;14350;1650;
2021-03-06 10:49:23;8999999538422;CLEAR SHP ICM UNISEX 55 ML;1;4200;0;4200;3750;450;
2021-03-06 11:45:19;8998866501026;MINYAK GORENG SEDAAP POUCH 1 L;1;15500;0;15500;14110;1390;
2021-03-06 11:45:19;001;PASEO SMART FACIAL SF 250S GT;1;10000;0;10000;9500;500;
2021-03-06 11:45:19;8993379254469;SABUN LERVIA 90G;1;3500;0;3500;2966;534;
2021-03-06 11:45:19;8998866607315;SOKLIN SOFTERGENT SAKURA 770G & PIRING;1;18000;0;18000;16055;1945;
2021-03-06 11:45:19;8992696404441;BEAR BRAND 189ML;3;8500;0;25500;23661;1839;
2021-03-06 11:45:19;8993176110135;MINYAK TELON LANG 30ML;1;10000;0;10000;8167;1833;
2021-03-06 11:45:19;8998866202312;NOODLE SEDAAP TASTY BAKMI AYAM 129 GR;1;5000;0;5000;4167;833;
2021-03-06 12:11:51;8996001600146;TEH PUCUK HARUM 350ML;1;3000;0;3000;2314;686;
2021-03-06 12:11:51;8996001318911;BETTER ISI 4;1;2000;0;2000;1700;300;
2021-03-06 13:35:34;8992761166229;FRESTEA MARKISA 350ML;1;4500;0;4500;3000;1500;
2021-03-06 13:38:25;8991002103764;GOOD DAY CPUCINO 10X25G;4;1500;0;6000;5580;420;
2021-03-06 13:38:25;8992761139018;ADES 600ML;1;3500;0;3500;2292;1208;
2021-03-06 13:38:25;8991102381024;FULLO VNL PCK;1;10000;0;10000;9000;1000;
2021-03-06 13:38:25;8992775001691;GARUDA ROSTA WAGYU BEEF;1;8000;0;8000;7176;824;
2021-03-06 13:38:25;8994834003752;TOCTIC;1;2000;0;2000;1700;300;
2021-03-06 13:38:25;RAINBOW;MINICOCO RAINBOW;2;500;0;1000;900;100;
2021-03-06 13:46:53;8992761002015;COCA COLA PET 390ML;1;5500;0;5500;4333;1167;
2021-03-06 13:46:53;8996001301579;MALKIST CKLT KELAPA PACK;1;11000;0;11000;9900;1100;
2021-03-06 13:54:48;8998989110167;SURYA GUDANG GARAM 16 FILTER;1;24000;0;24000;22100;1900;
2021-03-06 13:54:48;8990800004563;MENTOS 40X50 BUAH IND;1;5500;0;5500;5150;350;
2021-03-06 14:28:55;8994834003752;TOCTIC;2;2000;0;4000;3400;600;
2021-03-06 14:28:55;COKLAT;COKLAT COIN;2;500;0;1000;800;200;
2021-03-06 14:45:19;8992761139018;ADES 600ML;1;3500;0;3500;2292;1208;
2021-03-06 15:04:22;8992957220087;COKLAT SINGA;1;2000;0;2000;1700;300;
2021-03-06 15:08:58;8999909096004;SAMPOERNA 16 FILTER;1;24000;0;24000;23000;1000;
2021-03-06 15:36:58;089686011036;INDOMIE GORENG PEDAS;1;2700;0;2700;2452;248;
2021-03-06 16:30:33;8992628510158;SIMAS PALMIA;1;6000;0;6000;4832;1168;
2021-03-06 17:35:30;8997013790108;BIMURA KACANG TELUR 25G;3;1000;0;3000;2625;375;
2021-03-06 17:35:30;8991102989534;WFR TANGO LONG VNL 24G GTG;3;1000;0;3000;2016;984;
2021-03-06 18:19:31;8998866201964;MINYAK GORENG SABRINA 2L POUCH;1;28000;0;28000;26753;1247;
2021-03-06 18:37:47;089686043273;INDOMIE SAMBAL RICA;1;2700;0;2700;2452;248;
2021-03-06 18:37:47;8998989100120;GUDANG GARAM MINI;1;18000;0;18000;16600;1400;
2021-03-06 19:09:03;8998866202671;NOODLE SEDAAP MIE KOREAN SPICY SOUP CUP;1;5000;0;5000;3917;1083;
2021-03-06 19:09:03;8992761139018;ADES 600ML;1;3500;0;3500;2292;1208;
2021-03-06 19:50:42;8998989300261;GUDANG GARAM SURYA 12 FILTER;1;18000;0;18000;16450;1550;
2021-03-06 20:22:56;8999909982000;SAMPOERNA 12 FILTER;1;18000;0;18000;16200;1800;
2021-03-06 21:13:53;8998866200325;NOODLE SEDAAP MIE SOTO;4;2200;0;8800;7808;992;
2021-03-06 21:13:53;8998866200578;NOODLE SEDAAP KARI KENTAL SPC 75 GR;4;2300;0;9200;7808;1392;
2021-03-06 21:17:46;8850507002968;A1 KING TRUCK;1;16500;0;16500;15500;1000;
2021-03-06 21:17:46;8850507001152;MOTU ATV;1;10000;0;10000;8000;2000;
2021-03-06 21:17:46;8998009010590;ULTRA CHO 125;2;3000;0;6000;4856;1144;
2021-03-06 21:17:46;8992775311615;CHOCOLATOS;1;12000;0;12000;9983;2017;
2021-03-06 21:17:46;8996001304020;SLAI OLAI NANAS;1;8500;0;8500;7700;800;
2021-03-06 21:18:25;8998866202466;JAPOTA HAPPY HONEY BUTTER;1;5000;0;5000;4150;850;
2021-03-06 21:18:25;RT ISI 6;ROTI ISI 6;1;5000;0;5000;4500;500;
2021-03-06 21:18:25;8998866202435;JAPOTA UMAMI JAPANESE SEAWEED 35GR;1;5000;0;5000;4150;850;
2021-03-06 21:22:43;8998989300261;GUDANG GARAM SURYA 12 FILTER;1;18000;0;18000;16450;1550;
2021-03-06 21:22:43;123124;KOREK BIASA;1;2000;0;2000;1800;200;
2021-03-06 21:32:27;8999999530495;AXE HIGH HOLD MATTE WAX 75G;1;23200;0;23200;20845;2355;
2021-03-06 21:42:04;8994834003752;TOCTIC;5;2000;0;10000;8500;1500;
2021-03-06 21:42:04;8991102384841;WFR TANGO LONG CKLT 130G;2;5000;0;10000;7546;2454;
2021-03-06 21:42:04;8998866201469;POTABEE REGULER BBQ BEEF 68 GR;1;8000;0;8000;7200;800;
2021-03-06 21:42:04;8992775001691;GARUDA ROSTA WAGYU BEEF;1;8000;0;8000;7176;824;
2021-03-06 21:42:04;8996001600375;LE MINERAL 330ML;2;2000;0;4000;2834;1166;
2021-03-06 21:42:04;8996001600269;LE MINERAL 600ML;1;3000;0;3000;1688;1312;
2021-03-06 21:42:04;8992761139018;ADES 600ML;1;3500;0;3500;2292;1208;
2021-03-06 21:43:19;8993470279651;JOGER CHOCKY BAR;3;1000;0;3000;2601;399;
2021-03-06 21:43:19;JGR SHN;JOGER SHINY SACHET;1;500;0;500;437;63;
2021-03-06 21:58:22;8992775311325;GERY SNACK&SEREAL 100G;1;7000;0;7000;5892;1108;
2021-03-06 21:58:22;8991102989534;WFR TANGO LONG VNL 24G GTG;3;1000;0;3000;2016;984;
2021-03-06 22:14:03;8996001600269;LE MINERAL 600ML;1;3000;0;3000;1688;1312;
2021-03-06 22:20:31;8996001312353;MALKIST KELAPA KOPYOR;1;6700;0;6700;5400;1300;
2021-03-06 22:20:31;8996001304013;SLAI OLAI PACK;1;8500;0;8500;7700;800;
2021-03-06 22:24:16;8992959953020;SWEETY BRONZE M1;1;3000;0;3000;2671;329;
2021-03-06 22:53:59;8998898101409;TOLAK ANGIN SIDOMUNCUL;2;3500;0;7000;5416;1584;
2021-03-06 22:53:59;8992761164546;NUTRIBOOST STRAWBERRY 300ML;1;6500;0;6500;5300;1200;
2021-03-06 23:02:38;GL;GULA 1 LITER;1;11500;0;11500;10500;1000;
2021-03-06 23:24:53;8992696523067;MILO ACTVGO UHT 180ML;4;4500;0;18000;14060;3940;
2021-03-06 23:24:53;8996001600269;LE MINERAL 600ML;1;3000;0;3000;1688;1312;
2021-03-06 23:24:53;8997013790108;BIMURA KACANG TELUR 25G;2;1000;0;2000;1750;250;
2021-03-06 23:24:53;GL;GULA 1 LITER;2;11500;0;23000;21000;2000;
2021-03-07 00:29:02;RT ISI 6;ROTI ISI 6;1;5000;0;5000;4500;500;
2021-03-07 00:29:02;8997028590014;ARGUS 220ML;5;500;0;2500;1510;990;
2021-03-07 00:29:02;PUDING;VITA PUDDING;1;5000;0;5000;3750;1250;
2021-03-07 00:29:02;8998866200813;NOODLE SEDAAP MIE GORENG CUP 85 GR;1;5000;0;5000;3917;1083;
2021-03-07 00:31:01;8998009010590;ULTRA CHO 125;1;3000;0;3000;2428;572;
2021-03-07 00:31:01;8998866202244;EKOMIE BUMBU KALDU AYAM;1;1000;0;1000;860;140;
2021-03-07 11:24:39;089686834055;FREISS JERUK;2;11000;0;22000;17500;4500;
2021-03-07 11:24:39;711844150027;ABC NANAS;1;15000;0;15000;12241;2759;
2021-03-07 11:24:39;GL;GULA 1 LITER;8;11500;0;92000;84000;8000;
2021-03-07 11:29:53;8996001600146;TEH PUCUK HARUM 350ML;1;3000;0;3000;2314;686;
2021-03-07 11:29:53;8992957220087;COKLAT SINGA;1;2000;0;2000;1700;300;
2021-03-07 11:29:53;RAINBOW;MINICOCO RAINBOW;1;500;0;500;450;50;
2021-03-07 11:29:53;COKLAT;COKLAT COIN;1;500;0;500;400;100;
2021-03-07 11:29:53;8998866202619;SEDAAP MIE KOREAN SPICY SOUP BAG 77 GR;2;2300;0;4600;4054;546;
2021-03-07 11:29:53;8999999050009;SUNLIGHT LIME NEW POUCH 95ML;1;2000;0;2000;1600;400;
2021-03-07 11:29:53;8998866200301;NOODLE SEDAAP GORENG  90 GR;2;2500;0;5000;4046;954;
2021-03-07 11:29:53;8992957220117;COKLAT BERUANG;1;2000;0;2000;1700;300;
2021-03-07 11:29:53;RT 1000;ROTI 1000;1;1000;0;1000;750;250;
2021-03-07 11:30:12;8994867000162;ROKOK PUNDIMAS KRETEK16;1;10000;0;10000;8600;1400;
2021-03-07 13:41:27;8999999059316;LIFEBOUY TS MILDCARE 75G;1;3000;0;3000;2500;500;
2021-03-07 13:41:27;8998866500708;FLORIDINA ORANGE;1;3000;0;3000;2500;500;
2021-03-07 13:41:27;8998989300261;GUDANG GARAM SURYA 12 FILTER;1;18000;0;18000;16450;1550;
2021-03-07 14:07:53;8997009510116;LEMON WATER;1;7000;0;7000;5694;1306;
2021-03-07 14:07:53;9556001025272;NESCAFE LATTE 240ML;1;8500;0;8500;7437;1063;
2021-03-07 14:07:53;8994834003752;TOCTIC;1;2000;0;2000;1700;300;
2021-03-07 14:07:53;8996001600610;TORA MILKY LATTE 180ML;1;3500;0;3500;2750;750;
2021-03-07 14:07:53;8991102384841;WFR TANGO LONG CKLT 130G;1;5000;0;5000;3773;1227;
2021-03-07 14:07:53;8994834006128;TOCTIC PEDAS;2;2000;0;4000;3400;600;
2021-03-07 14:53:12;8998866200882;SUKSESMIE GORENG AYAM KRMS 133GR;2;3500;0;7000;6000;1000;
2021-03-07 14:54:04;8992388101092;NU GREEN TE HONEY 330ML;1;3500;0;3500;2854;646;
2021-03-07 17:07:55;8998866200561;EKOMIE SUPER 600GR;1;10000;0;10000;8615;1385;
2021-03-07 17:07:55;089686043273;INDOMIE SAMBAL RICA;1;2700;0;2700;2452;248;
2021-03-07 17:43:46;8999999531485;MOLTO EDP PINK ROSE SC 10ML;2;5500;0;11000;9600;1400;
2021-03-07 17:43:46;8996001350515;ZUPERRR KEJU CHOCO;1;10000;0;10000;8000;2000;
2021-03-07 17:43:46;8992694242502;ZWITZAL SOAP CALSSIC 70G;1;3800;0;3800;3410;390;
2021-03-07 17:43:46;8991102281416;PERMEN MINTZ PPMINT;1;4500;0;4500;4000;500;
2021-03-07 17:43:46;8997027490018;LADAMAS MERICA BUBUK;1;9500;0;9500;8898;602;
2021-03-07 17:43:46;8991002105409;KOPI KAPAL API;1;20000;0;20000;18888;1112;
2021-03-07 17:43:46;8992959117569;SFX DS REG FLOW NW 8;1;4000;0;4000;3530;470;
2021-03-07 17:43:46;8999999192150;ROYCO FDS CHICKEN 100GR;1;5000;0;5000;4300;700;
2021-03-07 17:49:12;8992957214307;SAFARI MECES;1;5500;0;5500;4500;1000;
2021-03-07 18:23:22;8992696404441;BEAR BRAND 189ML;1;8500;0;8500;7887;613;
2021-03-07 18:23:22;8992959953181;SWEETY BRONZE L30+2;1;55000;0;55000;53410;1590;
2021-03-07 18:26:44;8992696523081;MILO UHT 110ML;1;2500;0;2500;1962;538;
2021-03-07 18:28:32;8998866200578;NOODLE SEDAAP KARI KENTAL SPC 75 GR;2;2300;0;4600;3904;696;
2021-03-07 18:33:42;8991102385060;TANGO WAFFLE CHOX;1;8000;0;8000;6212;1788;
2021-03-07 18:41:02;8994834003752;TOCTIC;1;2000;0;2000;1700;300;
2021-03-07 18:41:02;8999999520151;PEPSODENT TB FAMILY SOFT;1;2100;0;2100;1900;200;
2021-03-07 19:22:32;GL;GULA 1 LITER;3;11500;0;34500;31500;3000;
2021-03-07 19:22:32;8995333032113;TERIGU GATOT KACA 1 KG;1;8500;0;8500;8012;488;
2021-03-07 19:22:32;8994834006128;TOCTIC PEDAS;1;2000;0;2000;1700;300;
2021-03-07 19:22:32;8996001600146;TEH PUCUK HARUM 350ML;1;3000;0;3000;2314;686;
2021-03-07 19:59:57;8998866202244;EKOMIE BUMBU KALDU AYAM;5;1000;0;5000;4300;700;
2021-03-07 20:12:27;089686021127;INTER MIE KALDU;20;875;0;17500;16260;1240;
2021-03-07 20:12:27;089686021219;INTER MIE GORENG;20;875;0;17500;17700;-200;
2021-03-07 20:12:27;8998866200325;NOODLE SEDAAP MIE SOTO;4;2200;0;8800;7808;992;
2021-03-07 20:12:27;089686010107;INDOMIE KALDU AYAM;4;2500;0;10000;8600;1400;
2021-03-07 20:12:27;8999999558086;RINSO MOLTO FERFUME ESSENSE PWD 44G;6;1000;0;6000;4830;1170;
2021-03-07 20:24:15;8995333032113;TERIGU GATOT KACA 1 KG;1;8500;0;8500;8012;488;
2021-03-07 20:24:15;8992775001691;GARUDA ROSTA WAGYU BEEF;1;8000;0;8000;7176;824;
2021-03-07 20:24:15;8992761139018;ADES 600ML;1;3500;0;3500;2292;1208;
2021-03-07 20:24:15;8997021870052;FRESH CARE GREEN TEA 10ML;1;12000;0;12000;10000;2000;
2021-03-07 20:24:15;8995333060772;TERIGU GATOT KACA 500GR;1;4500;0;4500;4065;435;
2021-03-07 21:04:39;8998866693660;SOKLIN FLOORCLENER KUNING 900ML;1;14000;0;14000;12436;1564;
2021-03-07 21:04:39;8998866608084;KECAP MANIS SEDAAP POUCH 550ML;1;19000;0;19000;17000;2000;
2021-03-07 21:04:39;8998866200851;NOODLE SEDAAP MIE BAKSO SPESIAL CUP 77 GR;1;4500;0;4500;3650;850;
2021-03-07 21:27:36;089686010824;INDOMIE GORENG SPESIAL;2;2700;0;5400;4904;496;
2021-03-07 21:27:36;089686011036;INDOMIE GORENG PEDAS;1;2700;0;2700;2452;248;
2021-03-07 21:27:36;089686010343;INDOMIE SOTO MIE;2;2600;0;5200;4734;466;
2021-03-07 21:27:36;8999999514006;BANGO MANIS 60ML;1;3000;0;3000;2400;600;
2021-03-07 21:27:36;8993072254056;MELROSE COTTON BUDS KCL;1;3000;0;3000;2450;550;
2021-03-07 21:27:36;8850507002968;A1 KING TRUCK;1;16500;0;16500;15500;1000;
2021-03-07 22:01:45;8998989110167;SURYA GUDANG GARAM 16 FILTER;1;24000;0;24000;22100;1900;
2021-03-07 22:01:45;TG;TEH GELAS;2;1000;0;2000;1458;542;
2021-03-07 22:01:45;8993470671752;JOGER STICK DUO KACANG;3;1000;0;3000;2550;450;
2021-03-07 22:01:45;089686010107;INDOMIE KALDU AYAM;1;2500;0;2500;2150;350;
2021-03-07 22:01:45;089686021127;INTER MIE KALDU;1;1000;0;1000;813;187;
2021-03-08 11:14:48;8993989311279;CLAS MILD 12;1;17000;0;17000;15700;1300;
2021-03-08 11:32:49;8996001600146;TEH PUCUK HARUM 350ML;1;3000;0;3000;2314;686;
2021-03-08 11:35:12;8999999706173;PEPSODENT WHITE 120G;3;6700;0;20100;17820;2280;
2021-03-08 11:35:12;8999999045913;LIFEBUOY MILDCARE 110GR;3;4000;0;12000;10500;1500;
2021-03-08 12:18:42;8998866608008;KECAP MANIS SEDAAP BOTOL 135 ML;1;6300;0;6300;5615;685;
2021-03-08 12:55:19;8999999706081;PEPSODENT WHITE 75G;1;5000;0;5000;3850;1150;
2021-03-08 14:12:57;8992761145033;FANTA STRAW PET 250ML;1;3500;0;3500;2417;1083;
2021-03-08 14:42:04;JGR SHN;JOGER SHINY SACHET;1;500;0;500;437;63;
2021-03-08 14:42:04;ARG;ARGUS 220ML;1;14500;0;14500;12500;2000;
2021-03-08 14:59:42;8996001600146;TEH PUCUK HARUM 350ML;1;3000;0;3000;2314;686;
2021-03-08 15:10:15;8992959953037;SWEETY BRONZE L1;2;3000;0;6000;5342;658;
2021-03-08 15:39:05;8996001305041;ROMA SANDWICH CKLT;1;7000;0;7000;5000;2000;
2021-03-08 15:44:00;8995333060703;TERIGU KOMPAS 1KG;1;10500;0;10500;9816;684;
2021-03-08 15:44:00;8996001301142;ROMA KELAPA;1;8000;0;8000;6628;1372;
2021-03-08 16:00:45;PUDING;VITA PUDDING;1;5000;0;5000;3750;1250;
2021-03-08 16:52:05;8998989300261;GUDANG GARAM SURYA 12 FILTER;1;18000;0;18000;16450;1550;
2021-03-08 17:31:31;8997025911706;HATARI SHP MARGARINE;1;5000;0;5000;4800;200;
2021-03-08 17:52:33;8994867000162;ROKOK PUNDIMAS KRETEK16;1;10000;0;10000;8600;1400;
2021-03-08 18:27:23;8998866200813;NOODLE SEDAAP MIE GORENG CUP 85 GR;1;5000;0;5000;3917;1083;
2021-03-08 18:31:31;8998866200578;MIE SEDAAP KARI KENTAL;1;2500;0;2500;1952;548;
2021-03-08 19:02:03;6907992823966;JD BLUEBERRY;1;3500;0;3500;3000;500;
2021-03-08 19:02:03;6907992823911;JD CRUNCHY HONEYDEW MELON;1;8000;0;8000;6800;1200;
2021-03-08 19:02:03;8998866202725;MILKU COKLAT PREMIUM 200ML;1;3000;0;3000;2375;625;
2021-03-08 19:02:03;6907992823829;JD MILKY MILK;1;3000;0;3000;2600;400;
2021-03-08 19:02:03;8991102714495;TANGO DRINK COKLAT;1;5000;0;5000;3818;1182;
2021-03-08 20:06:12;6907992823652;JD CHOCOLATE MILKSHAKE;1;6000;0;6000;5200;800;
2021-03-08 20:06:12;TG;TEH GELAS;1;1000;0;1000;729;271;
2021-03-08 20:06:12;TG APEL;TEH GELAS APEL;1;2000;0;2000;1178;822;
2021-03-08 20:06:12;8997028590014;ARGUS 220ML;2;500;0;1000;604;396;
2021-03-08 20:23:00;6907992823911;JD CRUNCHY HONEYDEW MELON;1;8000;0;8000;6800;1200;
2021-03-08 20:26:10;8997018250218;JAHE MERAH;2;1000;0;2000;1666;334;
2021-03-08 21:08:19;8992628510158;SIMAS PALMIA;1;6000;0;6000;4832;1168;
2021-03-08 21:08:19;8995333032113;TERIGU GATOT KACA 1 KG;1;8500;0;8500;8012;488;
2021-03-08 21:08:19;8998866501026;MINYAK GORENG SEDAAP POUCH 1 L;1;15500;0;15500;14110;1390;
2021-03-08 21:08:19;8998866202343;MIE SEDAAP KOREAN SPICY;1;2500;0;2500;2023;477;
2021-03-08 21:08:19;089686010824;INDOMIE GORENG SPESIAL;1;2700;0;2700;2452;248;
2021-03-08 21:08:19;8992388111145;MIE ABC SELERA PEDAS- SUP TOMAT PEDAS;1;2500;0;2500;2023;477;
2021-03-08 21:08:19;8998866202244;EKOMIE BUMBU KALDU AYAM;2;1000;0;2000;1720;280;
2021-03-08 21:08:19;8998898830125;KKB ENER-G ANGGUR;1;5500;0;5500;4824;676;
2021-03-08 22:44:39;089686010343;INDOMIE SOTO MIE;1;2600;0;2600;2367;233;
2021-03-08 22:44:39;089686010824;INDOMIE GORENG SPESIAL;1;2700;0;2700;2452;248;
2021-03-08 22:45:08;8992761145033;FANTA STRAW PET 250ML;1;3500;0;3500;2417;1083;
2021-03-08 22:47:26;8999999027261;LIFEBUOY BW LEMONFRESH LD REFF 450 ML;1;25000;0;25000;22110;2890;
2021-03-08 22:47:26;8999999007768;FAIR&LOVELY MULTIVITAMIN  CREAM 9 ML;1;4500;0;4500;3200;1300;
2021-03-08 22:48:54;8998866202435;JAPOTA UMAMI JAPANESE SEAWEED 35GR;2;5000;0;10000;8300;1700;
2021-03-09 00:37:32;8991102714594;TANGO DRINK BLCK VNL;1;5000;0;5000;3818;1182;
2021-03-09 00:37:32;8991102228053;TEH GELAS BOTOL;1;3000;0;3000;1922;1078;
2021-03-09 00:37:32;TG MARKISA;TEH GELAS MARKISA;1;2000;0;2000;1178;822;
2021-03-09 00:37:32;RT ISI 6;ROTI ISI 6;1;5000;0;5000;4500;500;
2021-03-09 11:34:55;8997025911706;HATARI SHP MARGARINE;1;5000;0;5000;4800;200;
2021-03-09 11:34:55;8998009010231;ULTRA CHO 250;1;6000;0;6000;4784;1216;
2021-03-09 11:34:55;8992696405417;DNCO  SHC 27G;1;3000;0;3000;2647;353;
2021-03-09 11:34:55;8992628022156;BIMOLI KLASIK TOUCH 1 LT;1;16000;0;16000;14350;1650;
2021-03-09 11:34:55;8998866601429;POWDET DAIA BUNGA BAG 290GR;2;5000;0;10000;8900;1100;
2021-03-09 11:34:55;8999999556341;MOLTO EDP PINK ROSE 20ML;2;1000;0;2000;1600;400;
2021-03-09 11:34:55;8990800016757;BB TUTI FRUITTY COSMO;1;8500;0;8500;7600;900;
2021-03-09 11:34:55;RT BAKPIA;ROTI BAKPIA;1;1000;0;1000;750;250;
2021-03-09 11:34:55;JGR SHN;JOGER SHINY SACHET;1;500;0;500;437;63;
2021-03-09 11:34:55;TG MARKISA;TEH GELAS MARKISA;1;2000;0;2000;1178;822;
2021-03-09 11:35:30;8991102281430;PERMEN MINTZ DUOMINT;1;4500;0;4500;4000;500;
2021-03-09 11:56:56;089686011494;INDOMIE SOTO PADANG;2;2600;0;5200;4634;566;
2021-03-09 11:56:56;RT 1000;ROTI 1000;2;1000;0;2000;1500;500;
2021-03-09 14:51:59;8992761111540;FANTA STRAWBERY SLIM CAM 250ML;1;5000;0;5000;3750;1250;
2021-03-09 14:51:59;8992957220025;GOLDEN CITY MINI;1;3000;0;3000;2500;500;
2021-03-09 14:51:59;8997013790108;BIMURA KACANG TELUR 25G;2;1000;0;2000;1750;250;
2021-03-09 14:51:59;8992761139018;ADES 600ML;1;3500;0;3500;2292;1208;
2021-03-09 14:51:59;8992957220186;COKLAT RUSA;2;2000;0;4000;3400;600;
2021-03-09 15:22:58;8998989300261;GUDANG GARAM SURYA 12 FILTER;1;18000;0;18000;16450;1550;
2021-03-09 15:39:45;6907992823935;JD SWEETCORN;1;3500;0;3500;3000;500;
2021-03-09 16:24:10;8998989500128;GUDANG GARAM MERAH KECIL 12KS;1;13000;0;13000;11900;1100;
2021-03-09 17:28:31;8998989500128;GUDANG GARAM MERAH KECIL 12KS;1;13000;0;13000;11900;1100;
2021-03-09 17:31:28;8998989100120;GUDANG GARAM MINI;1;18000;0;18000;16600;1400;
2021-03-09 17:42:50;8998898830125;KKB ENER-G ANGGUR;1;5500;0;5500;4824;676;
2021-03-09 17:55:47;GL;GULA 1 LITER;2;11500;0;23000;21000;2000;
2021-03-09 18:03:51;RT CD;ROTI COKLAT DURIAN;1;7000;0;7000;6200;800;
2021-03-09 18:03:51;8992696404441;BEAR BRAND 189ML;1;8500;0;8500;7887;613;
2021-03-09 19:44:05;089686021127;INTER MIE KALDU;5;1000;0;5000;4065;935;
2021-03-09 19:44:05;8998866202244;EKOMIE BUMBU KALDU AYAM;5;1000;0;5000;4300;700;
2021-03-09 19:44:05;8998989300261;GUDANG GARAM SURYA 12 FILTER;1;18000;0;18000;16450;1550;
2021-03-09 19:59:04;GL;GULA 1 LITER;1;11500;0;11500;10500;1000;
2021-03-09 19:59:04;RT BAKPIA;ROTI BAKPIA;1;1000;0;1000;750;250;
2021-03-09 20:24:30;BRS;BERAS BUMN 10KG;2;128000;0;256000;180000;76000;
2021-03-09 20:24:30;8994867000162;ROKOK PUNDIMAS KRETEK16;1;10000;0;10000;8600;1400;
2021-03-09 20:24:30;8991102384841;WFR TANGO LONG CKLT 130G;1;5000;0;5000;3773;1227;
2021-03-09 20:36:24;8998866200301;MIE SEDAAP GORENG;2;2500;0;5000;4046;954;
2021-03-09 20:36:24;8999999504656;SARI MURNI 20X1.8G;1;5000;0;5000;4200;800;
2021-03-09 20:36:24;8998866501026;MINYAK GORENG SEDAAP POUCH 1 L;1;15500;0;15500;14110;1390;
2021-03-09 20:36:24;8998866602563;NUVO FAMILY HIJAU 76G;1;2000;0;2000;1820;180;
2021-03-09 20:36:24;8998866610742;NOVO FAMILY PINK 76G;1;2000;0;2000;1820;180;
2021-03-09 20:36:24;8999999030179;PEPSODENT ACTION 123 COMPLETE 75G;1;6700;0;6700;5170;1530;
2021-03-09 20:36:24;8999999534752;PEPSODENT ACTION123 CHARCOAL 65G;1;7400;0;7400;6710;690;
2021-03-09 20:36:24;GL;GULA 1 LITER;1;11500;0;11500;10500;1000;
2021-03-09 20:39:58;8998866201827;JAVANA GULA BATU 350ML;1;3000;0;3000;2150;850;
2021-03-09 21:00:27;8999999005580;DOVE DEO WMN RONOURISH & SMOOTH 40 ML;1;17800;0;17800;16050;1750;
2021-03-09 21:00:27;6907992823911;JD CRUNCHY HONEYDEW MELON;1;8000;0;8000;6800;1200;
2021-03-09 21:00:27;PRG;PARAGO;2;500;0;1000;800;200;
2021-03-09 21:00:27;RT BAKPIA;ROTI BAKPIA;1;1000;0;1000;750;250;
2021-03-09 21:06:02;8886013213208;FRENCH FREIS 2000;2;5000;0;10000;7500;2500;
2021-03-09 21:06:02;001;PASEO SMART FACIAL SF 250S GT;1;10000;0;10000;9500;500;
2021-03-09 21:06:02;8998009010569;ULTRA CHO 200;1;5000;0;5000;3830;1170;
2021-03-09 21:06:02;8992628020152;BIMOLI POUCH 2L;1;30000;0;30000;28983;1017;
2021-03-09 21:06:02;8998866200301;MIE SEDAAP GORENG;1;2500;0;2500;2023;477;
2021-03-09 21:16:51;RT BAKPIA;ROTI BAKPIA;5;1000;0;5000;3750;1250;
2021-03-10 08:51:51;8991102987639;WFR TANGO LONG VNL 130G;1;5000;0;5000;3773;1227;
2021-03-10 08:51:51;8997025914059;HATARI SEE HONG;1;5000;0;5000;4800;200;
2021-03-10 09:02:42;8991102228053;TEH GELAS BOTOL;1;3000;0;3000;1922;1078;
2021-03-10 09:02:42;8996001600146;TEH PUCUK HARUM 350ML;2;3000;0;6000;4628;1372;
2021-03-10 09:02:42;8998866202725;MILKU COKLAT PREMIUM 200ML;1;3000;0;3000;2375;625;
2021-03-10 09:02:42;8996001600641;TORA CAPPUCINO;1;3500;0;3500;2750;750;
2021-03-10 09:02:42;8991102381024;FULLO VNL PCK;1;10000;0;10000;9000;1000;
2021-03-10 09:18:32;RT BAKPIA;ROTI BAKPIA;2;1000;0;2000;1500;500;
2021-03-10 09:18:32;8998866201865;KRISBEE PILLOW CHOCOLAVA 120 GR;1;8000;0;8000;7250;750;
2021-03-10 10:17:57;8991102213189;BLASTER UNGU;1;5000;0;5000;3106;1894;
2021-03-10 10:17:57;089686400816;SAMBAL EXTRA PEDAS 135ML;2;5500;0;11000;9232;1768;
2021-03-10 10:17:57;GL;GULA 1 LITER;2;11500;0;23000;21000;2000;
2021-03-10 11:12:59;8998866200561;EKOMIE SUPER 600GR;1;10000;0;10000;8615;1385;
2021-03-10 11:14:29;HT;HOT-HOT;2;500;0;1000;700;300;
2021-03-10 12:14:49;BRS5;BERAS BUMN 5KG;1;64000;0;64000;45000;19000;
2021-03-10 12:16:59;8991102384841;WFR TANGO LONG CKLT 130G;1;5000;0;5000;3773;1227;
2021-03-10 13:19:09;8997009510055;YOU C1000;1;8000;0;8000;4846;3154;
2021-03-10 13:19:09;8992761139018;ADES 600ML;1;3500;0;3500;2292;1208;
2021-03-10 13:38:13;RT KJ;ROTI KASUR JUMBO;1;7000;0;7000;6200;800;
2021-03-10 13:40:23;8992761145033;FANTA STRAW PET 250ML;2;3500;0;7000;4834;2166;
2021-03-10 13:40:23;8992761145026;SPRITE PET 250ML;2;3500;0;7000;4834;2166;
2021-03-10 13:40:23;8994834006128;TOCTIC PEDAS;1;2000;0;2000;1700;300;
2021-03-10 13:44:06;8999909982000;SAMPOERNA 12 FILTER;2;18000;0;36000;32400;3600;
2021-03-10 15:31:02;8996001318911;BETTER ISI 4;1;2000;0;2000;1700;300;
2021-03-10 15:52:16;8998989300261;GUDANG GARAM SURYA 12 FILTER;1;18000;0;18000;16450;1550;
2021-03-10 15:52:16;PRG;PARAGO;3;500;0;1500;1200;300;
2021-03-10 15:52:16;HT;HOT-HOT;1;500;0;500;350;150;
2021-03-10 17:43:21;GL;GULA 1 LITER;1;11500;0;11500;10500;1000;
2021-03-10 17:43:21;PT;POTO-POTO SINJAI;2;6000;0;12000;10000;2000;
2021-03-10 17:43:21;8998866602273;HERSPROTEX SOFTCARE MAX;1;3500;0;3500;2950;550;
2021-03-10 17:43:21;8999999719395;VASELINE HW UV LIGHTENING 100ML;1;12900;0;12900;11805;1095;
2021-03-10 17:43:21;8999999502393;ROYCO FDS CHICKEN 8G;1;5000;0;5000;4500;500;
2021-03-10 19:34:13;8998989300261;GUDANG GARAM SURYA 12 FILTER;1;18000;0;18000;16450;1550;
2021-03-10 20:02:14;8998866200820;NOODLE SEDAAP MIE AYAM BAWANG TLR CUP 77 GR;2;4500;0;9000;7300;1700;
2021-03-10 20:02:14;RT BAKPIA;ROTI BAKPIA;1;1000;0;1000;750;250;
2021-03-10 20:02:14;RT 1000;ROTI 1000;3;1000;0;3000;2250;750;
2021-03-10 20:02:14;8993470671752;JOGER STICK DUO KACANG;1;1000;0;1000;850;150;
2021-03-10 20:02:14;TG;TEH GELAS;2;1000;0;2000;1458;542;
2021-03-10 20:02:14;PRG;PARAGO;3;500;0;1500;1200;300;
2021-03-10 20:10:48;8886013213208;FRENCH FREIS 2000;2;5000;0;10000;7500;2500;
2021-03-10 20:10:48;8998009040023;TEH KOTAK;1;5000;0;5000;2827;2173;
2021-03-10 20:10:48;8996001600269;LE MINERAL 600ML;1;3000;0;3000;1688;1312;
2021-03-10 20:10:48;8997025911058;HATARI SHP KELAPA;1;5000;0;5000;4800;200;
2021-03-10 20:55:01;GL;GULA 1 LITER;1;11500;0;11500;10500;1000;
2021-03-10 20:55:01;PRG;PARAGO;6;500;0;3000;2400;600;
2021-03-10 20:55:01;8999909096004;SAMPOERNA 16 FILTER;1;24000;0;24000;23000;1000;
2021-03-10 20:55:01;COKLAT;COKLAT COIN;6;500;0;3000;2400;600;
2021-03-10 20:55:01;8997013790108;BIMURA KACANG TELUR 25G;3;1000;0;3000;2625;375;
2021-03-10 21:44:23;8992736980164;SASA TEPUNG KENTUCKY 80G;2;3000;0;6000;4362;1638;
2021-03-10 21:44:23;8992753100101;BKM FULL CREAM GOLD 370;3;15500;0;46500;44400;2100;
2021-03-10 21:44:23;8996001355237;SUPER STAR;1;11000;0;11000;9900;1100;
2021-03-10 21:44:23;8998866200851;NOODLE SEDAAP MIE BAKSO SPESIAL CUP 77 GR;1;4500;0;4500;3650;850;
2021-03-10 21:46:27;8992775311486;CHOCOLATOS DARK 16G;1;18000;0;18000;15173;2827;
2021-03-10 22:06:04;8993989311279;CLAS MILD 12;1;17000;0;17000;15700;1300;
2021-03-10 22:21:42;089686021127;INTER MIE KALDU;1;1000;0;1000;813;187;
2021-03-10 22:21:42;8997028590014;ARGUS 220ML;1;500;0;500;302;198;
2021-03-10 22:37:24;8994023000050;MEGKEJU SERBAGUNA 165G;1;12000;0;12000;10339;1661;
2021-03-10 22:38:54;8997210107877;VORTEX SMART 3;1;5000;0;5000;9500;-4500;
2021-03-10 22:38:54;8992959508992;SWEETY SILVER PANTS L 28;1;56800;0;56800;51819;4981;
2021-03-10 22:41:04;8992959020012;SWEETY SILVER PANTS XL 34;1;78000;0;78000;73637;4363;
2021-03-10 22:41:57;8999999049454;REXONA WMN RO FREE SPIRIT 45 ML;1;15000;0;15000;13550;1450;
2021-03-11 09:51:21;GL;GULA 1 LITER;1;11500;0;11500;10500;1000;
2021-03-11 09:51:21;001;PASEO SMART FACIAL SF 250S GT;1;10000;0;10000;9500;500;
2021-03-11 09:51:21;8999999059781;SUNLIGHT LIME NEW POUCH 210ML;1;5000;0;5000;4300;700;
2021-03-11 09:51:21;8997021870151;FRESH CARE STRONG 110ML;1;12000;0;12000;10000;2000;
2021-03-11 09:51:21;8999999519872;DOVE DEO WMN RO POMEGRANATE 40 ML;1;16500;0;16500;15000;1500;
2021-03-11 09:51:21;8998866201841;GOLDA DOLCE LATTE 200ML;1;3000;0;3000;2500;500;
2021-03-11 09:51:21;089686017748;SARIMIE GORENG ISI 2;1;3500;0;3500;3120;380;
2021-03-11 09:51:21;COKLAT;COKLAT COIN;1;500;0;500;400;100;
2021-03-11 09:51:21;089686041705;INDOMIE GORENG JUMBO;1;3500;0;3500;3143;357;
2021-03-11 09:51:21;089686043204;INDOMIE MIE ACEH;1;2700;0;2700;2452;248;
2021-03-11 09:51:21;8996001600399;LE MINERAL 1500ML;1;5000;0;5000;4042;958;
2021-03-11 10:00:48;GL;GULA 1 LITER;5;11500;0;57500;52500;5000;
2021-03-11 10:00:48;8999999195656;SARI WANGI 50X1.85;2;10000;0;20000;17400;2600;
2021-03-11 10:22:15;8997027300089;NOMOS;1;4000;0;4000;2963;1037;
2021-03-11 10:22:15;8991102281416;PERMEN MINTZ PPMINT;1;4500;0;4500;4000;500;
2021-03-11 10:22:15;RT 1000;ROTI 1000;1;1000;0;1000;750;250;
2021-03-11 10:36:14;GL;GULA 1 LITER;2;11500;0;23000;21000;2000;
2021-03-11 10:36:14;8999999195649;SARI WANGI 25X1.86G;1;6000;0;6000;5050;950;
2021-03-11 10:36:33;GL;GULA 1 LITER;2;11500;0;23000;21000;2000;
2021-03-11 10:36:33;8999999195649;SARI WANGI 25X1.86G;1;6000;0;6000;5050;950;
2021-03-11 10:38:27;8993083929837;BISKITOP BLACK COOKIES;1;27000;0;27000;23700;3300;
2021-03-11 11:26:55;9556001004673;MILO NESTLE MALAYSIA ACTIVE GO;1;85000;0;85000;80000;5000;
2021-03-11 11:26:55;8992933216110;NUTRIJELL MANGO;1;6000;0;6000;4950;1050;
2021-03-11 11:26:55;8992933214116;NUTRIJELL MELON;1;6000;0;6000;5041;959;
2021-03-11 12:13:15;8992959953013;SWEETY BRONZE S1;5;2000;0;10000;6895;3105;
2021-03-11 13:52:13;8998009010231;ULTRA CHO 250;1;6000;0;6000;4784;1216;
2021-03-11 13:52:13;8998989300261;GUDANG GARAM SURYA 12 FILTER;1;18000;0;18000;16450;1550;
2021-03-11 13:52:13;089686043204;INDOMIE MIE ACEH;1;2700;0;2700;2452;248;
2021-03-11 13:58:14;8999999555191;SAHAJA PENCUCI PRG JRUK NIPIS  BTL 650ML;1;19000;0;19000;17250;1750;
2021-03-11 13:58:14;8998866201841;GOLDA DOLCE LATTE 200ML;1;3000;0;3000;2500;500;
2021-03-11 13:58:14;8998989300261;GUDANG GARAM SURYA 12 FILTER;1;18000;0;18000;16450;1550;
2021-03-11 14:44:37;8994867000162;ROKOK PUNDIMAS KRETEK16;1;10000;0;10000;8600;1400;
2021-03-11 14:45:26;8991102384841;WFR TANGO LONG CKLT 130G;1;5000;0;5000;3773;1227;
2021-03-11 15:34:54;089686010343;INDOMIE SOTO MIE;1;2600;0;2600;2367;233;
2021-03-11 15:56:24;8996001600375;LE MINERAL 330ML;1;2000;0;2000;1417;583;
2021-03-11 15:56:24;HT;HOT-HOT;2;500;0;1000;700;300;
2021-03-11 15:56:24;8992957220063;COKLAT BANGO;1;2000;0;2000;1700;300;
2021-03-11 17:15:33;089686011494;INDOMIE SOTO PADANG;2;2600;0;5200;4634;566;
2021-03-11 17:15:33;8998866610261;POWDET DAIA SOFTENER BAG 290 GR;1;5000;0;5000;4450;550;
2021-03-11 17:17:32;8996001312445;MALKIST CAPPUCINO;1;6500;0;6500;5400;1100;
2021-03-11 17:17:32;089686010107;INDOMIE KALDU AYAM;2;2500;0;5000;4300;700;
2021-03-11 17:17:32;8886013213208;FRENCH FREIS 2000;1;5000;0;5000;3750;1250;
2021-03-11 17:32:42;8998989500166;GUDANG GARAM MERAH BESAR 16KS;1;17000;0;17000;15300;1700;
2021-03-11 17:34:01;8998989500166;GUDANG GARAM MERAH BESAR 16KS;2;17000;0;34000;30600;3400;
2021-03-11 17:34:01;8999999524722;SUNLIGHT LIME NEW PCH 435ML;1;10000;0;10000;9100;900;
2021-03-11 17:40:02;8999999502003;SARIMURNI RL RB 1,8G;5;1500;0;7500;6035;1465;
2021-03-11 17:40:02;8992957220186;COKLAT RUSA;2;2000;0;4000;3400;600;
2021-03-11 17:40:02;8992957220025;GOLDEN CITY MINI;2;3000;0;6000;5000;1000;
2021-03-11 17:40:02;089686041705;INDOMIE GORENG JUMBO;2;3500;0;7000;6286;714;
2021-03-11 17:40:02;089686043204;INDOMIE MIE ACEH;2;2700;0;5400;4904;496;
2021-03-11 17:40:02;8992696523081;MILO UHT 110ML;1;2500;0;2500;1962;538;
2021-03-11 17:50:39;8996001600269;LE MINERAL 600ML;1;3000;0;3000;1688;1312;
2021-03-11 17:50:39;HT;HOT-HOT;2;500;0;1000;700;300;
2021-03-11 18:12:06;8999801700030;SUSU FOYU;1;11500;0;11500;10000;1500;
2021-03-11 18:12:06;8991111102832;JB POWDER BEDTIME 300G;1;14500;0;14500;13120;1380;
2021-03-11 18:12:06;HT;HOT-HOT;8;500;0;4000;2800;1200;
2021-03-11 18:18:09;8992761139018;ADES 600ML;1;3500;0;3500;2292;1208;
2021-03-11 18:18:09;8992957220025;GOLDEN CITY MINI;1;3000;0;3000;2500;500;
2021-03-11 20:44:16;8993007003063;ENAAK 500G;1;11000;0;11000;9625;1375;
2021-03-11 20:46:32;TG;TEH GELAS;1;1000;0;1000;729;271;
2021-03-11 20:46:32;8991102228053;TEH GELAS BOTOL;1;3000;0;3000;1922;1078;
2021-03-11 20:46:32;8992696405417;DNCO  SHC 27G;1;3000;0;3000;2647;353;
2021-03-11 20:46:32;8996001312445;MALKIST CAPPUCINO;1;6500;0;6500;5400;1100;
2021-03-11 20:46:32;HT;HOT-HOT;1;500;0;500;350;150;
2021-03-11 20:46:58;8999801700030;SUSU FOYU;1;11500;0;11500;10000;1500;
2021-03-11 20:46:58;8991004011906;KOPI BORONG;1;10000;0;10000;8333;1667;
2021-03-11 21:01:15;8999999001179;LIFEBUOY BW COOLFRESH LD REFF 450 ML;1;25000;0;25000;22110;2890;
2021-03-11 21:01:15;8998989300391;SURYA PRO PUTIH;1;20000;0;20000;18600;1400;
2021-03-11 21:09:15;8992761145033;FANTA STRAW PET 250ML;4;3500;0;14000;9668;4332;
2021-03-11 21:09:15;8992761145019;COCA COLA PET 250ML;1;3500;0;3500;2417;1083;
2021-03-11 21:09:15;8998866201889;KRISBEE PILLOW STRAWBERRY ICE CREAM 120GR;1;8000;0;8000;7250;750;
2021-03-11 22:11:20;8992959974018;SFX SIRIH 36CM 12+1;1;12000;0;12000;10686;1314;
2021-03-11 22:11:20;6907992823850;JD CHOCO CIRLE;1;5500;0;5500;4700;800;
2021-03-11 22:11:20;76239878;MARLBORO GOLD;1;30000;0;30000;27700;2300;
2021-03-11 22:13:04;8992761145026;SPRITE PET 250ML;2;3500;0;7000;4834;2166;
2021-03-11 22:13:04;8998866202244;EKOMIE BUMBU KALDU AYAM;1;1000;0;1000;860;140;
2021-03-11 22:13:04;8992957220117;COKLAT BERUANG;1;2000;0;2000;1700;300;
2021-03-11 22:22:28;089686010190;INDOMIE KARI AYAM;2;2800;0;5600;5044;556;
2021-03-11 22:22:28;GL;GULA 1 LITER;1;11500;0;11500;10500;1000;
2021-03-11 22:22:28;8997013790108;BIMURA KACANG TELUR 25G;2;1000;0;2000;1750;250;
2021-03-11 22:22:28;8998866610070;SOKLIN SOFTERGEN 280G PURPLE;1;5000;0;5000;4425;575;
2021-03-11 22:37:41;8990800004563;MENTOS 40X50 BUAH IND;1;5500;0;5500;5150;350;
2021-03-11 22:44:03;8999999401238;RINSO ANTI NODA 770G;1;21200;0;21200;19338;1862;
2021-03-11 23:51:36;089686010343;INDOMIE SOTO MIE;1;2600;0;2600;2367;233;
2021-03-12 11:12:06;8998989121163;SURYA PRO MERAH;1;20000;0;20000;18600;1400;
2021-03-12 11:12:06;8998866200882;SUKSESMIE GORENG AYAM KRMS 133GR;1;3500;0;3500;3000;500;
2021-03-12 11:12:06;8998866608718;DAIA SOFTENER PINK;1;5000;0;5000;4450;550;
2021-03-12 11:12:06;8996001355237;SUPER STAR;1;11000;0;11000;9900;1100;
2021-03-12 11:12:06;8991102384841;WFR TANGO LONG CKLT 130G;1;5000;0;5000;3773;1227;
2021-03-12 11:12:06;8996001318911;BETTER ISI 4;1;2000;0;2000;1700;300;
2021-03-12 11:12:06;MLTO PINK;MOLTO ALL IN ONE;4;1000;0;4000;3200;800;
2021-03-12 11:12:06;8991001780133;TWISTER BLACK;1;5000;0;5000;4600;400;
2021-03-12 11:12:06;8998989300261;GUDANG GARAM SURYA 12 FILTER;1;18000;0;18000;16450;1550;
2021-03-12 11:28:25;HT;HOT-HOT;1;500;0;500;350;150;
2021-03-12 13:09:48;6907992823867;JD CRUNCHY CHOCOLATE MALT;1;5500;0;5500;4700;800;
2021-03-12 13:09:48;8886013213208;FRENCH FREIS 2000;1;5000;0;5000;3750;1250;
2021-03-12 13:09:48;8998866202060;POTABEE AYAM BAKAR PEDAS 35 GR;1;5000;0;5000;4150;850;
2021-03-12 13:09:48;8998866202619;MIE SEDAAP KOREAN SPICY SOUP;1;2500;0;2500;1952;548;
2021-03-12 13:09:48;089686043273;INDOMIE SAMBAL RICA;1;2700;0;2700;2452;248;
2021-03-12 14:09:13;089686043273;INDOMIE SAMBAL RICA;1;2700;0;2700;2452;248;
2021-03-12 14:24:53;6907992823652;JD CHOCOLATE MILKSHAKE;1;6000;0;6000;5200;800;
2021-03-12 14:24:53;6907992823591;JD STRAW MILKSHAKE;3;5000;0;15000;12900;2100;
2021-03-12 14:42:13;8998866202725;MILKU COKLAT PREMIUM 200ML;1;3000;0;3000;2375;625;
2021-03-12 14:42:13;8992957220063;COKLAT BANGO;1;2000;0;2000;1700;300;
2021-03-12 14:56:55;8994867006997;ROKOK PENA BOLD 20BTG;1;17000;0;17000;15000;2000;
2021-03-12 15:05:46;8996001318911;BETTER ISI 4;1;2000;0;2000;1700;300;
2021-03-12 15:09:26;8991188943062;SASA 250G;2;10000;0;20000;16000;4000;
2021-03-12 15:29:54;089686010343;INDOMIE SOTO MIE;1;2600;0;2600;2367;233;
2021-03-12 15:54:00;089686041705;INDOMIE GORENG JUMBO;1;3500;0;3500;3143;357;
2021-03-12 15:54:00;8993989311279;CLAS MILD 12;1;17000;0;17000;15700;1300;
2021-03-12 16:21:08;6907992823591;JD STRAW MILKSHAKE;3;5000;0;15000;12900;2100;
2021-03-12 17:48:56;RT CD;ROTI COKLAT DURIAN;1;7000;0;7000;6200;800;
2021-03-12 17:48:56;8992761139018;ADES 600ML;1;3500;0;3500;2292;1208;
2021-03-12 17:49:35;8999999195649;SARI WANGI 25X1.86G;1;6000;0;6000;5050;950;
2021-03-12 17:49:35;GL;GULA 1 LITER;1;11500;0;11500;10500;1000;
2021-03-12 17:49:35;8998989500166;GUDANG GARAM MERAH BESAR 16KS;1;17000;0;17000;15300;1700;
2021-03-12 21:55:53;089686834307;FREISS LECI;1;11000;0;11000;8750;2250;
2021-03-12 21:55:53;8999801700030;SUSU FOYU;1;11500;0;11500;10000;1500;
2021-03-12 21:55:53;8992933243116;NUTRIJELLL KELAPA;2;6000;0;12000;9666;2334;
2021-03-12 21:55:53;8992933214116;NUTRIJELL MELON;1;6000;0;6000;5041;959;
2021-03-12 22:18:11;711844610095;LARISSA UDANG 500 GR;1;11000;0;11000;9790;1210;
2021-03-12 22:18:11;8997013790092;BIMURA KERUPUK BAWANG 25G;2;1000;0;2000;1748;252;
2021-03-12 22:18:11;8997013790108;BIMURA KACANG TELUR 25G;3;1000;0;3000;2625;375;
2021-03-12 22:18:11;8996001318980;BETTER 120G;1;6000;0;6000;5100;900;
2021-03-13 11:13:27;089686043204;INDOMIE MIE ACEH;1;2700;0;2700;2452;248;
2021-03-13 11:13:27;8998989300261;GUDANG GARAM SURYA 12 FILTER;1;18000;0;18000;16450;1550;
2021-03-13 11:13:27;8993571004732;SALAS SALEP CAP19 6G;1;7000;0;7000;6000;1000;
2021-03-13 13:04:51;6907992823904;JD CRUNCHY CHOCOLATE VAN;2;8000;0;16000;13600;2400;
2021-03-13 13:04:51;6907992823935;JD SWEETCORN;2;3500;0;7000;6000;1000;
2021-03-13 13:04:51;6907992823911;JD CRUNCHY HONEYDEW MELON;1;8000;0;8000;6800;1200;
2021-03-13 13:06:05;GL;GULA 1 LITER;1;11500;0;11500;10500;1000;
2021-03-13 13:06:05;8992759120264;LARISST 220;1;10000;0;10000;9200;800;
2021-03-13 13:06:05;8999999031602;SARI MURNI 20X1.6G;1;6000;0;6000;5400;600;
2021-03-13 13:22:44;8999909096004;SAMPOERNA 16 FILTER;1;24000;0;24000;23000;1000;
2021-03-13 13:22:44;8992761166038;MMP ORANGE 300ML;1;5000;0;5000;3750;1250;
2021-03-13 13:22:44;8996001318911;BETTER ISI 4;1;2000;0;2000;1700;300;
2021-03-13 14:00:25;8999999561123;MOLTO PEWANGI PURPLE 820ML;1;12500;0;12500;11275;1225;
2021-03-13 14:11:31;MOLTO PINK;MOLTO ALL IN ONE 11 ML;2;500;0;1000;800;200;
2021-03-13 16:04:49;8999999531485;MOLTO EDP PINK ROSE SC 10ML;1;5500;0;5500;4800;700;
2021-03-13 16:08:49;8994834006128;TOCTIC PEDAS;1;2000;0;2000;1700;300;
2021-03-13 16:08:49;8997009510055;YOU C1000;1;8000;0;8000;4846;3154;
2021-03-13 17:20:53;8998866201469;POTABEE REGULER BBQ BEEF 68 GR;2;8000;0;16000;14400;1600;
2021-03-13 17:20:53;8999999195656;SARI WANGI 50X1.85;2;10000;0;20000;17400;2600;
2021-03-13 17:20:53;8991004011906;KOPI BORONG;1;10000;0;10000;8333;1667;
2021-03-13 17:20:53;8991002105409;KOPI KAPAL API;2;20000;0;40000;37776;2224;
2021-03-13 17:20:53;GL;GULA 1 LITER;2;11500;0;23000;21000;2000;
2021-03-13 17:31:04;GL;GULA 1 LITER;1;11500;0;11500;10500;1000;
2021-03-13 17:31:04;8886013213208;FRENCH FREIS 2000;1;5000;0;5000;3750;1250;
2021-03-13 17:31:39;8992761166205;FRESTEA GREEN HONEY 350ML;1;4500;0;4500;3000;1500;
2021-03-13 18:41:13;8998866202343;MIE SEDAAP KOREAN SPICY;1;2500;0;2500;2023;477;
2021-03-13 18:41:13;089686043273;INDOMIE SAMBAL RICA;2;2700;0;5400;4904;496;
2021-03-13 18:41:13;8992761139018;ADES 600ML;1;3500;0;3500;2292;1208;
2021-03-13 18:42:11;8992761139018;ADES 600ML;1;3500;0;3500;2292;1208;
2021-03-13 18:42:11;8998866202671;NOODLE SEDAAP MIE KOREAN SPICY SOUP CUP;1;5000;0;5000;3917;1083;
2021-03-13 18:47:31;8998989500166;GUDANG GARAM MERAH BESAR 16KS;1;17000;0;17000;15300;1700;
2021-03-13 20:00:34;8998009040023;TEH KOTAK;4;5000;0;20000;11308;8692;
2021-03-13 20:00:34;8997025914059;HATARI SEE HONG;1;5000;0;5000;4800;200;
2021-03-13 20:01:05;8992753101207;BENDERA KENTAL MANIS 370G;2;11500;0;23000;19400;3600;
2021-03-13 20:30:44;RT 1000;ROTI 1000;1;1000;0;1000;750;250;
2021-03-13 20:30:44;8991002103764;GOOD DAY CPUCINO 10X25G;4;1500;0;6000;5580;420;
2021-03-13 22:00:03;8998989110167;SURYA GUDANG GARAM 16 FILTER;2;24000;0;48000;44200;3800;
2021-03-13 22:08:00;76239878;MARLBORO GOLD;1;30000;0;30000;27700;2300;
2021-03-13 22:08:00;8998866201841;GOLDA DOLCE LATTE 200ML;1;3000;0;3000;2500;500;
2021-03-13 22:08:00;9556001047175;NESCAFE ORI 240ML;1;8500;0;8500;7337;1163;
2021-03-13 22:10:28;8991002103764;GOOD DAY CPUCINO 10X25G;1;1500;0;1500;1395;105;
2021-03-13 22:10:28;089686010824;INDOMIE GORENG SPESIAL;2;2700;0;5400;4904;496;
2021-03-13 22:10:28;089686010343;INDOMIE SOTO MIE;2;2600;0;5200;4734;466;
2021-03-13 22:10:28;089686011036;INDOMIE GORENG PEDAS;1;2700;0;2700;2452;248;
2021-03-13 22:10:28;8999999059316;LIFEBOUY TS MILDCARE 75G;1;3000;0;3000;2500;500;
2021-03-13 22:10:28;8992946511790;SHINZUI 85G;1;5000;0;5000;3475;1525;
2021-03-13 22:25:34;8999999401238;RINSO ANTI NODA 770G;3;21200;0;63600;58014;5586;
2021-03-13 22:25:34;8998866608725;DAIA SOFTENER BAG 850G;1;18000;0;18000;15627;2373;
2021-03-13 22:35:09;8996001305041;ROMA SANDWICH CKLT;1;7000;0;7000;5000;2000;
2021-03-13 22:41:38;8998866202237;NOODLE SEDAAP TASTY AYAM GEPREK 124 GR;1;5000;0;5000;4167;833;
2021-03-14 00:11:14;089686011036;INDOMIE GORENG PEDAS;1;2700;0;2700;2452;248;
2021-03-14 00:11:14;8998866202404;NOODLE SEDAAP MIE KOREAN SPICY CHICKEN CUP;1;5000;0;5000;3917;1083;
2021-03-14 00:11:14;8993470671752;JOGER STICK DUO KACANG;2;1000;0;2000;1700;300;
2021-03-14 00:11:14;8998866201827;JAVANA GULA BATU 350ML;1;3000;0;3000;2150;850;
2021-03-14 11:07:00;8998866608558;SOKLIN SOFTERGENT 770G & PIRING;1;18000;0;18000;16055;1945;
2021-03-14 11:07:00;8999999529291;MOLTO PURE SACHET 10ML;1;6000;0;6000;4800;1200;
2021-03-14 11:07:00;8998866692663;SOKLIN FLOORCLENER KUNING 450ML;1;7000;0;7000;6385;615;
2021-03-14 11:07:00;8998866608718;DAIA SOFTENER PINK;1;5000;0;5000;4450;550;
2021-03-14 11:07:00;8999999502003;SARIMURNI RL RB 1,8G;2;1500;0;3000;2414;586;
2021-03-14 11:07:00;8999999195656;SARI WANGI 50X1.85;1;10000;0;10000;8700;1300;
2021-03-14 11:07:00;GL;GULA 1 LITER;3;11500;0;34500;31500;3000;
2021-03-14 11:07:00;8851019015132;POCKY DOUBLE CHOCOLATE 47G;1;7300;0;7300;5671;1629;
2021-03-14 11:07:00;8851019210117;POCKY CHOCOLATE 47G;1;7300;0;7300;5671;1629;
2021-03-14 11:07:00;8991102228053;TEH GELAS BOTOL;1;3000;0;3000;1922;1078;
2021-03-14 11:07:00;HT;HOT-HOT;2;500;0;1000;700;300;
2021-03-14 11:07:00;COKLAT;COKLAT COIN;1;500;0;500;400;100;
2021-03-14 11:07:00;8998989500166;GUDANG GARAM MERAH BESAR 16KS;2;17000;0;34000;30600;3400;
2021-03-14 11:07:00;8992761139018;ADES 600ML;1;3500;0;3500;2292;1208;
2021-03-14 11:07:00;8995333032113;TERIGU GATOT KACA 1 KG;1;8500;0;8500;8012;488;
2021-03-14 11:07:00;8998989300261;GUDANG GARAM SURYA 12 FILTER;1;18000;0;18000;16450;1550;
2021-03-14 11:35:41;8992761139018;ADES 600ML;1;3500;0;3500;2292;1208;
2021-03-14 11:35:41;8992761145033;FANTA STRAW PET 250ML;1;3500;0;3500;2417;1083;
2021-03-14 13:17:16;8996001600146;TEH PUCUK HARUM 350ML;3;3000;0;9000;6942;2058;
2021-03-14 13:26:38;GL;GULA 1 LITER;1;11500;0;11500;10500;1000;
2021-03-14 13:26:38;8992759120264;LARISST 220;1;10000;0;10000;9200;800;
2021-03-14 15:17:19;8991111112206;C&C DEEP ACTION CLEANSER 50G;1;14000;0;14000;12900;1100;
2021-03-14 15:45:38;8993176110081;MINYAK KAYU PUTIH 30ML;1;12000;0;12000;9091;2909;
2021-03-14 15:45:38;6907992823591;JD STRAW MILKSHAKE;1;5000;0;5000;4300;700;
2021-03-14 15:45:38;8996001301142;ROMA KELAPA;1;8000;0;8000;6628;1372;
2021-03-14 15:45:38;8997013790108;BIMURA KACANG TELUR 25G;2;1000;0;2000;1750;250;
2021-03-14 16:28:53;8998866202725;MILKU COKLAT PREMIUM 200ML;1;3000;0;3000;2375;625;
2021-03-14 16:28:53;PRG;PARAGO;4;500;0;2000;1600;400;
2021-03-14 16:31:03;GL;GULA 1 LITER;1;11500;0;11500;10500;1000;
2021-03-14 16:31:03;8998009020520;BUAVITA MINI GUAVA 125ML;2;6000;0;12000;10500;1500;
2021-03-14 17:44:43;8992959971093;SFX COMFORT SLIME 6;2;8500;0;17000;15596;1404;
2021-03-14 18:14:31;8991102281430;PERMEN MINTZ DUOMINT;1;4500;0;4500;4000;500;
2021-03-14 18:14:31;6907992823850;JD CHOCO CIRLE;1;5500;0;5500;4700;800;
2021-03-14 18:20:47;8995333000822;TERIGU KOMPAS SOFT 500GR;1;5500;0;5500;4967;533;
2021-03-14 18:20:47;8998866608046;KECAP MANIS SEDAAP POUCH 225ML;1;8300;0;8300;7375;925;
2021-03-14 18:43:22;8992959953044;SWEETY BRONZE XL1;6;2500;0;15000;13500;1500;
2021-03-14 18:43:22;8992753102303;BKM SCT CKLT 40G;1;7500;0;7500;6900;600;
2021-03-14 20:02:26;8998989300261;GUDANG GARAM SURYA 12 FILTER;1;18000;0;18000;16450;1550;
2021-03-14 20:22:01;8992761145033;FANTA STRAW PET 250ML;2;3500;0;7000;4834;2166;
2021-03-14 20:23:00;8996001600641;TORA CAPPUCINO;2;3500;0;7000;5500;1500;
2021-03-14 20:23:00;8992761166212;FRESTEA APPLE 350ML;1;4500;0;4500;3000;1500;
2021-03-14 20:23:00;HT;HOT-HOT;1;500;0;500;350;150;
2021-03-14 20:23:00;8851019210193;POCKY CHOCO BANANA 47G;1;7300;0;7300;5671;1629;
2021-03-14 20:35:11;8995333032113;TERIGU GATOT KACA 1 KG;1;8500;0;8500;8012;488;
2021-03-14 20:35:11;8995333060772;TERIGU GATOT KACA 500GR;1;4500;0;4500;4065;435;
2021-03-14 20:59:09;GL;GULA 1 LITER;1;11500;0;11500;10500;1000;
2021-03-14 20:59:09;8886013213208;FRENCH FREIS 2000;2;5000;0;10000;7500;2500;
2021-03-14 20:59:09;8992628022156;BIMOLI KLASIK TOUCH 1 LT;1;16000;0;16000;14350;1650;
2021-03-14 20:59:09;8998009010569;ULTRA CHO 200;1;5000;0;5000;3830;1170;
2021-03-14 20:59:09;8996001305041;ROMA SANDWICH CKLT;1;7000;0;7000;5000;2000;
2021-03-14 20:59:09;HT;HOT-HOT;1;500;0;500;350;150;
2021-03-14 21:24:20;8998866201452;POTABEE REGULER BBQ BEEF 35GR;1;4800;0;4800;4150;650;
2021-03-14 21:51:47;8998866202060;POTABEE AYAM BAKAR PEDAS 35 GR;1;5000;0;5000;4150;850;
2021-03-14 21:51:47;HT;HOT-HOT;4;500;0;2000;1400;600;
2021-03-14 23:26:34;089686061024;POP MIE MINI SOTO RL;1;3000;0;3000;2702;298;
2021-03-14 23:27:21;089686061079;POP MIE MINI AY BAWANG RL;1;3000;0;3000;2702;298;
2021-03-14 23:27:21;8886057883665;KRATING DAENG;1;6000;0;6000;4286;1714;
2021-03-15 09:38:44;8996001600399;LE MINERAL 1500ML;1;5000;0;5000;4042;958;
2021-03-15 09:38:44;089686041705;INDOMIE GORENG JUMBO;1;3500;0;3500;3143;357;
2021-03-15 09:38:44;089686011036;INDOMIE GORENG PEDAS;1;2700;0;2700;2452;248;
2021-03-15 09:38:44;8851019210117;POCKY CHOCOLATE 47G;1;7300;0;7300;5671;1629;
2021-03-15 09:38:44;8851019015132;POCKY DOUBLE CHOCOLATE 47G;1;7300;0;7300;5671;1629;
2021-03-15 09:38:44;8998989100120;GUDANG GARAM MINI;1;18000;0;18000;16600;1400;
2021-03-15 09:38:44;8991001503114;CHACHA MILK CHOCOLATE 35G;1;5500;0;5500;4900;600;
2021-03-15 09:38:44;8992761139018;ADES 600ML;2;3500;0;7000;4584;2416;
2021-03-15 09:38:44;8998866608558;SOKLIN SOFTERGENT 770G & PIRING;1;18000;0;18000;16055;1945;
2021-03-15 09:38:44;8999999529291;MOLTO PURE SACHET 10ML;1;6000;0;6000;4800;1200;
2021-03-15 09:38:44;8998866692663;SOKLIN FLOORCLENER KUNING 450ML;1;7000;0;7000;6385;615;
2021-03-15 09:38:44;8998866610261;POWDET DAIA SOFTENER BAG 290 GR;1;5000;0;5000;4450;550;
2021-03-15 09:38:44;8999999502003;SARIMURNI RL RB 1,8G;2;1500;0;3000;2414;586;
2021-03-15 09:38:44;GL;GULA 1 LITER;3;11500;0;34500;31500;3000;
2021-03-15 09:38:44;8851019210193;POCKY CHOCO BANANA 47G;1;7300;0;7300;5671;1629;
2021-03-15 09:38:44;8996001600146;TEH PUCUK HARUM 350ML;1;3000;0;3000;2314;686;
2021-03-15 09:38:44;HT;HOT-HOT;2;500;0;1000;700;300;
2021-03-15 09:38:44;COKLAT;COKLAT COIN;2;500;0;1000;800;200;
2021-03-15 09:38:44;8998989500166;GUDANG GARAM MERAH BESAR 16KS;2;17000;0;34000;30600;3400;
2021-03-15 09:38:44;76164217;MARLBORO MERAH;1;30000;0;30000;27700;2300;
2021-03-15 09:38:44;8995333032113;TERIGU GATOT KACA 1 KG;1;8500;0;8500;8012;488;
2021-03-15 09:39:38;8992957220117;COKLAT BERUANG;1;2000;0;2000;1700;300;
2021-03-15 09:39:38;8996001600146;TEH PUCUK HARUM 350ML;1;3000;0;3000;2314;686;
2021-03-15 10:32:30;GL;GULA 1 LITER;1;11500;0;11500;10500;1000;
2021-03-15 11:09:50;8998866202619;MIE SEDAAP KOREAN SPICY SOUP;1;2500;0;2500;1952;548;
2021-03-15 11:09:50;8998866202343;MIE SEDAAP KOREAN SPICY;1;2500;0;2500;2023;477;
2021-03-15 12:01:57;8886030322907;PORSTEX BIRU 500ML;1;15500;0;15500;13000;2500;
2021-03-15 12:01:57;8998866605106;CLING BIRU BTL 440ML;1;8500;0;8500;7600;900;
2021-03-15 12:01:57;8995333000822;TERIGU KOMPAS SOFT 500GR;1;5500;0;5500;4967;533;
2021-03-15 12:01:57;001;PASEO SMART FACIAL SF 250S GT;1;10000;0;10000;9500;500;
2021-03-15 12:01:57;8992628022156;BIMOLI KLASIK TOUCH 1 LT;1;16000;0;16000;14350;1650;
2021-03-15 13:55:00;8998866201964;MINYAK GORENG SABRINA 2L POUCH;1;28000;0;28000;26753;1247;
2021-03-15 15:05:06;GL;GULA 1 LITER;2;11500;0;23000;21000;2000;
2021-03-15 15:07:22;GL;GULA 1 LITER;1;11500;0;11500;10500;1000;
2021-03-15 15:07:22;RT 1000;ROTI 1000;1;1000;0;1000;750;250;
2021-03-15 15:16:56;8999999059781;SUNLIGHT LIME NEW POUCH 210ML;1;5000;0;5000;4300;700;
2021-03-15 15:38:12;8996001600146;TEH PUCUK HARUM 350ML;1;3000;0;3000;2314;686;
2021-03-15 15:38:12;8996001318911;BETTER ISI 4;1;2000;0;2000;1700;300;
2021-03-15 16:02:27;BRS;BERAS BUMN 10KG;1;128000;0;128000;90000;38000;
2021-03-15 16:02:27;GL;GULA 1 LITER;2;11500;0;23000;21000;2000;
2021-03-15 16:02:27;8999999195649;SARI WANGI 25X1.86G;1;6000;0;6000;5050;950;
2021-03-15 16:02:27;8992753100101;BKM FULL CREAM GOLD 370;1;15500;0;15500;14800;700;
2021-03-15 16:10:17;6907992823874;JD CRUNCHY CHOCO BLUEBERRY;1;5500;0;5500;4700;800;
2021-03-15 16:10:17;6907992823591;JD STRAW MILKSHAKE;2;5000;0;10000;8600;1400;
2021-03-15 16:54:15;6907992823843;JD MOCHA CRISPY;1;5000;0;5000;4400;600;
2021-03-15 17:47:12;8998866201841;GOLDA DOLCE LATTE 200ML;1;3000;0;3000;2500;500;
2021-03-15 17:47:12;COKLAT;COKLAT COIN;1;500;0;500;400;100;
2021-03-15 18:03:18;8998866501033;MINYAK GORENG SEDAAP POUCH 2L;1;29000;0;29000;27746;1254;
2021-03-15 18:29:38;8992946511790;SHINZUI 85G;1;5000;0;5000;3475;1525;
2021-03-15 18:30:20;8992696404441;BEAR BRAND 189ML;1;8500;0;8500;7887;613;
2021-03-15 18:30:20;8999908204202;MY BABY MINYAK TELON 60ML;1;15000;0;15000;13545;1455;
2021-03-15 18:34:54;8998866200325;MIE SEDAAP SOTO;2;2500;0;5000;3904;1096;
2021-03-15 20:00:41;8998866106351;ZINC MEN ACTIVE COOL 70ML;1;8500;0;8500;7550;950;
2021-03-15 20:07:05;6901997923072;SILET SEAGULL;1;6000;0;6000;5500;500;
2021-03-15 20:07:05;8991004011906;KOPI BORONG;1;10000;0;10000;8333;1667;
2021-03-15 20:07:05;ABC SPW;BATERAI ABC SPW;1;4500;0;4500;3893;607;
2021-03-15 20:35:16;8995333032113;TERIGU GATOT KACA 1 KG;1;8500;0;8500;8012;488;
2021-03-15 20:35:16;8995333060772;TERIGU GATOT KACA 500GR;1;4500;0;4500;4065;435;
2021-03-15 20:35:16;8991102384841;WFR TANGO LONG CKLT 130G;1;5000;0;5000;3773;1227;
2021-03-15 20:35:16;8998898830125;KKB ENER-G ANGGUR;1;5500;0;5500;4824;676;
2021-03-15 20:35:16;GL;GULA 1 LITER;1;11500;0;11500;10500;1000;
2021-03-15 20:54:06;8999999034702;PONDS MEN ACNE SOLUTION 50G;1;18500;0;18500;17160;1340;
2021-03-15 20:54:06;8998866500708;FLORIDINA ORANGE;1;3000;0;3000;2500;500;
2021-03-15 21:13:33;8992959072202;HN PANTS L 20;1;35000;0;35000;32576;2424;
2021-03-15 21:18:32;GL;GULA 1 LITER;2;11500;0;23000;21000;2000;
2021-03-15 21:18:32;8998866200578;MIE SEDAAP KARI KENTAL;2;2500;0;5000;3904;1096;
2021-03-15 21:35:51;8998866201841;GOLDA DOLCE LATTE 200ML;1;3000;0;3000;2500;500;
2021-03-15 21:35:51;8992761164546;NUTRIBOOST STRAWBERRY 300ML;1;6500;0;6500;5300;1200;
2021-03-15 22:17:12;8999801700030;SUSU FOYU;1;11500;0;11500;10000;1500;
2021-03-15 22:22:14;8998898101409;TOLAK ANGIN SIDOMUNCUL;3;3500;0;10500;8124;2376;
2021-03-15 22:22:14;8997021870014;FRESH CARE CITRUS 10ML;1;12000;0;12000;10000;2000;
2021-03-15 22:22:14;8992696404441;BEAR BRAND 189ML;1;8500;0;8500;7887;613;
2021-03-15 22:22:14;8997009510055;YOU C1000;1;8000;0;8000;4846;3154;
2021-03-15 22:23:44;8997009510055;YOU C1000;1;8000;0;8000;4846;3154;
2021-03-15 22:23:44;8992696404441;BEAR BRAND 189ML;1;8500;0;8500;7887;613;
2021-03-15 22:23:44;8997021870014;FRESH CARE CITRUS 10ML;1;12000;0;12000;10000;2000;
2021-03-15 22:23:44;8998898101409;TOLAK ANGIN SIDOMUNCUL;3;3500;0;10500;8124;2376;
2021-03-15 22:43:10;ARG;ARGUS 220ML;1;14500;0;14500;12500;2000;
2021-03-15 22:43:10;HT;HOT-HOT;1;500;0;500;350;150;
2021-03-15 22:58:11;8998989110167;SURYA GUDANG GARAM 16 FILTER;1;24000;0;24000;22100;1900;
2021-03-15 22:58:11;8998989300391;SURYA PRO PUTIH;1;20000;0;20000;18600;1400;
2021-03-16 10:32:40;8995333032113;TERIGU GATOT KACA 1 KG;1;8500;0;8500;8012;488;
2021-03-16 10:32:40;8995333060772;TERIGU GATOT KACA 500GR;1;4500;0;4500;4065;435;
2021-03-16 10:32:40;8999999502409;ROYCO FDS BEEF 9G;2;500;0;1000;750;250;
2021-03-16 10:32:40;8997025914059;HATARI SEE HONG;1;5000;0;5000;4800;200;
2021-03-16 10:32:40;8998989300261;GUDANG GARAM SURYA 12 FILTER;1;18000;0;18000;16450;1550;
2021-03-16 10:32:40;8998866608008;KECAP MANIS SEDAAP BOTOL 135 ML;1;6300;0;6300;5615;685;
2021-03-16 10:32:40;8995333060703;TERIGU KOMPAS 1KG;1;10500;0;10500;9816;684;
2021-03-16 10:32:40;8992761166038;MMP ORANGE 300ML;1;5000;0;5000;3750;1250;
2021-03-16 10:35:56;711844610095;LARISSA UDANG 500 GR;1;11000;0;11000;9790;1210;
2021-03-16 10:52:46;711844610095;LARISSA UDANG 500 GR;2;11000;0;22000;19580;2420;
2021-03-16 10:52:46;8998866201933;MINYAK GORENG SEDAAP 5 L;1;72000;0;72000;70230;1770;
2021-03-16 11:05:01;8991188943062;SASA 250G;1;10000;0;10000;8000;2000;
2021-03-16 11:05:01;8991002105409;KOPI KAPAL API;1;20000;0;20000;18888;1112;
2021-03-16 11:05:01;8998989300261;GUDANG GARAM SURYA 12 FILTER;1;18000;0;18000;16450;1550;
2021-03-16 11:50:49;6907992823676;JD PEACH;1;2000;0;2000;1700;300;
2021-03-16 11:52:22;8999999502409;ROYCO FDS BEEF 9G;2;500;0;1000;750;250;
2021-03-16 11:52:22;089686021141;INTER MIE SOTO;6;1000;0;6000;5124;876;
2021-03-16 11:52:22;8998866500708;FLORIDINA ORANGE;1;3000;0;3000;2500;500;
2021-03-16 11:52:22;8996001600146;TEH PUCUK HARUM 350ML;1;3000;0;3000;2314;686;
2021-03-16 11:52:22;6907992823874;JD CRUNCHY CHOCO BLUEBERRY;1;5500;0;5500;4700;800;
2021-03-16 12:21:45;8998866201841;GOLDA DOLCE LATTE 200ML;1;3000;0;3000;2500;500;
2021-03-16 12:32:20;8993007003063;ENAAK 500G;1;11000;0;11000;9625;1375;
2021-03-16 12:51:55;8993007003063;ENAAK 500G;1;11000;0;11000;9625;1375;
2021-03-16 12:52:07;8998866500708;FLORIDINA ORANGE;1;3000;0;3000;2500;500;
2021-03-16 12:57:19;8996001600375;LE MINERAL 330ML;2;2000;0;4000;2834;1166;
2021-03-16 12:57:19;8998866500708;FLORIDINA ORANGE;1;3000;0;3000;2500;500;
2021-03-16 12:57:19;8994834006128;TOCTIC PEDAS;2;2000;0;4000;3400;600;
2021-03-16 12:57:19;COKLAT;COKLAT COIN;1;500;0;500;400;100;
2021-03-16 14:48:36;GL;GULA 1 LITER;1;11500;0;11500;10500;1000;
2021-03-16 14:48:36;RT 1000;ROTI 1000;2;1000;0;2000;1500;500;
2021-03-16 15:54:25;089686821086;ICHI OCHA MELATI;1;3000;0;3000;2250;750;
2021-03-16 15:54:25;8992761139018;ADES 600ML;1;3500;0;3500;2292;1208;
2021-03-16 15:54:25;RT 1000;ROTI 1000;1;1000;0;1000;750;250;
2021-03-16 15:54:25;8993470671752;JOGER STICK DUO KACANG;2;1000;0;2000;1700;300;
2021-03-16 15:54:25;8997009510055;YOU C1000;1;8000;0;8000;4846;3154;
2021-03-16 16:11:25;GL;GULA 1 LITER;4;11500;0;46000;42000;4000;
2021-03-16 16:11:25;8998866501033;MINYAK GORENG SEDAAP POUCH 2L;1;29000;0;29000;27746;1254;
2021-03-16 16:31:08;8992628010139;BIMOLI 5L;1;75000;0;75000;72100;2900;
2021-03-16 16:34:42;8998866202619;MIE SEDAAP KOREAN SPICY SOUP;1;2500;0;2500;1952;548;
2021-03-16 16:34:42;8992761145026;SPRITE PET 250ML;1;3500;0;3500;2417;1083;
2021-03-16 16:47:31;089686834253;FREISS MELON;1;16000;0;16000;14200;1800;
2021-03-16 17:38:11;9556040040038;SUSU F&N;1;33000;0;33000;30000;3000;
2021-03-16 17:38:11;8992761139018;ADES 600ML;1;3500;0;3500;2292;1208;
2021-03-16 17:43:10;8998866500135;HERSPROTEX SOFTCARE WINGS;1;5500;0;5500;4820;680;
2021-03-16 17:47:03;8992946511790;SHINZUI 85G;1;5000;0;5000;3475;1525;
2021-03-16 17:47:03;8992959953181;SWEETY BRONZE L30+2;1;55000;0;55000;53410;1590;
2021-03-16 17:47:03;8998866612173;SOKLIN SOFTERGENT 770G & PIRING;1;18000;0;18000;16055;1945;
2021-03-16 17:47:03;8998866200301;MIE SEDAAP GORENG;1;2500;0;2500;2023;477;
2021-03-16 17:47:03;8998866202619;MIE SEDAAP KOREAN SPICY SOUP;1;2500;0;2500;1952;548;
2021-03-16 17:47:03;8998866202343;MIE SEDAAP KOREAN SPICY;2;2500;0;5000;4046;954;
2021-03-16 17:47:03;8992702000063;INDOMILK COKLAT 370G;1;10000;0;10000;9020;980;
2021-03-16 17:47:03;089686400816;SAMBAL EXTRA PEDAS 135ML;1;5500;0;5500;4616;884;
2021-03-16 17:47:03;8997009510055;YOU C1000;1;8000;0;8000;4846;3154;
2021-03-16 19:05:18;8992696523081;MILO UHT 110ML;1;2500;0;2500;1962;538;
2021-03-16 19:05:18;8998989500166;GUDANG GARAM MERAH BESAR 16KS;2;17000;0;34000;30600;3400;
2021-03-16 19:05:18;8999999031602;SARI MURNI 20X1.6G;1;6000;0;6000;5400;600;
2021-03-16 19:08:50;8998866202404;NOODLE SEDAAP MIE KOREAN SPICY CHICKEN CUP;1;5000;0;5000;3917;1083;
2021-03-16 19:08:50;8998866200844;NOODLE SEDAAP MIE KARI SPESIAL CUP 81 GR;1;4500;0;4500;3650;850;
2021-03-16 19:08:50;8992761139018;ADES 600ML;1;3500;0;3500;2292;1208;
2021-03-16 19:43:17;8994867000179;ROKOK PENA MILD 16;1;14500;0;14500;13000;1500;
2021-03-16 19:45:05;8991102987639;WFR TANGO LONG VNL 130G;1;5000;0;5000;3773;1227;
2021-03-16 19:45:05;8996001355237;SUPER STAR;1;11000;0;11000;9900;1100;
2021-03-16 19:45:05;8991002103764;GOOD DAY CPUCINO 10X25G;2;1500;0;3000;2790;210;
2021-03-16 19:45:05;SNTN;SANTAN BUBUK;2;2500;0;5000;3000;2000;
2021-03-16 19:47:53;8999999710866;PEPSODENT 123 HERBAL 190G;1;18000;0;18000;17500;500;
2021-03-16 19:47:53;8991102384841;WFR TANGO LONG CKLT 130G;1;5000;0;5000;3773;1227;
2021-03-16 19:50:06;8998866613262;SUKSESMIE SOTO 111 GR;1;3500;0;3500;2770;730;
2021-03-16 19:50:06;8992752112013;MIZONE;1;5000;0;5000;3800;1200;
2021-03-16 19:50:06;8886013213208;FRENCH FREIS 2000;1;5000;0;5000;3750;1250;
2021-03-16 19:50:06;6907992824963;JD MILKY CHOCOLATE;1;3000;0;3000;2600;400;
2021-03-16 19:50:06;8992761145026;SPRITE PET 250ML;1;3500;0;3500;2417;1083;
2021-03-16 19:50:06;8998009010590;ULTRA CHO 125;1;3000;0;3000;2428;572;
2021-03-16 19:50:06;8993470671752;JOGER STICK DUO KACANG;2;1000;0;2000;1700;300;
2021-03-16 19:50:06;TG;TEH GELAS;1;1000;0;1000;729;271;
2021-03-16 19:50:06;HT;HOT-HOT;1;500;0;500;350;150;
2021-03-16 19:50:06;COKLAT;COKLAT COIN;2;500;0;1000;800;200;
2021-03-16 21:01:49;6907992823935;JD SWEETCORN;4;3500;0;14000;12000;2000;
2021-03-16 21:06:05;8992959953136;SWEETY BRONZE L20;1;40000;0;40000;36770;3230;
2021-03-16 21:06:05;8992957220117;COKLAT BERUANG;1;2000;0;2000;1700;300;
2021-03-16 21:06:05;8992957220025;GOLDEN CITY MINI;1;3000;0;3000;2500;500;
2021-03-16 21:19:46;6907992823904;JD CRUNCHY CHOCOLATE VAN;1;8000;0;8000;6800;1200;
2021-03-16 21:19:46;6907992823935;JD SWEETCORN;3;3500;0;10500;9000;1500;
2021-03-16 21:19:46;6907992825076;JD WATERMELON APPLE;1;2000;0;2000;1700;300;
2021-03-16 21:19:46;6907992823966;JD BLUEBERRY;3;3500;0;10500;9000;1500;
2021-03-16 21:57:30;8998866501026;MINYAK GORENG SEDAAP POUCH 1 L;1;15500;0;15500;14110;1390;
2021-03-16 22:22:18;GL;GULA 1 LITER;2;11500;0;23000;21000;2000;
2021-03-17 09:30:32;089686043204;INDOMIE MIE ACEH;1;2700;0;2700;2452;248;
2021-03-17 09:30:32;8999999059323;LIFEBOUY LEMONFRESH DG 75G;1;3000;0;3000;2500;500;
2021-03-17 09:30:32;8996001600146;TEH PUCUK HARUM 350ML;1;3000;0;3000;2314;686;
2021-03-17 10:11:37;8992759120264;LARISST 220;5;10000;0;50000;46000;4000;
2021-03-17 10:11:37;8999999008475;SUNLIGHT LIME NEW REF 1600ML;1;33000;0;33000;29800;3200;
2021-03-17 10:11:37;8999999059781;SUNLIGHT LIME NEW POUCH 210ML;1;5000;0;5000;4300;700;
2021-03-17 12:11:33;8992761145033;FANTA STRAW PET 250ML;1;3500;0;3500;2417;1083;
2021-03-17 12:40:00;8998866500708;FLORIDINA ORANGE;1;3000;0;3000;2500;500;
2021-03-17 15:30:39;8996001301142;ROMA KELAPA;1;8000;0;8000;6628;1372;
2021-03-17 15:30:39;8996001312353;MALKIST KELAPA KOPYOR;1;6700;0;6700;5400;1300;
2021-03-17 15:30:39;8996001350423;ZUPER KEJU;1;9200;0;9200;8360;840;
2021-03-17 15:33:48;6907992823935;JD SWEETCORN;1;3500;0;3500;3000;500;
2021-03-17 15:33:48;8996001600375;LE MINERAL 330ML;3;2000;0;6000;4251;1749;
2021-03-17 15:33:48;8886057883665;KRATING DAENG;1;6000;0;6000;4286;1714;
2021-03-17 15:33:48;8992388101092;NU GREEN TE HONEY 330ML;1;3500;0;3500;2854;646;
2021-03-17 15:33:48;8998866201483;POTABEE REGULER GRILLED SEAWEED 35GR;1;5000;0;5000;4150;850;
2021-03-17 15:33:48;8886013213208;FRENCH FREIS 2000;1;5000;0;5000;3750;1250;
2021-03-17 15:33:48;SF TAWAR PND;SAFFANAH TAWAR PANDAN;1;9000;0;9000;9500;-500;
2021-03-17 15:47:46;8998009040023;TEH KOTAK;3;5000;0;15000;8481;6519;
2021-03-17 15:47:46;8997028590014;ARGUS 220ML;12;500;0;6000;3624;2376;
2021-03-17 16:01:03;8992761147143;SPRITE WATERLYMON 425ML;1;5500;0;5500;4300;1200;
2021-03-17 16:17:50;8998009040023;TEH KOTAK;1;5000;0;5000;2827;2173;
2021-03-17 16:23:48;8999909096004;SAMPOERNA 16 FILTER;1;24000;0;24000;23000;1000;
2021-03-17 16:23:48;8992761111540;FANTA STRAWBERY SLIM CAM 250ML;1;5000;0;5000;3750;1250;
2021-03-17 16:23:48;SF BOX;SAFFANAH ROTI BOX;1;12000;0;12000;10500;1500;
2021-03-17 17:34:51;8996001318911;BETTER ISI 4;1;2000;0;2000;1700;300;
2021-03-17 18:11:39;SF TAWAR ORI;SAFFANAH TAWAR ORI;1;8500;0;8500;9000;-500;
2021-03-17 18:11:39;8991102385060;TANGO WAFFLE CHOX;1;8000;0;8000;6212;1788;
2021-03-17 18:44:54;YP;YUPI;4;250;0;1000;832;168;
2021-03-17 18:44:54;KJ;KINDER JOY;2;2000;0;4000;3166;834;
2021-03-17 18:59:21;GL;GULA 1 LITER;1;11500;0;11500;10500;1000;
2021-03-17 18:59:21;8999999195649;SARI WANGI 25X1.86G;1;6000;0;6000;5050;950;
2021-03-17 18:59:21;8996001600399;LE MINERAL 1500ML;1;5000;0;5000;4042;958;
2021-03-17 20:18:53;8992775312469;GERY SALUT COKELAT;1;11000;0;11000;9983;1017;
2021-03-17 20:18:53;089686017748;SARIMIE GORENG ISI 2;1;3500;0;3500;3120;380;
2021-03-17 20:18:53;089686041705;INDOMIE GORENG JUMBO;1;3500;0;3500;3143;357;
2021-03-17 20:18:53;089686010107;INDOMIE KALDU AYAM;1;2500;0;2500;2150;350;
2021-03-17 20:41:48;GL;GULA 1 LITER;3;11500;0;34500;31500;3000;
2021-03-17 20:41:48;8996001312445;MALKIST CAPPUCINO;1;6500;0;6500;5400;1100;
2021-03-17 20:41:48;8996001600269;LE MINERAL 600ML;1;3000;0;3000;1688;1312;
2021-03-17 20:41:48;089686010107;INDOMIE KALDU AYAM;2;2500;0;5000;4300;700;
2021-03-17 20:41:48;089686010343;INDOMIE SOTO MIE;2;2600;0;5200;4734;466;
2021-03-17 20:41:48;8999999195656;SARI WANGI 50X1.85;1;10000;0;10000;8700;1300;
2021-03-17 21:33:45;8995333032113;TERIGU GATOT KACA 1 KG;1;8500;0;8500;8012;488;
2021-03-17 21:33:45;8995333060772;TERIGU GATOT KACA 500GR;1;4500;0;4500;4065;435;
2021-03-17 21:33:45;8999999195649;SARI WANGI 25X1.86G;1;6000;0;6000;5050;950;
2021-03-17 21:33:45;8998866202343;MIE SEDAAP KOREAN SPICY;2;2500;0;5000;4046;954;
2021-03-17 21:33:45;089686010824;INDOMIE GORENG SPESIAL;1;2700;0;2700;2452;248;
2021-03-17 21:33:45;8998866108317;EMERON HJB ANTDNDF 10ML;1;5000;0;5000;4185;815;
2021-03-17 21:33:45;8998866608718;DAIA SOFTENER PINK;1;5000;0;5000;4450;550;
2021-03-17 21:33:45;8934868015024;REXONA DEO LOTION FREE SPIRIT 9G;2;4500;0;9000;7800;1200;
2021-03-17 21:33:45;8997021870151;FRESH CARE STRONG 110ML;1;12000;0;12000;10000;2000;
2021-03-17 21:43:26;SF BOX;SAFFANAH ROTI BOX;13;12000;0;156000;136500;19500;
2021-03-17 21:43:26;ARG;ARGUS 220ML;1;14500;0;14500;12500;2000;
2021-03-17 21:49:39;SF SOSIS;SAFFANAH ROTI SOSIS;1;6000;0;6000;5500;500;
2021-03-17 22:05:36;8998866200882;SUKSESMIE GORENG AYAM KRMS 133GR;1;3500;0;3500;3000;500;
2021-03-17 22:05:36;8998866613262;SUKSESMIE SOTO 111 GR;1;3500;0;3500;2770;730;
2021-03-17 22:10:25;TG MARKISA;TEH GELAS MARKISA;1;2000;0;2000;1178;822;
2021-03-17 22:10:25;YP;YUPI;6;250;0;1500;1248;252;
2021-03-17 22:10:25;MARS;MARSHMELLOW;3;500;0;1500;1299;201;
2021-03-17 22:12:26;8999999049409;REXONA MEN ICE COOL 45 ML;1;15000;0;15000;13550;1450;
2021-03-17 22:12:26;8998866200844;NOODLE SEDAAP MIE KARI SPESIAL CUP 81 GR;1;4500;0;4500;3650;850;
2021-03-17 22:12:26;8992775311325;GERY SNACK&SEREAL 100G;2;7000;0;14000;11784;2216;
2021-03-17 22:13:46;JGR SHN;JOGER SHINY SACHET;4;500;0;2000;1748;252;
2021-03-17 22:13:46;8993470671752;JOGER STICK DUO KACANG;2;1000;0;2000;1700;300;
2021-03-17 22:13:46;COKLAT;COKLAT COIN;3;500;0;1500;1200;300;
2021-03-17 22:17:16;6907992824963;JD MILKY CHOCOLATE;2;3000;0;6000;5200;800;
2021-03-17 22:41:12;8991102989534;WFR TANGO LONG VNL 24G GTG;5;1000;0;5000;3360;1640;
2021-03-18 09:45:52;8992761122331;FRESTEA APPEL 500ML;1;6500;0;6500;4708;1792;
2021-03-18 09:45:52;089686043273;INDOMIE SAMBAL RICA;1;2700;0;2700;2452;248;
2021-03-18 09:45:52;089686041705;INDOMIE GORENG JUMBO;1;3500;0;3500;3143;357;
2021-03-18 09:56:11;8992628022156;BIMOLI KLASIK TOUCH 1 LT;1;16000;0;16000;14350;1650;
2021-03-18 09:56:11;8850507000094;POLICE BONCHA;2;2000;0;4000;1600;2400;
2021-03-18 09:59:08;8998866608459;POWDET DAIA PUTIH BAG 290GR;1;5000;0;5000;4450;550;
2021-03-18 09:59:08;8999999558086;RINSO MOLTO FERFUME ESSENSE PWD 44G;1;1000;0;1000;805;195;
2021-03-18 09:59:08;8998866201841;GOLDA DOLCE LATTE 200ML;1;3000;0;3000;2500;500;
2021-03-18 09:59:08;8991002103764;GOOD DAY CPUCINO 10X25G;3;1500;0;4500;4185;315;
2021-03-18 10:02:01;YP;YUPI;4;250;0;1000;832;168;
2021-03-18 10:02:01;MARS;MARSHMELLOW;2;500;0;1000;866;134;
2021-03-18 11:13:22;8999908284907;MY BABY MINYAK TELON 90ML;1;25000;0;25000;22700;2300;
2021-03-18 11:30:34;8998866201841;GOLDA DOLCE LATTE 200ML;1;3000;0;3000;2500;500;
2021-03-18 12:47:24;8996001600269;LE MINERAL 600ML;1;3000;0;3000;1688;1312;
2021-03-18 12:47:24;001;PASEO SMART FACIAL SF 250S GT;1;10000;0;10000;9500;500;
2021-03-18 13:07:26;8998989300261;GUDANG GARAM SURYA 12 FILTER;1;18000;0;18000;16450;1550;
2021-03-18 13:07:26;SF TAWAR PND;SAFFANAH TAWAR PANDAN;1;9000;0;9000;9500;-500;
2021-03-18 13:07:26;8998866608046;KECAP MANIS SEDAAP POUCH 225ML;1;8300;0;8300;7375;925;
2021-03-18 13:07:26;8999908284907;MY BABY MINYAK TELON 90ML;1;25000;0;25000;22700;2300;
2021-03-18 13:08:44;8998866201827;JAVANA GULA BATU 350ML;1;3000;0;3000;2150;850;
2021-03-18 13:10:19;SST;SUPERSTAR;1;1000;0;1000;916;84;
2021-03-18 13:10:19;ff;FULLO BLASTO;1;1000;0;1000;995;5;
2021-03-18 13:34:05;8996001318430;BETTER 1000;3;1000;0;3000;2460;540;
2021-03-18 13:56:03;8998866608718;DAIA SOFTENER PINK;1;5000;0;5000;4450;550;
2021-03-18 13:56:03;8850507000094;POLICE BONCHA;1;2000;0;2000;800;1200;
2021-03-18 13:56:03;MARS;MARSHMELLOW;1;500;0;500;433;67;
2021-03-18 13:56:03;JGR SHN;JOGER SHINY SACHET;1;500;0;500;437;63;
2021-03-18 14:09:49;8997013790108;BIMURA KACANG TELUR 25G;2;1000;0;2000;1750;250;
2021-03-18 14:09:49;8999999524524;MOLTO EDP PINK LUXURY ROSE 800ML;1;29200;0;29200;26600;2600;
2021-03-18 14:57:39;8996001301142;ROMA KELAPA;1;8000;0;8000;6628;1372;
2021-03-18 14:57:39;8996001304129;SLAI OLAI STROBERI;1;12000;0;12000;9900;2100;
2021-03-18 14:57:39;GL;GULA 1 LITER;2;11500;0;23000;21000;2000;
2021-03-18 15:43:10;8998989300261;GUDANG GARAM SURYA 12 FILTER;1;18000;0;18000;16450;1550;
2021-03-18 15:43:59;PRG;PARAGO;4;500;0;2000;1600;400;
2021-03-18 17:43:30;8991102022347;SIKAT GIGI FORMULA RIPPLE;1;5000;0;5000;4583;417;
2021-03-18 17:43:30;8997025911058;HATARI SHP KELAPA;1;5000;0;5000;4800;200;
2021-03-18 17:43:30;8996001305041;ROMA SANDWICH CKLT;1;7000;0;7000;5000;2000;
2021-03-18 18:53:53;YP;YUPI;4;250;0;1000;832;168;
2021-03-18 19:20:57;8998866501033;MINYAK GORENG SEDAAP POUCH 2L;1;29000;0;29000;27746;1254;
2021-03-18 19:26:52;8998866202619;MIE SEDAAP KOREAN SPICY SOUP;1;2500;0;2500;1952;548;
2021-03-18 19:26:59;HT;HOT-HOT;1;500;0;500;350;150;
2021-03-18 20:08:03;8992761145033;FANTA STRAW PET 250ML;1;3500;0;3500;2417;1083;
2021-03-18 20:08:37;8991102022347;SIKAT GIGI FORMULA RIPPLE;1;5000;0;5000;4583;417;
2021-03-18 21:20:58;8993989311279;CLAS MILD 12;1;17000;0;17000;15700;1300;
2021-03-18 22:03:41;SF KEMASAN;SAFFANAH ROTI KEMASAN;1;3500;0;3500;3000;500;
2021-03-18 22:03:41;SF SOSIS;SAFFANAH ROTI SOSIS;1;6000;0;6000;5500;500;
2021-03-18 22:03:41;YP;YUPI;4;250;0;1000;832;168;
2021-03-19 10:52:44;8998989110167;SURYA GUDANG GARAM 16 FILTER;1;24000;0;24000;22100;1900;
2021-03-19 10:52:44;8999909096004;SAMPOERNA 16 FILTER;1;24000;0;24000;23000;1000;
2021-03-19 10:52:44;8999999192150;ROYCO FDS CHICKEN 100GR;1;5000;0;5000;4300;700;
2021-03-19 10:52:44;8998866202299;KECAP MANIS SEDAAP SPC REFILL 220ML;1;9500;0;9500;8500;1000;
2021-03-19 10:57:10;8995333032113;TERIGU GATOT KACA 1 KG;1;8500;0;8500;8012;488;
2021-03-19 10:57:10;8995333060772;TERIGU GATOT KACA 500GR;1;4500;0;4500;4065;435;
2021-03-19 10:57:10;8997012321204;MAXX BUMBU BALADO;1;5000;0;5000;4100;900;
2021-03-19 10:57:10;8999999502409;ROYCO FDS BEEF 9G;2;500;0;1000;750;250;
2021-03-19 10:57:10;RT 1000;ROTI 1000;1;1000;0;1000;750;250;
2021-03-19 10:57:10;8996001355237;SUPER STAR;1;11000;0;11000;9900;1100;
2021-03-19 10:57:10;8991102380805;FULLO  CKL PCK 8G;1;10000;0;10000;9000;1000;
2021-03-19 10:57:10;COKLAT;COKLAT COIN;8;500;0;4000;3200;800;
2021-03-19 10:57:10;JGR SHN;JOGER SHINY SACHET;8;500;0;4000;3496;504;
2021-03-19 10:57:10;SNTN;SANTAN BUBUK;1;2500;0;2500;1500;1000;
2021-03-19 11:11:21;6907992823959;JD HAWTHORN BERRY;1;2000;0;2000;1700;300;
2021-03-19 11:11:21;6907992823966;JD BLUEBERRY;1;3500;0;3500;3000;500;
2021-03-19 11:11:21;089686021219;INTER MIE GORENG;1;1000;0;1000;885;115;
2021-03-19 11:11:21;8998866202244;EKOMIE BUMBU KALDU AYAM;1;1000;0;1000;860;140;
2021-03-19 12:24:55;8994834005923;SPIX 1000;1;1000;0;1000;850;150;
2021-03-19 12:24:55;8991002103764;GOOD DAY CPUCINO 10X25G;1;1500;0;1500;1395;105;
2021-03-19 12:24:55;6907992825076;JD WATERMELON APPLE;1;2000;0;2000;1700;300;
2021-03-19 12:24:55;8993379200886;SABUN HARMONY ORANGE 70G;1;2000;0;2000;1652;348;
2021-03-19 13:12:08;8992761145026;SPRITE PET 250ML;1;3500;0;3500;2417;1083;
2021-03-19 13:12:08;8994834003752;TICTIC;1;2000;0;2000;1700;300;
2021-03-19 13:35:33;SS;SUPER SNAPS;1;1500;0;1500;1333;167;
2021-03-19 13:35:33;PRG;PARAGO;1;500;0;500;400;100;
2021-03-19 13:42:56;8994867007161;ROKOK PENA GOLD 20;1;17000;0;17000;15000;2000;
2021-03-19 13:42:56;8998866609043;DAIA SOFTENER GUSSET 565G;1;10000;0;10000;8700;1300;
2021-03-19 14:07:27;8992959953167;SWEETY BRONZE S36;1;48000;0;48000;45682;2318;
2021-03-19 14:07:27;SF SOSIS;SAFFANAH ROTI SOSIS;1;6000;0;6000;5500;500;
2021-03-19 14:38:48;8992775310212;GERY PASTA COKELAT;1;18000;0;18000;16029;1971;
2021-03-19 14:50:26;GL;GULA 1 LITER;1;11500;0;11500;10500;1000;
2021-03-19 16:17:36;8999909982000;SAMPOERNA 12 FILTER;1;18000;0;18000;16200;1800;
2021-03-19 16:17:36;8992761145033;FANTA STRAW PET 250ML;3;3500;0;10500;7251;3249;
2021-03-19 16:56:19;089686010824;INDOMIE GORENG SPESIAL;1;2700;0;2700;2452;248;
2021-03-19 16:56:19;8992696405417;DNCO  SHC 27G;4;3000;0;12000;10588;1412;
2021-03-19 16:56:19;8997025914059;HATARI SEE HONG;1;5000;0;5000;4800;200;
2021-03-19 16:56:19;8992696523081;MILO UHT 110ML;2;2500;0;5000;3924;1076;
2021-03-19 16:56:19;8994834003752;TICTIC;1;2000;0;2000;1700;300;
2021-03-19 16:56:19;8996001305041;ROMA SANDWICH CKLT;1;7000;0;7000;5000;2000;
2021-03-19 16:58:40;8997013790108;BIMURA KACANG TELUR 25G;3;1000;0;3000;2625;375;
2021-03-19 16:58:40;8994834005923;SPIX 1000;2;1000;0;2000;1700;300;
2021-03-19 17:06:15;8998866200882;SUKSESMIE GORENG AYAM KRMS 133GR;3;3500;0;10500;9000;1500;
2021-03-19 17:23:40;8998866602273;HERSPROTEX SOFTCARE MAX;1;3500;0;3500;2950;550;
2021-03-19 17:29:16;8992761147143;SPRITE WATERLYMON 425ML;1;5500;0;5500;4300;1200;
2021-03-19 17:29:16;6907992823904;JD CRUNCHY CHOCOLATE VAN;3;8000;0;24000;20400;3600;
2021-03-19 17:29:16;8998866201483;POTABEE REGULER GRILLED SEAWEED 35GR;1;5000;0;5000;4150;850;
2021-03-19 17:29:16;8998866200813;NOODLE SEDAAP MIE GORENG CUP 85 GR;1;5000;0;5000;3917;1083;
2021-03-19 17:29:16;8998866202664;POTABEE WAGYU BEEF STEAK 68 GR;1;8000;0;8000;7200;800;
2021-03-19 17:29:16;SF TAWAR PND;SAFFANAH TAWAR PANDAN;1;9000;0;9000;9500;-500;
2021-03-19 17:29:16;8998866202312;NOODLE SEDAAP TASTY BAKMI AYAM 129 GR;1;5000;0;5000;4167;833;
2021-03-19 17:33:19;8996001350829;WAFELLO COKLAT;2;17000;0;34000;32000;2000;
2021-03-19 17:33:19;8996001351888;WFR WAFELLO;1;17000;0;17000;15500;1500;
2021-03-19 17:33:19;8998866202237;NOODLE SEDAAP TASTY AYAM GEPREK 124 GR;1;5000;0;5000;4167;833;
2021-03-19 17:33:19;8991102160711;COOKIEZ;1;16000;0;16000;14500;1500;
2021-03-19 17:33:19;8992775001820;CHOCOLATOS WAFER CREAM;1;17500;0;17500;15761;1739;
2021-03-19 17:33:19;8991102308861;FULLO BLASTO;1;16000;0;16000;14545;1455;
2021-03-19 17:37:42;8993470671752;JOGER STICK DUO KACANG;1;28000;0;28000;25500;2500;
2021-03-19 17:37:42;JGRP;JOGER PASTA STICK MOBIL;2;13000;0;26000;23500;2500;
2021-03-19 18:07:05;8994834005923;SPIX 1000;2;1000;0;2000;1700;300;
2021-03-19 18:07:05;8998866500708;FLORIDINA ORANGE;1;3000;0;3000;2500;500;
2021-03-19 18:07:56;8991001121615;SILVERQUEEN NUT;1;15000;0;15000;13200;1800;
2021-03-19 18:23:51;SKT;SIKAT CUCI;1;6000;0;6000;5000;1000;
2021-03-19 18:23:51;8997013790108;BIMURA KACANG TELUR 25G;1;1000;0;1000;875;125;
2021-03-19 19:21:02;8999801700030;SUSU FOYU;1;11500;0;11500;10000;1500;
2021-03-19 19:53:36;8999909982000;SAMPOERNA 12 FILTER;1;18000;0;18000;16200;1800;
2021-03-19 19:53:36;8999999001124;LIFEBUOY MILD CARE REF 250ML;1;15000;0;15000;13550;1450;
2021-03-19 19:55:04;8999908204202;MY BABY MINYAK TELON 60ML;1;15000;0;15000;13545;1455;
2021-03-19 19:55:04;8992959953174;SWEETY BRONZE M34+2;1;58000;0;58000;53182;4818;
2021-03-19 19:55:04;8850007090267;JB BATH MILK 400ML (REFILL);1;24500;0;24500;23390;1110;
2021-03-19 19:55:04;8994834003752;TICTIC;1;2000;0;2000;1700;300;
2021-03-19 19:55:04;8999099920714;SGM 1+ VANILA 900;1;80000;0;80000;78510;1490;
2021-03-19 20:08:40;8991102385060;TANGO WAFFLE CHOX;1;8000;0;8000;6212;1788;
2021-03-19 20:08:40;089686400427;SAMBAL PEDAS 135ML;1;5500;0;5500;4616;884;
2021-03-19 20:08:40;8992959117613;SFX DAUN SIRIH WING 1;3;5000;0;15000;12390;2610;
2021-03-19 20:08:40;8996001301142;ROMA KELAPA;1;8000;0;8000;6628;1372;
2021-03-19 20:08:40;8998866200882;SUKSESMIE GORENG AYAM KRMS 133GR;1;3500;0;3500;3000;500;
2021-03-19 20:08:40;8998866202619;MIE SEDAAP KOREAN SPICY SOUP;1;2500;0;2500;1952;548;
2021-03-19 20:08:40;8998866200325;MIE SEDAAP SOTO;1;2500;0;2500;1952;548;
2021-03-19 20:08:40;8999999048280;SUNSILK SHP RFR ANTI DDRF 9 ML;2;1000;0;2000;18600;-16600;
2021-03-19 20:08:40;8991111111964;C&C FACIAL WASH 50ML;1;12000;0;12000;10870;1130;
2021-03-19 20:36:58;GL;GULA 1 LITER;3;11500;0;34500;31500;3000;
2021-03-19 20:50:54;8998866501026;MINYAK GORENG SEDAAP POUCH 1 L;1;15500;0;15500;14110;1390;
2021-03-19 20:50:54;8992628605151;AMANDA MARGARINE;1;5000;0;5000;3806;1194;
2021-03-19 20:50:54;8995333060772;TERIGU GATOT KACA 500GR;1;4500;0;4500;4065;435;
2021-03-19 20:50:54;8995333032113;TERIGU GATOT KACA 1 KG;1;8500;0;8500;8012;488;
2021-03-19 20:52:12;8992753100101;BKM FULL CREAM GOLD 370;1;15500;0;15500;14800;700;
2021-03-19 20:52:45;8992957220186;COKLAT RUSA;1;2000;0;2000;1700;300;
2021-03-19 21:22:23;8999999195656;SARI WANGI 50X1.85;4;10000;0;40000;34800;5200;
2021-03-19 21:22:23;8999999710873;PEPSODENT ACTION123 HERBAL 120G;4;11400;0;45600;41600;4000;
2021-03-19 21:22:23;8999999059316;LIFEBOUY TS MILDCARE 75G;8;3000;0;24000;20000;4000;
2021-03-19 21:22:23;8999999059309;LIFEBOUY TS TOTAL 10 DG 75G;8;3000;0;24000;20000;4000;
2021-03-19 21:22:23;8999999518998;RINSO MOLTO PERFUME ESSENSE 770GR;4;21300;0;85200;77352;7848;
2021-03-19 21:22:23;8996001301142;ROMA KELAPA;6;8000;0;48000;39768;8232;
2021-03-19 21:22:23;8996001305249;ROMA KELAPA CREAM;2;6800;0;13600;11028;2572;
2021-03-19 21:22:23;8992702000018;INDOMILK 370G;4;10000;0;40000;36080;3920;
2021-03-19 21:22:23;8992753101207;BENDERA KENTAL MANIS 370G;8;11500;0;92000;77600;14400;
2021-03-19 21:22:23;GL;GULA 1 LITER;40;11500;0;460000;420000;40000;
2021-03-19 21:22:23;8998866501026;MINYAK GORENG SEDAAP POUCH 1 L;20;15500;0;310000;282200;27800;
2021-03-19 21:22:23;089686010107;INDOMIE KALDU AYAM;320;2500;0;800000;688000;112000;
2021-03-19 21:22:23;8991102384841;WFR TANGO LONG CKLT 130G;2;5000;0;10000;7546;2454;
2021-03-19 21:22:23;8991102987639;WFR TANGO LONG VNL 130G;1;5000;0;5000;3773;1227;
2021-03-19 21:22:23;8997013790108;BIMURA KACANG TELUR 25G;2;1000;0;2000;1750;250;
2021-03-19 21:26:15;8998866501033;MINYAK GORENG SEDAAP POUCH 2L;1;29000;0;29000;27746;1254;
2021-03-19 22:14:39;SF TAWAR ORI;SAFFANAH TAWAR ORI;2;9000;0;18000;17000;1000;
2021-03-19 22:18:13;8991111101507;JB POWDER BLOSSOM 50G;1;3500;0;3500;3000;500;
2021-03-19 22:18:13;8991004011906;KOPI BORONG;1;10000;0;10000;8333;1667;
2021-03-19 22:18:13;8999999059934;PONDS AGE MIRACLE NIGHT CREAM 10G;1;32000;0;32000;29040;2960;
2021-03-19 22:19:53;8850507001176;HERO RACING;1;12000;0;12000;10600;1400;
2021-03-19 22:58:25;8998989300261;GUDANG GARAM SURYA 12 FILTER;1;18000;0;18000;16450;1550;
2021-03-19 23:01:56;8991102228053;TEH GELAS BOTOL;1;3000;0;3000;1922;1078;
2021-03-19 23:01:56;8994834005923;SPIX 1000;1;1000;0;1000;850;150;
2021-03-19 23:01:56;8886013213208;FRENCH FREIS 2000;1;5000;0;5000;3750;1250;
2021-03-19 23:08:10;8999999519735;PEPSODENT TB BAMBOO SALT;1;13200;0;13200;11990;1210;
2021-03-19 23:08:10;8999999534769;PEPSODENT ACTION123 CHARCOAL 160G;1;16800;0;16800;15345;1455;
2021-03-19 23:08:10;8999999053048;PONDS FACIAL FOAM 100G;1;27000;0;27000;24900;2100;
2021-03-19 23:08:10;8999999559861;AXE DARK POCKET FRAG 17ML;1;10000;0;10000;8000;2000;
2021-03-19 23:08:10;8999999549312;VASELINE SUPERFOOD GREEN TEA 200ML;1;26000;0;26000;23940;2060;
2021-03-19 23:08:10;8999999049669;REXONA MEN RO INVISIBLE DRY 45 ML;1;15000;0;15000;13550;1450;
2021-03-19 23:08:10;8992222054973;GATSBY STYLING POMADE 30GR;1;15000;0;15000;13000;2000;
2021-03-19 23:08:10;8999999567576;LIFEBUOY HAND SANITIZER 100ML;1;19000;0;19000;17600;1400;
2021-03-19 23:12:11;8998866106481;POSH WHISES 150ML;1;19500;0;19500;17500;2000;
2021-03-19 23:12:11;8999999707835;CLOSEUP GREEN 65G;1;7000;0;7000;6000;1000;
2021-03-19 23:12:11;8850007652564;C&C NATURAL BRIGHT 50ML;1;14000;0;14000;12900;1100;
2021-03-19 23:12:11;8999999037765;PEPSODENT WHITE 225G;1;12000;0;12000;10750;1250;
2021-03-19 23:12:11;8999999549305;VASELINE SUPERFOOD CRANBERRY 200ML;1;26000;0;26000;23940;2060;
2021-03-19 23:12:11;4800888141125;AXE DEO BODYSPRAY DARK 150ML;1;20000;0;20000;10615;9385;
2021-03-19 23:39:15;8992761145033;FANTA STRAW PET 250ML;1;3500;0;3500;2417;1083;
2021-03-19 23:39:15;089686017748;SARIMIE GORENG ISI 2;1;3500;0;3500;3120;380;
2021-03-19 23:53:31;8998989300261;GUDANG GARAM SURYA 12 FILTER;1;18000;0;18000;16450;1550;
2021-03-19 23:53:31;8994834005923;SPIX 1000;8;1000;0;8000;6800;1200;
2021-03-22 09:55:30;8998009010569;ULTRA CHO 200;1;5000;0;5000;3830;1170;
2021-03-22 09:55:30;8991001780140;TWISTER CHOCO;1;5000;0;5000;4600;400;
2021-03-22 09:55:30;8996001302323;MALKIST ABON;1;6500;0;6500;4800;1700;
2021-03-22 09:55:30;8998866202237;NOODLE SEDAAP TASTY AYAM GEPREK 124 GR;1;5000;0;5000;4167;833;
2021-03-22 09:55:30;8992775211410;PILUS GARUDA PEDAS;1;5500;0;5500;4713;787;
2021-03-22 09:55:30;8997013790108;BIMURA KACANG TELUR 25G;1;1000;0;1000;875;125;
2021-03-22 09:55:30;089686061024;POP MIE MINI SOTO RL;2;3000;0;6000;5404;596;
2021-03-22 09:55:30;8998866202404;NOODLE SEDAAP MIE KOREAN SPICY CHICKEN CUP;1;5000;0;5000;3917;1083;
2021-03-22 09:55:30;8992696404441;BEAR BRAND 189ML;2;8500;0;17000;15774;1226;
2021-03-22 09:55:30;ff;FULLO BLASTO;6;1000;0;6000;5970;30;
2021-03-22 09:55:30;8993470279651;JOGER CHOCKY BAR;1;1000;0;1000;867;133;
2021-03-22 09:55:30;8994834005923;SPIX 1000;1;1000;0;1000;850;150;
2021-03-22 09:55:30;089686011494;INDOMIE SOTO PADANG;2;2600;0;5200;4634;566;
2021-03-22 09:55:30;089686010343;INDOMIE SOTO MIE;2;2600;0;5200;4734;466;
2021-03-22 09:55:49;GL;GULA 1 LITER;2;11500;0;23000;21000;2000;
2021-03-22 09:59:10;6907992825076;JD WATERMELON APPLE;1;2000;0;2000;1700;300;
2021-03-22 09:59:10;8992775310212;GERY PASTA COKELAT;1;18000;0;18000;16029;1971;
2021-03-22 09:59:10;8997013790108;BIMURA KACANG TELUR 25G;1;1000;0;1000;875;125;
2021-03-22 09:59:10;8996001318430;BETTER 1000;1;1000;0;1000;820;180;
2021-03-22 09:59:10;089686010107;INDOMIE KALDU AYAM;1;2500;0;2500;2150;350;
2021-03-22 09:59:10;8998989100120;GUDANG GARAM MINI;1;18000;0;18000;16600;1400;
2021-03-22 09:59:10;8996001600399;LE MINERAL 1500ML;1;5000;0;5000;4042;958;
2021-03-22 10:05:23;PRG;PARAGO;1;500;0;500;400;100;
2021-03-22 10:05:23;8999999559854;AXE BLACK POCKET FRAG 17ML;1;10000;0;10000;8000;2000;
2021-03-22 10:05:23;8992775712603;MYTEA POCI OOLONG;1;5000;0;5000;4410;590;
2021-03-22 10:05:23;8998989110167;SURYA GUDANG GARAM 16 FILTER;3;24000;0;72000;66300;5700;
2021-03-22 10:05:23;SF SOSIS;SAFFANAH ROTI SOSIS;5;6000;0;30000;27500;2500;
2021-03-22 10:05:23;8992761164546;NUTRIBOOST STRAWBERRY 300ML;2;6500;0;13000;10600;2400;
2021-03-22 10:06:07;8998866201841;GOLDA DOLCE LATTE 200ML;1;3000;0;3000;2500;500;
2021-03-22 10:06:07;bb;BENG-BENG;1;1500;0;1500;1450;50;
2021-03-22 10:06:07;PRG;PARAGO;1;500;0;500;400;100;
2021-03-22 10:08:53;8996001302323;MALKIST ABON;1;6500;0;6500;4800;1700;
2021-03-22 10:08:53;8995333032113;TERIGU GATOT KACA 1 KG;1;8500;0;8500;8012;488;
2021-03-22 10:08:53;8994867007161;ROKOK PENA GOLD 20;1;17000;0;17000;15000;2000;
2021-03-22 10:08:53;8992959971109;SFX COMFORT SLIM 36CM 12+1;1;16500;0;16500;15152;1348;
2021-03-22 10:08:53;8997009510055;YOU C1000;1;8000;0;8000;4846;3154;
2021-03-22 10:08:53;RT 1000;ROTI 1000;1;1000;0;1000;750;250;
2021-03-22 10:08:53;8998009010590;ULTRA CHO 125;3;3000;0;9000;7284;1716;
2021-03-22 10:12:42;8999999059316;LIFEBOUY TS MILDCARE 75G;1;3000;0;3000;2500;500;
2021-03-22 10:31:40;8996001600399;LE MINERAL 1500ML;2;5000;0;10000;8084;1916;
2021-03-22 10:58:40;8997218380074;ICHITAN MILK TEA;1;8000;0;8000;6583;1417;
2021-03-22 10:58:40;8997218380135;ICHITAN GREEN TEA;2;8000;0;16000;13166;2834;
2021-03-22 10:58:40;8992775305164;MALKIST GREEN TEA;1;6500;0;6500;5500;1000;
2021-03-22 10:58:55;TBM;NESTA TBM;1;5000;0;5000;4000;1000;
2021-03-22 14:06:53;8994834005923;SPIX 1000;1;1000;0;1000;850;150;
2021-03-22 14:06:53;GL;GULA 1 LITER;1;11500;0;11500;10500;1000;
2021-03-22 14:06:53;YP;YUPI;4;250;0;1000;832;168;
2021-03-22 14:19:50;8998989300261;GUDANG GARAM SURYA 12 FILTER;1;18000;0;18000;16450;1550;
2021-03-22 15:07:49;8992222052979;GATSBY WATER GLOSS MERAH;1;5000;0;5000;3700;1300;
2021-03-22 15:53:02;ff;FULLO BLASTO;3;1000;0;3000;2985;15;
2021-03-22 15:53:02;8998989500166;GUDANG GARAM MERAH BESAR 16KS;1;17000;0;17000;15300;1700;
2021-03-22 15:53:02;8998989300261;GUDANG GARAM SURYA 12 FILTER;1;18000;0;18000;16450;1550;
2021-03-22 16:17:36;8992761145026;SPRITE PET 250ML;1;3500;0;3500;2417;1083;
2021-03-22 16:17:36;COKLAT;COKLAT COIN;3;500;0;1500;1200;300;
2021-03-22 16:39:47;089686043273;INDOMIE SAMBAL RICA;1;2700;0;2700;2452;248;
2021-03-22 17:28:52;8999999059316;LIFEBOUY TS MILDCARE 75G;1;3000;0;3000;2500;500;
2021-03-22 17:35:07;8998866201964;MINYAK GORENG SABRINA 2L POUCH;1;28000;0;28000;26753;1247;
2021-03-22 17:35:07;8995333060703;TERIGU KOMPAS 1KG;1;10500;0;10500;9816;684;
2021-03-22 17:44:47;8998989110167;SURYA GUDANG GARAM 16 FILTER;1;24000;0;24000;22100;1900;
2021-03-22 17:44:47;8996001301579;MALKIST CKLT KELAPA PACK;1;11000;0;11000;9900;1100;
2021-03-22 17:44:47;8992761145026;SPRITE PET 250ML;2;3500;0;7000;4834;2166;
2021-03-22 17:44:47;RT 1000;ROTI 1000;2;1000;0;2000;1500;500;
2021-03-22 18:18:04;8999999520892;FAIR&LOVELY POWDER CREAM 20 G;1;18500;0;18500;16830;1670;
2021-03-22 18:18:04;089686010343;INDOMIE SOTO MIE;1;2600;0;2600;2367;233;
2021-03-22 18:24:50;089686017748;SARIMIE GORENG ISI 2;1;3500;0;3500;3120;380;
2021-03-22 18:34:01;GL;GULA 1 LITER;1;11500;0;11500;10500;1000;
2021-03-22 18:34:01;089686011036;INDOMIE GORENG PEDAS;2;2700;0;5400;4904;496;
2021-03-22 18:38:29;GL;GULA 1 LITER;1;11500;0;11500;10500;1000;
2021-03-22 18:38:29;089686043051;INDOMIE COTO MAKASSAR;1;2800;0;2800;2525;275;
2021-03-22 18:48:47;MG;MINYAK GOSOK SAFERTABAT;1;28000;0;28000;25000;3000;
2021-03-22 19:43:35;GL;GULA 1 LITER;2;11500;0;23000;21000;2000;
2021-03-22 20:24:26;ff;FULLO BLASTO;3;1000;0;3000;2985;15;
2021-03-22 20:24:26;8998866605816;SOKLIN  SMART COLOR CARE 800 & PIRING;1;20000;0;20000;18100;1900;
2021-03-22 20:24:26;SF TAWAR ORI;SAFFANAH TAWAR ORI;1;9000;0;9000;8500;500;
2021-03-22 20:26:21;8992753102204;BKM COKLAT 370G;1;11300;0;11300;9500;1800;
2021-03-22 20:44:12;8994867007161;ROKOK PENA GOLD 20;1;17000;0;17000;15000;2000;
2021-03-22 21:36:47;8994834005923;SPIX 1000;1;1000;0;1000;850;150;
2021-03-22 21:36:47;POTO;KERUPUK PANJANG;1;5000;0;5000;4000;1000;
2021-03-22 22:34:41;6907992823607;JD CHOCO CAPTAIN;1;5500;0;5500;4700;800;
2021-03-22 22:34:41;8994834006128;TICTIC PEDAS;1;2000;0;2000;1700;300;
2021-03-22 22:35:06;8998989110167;SURYA GUDANG GARAM 16 FILTER;1;24000;0;24000;22100;1900;
2021-03-22 22:36:13;089686043273;INDOMIE SAMBAL RICA;1;2700;0;2700;2452;248;
2021-03-22 22:36:13;8998866202343;MIE SEDAAP KOREAN SPICY;1;2500;0;2500;2023;477;
2021-03-22 22:36:13;8998866200301;MIE SEDAAP GORENG;1;2500;0;2500;2023;477;
2021-03-23 10:13:12;8998009010231;ULTRA CHO 250;1;6000;0;6000;4784;1216;
2021-03-23 10:13:12;SF KEMASAN;SAFFANAH ROTI KEMASAN;2;3500;0;7000;6000;1000;
2021-03-23 12:13:00;8994867000162;ROKOK PUNDIMAS KRETEK16;1;10000;0;10000;8600;1400;
2021-03-23 12:37:23;8996001600269;LE MINERAL 600ML;1;3000;0;3000;1688;1312;
2021-03-23 12:52:13;8998866602273;HERSPROTEX SOFTCARE MAX;1;3500;0;3500;2950;550;
2021-03-23 12:56:36;8998989300261;GUDANG GARAM SURYA 12 FILTER;1;18000;0;18000;16450;1550;
2021-03-23 12:56:45;123124;KOREK BIASA;1;2000;0;2000;1800;200;
2021-03-23 13:10:59;711844610095;LARISSA UDANG 500 GR;2;11000;0;22000;19580;2420;
2021-03-23 13:28:08;8999999538446;SUNSILK SHP BLKSHINE 55 ML3750;1;4500;0;4500;3750;750;
2021-03-23 13:28:08;8998866106542;EMERON LOVELY NAT PINK 200ML;1;6000;0;6000;5075;925;
2021-03-23 14:56:48;MARS;MARSHMELLOW;1;500;0;500;433;67;
2021-03-23 14:56:48;SF BOX;SAFFANAH ROTI BOX;1;12000;0;12000;10500;1500;
2021-03-23 15:14:43;8999999050009;SUNLIGHT LIME NEW POUCH 95ML;1;2000;0;2000;1600;400;
2021-03-23 15:25:23;8991004011906;KOPI BORONG;1;10000;0;10000;8333;1667;
2021-03-23 15:25:23;8999999195656;SARI WANGI 50X1.85;1;10000;0;10000;8700;1300;
2021-03-23 15:25:23;8994834005923;SPIX 1000;3;1000;0;3000;2550;450;
2021-03-23 15:25:23;8999999557447;PEPSODENT ACTION123 SIWAK 110G;1;9000;0;9000;8000;1000;
2021-03-23 15:25:23;8999999502409;ROYCO FDS BEEF 9G;6;500;0;3000;2250;750;
2021-03-23 15:31:32;089686021141;INTER MIE SOTO;1;1000;0;1000;854;146;
2021-03-23 15:55:57;MARS;MARSHMELLOW;2;500;0;1000;866;134;
2021-03-23 15:59:00;8998866500708;FLORIDINA ORANGE;1;3000;0;3000;2500;500;
2021-03-23 16:00:27;089686041705;INDOMIE GORENG JUMBO;1;3500;0;3500;3143;357;
2021-03-23 16:00:27;8996001305041;ROMA SANDWICH CKLT;1;7000;0;7000;5000;2000;
2021-03-23 16:25:47;MARS;MARSHMELLOW;4;500;0;2000;1732;268;
2021-03-23 16:26:48;GL;GULA 1 LITER;3;11500;0;34500;31500;3000;
2021-03-23 16:39:38;8997013790108;BIMURA KACANG TELUR 25G;10;1000;0;10000;8750;1250;
2021-03-23 16:39:38;8992775001042;PILUS GARUDA MI GORENG;1;5500;0;5500;4713;787;
2021-03-23 16:39:38;8992775211410;PILUS GARUDA PEDAS;1;5500;0;5500;4713;787;
2021-03-23 16:39:38;KR;KRESEK;10;100;0;1000;990;10;
2021-03-23 16:40:55;8996001600269;LE MINERAL 600ML;1;3000;0;3000;1688;1312;
2021-03-23 16:40:55;8992761166205;FRESTEA GREEN HONEY 350ML;2;4500;0;9000;6000;3000;
2021-03-23 16:42:10;8991102281416;PERMEN MINTZ PPMINT;1;4500;0;4500;4000;500;
2021-03-23 16:42:10;8996001600269;LE MINERAL 600ML;1;3000;0;3000;1688;1312;
2021-03-23 16:42:10;HT;HOT-HOT;1;500;0;500;350;150;
2021-03-23 17:39:43;8999999559861;AXE DARK POCKET FRAG 17ML;1;10000;0;10000;8000;2000;
2021-03-23 17:43:57;8998989110167;SURYA GUDANG GARAM 16 FILTER;1;24000;0;24000;22100;1900;
2021-03-23 17:43:57;8998866202244;EKOMIE BUMBU KALDU AYAM;1;1000;0;1000;860;140;
2021-03-23 17:43:57;8998866201841;GOLDA DOLCE LATTE 200ML;1;3000;0;3000;2500;500;
2021-03-23 17:45:33;8994834006128;TICTIC PEDAS;1;2000;0;2000;1700;300;
2021-03-23 17:45:33;8999999027049;LIFEBUOY PRWTN RMBT RNTK 9ML;2;1000;0;2000;9000;-7000;
2021-03-23 17:45:33;8992959304235;SFX COMFORT SLIM 29CM 8S;1;8000;0;8000;7387;613;
2021-03-23 17:46:35;8998898337440;TOLAK ANGIN CARE 10ML;1;10000;0;10000;7893;2107;
2021-03-23 17:51:57;8998866202244;EKOMIE BUMBU KALDU AYAM;3;1000;0;3000;2580;420;
2021-03-23 18:40:08;8999999531485;MOLTO EDP PINK ROSE SC 10ML;1;5500;0;5500;4800;700;
2021-03-23 18:40:08;8992696404441;BEAR BRAND 189ML;1;8500;0;8500;7887;613;
2021-03-23 18:40:08;8997009510055;YOU C1000;1;8000;0;8000;4846;3154;
2021-03-23 18:40:08;6907992823652;JD CHOCOLATE MILKSHAKE;1;6000;0;6000;5200;800;
2021-03-23 18:40:08;8998866200301;MIE SEDAAP GORENG;1;2500;0;2500;2023;477;
2021-03-23 19:08:23;8997013790108;BIMURA KACANG TELUR 25G;1;1000;0;1000;875;125;
2021-03-23 19:08:23;8997013790092;BIMURA KERUPUK BAWANG 25G;1;1000;0;1000;874;126;
2021-03-23 19:08:23;8998989300261;GUDANG GARAM SURYA 12 FILTER;1;18000;0;18000;16450;1550;
2021-03-23 19:55:34;8992775310212;GERY PASTA COKELAT;1;18000;0;18000;16029;1971;
2021-03-23 19:59:13;8999909096004;SAMPOERNA 16 FILTER;1;24000;0;24000;23000;1000;
2021-03-23 22:33:02;8998989300261;GUDANG GARAM SURYA 12 FILTER;1;18000;0;18000;16450;1550;
2021-03-24 10:06:15;8999999549480;SUNLIGHT LIME CRM SCH 270G;1;5000;0;5000;4500;500;
2021-03-24 10:06:15;8999999027261;LIFEBUOY BW LEMONFRESH LD REFF 450 ML;1;25000;0;25000;22110;2890;
2021-03-24 10:06:15;8991001503114;CHACHA MILK CHOCOLATE 35G;1;5500;0;5500;4900;600;
2021-03-24 10:06:15;8998866202244;EKOMIE BUMBU KALDU AYAM;3;1000;0;3000;2580;420;
2021-03-24 10:06:15;SF TAWAR ORI;SAFFANAH TAWAR ORI;1;9000;0;9000;8500;500;
2021-03-24 10:06:15;8992753031900;BKM SCT PUTIH 40G;1;7500;0;7500;6900;600;
2021-03-24 10:06:15;8994834003752;TICTIC;2;2000;0;4000;3400;600;
2021-03-24 10:06:37;YP;YUPI;4;250;0;1000;832;168;
2021-03-24 10:06:37;8996001318430;BETTER 1000;1;1000;0;1000;820;180;
2021-03-24 10:15:10;11;PASEO SMART FHSTD PERF 6P 12S;1;5000;0;5000;4264;736;
2021-03-24 10:31:40;8996001600269;LE MINERAL 600ML;1;3000;0;3000;1688;1312;
2021-03-24 10:54:48;8993072254056;MELROSE COTTON BUDS KCL;1;3000;0;3000;2450;550;
2021-03-24 11:40:16;8998866201841;GOLDA DOLCE LATTE 200ML;2;3000;0;6000;5000;1000;
2021-03-24 12:04:10;8996001600399;LE MINERAL 1500ML;1;5000;0;5000;4042;958;
2021-03-24 12:22:25;8998989300261;GUDANG GARAM SURYA 12 FILTER;1;18000;0;18000;16450;1550;
2021-03-24 12:22:25;8994867000162;ROKOK PUNDIMAS KRETEK16;1;10000;0;10000;8600;1400;
2021-03-24 12:33:21;8998866610087;JAVANA ORIGINAL 350ML;1;3000;0;3000;2150;850;
2021-03-24 12:33:21;8994834003752;TICTIC;1;2000;0;2000;1700;300;
2021-03-24 14:24:05;ARG;ARGUS 220ML;3;14500;0;43500;37500;6000;
2021-03-24 16:00:38;6907992823874;JD CRUNCHY CHOCO BLUEBERRY;1;5500;0;5500;4700;800;
2021-03-24 16:00:38;6907992823867;JD CRUNCHY CHOCOLATE MALT;1;5500;0;5500;4700;800;
2021-03-24 17:53:47;8996001600375;LE MINERAL 330ML;1;2000;0;2000;1417;583;
2021-03-24 17:57:33;6907992823669;JD MILKY STRAW;1;3000;0;3000;2600;400;
2021-03-24 17:57:33;6907992823935;JD SWEETCORN;1;3500;0;3500;3000;500;
2021-03-24 17:57:33;8850507000094;POLICE BONCHA;1;2000;0;2000;800;1200;
2021-03-24 17:57:33;YP;YUPI;2;250;0;500;416;84;
2021-03-24 18:25:30;8999999528218;CITRA NATURAL WHITE BTL 220ML;1;17000;0;17000;15450;1550;
2021-03-24 18:46:01;8992761139018;ADES 600ML;2;3500;0;7000;4584;2416;
2021-03-24 18:46:01;089686043273;INDOMIE SAMBAL RICA;1;2700;0;2700;2452;248;
2021-03-24 19:12:40;8999999706111;PEPSODENT WHITE 25G;1;2000;0;2000;1450;550;
2021-03-24 19:12:40;8998866103985;CIPT SIKP;1;3000;0;3000;2552;448;
2021-03-24 19:12:40;8999999559557;LUX BW MAGICAL ORCHID 85ML;1;5000;0;5000;4000;1000;
2021-03-24 19:12:40;8992761166052;FRESTEA MELATI 350ML;1;4500;0;4500;3000;1500;
2021-03-24 19:12:40;JGR SHN;JOGER SHINY SACHET;1;500;0;500;437;63;
2021-03-24 20:05:11;8998866501033;MINYAK GORENG SEDAAP POUCH 2L;1;29000;0;29000;27746;1254;
2021-03-24 20:31:50;8999801700030;SUSU FOYU;1;11500;0;11500;10000;1500;
2021-03-24 20:41:55;8992959971093;SFX COMFORT SLIME 6;1;8500;0;8500;7798;702;
2021-03-24 20:41:55;SF BOX;SAFFANAH ROTI BOX;1;12000;0;12000;10500;1500;
2021-03-24 20:41:55;123124;KOREK BIASA;1;2000;0;2000;1800;200;
2021-03-24 20:51:12;8999909096004;SAMPOERNA 16 FILTER;1;24000;0;24000;23000;1000;
2021-03-24 20:51:12;123124;KOREK BIASA;1;2000;0;2000;1800;200;
2021-03-24 20:52:00;8999999195656;SARI WANGI 50X1.85;1;10000;0;10000;8700;1300;
2021-03-24 21:05:17;RT SUSU;ROTI SUSU;2;8000;0;16000;15000;1000;
2021-03-24 21:05:17;RT KJ;ROTI KASUR JUMBO;2;7000;0;14000;12400;1600;
2021-03-24 21:05:17;8851019510132;POCKY;1;7300;0;7300;7000;300;
2021-03-24 21:05:17;8992752112013;MIZONE;1;5000;0;5000;3800;1200;
2021-03-24 21:06:55;8998866500708;FLORIDINA ORANGE;1;3000;0;3000;2500;500;
2021-03-24 21:58:39;8997027300089;NOMOS;1;4000;0;4000;2963;1037;
2021-03-24 22:18:07;089686010107;INDOMIE KALDU AYAM;4;2500;0;10000;8600;1400;
2021-03-24 22:18:07;8996001312278;MALKIST KEJU MANIS;1;6500;0;6500;5400;1100;
2021-03-24 22:18:07;8999999037765;PEPSODENT WHITE 225G;1;12000;0;12000;10750;1250;
2021-03-24 22:18:07;6907992823904;JD CRUNCHY CHOCOLATE VAN;1;8000;0;8000;6800;1200;
2021-03-24 22:18:07;6907992823607;JD CHOCO CAPTAIN;1;5500;0;5500;4700;800;
2021-03-24 22:18:07;6907992823966;JD BLUEBERRY;1;3500;0;3500;3000;500;
2021-03-25 16:55:41;8999999001155;LIFEBUOY BW TOTAL10 300ML;1;24000;0;24000;21550;2450;
2021-03-25 16:55:41;8999999033170;LIFEBUOY SHP  KUAT&BERKILAU 170ML;1;16500;0;16500;14950;1550;
2021-03-25 16:55:41;089686400427;SAMBAL PEDAS 135ML;1;5500;0;5500;4616;884;
2021-03-25 16:55:41;8999999059781;SUNLIGHT LIME NEW POUCH 210ML;1;5000;0;5000;4300;700;
2021-03-25 16:55:41;8992779289101;KIT CHAIN LUBE;1;22000;0;22000;19900;2100;
2021-03-25 16:55:41;8998866610070;SOKLIN SOFTERGEN 280G PURPLE;1;5000;0;5000;4425;575;
2021-03-25 16:55:41;8996001320051;KOPIKO COFFE CANDY;1;6200;0;6200;5600;600;
2021-03-25 16:55:41;8997025914059;HATARI SEE HONG;1;5000;0;5000;4800;200;
2021-03-25 16:55:41;8996001305041;ROMA SANDWICH CKLT;1;7000;0;7000;5000;2000;
2021-03-25 16:59:33;8994834006128;TICTIC PEDAS;1;2000;0;2000;1700;300;
2021-03-25 16:59:33;8994834003752;TICTIC;1;2000;0;2000;1700;300;
2021-03-25 16:59:33;8997218380135;ICHITAN GREEN TEA;1;8000;0;8000;6583;1417;
2021-03-25 16:59:33;SF KEMASAN;SAFFANAH ROTI KEMASAN;1;3500;0;3500;3000;500;
2021-03-25 16:59:33;8992759120264;LARISST 220;1;10000;0;10000;9200;800;
2021-03-25 16:59:33;8998866200325;MIE SEDAAP SOTO;2;2500;0;5000;3904;1096;
2021-03-25 16:59:33;YP;YUPI;2;250;0;500;416;84;
2021-03-25 17:00:36;8999999059323;LIFEBOUY LEMONFRESH DG 75G;2;3000;0;6000;5000;1000;
2021-03-25 17:00:36;8998008151065;MIWON 100 GR;1;3300;0;3300;2996;304;
2021-03-25 17:00:36;8999999192150;ROYCO FDS CHICKEN 100GR;1;5000;0;5000;4300;700;
2021-03-25 17:05:28;8997027300089;NOMOS;1;4000;0;4000;2963;1037;
2021-03-25 17:05:28;8998989300261;GUDANG GARAM SURYA 12 FILTER;1;18000;0;18000;16450;1550;
2021-03-25 17:05:28;8997218380074;ICHITAN MILK TEA;1;8000;0;8000;6583;1417;
2021-03-25 17:05:28;ff;FULLO BLASTO;3;1000;0;3000;2985;15;
2021-03-25 17:05:28;SF BOX;SAFFANAH ROTI BOX;1;12000;0;12000;10500;1500;
2021-03-25 17:05:28;8998866201964;MINYAK GORENG SABRINA 2L POUCH;1;28000;0;28000;26753;1247;
2021-03-25 17:05:28;8886013213208;FRENCH FREIS 2000;1;5000;0;5000;3750;1250;
2021-03-25 17:05:28;8992761145026;SPRITE PET 250ML;1;3500;0;3500;2417;1083;
2021-03-25 17:05:28;HT;HOT-HOT;1;500;0;500;350;150;
2021-03-25 17:30:35;8999999195649;SARI WANGI 25X1.86G;1;6000;0;6000;5050;950;
2021-03-25 17:30:35;8992761164546;NUTRIBOOST STRAWBERRY 300ML;1;6500;0;6500;5300;1200;
2021-03-25 17:52:42;8997009510055;YOU C1000;1;8000;0;8000;4846;3154;
2021-03-25 18:02:00;8998866201827;JAVANA GULA BATU 350ML;1;3000;0;3000;2150;850;
2021-03-25 18:02:00;SST;SUPERSTAR;1;1000;0;1000;916;84;
2021-03-25 21:17:08;8998866200301;MIE SEDAAP GORENG;2;2500;0;5000;4046;954;
2021-03-25 21:17:08;8998866202343;MIE SEDAAP KOREAN SPICY;2;2500;0;5000;4046;954;
2021-03-25 21:17:08;089686043273;INDOMIE SAMBAL RICA;2;2700;0;5400;4904;496;
2021-03-25 21:17:08;8998866200882;SUKSESMIE GORENG AYAM KRMS 133GR;2;3500;0;7000;6000;1000;
2021-03-25 21:17:08;8998009010569;ULTRA CHO 200;1;5000;0;5000;3830;1170;
2021-03-25 21:17:08;8992761164539;NUTRIBOOST ORANGE 300ML;1;6500;0;6500;5300;1200;
2021-03-25 21:17:08;8996001305249;ROMA KELAPA CREAM;1;6800;0;6800;5514;1286;
2021-03-25 21:17:09;SF TAWAR PND;SAFFANAH TAWAR PANDAN;1;9000;0;9000;9500;-500;
2021-03-25 21:20:32;8992984820717;SODA KUE;1;6000;0;6000;5000;1000;
2021-03-25 21:20:32;8997218380135;ICHITAN GREEN TEA;1;8000;0;8000;6583;1417;
2021-03-25 21:20:32;8991102022347;SIKAT GIGI FORMULA RIPPLE;1;5000;0;5000;4583;417;
2021-03-25 21:38:29;8993989311279;CLAS MILD 12;1;17000;0;17000;15700;1300;
2021-03-25 21:41:02;8999909096004;SAMPOERNA 16 FILTER;1;24000;0;24000;23000;1000;
2021-03-26 10:17:52;8996001600269;LE MINERAL 600ML;1;3000;0;3000;1688;1312;
2021-03-26 10:17:52;8993989311279;CLAS MILD 12;1;17000;0;17000;15700;1300;
2021-03-26 10:21:24;8997218380135;ICHITAN GREEN TEA;1;8000;0;8000;6583;1417;
2021-03-26 10:24:43;8991102385336;TANGO WAFFLE MILK;1;8000;0;8000;6212;1788;
2021-03-26 10:24:43;8992775001042;PILUS GARUDA MI GORENG;1;5500;0;5500;4713;787;
2021-03-26 10:24:43;8997013790092;BIMURA KERUPUK BAWANG 25G;1;1000;0;1000;874;126;
2021-03-26 10:24:43;8886013213208;FRENCH FREIS 2000;1;5000;0;5000;3750;1250;
2021-03-26 10:24:43;8992696404441;BEAR BRAND 189ML;2;8500;0;17000;15774;1226;
2021-03-26 10:24:43;8997013790108;BIMURA KACANG TELUR 25G;1;1000;0;1000;875;125;
2021-03-26 10:24:43;8990800004563;MENTOS 40X50 BUAH IND;1;5500;0;5500;5150;350;
2021-03-26 10:24:43;8851019510132;POCKY;1;7300;0;7300;7000;300;
2021-03-26 10:24:43;8998866201469;POTABEE REGULER BBQ BEEF 68 GR;1;8000;0;8000;7200;800;
2021-03-26 10:24:43;8992870311091;SALONPAS;1;6000;0;6000;4806;1194;
2021-03-26 10:27:06;GL;GULA 1 LITER;12;11500;0;138000;126000;12000;
2021-03-26 10:27:06;8998866501033;MINYAK GORENG SEDAAP POUCH 2L;6;29000;0;174000;166476;7524;
2021-03-26 10:27:06;6907992823843;JD MOCHA CRISPY;1;5000;0;5000;4400;600;
2021-03-26 10:27:06;8996001355237;SUPER STAR;1;11000;0;11000;9900;1100;
2021-03-26 10:27:06;9556001047175;NESCAFE ORI 240ML;1;8500;0;8500;7337;1163;
2021-03-26 10:27:06;9999;ISOLASI LAKBAN;1;8000;0;8000;6500;1500;
2021-03-26 10:27:06;8997009510055;YOU C1000;1;8000;0;8000;4846;3154;
2021-03-26 10:29:36;8999999195656;SARI WANGI 50X1.85;1;10000;0;10000;8700;1300;
2021-03-26 10:29:36;8999999544409;MOLTO DETERGEN CARE PURPLE PCH 700ML;1;20500;0;20500;18570;1930;
2021-03-26 10:29:36;8998989110167;SURYA GUDANG GARAM 16 FILTER;5;24000;0;120000;110500;9500;
2021-03-26 10:35:50;001;PASEO SMART FACIAL SF 250S GT;2;10000;0;20000;19000;1000;
2021-03-26 10:35:50;8992959107515;SFX NON WING 23CM 8;1;4000;0;4000;3288;712;
2021-03-26 10:35:50;8991102989534;WFR TANGO LONG VNL 24G GTG;2;1000;0;2000;1344;656;
2021-03-26 10:35:50;AMPLOP;AMPLOP;6;250;0;1500;840;660;
2021-03-26 10:35:50;8991001121615;SILVERQUEEN NUT;1;15000;0;15000;13200;1800;
2021-03-26 10:35:50;GL;GULA 1 LITER;1;11500;0;11500;10500;1000;
2021-03-26 10:35:50;8992753631209;OMELA 370;1;9500;0;9500;8400;1100;
2021-03-26 10:35:50;8998866610261;POWDET DAIA SOFTENER BAG 290 GR;1;5000;0;5000;4450;550;
2021-03-26 10:35:50;8999999534097;PEPSODENT PGB FCM 75G;1;5000;0;5000;3850;1150;
2021-03-26 10:35:50;8999999050009;SUNLIGHT LIME NEW POUCH 95ML;1;2000;0;2000;1600;400;
2021-03-26 10:35:50;8993470279651;JOGER CHOCKY BAR;1;1000;0;1000;867;133;
2021-03-26 10:37:09;BALON;BALON CABUTR;1;1000;0;1000;900;100;
2021-03-26 11:19:55;8886013213208;FRENCH FREIS 2000;1;5000;0;5000;3750;1250;
2021-03-26 11:32:43;6907992823676;JD PEACH;1;2000;0;2000;1700;300;
2021-03-26 11:32:43;8992761111540;FANTA STRAWBERY SLIM CAM 250ML;1;5000;0;5000;3750;1250;
2021-03-26 11:53:09;8995333000822;TERIGU KOMPAS SOFT 500GR;1;5500;0;5500;4967;533;
2021-03-26 12:30:33;8994834003752;TICTIC;2;2000;0;4000;3400;600;
2021-03-26 12:30:33;PRG;PARAGO;4;500;0;2000;1600;400;
2021-03-26 12:30:33;YP;YUPI;8;250;0;2000;1664;336;
2021-03-26 12:30:33;8850507000094;POLICE BONCHA;1;2000;0;2000;800;1200;
2021-03-26 12:42:59;MARS;MARSHMELLOW;4;500;0;2000;1732;268;
2021-03-30 11:53:21;8992725910417;LISTERINE FRESH BURST 100ML;1;7500;0;7500;6800;700;
2021-03-30 11:53:21;8991111152073;LISTERINE GREEN TEA 100ML;1;8000;0;8000;7600;400;
2021-03-30 11:53:21;8996001351888;WFR WAFELLO;1;17000;0;17000;15500;1500;
2021-03-30 11:53:21;8991102385060;TANGO WAFFLE CHOX;2;8000;0;16000;12424;3576;
2021-03-30 11:53:21;8992775001820;CHOCOLATOS WAFER CREAM;1;17500;0;17500;15761;1739;
2021-03-30 11:53:21;8996001355237;SUPER STAR;1;11000;0;11000;9900;1100;
2021-03-30 11:53:21;8991102994422;TANGO WALUT CHOCOBNN 18G;2;8200;0;16400;14544;1856;
2021-03-30 11:53:21;8991102385121;WFR TANGO VNL 7G;1;8300;0;8300;7455;845;
2021-03-30 11:53:21;8991102989312;WFR TANGO SBJ 7G;1;8300;0;8300;7455;845;
2021-03-30 11:53:21;8992775311486;CHOCOLATOS DARK 16G;1;18000;0;18000;15173;2827;
2021-03-30 11:53:21;8998866202237;NOODLE SEDAAP TASTY AYAM GEPREK 124 GR;3;5000;0;15000;12501;2499;
2021-03-30 11:53:21;8991102218085;CANNON BALL;1;10000;0;10000;9090;910;
2021-03-30 12:07:39;8998866200837;NOODLE SEDAAPMIE SOTO CUP 81 GR;1;4500;0;4500;3650;850;
2021-03-30 12:07:39;HT;HOT-HOT;1;500;0;500;350;150;
2021-03-30 12:07:39;BALON;BALON CABUTR;1;1000;0;1000;900;100;
2021-03-30 12:21:35;711844610095;LARISSA UDANG 500 GR;1;11000;0;11000;9790;1210;
2021-03-30 12:21:35;ARG;ARGUS 220ML;2;14500;0;29000;25000;4000;
2021-03-30 12:37:14;8998866202237;NOODLE SEDAAP TASTY AYAM GEPREK 124 GR;1;5000;0;5000;4167;833;
2021-03-30 12:37:14;8998866202312;NOODLE SEDAAP TASTY BAKMI AYAM 129 GR;2;5000;0;10000;8334;1666;
2021-03-31 12:16:24;8998866602570;NUVO FAMILY KUNING 76G;1;2000;0;2000;1820;180;
2021-03-31 12:16:24;8993379241858;SABUN HARMONY LEMON 70G;1;2000;0;2000;1652;348;
2021-03-31 12:16:24;8993379200879;SABUN HARMONY MELON 70G;1;2000;0;2000;1652;348;
2021-03-31 12:16:24;8998866602563;NUVO FAMILY HIJAU 76G;1;2000;0;2000;1820;180;
2021-03-31 12:16:24;SOSIS;SO NICE SAPI;3;1000;0;3000;2820;180;
2021-03-31 12:29:30;8992959508312;SWEETY SILVER PANTS XL RTG;1;15500;0;15500;13944;1556;
2021-03-31 12:29:30;COKLAT;COKLAT COIN;2;500;0;1000;800;200;
2021-03-31 12:29:30;HT;HOT-HOT;1;500;0;500;350;150;
2021-03-31 12:38:30;SOSIS;SO NICE SAPI;5;1000;0;5000;4700;300;
2021-03-31 12:55:56;8992761166205;FRESTEA GREEN HONEY 350ML;2;4500;0;9000;6000;3000;
2021-03-31 12:59:51;GL;GULA 1 LITER;1;11500;0;11500;10500;1000;
2021-03-31 12:59:51;8998989110167;SURYA GUDANG GARAM 16 FILTER;1;24000;0;24000;22100;1900;
2021-03-31 12:59:51;8998989500166;GUDANG GARAM MERAH BESAR 16KS;1;17000;0;17000;15300;1700;
2021-03-31 12:59:51;123124;KOREK BIASA;1;2000;0;2000;1800;200;
2021-03-31 14:08:14;ARG;ARGUS 220ML;3;14500;0;43500;37500;6000;
2021-03-31 14:14:57;8992694247163;ZWITSAL SOAP RICH N HON 70G;1;4000;0;4000;3410;590;
2021-03-31 14:14:57;8998866200301;MIE SEDAAP GORENG;1;2500;0;2500;2023;477;
2021-03-31 16:00:57;8996001603376;ENERGEN KURMA;1;18000;0;18000;15000;3000;
2021-03-31 16:00:57;8998866200844;NOODLE SEDAAP MIE KARI SPESIAL CUP 81 GR;3;4500;0;13500;10950;2550;
2021-03-31 16:22:18;8992959953334;SWEETY BRONZE XL42;1;80000;0;80000;75455;4545;
2021-03-31 16:22:18;8999999533434;CLEAR SHP COOL SPORT MNTL MEN 9 ML;1;10300;0;10300;9300;1000;
2021-03-31 16:22:18;8999999531478;MOLTO BLACK PURPLE;1;5500;0;5500;4800;700;
2021-03-31 16:22:18;8994023000050;MEGKEJU SERBAGUNA 165G;1;12000;0;12000;10339;1661;
2021-03-31 16:22:18;GL;GULA 1 LITER;1;11500;0;11500;10500;1000;
2021-03-31 16:22:18;8992957214307;SAFARI MECES;1;5500;0;5500;4500;1000;
2021-03-31 16:22:18;8850507000094;POLICE BONCHA;1;2000;0;2000;800;1200;
2021-03-31 16:22:18;8992775001042;PILUS GARUDA MI GORENG;1;5500;0;5500;4713;787;
2021-03-31 16:22:18;8992770034151;MASAKO 250GR;1;10000;0;10000;8000;2000;
2021-03-31 16:22:18;089686021219;INTER MIE GORENG;2;1000;0;2000;1770;230;
2021-03-31 16:39:23;8992959304235;SFX COMFORT SLIM 29CM 8S;1;8000;0;8000;7387;613;
2021-03-31 16:39:23;RT 1000;ROTI 1000;2;1000;0;2000;1500;500;
2021-03-31 16:39:23;8992761111533;SPRITE SLIM CAM250ML;1;5000;0;5000;3750;1250;
2021-03-31 16:39:23;8997018250218;JAHE MERAH;1;1000;0;1000;833;167;
2021-03-31 16:39:23;8998009010590;ULTRA CHO 125;1;3000;0;3000;2428;572;
2021-03-31 16:39:23;8991102384841;WFR TANGO LONG CKLT 130G;2;5000;0;10000;7546;2454;
2021-03-31 16:39:23;SF KEMASAN;SAFFANAH ROTI KEMASAN;4;3500;0;14000;12000;2000;
2021-03-31 16:39:23;8996001414002;TORA BIKA CAPPUCINO;1;13000;0;13000;12270;730;
2021-03-31 16:39:23;8998866106979;CIPTADENT TB CHARCOAL PROTEC;1;6000;0;6000;5250;750;
2021-03-31 16:39:23;8992761139018;ADES 600ML;1;3500;0;3500;2292;1208;
2021-03-31 16:39:23;PRG;PARAGO;2;500;0;1000;800;200;
2021-03-31 16:39:23;8998866201841;GOLDA DOLCE LATTE 200ML;1;3000;0;3000;2500;500;
2021-03-31 16:39:23;6907992824963;JD MILKY CHOCOLATE;1;3000;0;3000;2600;400;
2021-03-31 16:39:23;8993989311279;CLAS MILD 12;1;17000;0;17000;15700;1300;
2021-03-31 16:39:23;8850507000094;POLICE BONCHA;6;2000;0;12000;4800;7200;
2021-03-31 16:39:23;KJ;KINDER JOY;1;2000;0;2000;1583;417;
2021-03-31 16:39:23;6907992823676;JD PEACH;2;2000;0;4000;3400;600;
2021-03-31 16:39:23;YP;YUPI;4;250;0;1000;832;168;
2021-03-31 16:39:23;6907992823669;JD MILKY STRAW;1;3000;0;3000;2600;400;
2021-03-31 16:39:23;MARS;MARSHMELLOW;4;500;0;2000;1732;268;
2021-03-31 16:39:23;GL;GULA 1 LITER;1;11500;0;11500;10500;1000;
2021-03-31 16:39:23;8997009510055;YOU C1000;1;8000;0;8000;4846;3154;
2021-03-31 16:39:23;BALON;BALON CABUTR;3;1000;0;3000;2700;300;
2021-03-31 16:40:14;HT;HOT-HOT;2;500;0;1000;700;300;
2021-03-31 16:40:14;YP;YUPI;4;250;0;1000;832;168;
2021-03-31 16:40:14;8996001318430;BETTER 1000;2;1000;0;2000;1640;360;
2021-03-31 17:05:06;8996001600399;LE MINERAL 1500ML;1;5000;0;5000;4042;958;
2021-03-31 17:05:06;8992736424293;SASA BUMBU NASI GORENG 20G;3;2000;0;6000;3408;2592;
2021-03-31 17:05:06;8993379200886;SABUN HARMONY ORANGE 70G;1;2000;0;2000;1652;348;
2021-03-31 17:05:06;8850507002968;A1 KING TRUCK;1;16500;0;16500;15500;1000;
2021-03-31 17:05:06;SOSIS;SO NICE SAPI;6;1000;0;6000;5640;360;
2021-03-31 17:05:06;8999999017804;CITRA BW NATURAL WHITE LD 400ML;1;21000;0;21000;19000;2000;
2021-03-31 17:05:06;8998866107099;WET WIPES KODOMO BABY 50SHT CLSSC;1;15000;0;15000;13650;1350;
2021-03-31 17:05:06;8998866107464;POSH FRESH SPIRIT 150ML;1;19500;0;19500;17500;2000;
2021-03-31 17:05:06;8999999719401;VASELINE HW UV LIGHTENING PJ 400ML;1;43800;0;43800;39734;4066;
2021-03-31 17:05:06;8997210107877;VORTEX SMART 3;1;10000;0;10000;9500;500;
2021-03-31 17:05:06;8993365131538;MADU TJ MURNI 150G;1;14800;0;14800;13430;1370;
2021-03-31 17:05:06;8998866200301;MIE SEDAAP GORENG;3;2500;0;7500;6069;1431;
2021-03-31 17:05:06;BALON;BALON CABUTR;3;1000;0;3000;2700;300;
2021-03-31 17:05:06;8992761147143;SPRITE WATERLYMON 425ML;1;5500;0;5500;4300;1200;
2021-03-31 17:05:06;8994834006128;TICTIC PEDAS;4;2000;0;8000;6800;1200;
2021-03-31 17:05:06;8994834003752;TICTIC;1;2000;0;2000;1700;300;
2021-03-31 17:05:06;6907992823973;JD PINEAPPLE;1;5000;0;5000;4300;700;
2021-03-31 17:05:06;8998866501033;MINYAK GORENG SEDAAP POUCH 2L;1;28000;0;28000;27746;254;
2021-03-31 17:05:06;COKLAT;COKLAT COIN;2;500;0;1000;800;200;
2021-03-31 17:05:06;8997025911058;HATARI SHP KELAPA;1;5000;0;5000;4800;200;
2021-03-31 17:05:06;8991102384841;WFR TANGO LONG CKLT 130G;2;5000;0;10000;7546;2454;
2021-03-31 17:05:06;8999999050009;SUNLIGHT LIME NEW POUCH 95ML;1;2000;0;2000;1600;400;
2021-03-31 17:05:06;8993072153595;LARISST COTTON 35G;1;5000;0;5000;3300;1700;
2021-03-31 17:05:06;8992753631209;OMELA 370;1;9500;0;9500;8400;1100;
2021-03-31 17:05:06;4800888141125;AXE DEO BODYSPRAY DARK 150ML;1;20000;0;20000;10615;9385;
2021-03-31 17:05:06;8994037703749;WENIS JERUK;1;8000;0;8000;6500;1500;
2021-03-31 17:05:06;8998866202770;MIE SEDAAP SALERO PADANG;1;2500;0;2500;2362;138;
2021-03-31 17:05:06;8998989300261;GUDANG GARAM SURYA 12 FILTER;1;18000;0;18000;16450;1550;
2021-03-31 17:05:06;123124;KOREK BIASA;1;2000;0;2000;1800;200;
2021-03-31 17:05:06;SST;SUPERSTAR;2;1000;0;2000;1832;168;
2021-03-31 17:05:06;089686021127;INTER MIE KALDU;17;1000;0;17000;13821;3179;
2021-03-31 17:05:06;ARG;ARGUS 220ML;1;14500;0;14500;12500;2000;
2021-03-31 17:05:06;MARS;MARSHMELLOW;1;500;0;500;433;67;
2021-03-31 17:11:36;GL;GULA 1 LITER;1;11500;0;11500;10500;1000;
2021-03-31 17:11:36;001;PASEO SMART FACIAL SF 250S GT;1;10000;0;10000;9500;500;
2021-03-31 17:11:36;8999999057640;MOLTO EDP BLK PURPLE 20ML;6;1000;0;6000;4800;1200;
2021-03-31 17:11:36;8997218380135;ICHITAN GREEN TEA;1;8000;0;8000;6583;1417;
2021-03-31 17:11:36;TG;TEH GELAS;1;1000;0;1000;729;271;
2021-03-31 17:11:36;6907992824963;JD MILKY CHOCOLATE;5;3000;0;15000;13000;2000;
2021-03-31 17:11:36;PRG;PARAGO;1;500;0;500;400;100;
2021-03-31 17:11:36;6907992823966;JD BLUEBERRY;1;3500;0;3500;3000;500;
2021-03-31 17:11:36;8992694246340;ZWITSAL SHP NAT AVKS 100ML;1;11800;0;11800;10395;1405;
2021-03-31 17:11:36;8998866202435;JAPOTA UMAMI JAPANESE SEAWEED 35GR;1;5000;0;5000;4150;850;
2021-03-31 17:11:36;8992761002015;COCA COLA PET 390ML;1;5500;0;5500;4333;1167;
2021-03-31 17:11:36;8992775001042;PILUS GARUDA MI GORENG;1;5500;0;5500;4713;787;
2021-03-31 17:11:36;8992736424293;SASA BUMBU NASI GORENG 20G;1;2000;0;2000;1136;864;
2021-03-31 17:11:36;BALON;BALON CABUTR;2;1000;0;2000;1800;200;
2021-03-31 17:11:36;MARS;MARSHMELLOW;4;500;0;2000;1732;268;
2021-03-31 17:11:36;8999999524722;SUNLIGHT LIME NEW PCH 435ML;1;10000;0;10000;9100;900;
2021-03-31 17:11:36;8998989300261;GUDANG GARAM SURYA 12 FILTER;1;18000;0;18000;16450;1550;
2021-03-31 17:11:36;COKLAT;COKLAT COIN;4;500;0;2000;1600;400;
2021-03-31 17:11:36;8998989500166;GUDANG GARAM MERAH BESAR 16KS;2;17000;0;34000;30600;3400;
2021-03-31 17:11:36;8994834003752;TICTIC;1;2000;0;2000;1700;300;
2021-03-31 17:11:36;8999999049492;REXONA WMN RO POWDER DRY 45 ML;1;15000;0;15000;13500;1500;
2021-03-31 17:14:11;8992696404441;BEAR BRAND 189ML;1;8500;0;8500;7887;613;
2021-03-31 17:14:11;089686021127;INTER MIE KALDU;2;1000;0;2000;1626;374;
2021-03-31 17:14:11;8992696523081;MILO UHT 110ML;2;2500;0;5000;3924;1076;
2021-03-31 17:14:11;8997009510055;YOU C1000;2;8000;0;16000;9692;6308;
2021-03-31 17:14:11;8996001320051;KOPIKO COFFE CANDY;1;6200;0;6200;5600;600;
2021-03-31 17:14:11;8996001338056;TAMARIN;1;6000;0;6000;5100;900;
2021-03-31 17:15:23;8999999049454;REXONA WMN RO FREE SPIRIT 45 ML;1;15000;0;15000;13550;1450;
2021-03-31 17:15:23;089686021141;INTER MIE SOTO;1;1000;0;1000;854;146;
2021-03-31 17:15:23;MOLTO PINK;MOLTO ALL IN ONE 11 ML;1;500;0;500;400;100;
2021-03-31 17:15:23;PRG;PARAGO;1;500;0;500;400;100;
2021-03-31 17:17:41;8998866608312;GIV PAPAYA KOTAK 76GR;1;2000;0;2000;1820;180;
2021-03-31 17:17:41;8998866611725;EKONOMI PENCUCI PIRING  LIQ 290ML;1;5000;0;5000;4200;800;
2021-03-31 17:17:41;8998866501026;MINYAK GORENG SEDAAP POUCH 1 L;1;15000;0;15000;14110;890;
2021-03-31 17:17:41;8991111101507;JB POWDER BLOSSOM 50G;1;3500;0;3500;3000;500;
2021-03-31 17:17:41;8996001600399;LE MINERAL 1500ML;1;5000;0;5000;4042;958;
2021-03-31 17:18:46;8850507001176;HERO RACING;1;12000;0;12000;10600;1400;
2021-03-31 17:18:46;KJ;KINDER JOY;1;2000;0;2000;1583;417;
2021-03-31 17:18:46;BALON;BALON CABUTR;2;1000;0;2000;1800;200;
2021-03-31 17:18:46;8850507000094;POLICE BONCHA;1;2000;0;2000;800;1200;
2021-03-31 17:30:26;8992696523081;MILO UHT 110ML;1;2500;0;2500;1962;538;
2021-03-31 17:30:26;8992957220025;GOLDEN CITY MINI;1;3000;0;3000;2500;500;
2021-03-31 17:30:26;BALON;BALON CABUTR;3;1000;0;3000;2700;300;
2021-03-31 17:30:26;8991102989428;WFR TANGO LONG CKLT 24G GTG;1;1000;0;1000;672;328;
2021-03-31 17:30:26;8850507002968;A1 KING TRUCK;1;16500;0;16500;15500;1000;
2021-03-31 17:30:26;PRG;PARAGO;4;500;0;2000;1600;400;
2021-03-31 17:30:26;8998989500166;GUDANG GARAM MERAH BESAR 16KS;2;17000;0;34000;30600;3400;
2021-03-31 17:30:26;8992761139018;ADES 600ML;1;3500;0;3500;2292;1208;
2021-03-31 17:30:26;8998866201452;POTABEE REGULER BBQ BEEF 35GR;1;5000;0;5000;4150;850;
2021-03-31 17:30:26;8993470411433;JOGER CLASSIC;1;1000;0;1000;850;150;
2021-03-31 17:30:26;HT;HOT-HOT;1;500;0;500;350;150;
2021-03-31 17:30:26;8998866601429;POWDET DAIA BUNGA BAG 290GR;1;5000;0;5000;4450;550;
2021-03-31 17:30:26;MOLTO PINK;MOLTO ALL IN ONE 11 ML;4;500;0;2000;1600;400;
2021-03-31 17:30:26;8992957220117;COKLAT BERUANG;1;2000;0;2000;1700;300;
2021-03-31 17:30:26;8991102989534;WFR TANGO LONG VNL 24G GTG;1;1000;0;1000;672;328;
2021-03-31 17:30:26;8998989300261;GUDANG GARAM SURYA 12 FILTER;1;18000;0;18000;16450;1550;
2021-03-31 17:30:26;8998866202312;NOODLE SEDAAP TASTY BAKMI AYAM 129 GR;1;5000;0;5000;4167;833;
2021-03-31 17:34:29;8998989300261;GUDANG GARAM SURYA 12 FILTER;2;18000;0;36000;32900;3100;
2021-03-31 17:34:29;8998009010569;ULTRA CHO 200;1;5000;0;5000;3830;1170;
2021-03-31 17:34:29;8998009010590;ULTRA CHO 125;1;3000;0;3000;2428;572;
2021-03-31 17:34:29;8998866202343;MIE SEDAAP KOREAN SPICY;1;2500;0;2500;2023;477;
2021-03-31 17:34:29;8999999706081;PEPSODENT WHITE 75G;1;5000;0;5000;3850;1150;
2021-03-31 17:34:29;6907992823676;JD PEACH;1;2000;0;2000;1700;300;
2021-03-31 17:34:29;HT;HOT-HOT;2;500;0;1000;700;300;
2021-03-31 17:34:29;BALON;BALON CABUTR;3;1000;0;3000;2700;300;
2021-03-31 17:34:29;YP;YUPI;4;250;0;1000;832;168;
2021-03-31 17:34:29;KJ;KINDER JOY;1;2000;0;2000;1583;417;
2021-03-31 17:34:29;8995333032113;TERIGU GATOT KACA 1 KG;1;8500;0;8500;8012;488;
2021-03-31 17:34:29;MARS;MARSHMELLOW;1;500;0;500;433;67;
2021-03-31 17:45:26;8998989300261;GUDANG GARAM SURYA 12 FILTER;1;18000;0;18000;16450;1550;
2021-03-31 17:45:26;089686021127;INTER MIE KALDU;2;1000;0;2000;1626;374;
2021-03-31 17:45:26;8998866200325;MIE SEDAAP SOTO;2;2500;0;5000;3904;1096;
2021-03-31 17:45:26;8997009510055;YOU C1000;6;8000;0;48000;29076;18924;
2021-03-31 17:45:26;089686021141;INTER MIE SOTO;2;1000;0;2000;1708;292;
2021-03-31 17:45:26;8998866200578;MIE SEDAAP KARI KENTAL;20;2500;0;50000;45260;4740;
2021-03-31 17:45:26;8992628010139;BIMOLI 5L;1;75000;0;75000;72100;2900;
2021-03-31 17:45:26;8996001600399;LE MINERAL 1500ML;2;5000;0;10000;8084;1916;
2021-03-31 17:45:26;8998866501026;MINYAK GORENG SEDAAP POUCH 1 L;1;15000;0;15000;14110;890;
2021-03-31 17:45:26;8991002105409;KOPI KAPAL API;1;20000;0;20000;18888;1112;
2021-03-31 17:45:43;ff;FULLO BLASTO;1;1000;0;1000;995;5;
2021-03-31 17:51:33;8994834003752;TICTIC;2;2000;0;4000;3400;600;
2021-03-31 17:51:33;BALON;BALON CABUTR;1;1000;0;1000;900;100;
2021-03-31 17:55:39;8997021870014;FRESH CARE CITRUS 10ML;1;12000;0;12000;10000;2000;
2021-03-31 17:55:39;8998866200578;MIE SEDAAP KARI KENTAL;2;2500;0;5000;4526;474;
2021-03-31 17:55:39;8998866200301;MIE SEDAAP GORENG;2;2500;0;5000;4046;954;
2021-03-31 17:55:39;089686061024;POP MIE MINI SOTO RL;1;3000;0;3000;2702;298;
2021-03-31 17:55:39;8998866609043;DAIA SOFTENER GUSSET 565G;1;10000;0;10000;8700;1300;
2021-03-31 17:55:39;8991102385091;WFR TANGO CKLT 7G;1;8300;0;8300;7455;845;
2021-03-31 17:58:33;8992753182206;FF MILKY CKLT 180ML;1;4500;0;4500;3250;1250;
2021-03-31 17:58:33;8998009010569;ULTRA CHO 200;1;5000;0;5000;3830;1170;
2021-03-31 17:58:33;8992696404441;BEAR BRAND 189ML;1;8500;0;8500;7887;613;
2021-03-31 17:58:33;8995333032113;TERIGU GATOT KACA 1 KG;1;8500;0;8500;8012;488;
2021-03-31 18:07:27;8999999024772;VASELINE HW PERFECT 10 100 ML;1;19000;0;19000;17600;1400;
2021-03-31 18:07:27;8998866608725;DAIA SOFTENER BAG 850G;1;18000;0;18000;15627;2373;
2021-03-31 18:48:19;089686043051;INDOMIE COTO MAKASSAR;1;2800;0;2800;2525;275;
2021-03-31 18:48:19;089686021127;INTER MIE KALDU;2;1000;0;2000;1626;374;
2021-03-31 18:48:19;089686010824;INDOMIE GORENG SPESIAL;1;2700;0;2700;2452;248;
2021-03-31 18:48:19;8995333060772;TERIGU GATOT KACA 500GR;1;4500;0;4500;4065;435;
2021-03-31 19:07:50;8991102987639;WFR TANGO LONG VNL 130G;1;5000;0;5000;3773;1227;
2021-03-31 19:07:50;8992775305164;MALKIST GREEN TEA;1;6500;0;6500;5500;1000;
2021-03-31 19:07:50;RT 1000;ROTI 1000;2;1000;0;2000;1500;500;
2021-03-31 19:07:50;8997218380135;ICHITAN GREEN TEA;1;8000;0;8000;6583;1417;
2021-03-31 19:07:50;8886013213208;FRENCH FREIS 2000;1;5000;0;5000;3750;1250;
2021-03-31 19:07:50;8998866202664;POTABEE WAGYU BEEF STEAK 68 GR;1;8000;0;8000;7200;800;
2021-03-31 19:07:50;8998866610377;ISOPLUS;1;3000;0;3000;2350;650;
2021-03-31 19:07:50;8991002103764;GOOD DAY CAPPUCINO 10X25G;1;1500;0;1500;1395;105;
2021-03-31 19:07:50;6907992823904;JD CRUNCHY CHOCOLATE VAN;1;8000;0;8000;6800;1200;
2021-03-31 20:47:55;8991102384841;WFR TANGO LONG CKLT 130G;1;5000;0;5000;3773;1227;
2021-03-31 20:51:52;GL;GULA 1 LITER;1;11500;0;11500;10500;1000;
2021-03-31 20:51:52;8999999502393;ROYCO FDS CHICKEN 8G;1;5000;0;5000;4500;500;
2021-03-31 20:51:52;8992628022156;BIMOLI KLASIK TOUCH 1 LT;1;15500;0;15500;14350;1150;
2021-03-31 20:51:52;8998866202770;MIE SEDAAP SALERO PADANG;1;2500;0;2500;2362;138;
2021-03-31 20:51:52;8991004011906;KOPI BORONG;1;10000;0;10000;8333;1667;
2021-03-31 20:51:52;8998866202619;MIE SEDAAP KOREAN SPICY SOUP;1;2500;0;2500;2273;227;
2021-03-31 20:52:52;8994834003752;TICTIC;1;2000;0;2000;1700;300;
2021-03-31 20:52:52;8994834006128;TICTIC PEDAS;1;2000;0;2000;1700;300;
2021-03-31 21:12:49;8998989110167;SURYA GUDANG GARAM 16 FILTER;1;24000;0;24000;22100;1900;
2021-03-31 21:20:43;8994867000162;ROKOK PUNDIMAS KRETEK16;1;10000;0;10000;8600;1400;
2021-03-31 21:20:43;8998989300261;GUDANG GARAM SURYA 12 FILTER;1;18000;0;18000;16450;1550;
2021-03-31 22:14:25;8999999007768;FAIR&LOVELY MULTIVITAMIN  CREAM 9 ML;1;4500;0;4500;3200;1300;
2021-03-31 22:23:34;8998866105491;EMERON LOVELY SMOTH&BRIGHT 100ML;1;4300;0;4300;3800;500;
2021-03-31 22:47:32;8998866604963;POWDET DAIA LEMON 290GR;4;5000;0;20000;17800;2200;
2021-03-31 23:00:10;8997009510055;YOU C1000;1;8000;0;8000;4846;3154;
2021-03-31 23:00:10;8993989311279;CLAS MILD 12;1;17000;0;17000;15700;1300;
2021-03-31 23:01:36;8992753100101;BKM FULL CREAM GOLD 370;2;15500;0;31000;29600;1400;
2021-03-31 23:01:36;089686400816;SAMBAL EXTRA PEDAS 135ML;1;5500;0;5500;4950;550;
2021-03-31 23:01:36;GL;GULA 1 LITER;3;11500;0;34500;31500;3000;
2021-03-31 23:01:36;8998989121163;SURYA PRO MERAH;1;20000;0;20000;18600;1400;
2021-03-31 23:01:36;8994867000162;ROKOK PUNDIMAS KRETEK16;1;10000;0;10000;8600;1400;
2021-03-31 23:01:36;YP;YUPI;4;250;0;1000;832;168;
2021-03-31 23:01:36;SOSIS;SO NICE SAPI;1;1000;0;1000;940;60;
2021-04-01 11:10:39;8998989110167;SURYA GUDANG GARAM 16 FILTER;1;24000;0;24000;22100;1900;
2021-04-01 11:10:39;8998866610261;POWDET DAIA SOFTENER BAG 290 GR;1;5000;0;5000;4450;550;
2021-04-01 11:11:14;8998989110167;SURYA GUDANG GARAM 16 FILTER;4;24000;0;96000;88400;7600;
2021-04-01 11:16:27;8996001355237;SUPER STAR;1;11000;0;11000;9900;1100;
2021-04-01 11:16:27;8997025914059;HATARI SEE HONG;1;5000;0;5000;4800;200;
2021-04-01 11:16:27;SST;SUPERSTAR;2;1000;0;2000;1832;168;
2021-04-01 11:16:27;SOSIS;SO NICE SAPI;1;1000;0;1000;940;60;
2021-04-01 11:16:27;ff;FULLO BLASTO;2;1000;0;2000;1990;10;
2021-04-01 11:58:48;8999999195656;SARI WANGI 50X1.85;1;10000;0;10000;8700;1300;
2021-04-01 11:58:48;8992628022156;BIMOLI KLASIK TOUCH 1 LT;1;15500;0;15500;14350;1150;
2021-04-01 15:54:26;8998989110167;SURYA GUDANG GARAM 16 FILTER;1;24000;0;24000;22100;1900;
2021-04-01 15:55:44;8998989300261;GUDANG GARAM SURYA 12 FILTER;1;18000;0;18000;16450;1550;
2021-04-01 15:55:44;089686011036;INDOMIE GORENG PEDAS;1;2700;0;2700;2452;248;
2021-04-01 15:55:44;089686043273;INDOMIE SAMBAL RICA;1;2700;0;2700;2452;248;
2021-04-01 15:55:44;BALON;BALON CABUTR;2;1000;0;2000;1800;200;
2021-04-01 16:35:46;8999801700030;SUSU FOYU;1;11500;0;11500;10000;1500;
2021-04-01 16:35:46;8998866501033;MINYAK GORENG SEDAAP POUCH 2L;1;28000;0;28000;27746;254;
2021-04-01 16:36:32;8991102281416;PERMEN MINTZ PPMINT;1;4500;0;4500;4000;500;
2021-04-01 17:03:55;8998989110167;SURYA GUDANG GARAM 16 FILTER;2;24000;0;48000;44200;3800;
2021-04-01 17:11:16;8999999049492;REXONA WMN RO POWDER DRY 45 ML;1;15000;0;15000;13500;1500;
2021-04-01 17:17:57;8997218380074;ICHITAN MILK TEA;1;8000;0;8000;6583;1417;
2021-04-01 17:17:57;089686821086;ICHI OCHA MELATI;1;3000;0;3000;2250;750;
2021-04-01 17:17:57;kp;KALPA;1;2000;0;2000;1666;334;
2021-04-01 17:17:57;YP;YUPI;4;250;0;1000;832;168;
2021-04-01 17:17:57;FUZO;KUACI FUZO;1;1000;0;1000;850;150;
2021-04-01 17:21:42;8992761111533;SPRITE SLIM CAM250ML;1;5000;0;5000;3750;1250;
2021-04-01 17:42:25;8993379210854;SABUN HARMONY APPLE 70G;1;2000;0;2000;1652;348;
2021-04-01 18:30:36;8999999034023;VASELINE MEN ANTI ACNE 50G;1;17000;0;17000;15400;1600;
2021-04-01 19:36:39;8994420107789;SARDEN SAUS TOMAT;1;7000;0;7000;5833;1167;
2021-04-01 19:36:39;8996001414002;TORA BIKA CAPPUCINO;2;1500;0;3000;2454;546;
2021-04-01 19:37:00;8998866201964;MINYAK GORENG SABRINA 2L POUCH;1;28000;0;28000;26753;1247;
2021-04-01 19:37:00;8998866201865;KRISBEE PILLOW CHOCOLAVA 120 GR;1;8000;0;8000;7250;750;
2021-04-01 20:13:52;8995333060772;TERIGU GATOT KACA 500GR;1;4500;0;4500;4065;435;
2021-04-01 20:13:52;8995333032113;TERIGU GATOT KACA 1 KG;1;8500;0;8500;8012;488;
2021-04-01 20:31:19;8991102384841;WFR TANGO LONG CKLT 130G;2;5000;0;10000;7546;2454;
2021-04-01 20:31:19;8991102987639;WFR TANGO LONG VNL 130G;2;5000;0;10000;7546;2454;
2021-04-01 20:31:19;8992753102204;BKM COKLAT 370G;1;11300;0;11300;9500;1800;
2021-04-01 20:31:19;8991102994422;TANGO WALUT CHOCOBNN 18G;1;8200;0;8200;7272;928;
2021-04-01 21:36:57;8998008151065;MIWON 100 GR;1;3300;0;3300;2996;304;
2021-04-02 12:09:49;8997009510055;YOU C1000;1;8000;0;8000;4846;3154;
2021-04-02 12:09:49;8992753031900;BKM SCT PUTIH 40G;1;7500;0;7500;6900;600;
2021-04-02 12:09:49;8998866202060;POTABEE AYAM BAKAR PEDAS 35 GR;1;5000;0;5000;4150;850;
2021-04-02 12:09:49;089686021219;INTER MIE GORENG;4;1000;0;4000;3540;460;
2021-04-02 12:09:49;8996001301142;ROMA KELAPA;1;8000;0;8000;6628;1372;
2021-04-02 12:09:49;8996001305041;ROMA SANDWICH CKLT;1;7000;0;7000;5000;2000;
2021-04-02 12:09:49;GL;GULA 1 LITER;1;11500;0;11500;10500;1000;
2021-04-02 12:09:49;8996001301579;MALKIST CKLT KELAPA PACK;1;6500;0;6500;5400;1100;
2021-04-02 12:09:49;8998866105637;EMERON LOVELY MOIST&BRIGHT 200ML;1;7500;0;7500;6475;1025;
2021-04-02 12:09:49;TUSTEL;TUSUK TELINGA;1;1000;0;1000;833;167;
2021-04-02 12:09:49;8999999502409;ROYCO FDS BEEF 9G;8;500;0;4000;3000;1000;
2021-04-02 12:12:06;SOSIS;SO NICE SAPI;3;1000;0;3000;2820;180;
2021-04-02 12:26:40;BRS5;BERAS BUMN 5KG;1;64000;0;64000;50500;13500;
2021-04-02 12:26:40;8992959953136;SWEETY BRONZE L20;1;40000;0;40000;36770;3230;
2021-04-02 12:27:20;8994867000162;ROKOK PUNDIMAS KRETEK16;1;10000;0;10000;8600;1400;
2021-04-02 13:48:31;8934868015031;REXONA DEO LOTION ICE COOL;1;4500;0;4500;3900;600;
2021-04-02 13:48:31;8996001320051;KOPIKO COFFE CANDY;1;6200;0;6200;5600;600;
2021-04-02 13:48:31;8992761139018;ADES 600ML;1;3500;0;3500;2292;1208;
2021-04-02 14:17:56;8998989300261;GUDANG GARAM SURYA 12 FILTER;1;18000;0;18000;16450;1550;
2021-04-02 14:21:21;089686041705;INDOMIE GORENG JUMBO;1;3500;0;3500;3143;357;
2021-04-02 14:21:21;089686043051;INDOMIE COTO MAKASSAR;1;2800;0;2800;2525;275;
2021-04-02 14:21:21;8999999049447;REXONA WMN RO ADVANCED WHITE 45 ML;1;16500;0;16500;14900;1600;
2021-04-02 14:21:21;8998866202244;EKOMIE BUMBU KALDU AYAM;5;1000;0;5000;3990;1010;
2021-04-02 14:50:04;8997218380135;ICHITAN GREEN TEA;1;8000;0;8000;6583;1417;
2021-04-02 14:50:04;8998866202343;MIE SEDAAP KOREAN SPICY;1;2500;0;2500;2023;477;
2021-04-02 15:05:53;8998866202343;MIE SEDAAP KOREAN SPICY;1;2500;0;2500;2023;477;
2021-04-02 15:13:50;089686043204;INDOMIE MIE ACEH;1;2700;0;2700;2452;248;
2021-04-02 15:13:50;089686011036;INDOMIE GORENG PEDAS;1;2700;0;2700;2452;248;
2021-04-02 15:13:50;8998866202619;MIE SEDAAP KOREAN SPICY SOUP;1;2500;0;2500;2273;227;
2021-04-02 15:13:50;8998866202343;MIE SEDAAP KOREAN SPICY;1;2500;0;2500;2023;477;
2021-04-02 15:54:12;8998866500708;FLORIDINA ORANGE;1;3000;0;3000;2500;500;
2021-04-02 15:54:12;8992753182206;FF MILKY CKLT 180ML;1;4500;0;4500;3250;1250;
2021-04-02 15:54:12;8992753184200;FF MILKY STRY 180ML;1;4500;0;4500;3250;1250;
2021-04-02 15:54:12;8991102987639;WFR TANGO LONG VNL 130G;1;5000;0;5000;3773;1227;
2021-04-02 15:54:12;8991001780133;TWISTER BLACK;1;5000;0;5000;4600;400;
2021-04-02 15:54:12;8991001503107;CHACHA PEANUT 35GR;1;5500;0;5500;4900;600;
2021-04-02 15:54:12;MARS;MARSHMELLOW;1;500;0;500;433;67;
2021-04-02 16:04:18;8998866201841;GOLDA DOLCE LATTE 200ML;1;3000;0;3000;2500;500;
2021-04-02 16:32:08;SST;SUPERSTAR;5;1000;0;5000;4580;420;
2021-04-02 16:32:08;8991001121400;SILVERQUEEN ALMOND 65G;1;15000;0;15000;13200;1800;
2021-04-02 17:14:03;8998989110167;SURYA GUDANG GARAM 16 FILTER;1;24000;0;24000;22100;1900;
2021-04-02 17:43:36;8998866100243;KODOMO TP GRAPE TUBE 45G;1;5200;0;5200;4700;500;
2021-04-02 17:43:36;8999908284907;MY BABY MINYAK TELON 90ML;1;25000;0;25000;22700;2300;
2021-04-02 17:43:36;8991102385336;TANGO WAFFLE MILK;1;8000;0;8000;6212;1788;
2021-04-02 17:43:36;8999999707835;CLOSEUP GREEN 65G;1;7000;0;7000;6000;1000;
2021-04-02 17:43:36;RAINBOW;MINICOCO RAINBOW;7;500;0;3500;3150;350;
2021-04-02 17:43:36;8998009010590;ULTRA CHO 125;2;3000;0;6000;4856;1144;
2021-04-02 17:43:36;KJ;KINDER JOY;2;2000;0;4000;3166;834;
2021-04-02 18:01:43;8993324850449;BABY LOVE COTTON BUDS;1;5000;0;5000;4500;500;
2021-04-02 18:01:43;8996001355985;BENG-BENG SHARE IT;1;27000;0;27000;25000;2000;
2021-04-02 18:01:43;089686048704;SARIMIE GORENG AYAM KCP ISI 2;1;3500;0;3500;3120;380;
2021-04-02 18:01:43;089686017748;SARIMIE GORENG ISI 2;1;3500;0;3500;3120;380;
2021-04-02 18:01:43;8998866501026;MINYAK GORENG SEDAAP POUCH 1 L;1;15000;0;15000;14110;890;
2021-04-02 18:01:43;8997218380074;ICHITAN MILK TEA;1;8000;0;8000;6583;1417;
2021-04-02 18:01:43;8992959508916;SWEETY SILVER PANTS XXL 18;1;54500;0;54500;49546;4954;
2021-04-02 18:01:43;SF BOX;SAFFANAH ROTI BOX;1;12000;0;12000;10500;1500;
2021-04-02 18:36:34;089686043273;INDOMIE SAMBAL RICA;1;2700;0;2700;2452;248;
2021-04-02 18:36:34;8992761139018;ADES 600ML;1;3500;0;3500;2292;1208;
2021-04-02 18:36:34;8998989300261;GUDANG GARAM SURYA 12 FILTER;1;18000;0;18000;16450;1550;
2021-04-02 18:37:15;8998866501033;MINYAK GORENG SEDAAP POUCH 2L;1;28000;0;28000;27746;254;
2021-04-02 18:46:59;8996001600399;LE MINERAL 1500ML;1;5000;0;5000;4042;958;
2021-04-02 19:04:10;8995333032113;TERIGU GATOT KACA 1 KG;1;8500;0;8500;8012;488;
2021-04-02 19:04:10;8998866501033;MINYAK GORENG SEDAAP POUCH 2L;1;28000;0;28000;27746;254;
2021-04-02 19:19:53;8997009510055;YOU C1000;1;8000;0;8000;4846;3154;
2021-04-02 19:19:53;8998009010590;ULTRA CHO 125;1;3000;0;3000;2428;572;
2021-04-02 19:22:37;8996001312353;MALKIST KELAPA KOPYOR;1;6700;0;6700;5400;1300;
2021-04-02 19:22:37;8998989110167;SURYA GUDANG GARAM 16 FILTER;1;24000;0;24000;22100;1900;
2021-04-02 19:22:37;SF SOSIS;SAFFANAH ROTI SOSIS;1;6000;0;6000;5500;500;
2021-04-02 19:22:37;8991002103764;GOOD DAY CAPPUCINO 10X25G;1;1500;0;1500;1395;105;
2021-04-02 19:37:46;YP;YUPI;8;250;0;2000;1664;336;
2021-04-02 19:37:46;8992742360844;POLITEX SABUT STENLESS;2;4000;0;8000;4400;3600;
2021-04-02 20:08:02;8998989300261;GUDANG GARAM SURYA 12 FILTER;1;18000;0;18000;16450;1550;
2021-04-03 11:15:26;8998866803694;SOKLIN SOFTERGENT PURPLE BAG 770 & PIRING;1;18000;0;18000;16680;1320;
2021-04-03 11:15:26;8999999531492;MOLTO GLAMOUR;1;5000;0;5000;4800;200;
2021-04-03 11:15:26;BTS;BIMURA TARO SEAWEED 250G;1;10000;0;10000;9300;700;
2021-04-03 11:15:26;SF SOSIS;SAFFANAH ROTI SOSIS;5;6000;0;30000;27500;2500;
2021-04-03 11:15:26;8998866501033;MINYAK GORENG SEDAAP POUCH 2L;2;28000;0;56000;55492;508;
2021-04-03 11:15:26;BALON;BALON CABUTR;1;1000;0;1000;900;100;
2021-04-03 11:15:26;ff;FULLO BLASTO;1;1000;0;1000;995;5;
2021-04-03 11:15:26;8999999524838;SUNLIGHT MINT POUCH 755ML;1;17000;0;17000;15400;1600;
2021-04-03 11:15:26;8999999500665;RINSO MOLTO ROSE FRESH PWD 1,8KG;1;44700;0;44700;40726;3974;
2021-04-03 11:15:26;8993176110074;MINYAK KAYU PUTIH 60ML;1;20000;0;20000;17333;2667;
2021-04-03 11:15:26;8999999526856;MOLTO ALL IN ONE BLUE 11ML;1;5500;0;5500;4800;700;
2021-04-03 11:15:26;8934868015024;REXONA DEO LOTION FREE SPIRIT 9G;1;4500;0;4500;3900;600;
2021-04-03 11:15:26;8992222050418;GATSBY NORMAL 38GR;1;5000;0;5000;3850;1150;
2021-04-03 11:15:26;8998866603553;SOKLIN FLOORCLENER UNGU 900ML;1;14000;0;14000;12436;1564;
2021-04-03 11:15:26;8996001305003;SARI GANDUM SANDWICH;1;6000;0;6000;5100;900;
2021-04-03 11:15:26;8992388133345;NU MILK TEA TEH TARIK 330ML;1;6000;0;6000;5125;875;
2021-04-03 11:31:53;8996001600399;LE MINERAL 1500ML;1;5000;0;5000;4042;958;
2021-04-03 12:46:09;SF TAWAR KUPAS;SAFFANAH ROTI TAWAR KUPAS;1;10000;0;10000;9000;1000;
2021-04-03 13:07:05;8997009510055;YOU C1000;1;8000;0;8000;4846;3154;
2021-04-03 14:13:12;8998866600101;CREAM EKONOMI LEMON 455G;1;5500;0;5500;4750;750;
2021-04-03 14:13:12;8993379200855;SABUN HARMONY STRAWBERRY 70G;1;2000;0;2000;1652;348;
2021-04-03 14:36:00;8997218380074;ICHITAN MILK TEA;1;8000;0;8000;6583;1417;
2021-04-03 14:36:00;8992761002022;SPRITE PET 390ML;1;5500;0;5500;4300;1200;
2021-04-03 14:38:06;GL;GULA 1 LITER;1;11500;0;11500;10500;1000;
2021-04-03 15:30:34;8998989300261;GUDANG GARAM SURYA 12 FILTER;1;18000;0;18000;16450;1550;
2021-04-03 15:38:55;8992959971109;SFX COMFORT SLIM 36CM 12+1;1;16500;0;16500;15152;1348;
2021-04-03 15:46:07;8992761145033;FANTA STRAW PET 250ML;1;3500;0;3500;2417;1083;
2021-04-03 15:46:07;8992761122331;FRESTEA APPEL 500ML;1;6500;0;6500;4708;1792;
2021-04-03 15:54:34;8992761166205;FRESTEA GREEN HONEY 350ML;1;4500;0;4500;3000;1500;
2021-04-03 17:21:40;8992761166212;FRESTEA APPLE 350ML;1;4500;0;4500;3000;1500;
2021-04-03 17:21:40;8997009510055;YOU C1000;1;8000;0;8000;4846;3154;
2021-04-03 17:21:40;8991001780133;TWISTER BLACK;1;5000;0;5000;4600;400;
2021-04-03 17:21:40;SF TAWAR COKLAT;SAFFANAH ROTI TAWAR COKLAT;1;13500;0;13500;12000;1500;
2021-04-03 17:21:40;8994834003752;TICTIC;1;2000;0;2000;1700;300;
2021-04-03 17:21:40;8998866201483;POTABEE REGULER GRILLED SEAWEED 35GR;1;5000;0;5000;4150;850;
2021-04-03 17:21:40;8998866201469;POTABEE REGULER BBQ BEEF 68 GR;1;8000;0;8000;7200;800;
2021-04-03 17:22:38;MADU;MADU FLORES;1;135000;0;135000;130000;5000;
2021-04-03 17:22:38;8998989110167;SURYA GUDANG GARAM 16 FILTER;2;24000;0;48000;44200;3800;
2021-04-03 19:47:46;BTS;BIMURA TARO SEAWEED 250G;2;10000;0;20000;18600;1400;
2021-04-03 19:47:46;8991102385060;TANGO WAFFLE CHOX;1;8000;0;8000;6212;1788;
2021-04-03 19:47:46;8998866102605;KODOMO TB REG 2IN1;1;7500;0;7500;6600;900;
2021-04-03 19:47:46;SF TAWAR ORI;SAFFANAH TAWAR ORI;1;9000;0;9000;8000;1000;
2021-04-03 19:47:46;8999999524722;SUNLIGHT LIME NEW PCH 435ML;1;10000;0;10000;9100;900;
2021-04-03 19:47:46;8992959117569;SFX DS REG FLOW NW 8;1;4000;0;4000;3530;470;
2021-04-03 19:47:46;8992946511790;SHINZUI 85G;1;5000;0;5000;3475;1525;
2021-04-03 19:47:46;8992736980164;SASA TEPUNG KENTUCKY 80G;1;3000;0;3000;2181;819;
2021-04-03 19:47:46;8998866501033;MINYAK GORENG SEDAAP POUCH 2L;1;28000;0;28000;27746;254;
2021-04-03 19:47:46;8994834003752;TICTIC;3;2000;0;6000;5100;900;
2021-04-03 19:47:46;8991102385091;WFR TANGO CKLT 7G;1;8300;0;8300;7455;845;
2021-04-03 19:47:46;8991102385336;TANGO WAFFLE MILK;1;8000;0;8000;6212;1788;
2021-04-03 19:47:46;SF TAWAR COKLAT;SAFFANAH ROTI TAWAR COKLAT;1;13500;0;13500;12000;1500;
2021-04-03 19:47:46;8999999549138;CLEAR HIJAB AD SHP HF TMT 160ML;1;25000;0;25000;23870;1130;
2021-04-03 19:47:46;089686043051;INDOMIE COTO MAKASSAR;2;2800;0;5600;5050;550;
2021-04-03 19:47:46;6907992823904;JD CRUNCHY CHOCOLATE VAN;1;8000;0;8000;6800;1200;
2021-04-07 10:23:51;SF TAWAR KUPAS;SAFFANAH ROTI TAWAR KUPAS;1;10000;0;10000;9000;1000;
2021-04-07 10:23:51;8992753102204;BKM COKLAT 370G;1;11300;0;11300;9500;1800;
2021-04-07 10:45:47;8997028590014;ARGUS 220ML;4;500;0;2000;1208;792;
2021-04-07 10:45:47;8998866200851;NOODLE SEDAAP MIE BAKSO SPESIAL CUP 77 GR;1;4500;0;4500;3650;850;
2021-04-07 10:47:36;8994834003752;TICTIC;1;2000;0;2000;1700;300;
2021-04-07 10:47:36;6907992823676;JD PEACH;2;2000;0;4000;3400;600;
2021-04-07 10:53:12;6907992823935;JD SWEETCORN;1;3500;0;3500;3000;500;
2021-04-07 11:17:25;BTS;BIMURA TARO SEAWEED 250G;1;10000;0;10000;9300;700;
2021-04-07 11:17:25;8992946511790;SHINZUI 85G;1;5000;0;5000;3475;1525;
2021-04-07 11:35:27;GL;GULA 1 LITER;1;11500;0;11500;10500;1000;
2021-04-07 11:36:19;8998989500166;GUDANG GARAM MERAH BESAR 16KS;1;17000;0;17000;15300;1700;
2021-04-07 12:55:20;8992761164539;NUTRIBOOST ORANGE 300ML;2;6500;0;13000;10600;2400;
2021-04-07 12:55:20;8992761145026;SPRITE PET 250ML;3;3500;0;10500;7251;3249;
2021-04-07 14:41:49;YP;YUPI;10;250;0;2500;2080;420;
2021-04-07 14:41:49;8992696404441;BEAR BRAND 189ML;1;8500;0;8500;7887;613;
2021-04-07 14:41:49;8994834005923;SPIX 1000;1;1000;0;1000;850;150;
2021-04-07 14:41:49;TG;TEH GELAS;1;1000;0;1000;729;271;
2021-04-07 14:41:49;TUSTEL;TUSUK TELINGA;1;1000;0;1000;833;167;
2021-04-07 14:41:49;YOUTOP;YOUTOP;1;1000;0;1000;875;125;
2021-04-07 14:57:39;GL;GULA 1 LITER;2;11500;0;23000;21000;2000;
2021-04-07 14:59:35;ff;FULLO BLASTO;3;1000;0;3000;2985;15;
2021-04-07 14:59:35;PRG;PARAGO;8;500;0;4000;3200;800;
2021-04-07 15:05:54;8996001600269;LE MINERAL 600ML;1;3000;0;3000;1688;1312;
2021-04-07 15:42:05;8999999042646;RINSO MOLTO ROSE FRESH LIQ 40ML;1;5500;0;5500;4817;683;
2021-04-07 15:42:05;8998866202343;MIE SEDAAP KOREAN SPICY;2;2500;0;5000;4046;954;
2021-04-07 15:42:05;089686010107;INDOMIE KALDU AYAM;2;2500;0;5000;4300;700;
2021-04-07 16:17:50;6921101219235;YAKUAT JELLY;1;2000;0;2000;1750;250;
2021-04-07 16:17:50;6907992823676;JD PEACH;1;2000;0;2000;1700;300;
2021-04-07 16:45:31;8993365140356;MADU KURMA TJ 150G;3;14800;0;44400;40290;4110;
2021-04-07 16:45:31;8999999001209;LIFEBUOY BW MILDCARE LD REFF 450 ML;1;25000;0;25000;22110;2890;
2021-04-07 16:51:29;8997028590014;ARGUS 220ML;4;500;0;2000;1208;792;
2021-04-07 16:51:47;8996001600375;LE MINERAL 330ML;1;2000;0;2000;1417;583;
2021-04-07 16:51:47;9556001025272;NESCAFE LATTE 240ML;1;8500;0;8500;7437;1063;
2021-04-07 17:42:01;8999999519872;DOVE DEO WMN RO POMEGRANATE 40 ML;1;16500;0;16500;15000;1500;
2021-04-07 17:42:01;8998866606158;NUVO ACTIVE COOL 110G;2;3000;0;6000;5200;800;
2021-04-07 17:42:01;SF TAWAR COKLAT;SAFFANAH ROTI TAWAR COKLAT;2;13500;0;27000;24000;3000;
2021-04-07 17:43:54;SF TAWAR ORI;SAFFANAH TAWAR ORI;1;9000;0;9000;8000;1000;
2021-04-07 17:43:54;GL;GULA 1 LITER;1;11500;0;11500;10500;1000;
2021-04-07 17:45:42;089686021219;INTER MIE GORENG;1;1000;0;1000;885;115;
2021-04-07 17:45:42;8998866202770;MIE SEDAAP SALERO PADANG;3;2500;0;7500;7086;414;
2021-04-07 17:45:42;8998866200578;MIE SEDAAP KARI KENTAL;1;2500;0;2500;2263;237;
2021-04-07 18:43:04;ARG;ARGUS 220ML;1;14500;0;14500;12500;2000;
2021-04-07 18:43:04;8998866501026;MINYAK GORENG SEDAAP POUCH 1 L;1;15000;0;15000;14110;890;
2021-04-07 18:43:04;bb;BENG-BENG;2;1500;0;3000;2900;100;
2021-04-07 19:15:02;bb;BENG-BENG;1;1500;0;1500;1450;50;
2021-04-07 19:15:15;8998866201964;MINYAK GORENG SABRINA 2L POUCH;1;27500;0;27500;26753;747;
2021-04-07 19:16:22;8992775001653;GERY SALUT CHOCOLATE COCONUT;1;2000;0;2000;1476;524;
2021-04-07 19:35:24;8997028590014;ARGUS 220ML;4;500;0;2000;1208;792;
2021-04-07 19:48:09;8991001121615;SILVERQUEEN NUT;1;15000;0;15000;13200;1800;
2021-04-07 20:13:11;8998989300261;GUDANG GARAM SURYA 12 FILTER;1;18000;0;18000;16450;1550;
2021-04-07 21:00:03;8993989311279;CLAS MILD 12;1;17000;0;17000;15700;1300;
2021-04-07 21:14:52;8991002105409;KOPI KAPAL API;1;20000;0;20000;18888;1112;
2021-04-07 21:30:34;8994867007161;ROKOK PENA GOLD 20;1;17000;0;17000;15000;2000;
2021-04-07 21:30:34;8996001305126;ARDEN;1;18000;0;18000;16300;1700;
2021-04-07 21:30:34;001;PASEO SMART FACIAL SF 250S GT;1;10000;0;10000;9500;500;
2021-04-07 21:30:34;8996001301142;ROMA KELAPA;1;8000;0;8000;6628;1372;
2021-04-07 21:30:34;8991115012021;BB STRAWBERRY CREAM;1;8500;0;8500;7600;900;
2021-04-07 21:30:34;8991102228053;TEH GELAS BOTOL;1;3000;0;3000;1922;1078;
2021-04-07 21:30:34;8992388133345;NU MILK TEA TEH TARIK 330ML;1;6000;0;6000;5125;875;
2021-04-07 21:30:34;8996001305041;ROMA SANDWICH CKLT;1;7000;0;7000;5000;2000;
2021-04-07 21:30:34;SNTN;SANTAN BUBUK;1;2500;0;2500;1500;1000;
2021-04-07 21:30:34;8998989300261;GUDANG GARAM SURYA 12 FILTER;2;18000;0;36000;32900;3100;
2021-04-07 21:30:34;8991102384841;WFR TANGO LONG CKLT 130G;1;5000;0;5000;3773;1227;
2021-04-07 21:30:34;8992761166038;MMP ORANGE 300ML;1;5000;0;5000;3750;1250;
2021-04-07 21:30:34;8992761145019;COCA COLA PET 250ML;1;3500;0;3500;2417;1083;
2021-04-07 21:30:34;8992761139018;ADES 600ML;2;3500;0;7000;4584;2416;
2021-04-07 21:30:34;8998866202770;MIE SEDAAP SALERO PADANG;2;2500;0;5000;4724;276;
2021-04-07 21:30:34;ARG;ARGUS 220ML;1;14500;0;14500;12500;2000;
2021-04-07 21:30:34;ff;FULLO BLASTO;1;1000;0;1000;995;5;
2021-04-07 21:30:34;SF TAWAR ORI;SAFFANAH TAWAR ORI;1;9000;0;9000;8000;1000;
2021-04-07 21:30:34;8997018250218;JAHE MERAH;1;1000;0;1000;833;167;
2021-04-07 21:30:34;8998866202343;MIE SEDAAP KOREAN SPICY;1;2500;0;2500;2023;477;
2021-04-07 21:30:34;8998866202619;MIE SEDAAP KOREAN SPICY SOUP;1;2500;0;2500;2273;227;
2021-04-07 21:45:35;8998989500166;GUDANG GARAM MERAH BESAR 16KS;3;17000;0;51000;45900;5100;
2021-04-07 21:45:35;SOSIS;SO NICE SAPI;1;1000;0;1000;940;60;
2021-04-07 21:45:35;8997021870892;HOT IN CREAM STRONG 120G;1;18500;0;18500;17000;1500;
2021-04-07 21:45:35;8991004011906;KOPI BORONG;1;10000;0;10000;8333;1667;
2021-04-07 21:45:35;8994834003752;TICTIC;1;2000;0;2000;1700;300;
2021-04-07 21:45:35;089686041705;INDOMIE GORENG JUMBO;1;3500;0;3500;3143;357;
2021-04-07 21:45:35;8999999059781;SUNLIGHT LIME NEW POUCH 210ML;1;5000;0;5000;4300;700;
2021-04-07 21:45:35;8886013213208;FRENCH FREIS 2000;1;5000;0;5000;3750;1250;
2021-04-07 21:45:35;6907992825069;JD FRUITY;1;5000;0;5000;4400;600;
2021-04-07 21:45:35;8999999034726;PONDS MEN WHITE BOOST 50G;1;18500;0;18500;17160;1340;
2021-04-07 21:45:35;8991102385336;TANGO WAFFLE MILK;1;8000;0;8000;6212;1788;
2021-04-07 21:45:35;8996001440049;ENERGEN;4;1500;0;6000;4800;1200;
2021-04-07 21:45:35;8996001304143;SLAI OLAI NANAS;1;12000;0;12000;9900;2100;
2021-04-07 21:45:35;8999999552473;PEPSODENT ACTION123 SIWAK 65G;1;6200;0;6200;5600;600;
2021-04-07 21:45:35;8991102384841;WFR TANGO LONG CKLT 130G;1;5000;0;5000;3773;1227;
2021-04-07 21:45:35;8997218380135;ICHITAN GREEN TEA;1;8000;0;8000;6583;1417;
2021-04-07 21:45:35;8993007003063;ENAAK 500G;1;11000;0;11000;9625;1375;
2021-04-07 21:45:35;8998866200882;SUKSESMIE GORENG AYAM KRMS 133GR;1;3500;0;3500;3047;453;
2021-04-07 21:45:35;089686021141;INTER MIE SOTO;1;1000;0;1000;854;146;
2021-04-07 21:45:35;8998866202619;MIE SEDAAP KOREAN SPICY SOUP;1;2500;0;2500;2273;227;
2021-04-07 21:45:35;TG APEL;TEH GELAS APEL;1;2000;0;2000;1178;822;
2021-04-07 21:45:35;8993470279651;JOGER CHOCKY BAR;1;1000;0;1000;867;133;
2021-04-07 21:45:35;JGR SHN;JOGER SHINY SACHET;1;500;0;500;437;63;
2021-04-07 21:45:35;8996001370063;CHOKI-CHOKI;1;18200;0;18200;16500;1700;
2021-04-07 21:45:35;8851019210193;POCKY CHOCO BANANA 47G;1;7300;0;7300;5671;1629;
2021-04-07 21:45:35;8992775001660;WAFER CREAM COKLAT TABUR KEJU;1;19000;0;19000;17721;1279;
2021-04-07 21:45:35;8992696404441;BEAR BRAND 189ML;1;8500;0;8500;7887;613;
2021-04-07 21:45:35;BALON;BALON CABUTR;2;1000;0;2000;1800;200;
2021-04-07 21:45:35;8992946511790;SHINZUI 85G;1;5000;0;5000;3475;1525;
2021-04-07 21:45:35;8999999024772;VASELINE HW PERFECT 10 100 ML;1;19000;0;19000;17600;1400;
2021-04-07 21:45:35;8991111109121;JB POWDER BLOSSOM 75+25G;1;6000;0;6000;5430;570;
2021-04-07 21:45:35;8998989300261;GUDANG GARAM SURYA 12 FILTER;2;18000;0;36000;32900;3100;
2021-04-07 21:45:35;123124;KOREK BIASA;1;2000;0;2000;1800;200;
2021-04-07 21:50:14;8997027300089;NOMOS;1;4000;0;4000;2963;1037;
2021-04-07 21:50:14;8999909096004;SAMPOERNA 16 FILTER;1;24000;0;24000;23000;1000;
2021-04-07 21:50:14;ff;FULLO BLASTO;1;1000;0;1000;995;5;
2021-04-07 21:50:14;11;PASEO SMART FHSTD PERF 6P 12S;1;5000;0;5000;4264;736;
2021-04-07 21:50:14;8998866609487;SOKLIN SOFTERGEN 280G;1;5000;0;5000;4425;575;
2021-04-07 21:50:14;8998866604512;FRES&NATURAL SOAP VIOLET 65G;2;1800;0;3600;2850;750;
2021-04-07 21:50:14;8998866501033;MINYAK GORENG SEDAAP POUCH 2L;1;28000;0;28000;27746;254;
2021-04-07 22:03:09;BTS;BIMURA TARO SEAWEED 250G;1;10000;0;10000;9300;700;
2021-04-07 22:03:09;8993989311279;CLAS MILD 12;1;17000;0;17000;15700;1300;
2021-04-07 22:03:09;8996001600269;LE MINERAL 600ML;1;3000;0;3000;1688;1312;
2021-04-07 22:03:09;8992761111533;SPRITE SLIM CAM250ML;2;5000;0;10000;7500;2500;
2021-04-07 22:03:09;HT;HOT-HOT;1;500;0;500;350;150;
2021-04-07 22:03:09;8994834005923;SPIX 1000;7;1000;0;7000;5950;1050;
2021-04-07 22:03:09;SOSIS;SO NICE SAPI;3;1000;0;3000;2820;180;
2021-04-07 22:03:09;8992696404441;BEAR BRAND 189ML;1;8500;0;8500;7887;613;
2021-04-07 22:03:09;8997009510055;YOU C1000;2;8000;0;16000;9692;6308;
2021-04-07 22:03:09;8997218380135;ICHITAN GREEN TEA;1;8000;0;8000;6583;1417;
2021-04-07 22:03:09;089686021219;INTER MIE GORENG;3;1000;0;3000;2655;345;
2021-04-07 22:03:09;8996001312278;MALKIST KEJU MANIS;1;6500;0;6500;5400;1100;
2021-04-07 22:03:09;YP;YUPI;2;250;0;500;416;84;
2021-04-07 22:03:09;kp;KALPA;2;2000;0;4000;3332;668;
2021-04-07 22:03:09;VTM;VITAMIN;6;500;0;3000;2550;450;
2021-04-07 22:03:09;8993226365522;GARAM MEJA GYURI 200GR;2;2000;0;4000;3400;600;
2021-04-07 22:03:09;8992717781001;NATA DE COCO;3;13000;0;39000;36249;2751;
2021-04-07 22:03:09;8993007003063;ENAAK 500G;2;11000;0;22000;19250;2750;
2021-04-07 22:03:09;8994021000915;CINCAO;6;3000;0;18000;11748;6252;
2021-04-07 22:03:09;8997011700345;MIE KERING LANGIT BIRU;1;23000;0;23000;21000;2000;
2021-04-07 22:03:09;YOUTOP;YOUTOP;1;1000;0;1000;875;125;
2021-04-07 22:03:09;8993379152017;SABUN CUCI SURYA 200G;1;3000;0;3000;2281;719;
2021-04-07 22:03:09;6921101219235;YAKUAT JELLY;1;2000;0;2000;1750;250;
2021-04-07 22:03:09;8998989300261;GUDANG GARAM SURYA 12 FILTER;1;18000;0;18000;16450;1550;
2021-04-07 22:03:09;ff;FULLO BLASTO;1;1000;0;1000;995;5;
2021-04-07 22:03:09;8994867000179;ROKOK PENA MILD 16;1;14500;0;14500;13000;1500;
2021-04-07 22:03:09;MARS;MARSHMELLOW;1;500;0;500;433;67;
2021-04-07 22:03:09;8998009010590;ULTRA CHO 125;1;3000;0;3000;2428;572;
2021-04-07 22:03:09;6907992823652;JD CHOCOLATE MILKSHAKE;3;6000;0;18000;15600;2400;
2021-04-07 22:03:09;8991102989312;WFR TANGO SBJ 7G;1;8300;0;8300;7455;845;
2021-04-07 22:03:09;8992870311091;SALONPAS;1;6000;0;6000;4806;1194;
2021-04-07 22:10:00;SOSIS;SO NICE SAPI;2;1000;0;2000;1880;120;
2021-04-07 22:10:00;6921101219235;YAKUAT JELLY;2;2000;0;4000;3500;500;
2021-04-07 22:10:00;8998866202770;MIE SEDAAP SALERO PADANG;4;2500;0;10000;9448;552;
2021-04-07 22:10:00;8991102385060;TANGO WAFFLE CHOX;1;8000;0;8000;6212;1788;
2021-04-07 22:10:00;8991102385336;TANGO WAFFLE MILK;1;8000;0;8000;6212;1788;
2021-04-07 22:10:00;JGR;JOGER CHOCKY PASTA;1;20000;0;20000;18190;1810;
2021-04-07 22:10:00;PUL;PULPEN;5;1500;0;7500;4165;3335;
2021-04-07 22:10:00;6907992825069;JD FRUITY;1;5000;0;5000;4400;600;
2021-04-07 22:10:00;8996001603376;ENERGEN KURMA;1;2000;0;2000;1500;500;
2021-04-07 22:10:00;VTM;VITAMIN;1;500;0;500;425;75;
2021-04-07 22:10:00;8998866202244;EKOMIE BUMBU KALDU AYAM;1;1000;0;1000;798;202;
2021-04-07 22:10:00;8996001305126;ARDEN;1;18000;0;18000;16300;1700;
2021-04-07 22:10:00;8999999524722;SUNLIGHT LIME NEW PCH 435ML;1;10000;0;10000;9100;900;
2021-04-07 22:10:00;GL;GULA 1 LITER;2;11500;0;23000;21000;2000;
2021-04-07 22:10:00;8999999401221;RINSO ANTI NODA CLASSIC 430G;1;10800;0;10800;9806;994;
2021-04-07 22:10:00;8998989300261;GUDANG GARAM SURYA 12 FILTER;1;18000;0;18000;16450;1550;
2021-04-07 22:29:31;MOBIL;GULA GULA HP;1;2000;0;2000;1700;300;
2021-04-07 22:29:31;8998989110167;SURYA GUDANG GARAM 16 FILTER;1;24000;0;24000;22100;1900;
2021-04-07 22:29:31;8996001305041;ROMA SANDWICH CKLT;1;7000;0;7000;5000;2000;
2021-04-07 22:29:31;8998989500166;GUDANG GARAM MERAH BESAR 16KS;1;17000;0;17000;15300;1700;
2021-04-07 22:29:31;8998866202671;NOODLE SEDAAP MIE KOREAN SPICY SOUP CUP;1;5000;0;5000;4002;998;
2021-04-07 22:29:31;089686048704;SARIMIE GORENG AYAM KCP ISI 2;1;3500;0;3500;3120;380;
2021-04-07 22:29:31;8999999559045;SUNLIGHT LIME CREAM 110G;1;2000;0;2000;1800;200;
2021-04-07 22:29:31;8998866202404;NOODLE SEDAAP MIE KOREAN SPICY CHICKEN CUP;1;5000;0;5000;4002;998;
2021-04-07 22:29:31;8992628020152;BIMOLI POUCH 2L;1;30000;0;30000;28983;1017;
2021-04-07 22:29:31;8996001600399;LE MINERAL 1500ML;1;5000;0;5000;4042;958;
2021-04-07 22:29:31;SOSIS;SO NICE SAPI;2;1000;0;2000;1880;120;
2021-04-07 22:29:31;8998866202244;EKOMIE BUMBU KALDU AYAM;5;1000;0;5000;3990;1010;
2021-04-07 22:29:31;8993176110074;MINYAK KAYU PUTIH 60ML;1;20000;0;20000;17333;2667;
2021-04-07 22:29:31;SONICE;SONICE SOSIS AYAM;1;24000;0;24000;23500;500;
2021-04-07 22:29:31;8998866202732;MILKU STROBERI 200ML;1;3000;0;3000;2375;625;
2021-04-07 22:29:31;GL;GULA 1 LITER;1;11500;0;11500;10500;1000;
2021-04-07 22:29:31;8999999037765;PEPSODENT WHITE 225G;1;12000;0;12000;10750;1250;
2021-04-07 22:29:31;8999999529550;CLEAR COMPLETE SOFT CARE 80ML;1;11200;0;11200;10120;1080;
2021-04-07 22:29:31;8991102022347;SIKAT GIGI FORMULA RIPPLE;1;5000;0;5000;4583;417;
2021-04-07 22:29:31;8991102384841;WFR TANGO LONG CKLT 130G;2;5000;0;10000;7546;2454;
2021-04-07 22:29:31;8993083929806;BISKITOP COKLAT;1;30000;0;30000;27000;3000;
2021-04-07 22:29:31;001;PASEO SMART FACIAL SF 250S GT;1;10000;0;10000;9500;500;
2021-04-07 22:29:31;BTS;BIMURA TARO SEAWEED 250G;1;10000;0;10000;9300;700;
2021-04-07 22:29:31;8992705045122;AGAR-AGAR SATELIT HIJAU;1;3500;0;3500;2604;896;
2021-04-07 22:29:31;8992705035123;AGAR-AGAR SATELIT COKLAT;1;3500;0;3500;2604;896;
2021-04-07 22:29:31;8992705025124;AGAR-AGAR SATELIT MERAH;1;3500;0;3500;2604;896;
2021-04-07 22:29:31;8998866610087;JAVANA ORIGINAL 350ML;1;3000;0;3000;2150;850;
2021-04-07 22:29:31;8992696405486;DNCO FULL CREAM 400G;1;42000;0;42000;39537;2463;
2021-04-07 22:29:31;8996001305003;SARI GANDUM SANDWICH;1;6000;0;6000;5100;900;
2021-04-07 22:29:31;8998866200301;MIE SEDAAP GORENG;3;2500;0;7500;6069;1431;
2021-04-07 22:29:31;8992761122331;FRESTEA APPEL 500ML;1;6500;0;6500;4708;1792;
2021-04-07 22:29:31;JGR SHN;JOGER SHINY SACHET;1;500;0;500;437;63;
2021-04-07 22:29:31;089686043051;INDOMIE COTO MAKASSAR;2;2800;0;5600;5050;550;
2021-04-07 22:29:31;8999999059316;LIFEBOUY TS MILDCARE 75G;1;3000;0;3000;2500;500;
2021-04-07 22:29:31;8995333032113;TERIGU GATOT KACA 1 KG;1;8500;0;8500;8012;488;
2021-04-07 22:29:31;FUZO;KUACI FUZO;1;1000;0;1000;850;150;
2021-04-07 22:29:31;8999999195656;SARI WANGI 50X1.85;1;10000;0;10000;8700;1300;
2021-04-07 22:29:31;8994834003752;TICTIC;1;2000;0;2000;1700;300;
2021-04-07 22:29:31;8998866202060;POTABEE AYAM BAKAR PEDAS 35 GR;1;5000;0;5000;4150;850;
2021-04-07 22:29:31;8999999048167;SUNSILK SHP BLACK SHINE 9ML;1;10500;0;10500;9300;1200;
2021-04-07 22:29:31;8997028590014;ARGUS 220ML;2;500;0;1000;604;396;
2021-04-07 22:29:31;ff;FULLO BLASTO;3;1000;0;3000;2985;15;
2021-04-07 22:39:36;8998866202695;KOPI MAYOR;2;6000;0;12000;9000;3000;
2021-04-07 22:39:36;8993379152017;SABUN CUCI SURYA 200G;1;3000;0;3000;2281;719;
2021-04-07 22:39:36;SF TAWAR ORI;SAFFANAH TAWAR ORI;1;9000;0;9000;8000;1000;
2021-04-07 22:39:36;8992702000018;INDOMILK 370G;1;10000;0;10000;9020;980;
2021-04-07 22:39:36;8992388133017;NU MILK TEA ORI 330ML;1;5000;0;5000;5125;-125;
2021-04-07 22:39:36;8886013213208;FRENCH FREIS 2000;1;5000;0;5000;3750;1250;
2021-04-07 22:39:36;BTS;BIMURA TARO SEAWEED 250G;1;10000;0;10000;9300;700;
2021-04-07 22:39:36;SF BOX;SAFFANAH ROTI BOX;1;12000;0;12000;10500;1500;
2021-04-07 22:39:36;GL;GULA 1 LITER;2;11500;0;23000;21000;2000;
2021-04-07 22:39:36;8997009510116;LEMON WATER;1;7000;0;7000;5694;1306;
2021-04-07 22:39:36;8992761164546;NUTRIBOOST STRAWBERRY 300ML;1;6500;0;6500;5300;1200;
2021-04-11 11:44:43;GL;GULA 1 LITER;2;11500;0;23000;21000;2000;
2021-04-11 11:44:43;8999801700030;SUSU FOYU;3;11500;0;34500;31350;3150;
2021-04-11 11:44:43;8997021300092;LARISSA BAWANG 250GR;1;5500;0;5500;5125;375;
2021-04-11 11:44:43;8992770061034;SAJIKU;2;2000;0;4000;3000;1000;
2021-04-11 11:44:43;089686440287;OPOR AYAM;2;5000;0;10000;9000;1000;
2021-04-11 11:44:43;8850507002968;A1 KING TRUCK;1;16500;0;16500;15500;1000;
2021-04-11 11:44:43;BALON;BALON CABUTR;3;1000;0;3000;2700;300;
2021-04-11 12:09:22;8992959508848;SWEETY SILVER PANTS L 18;1;41500;0;41500;37728;3772;
2021-04-11 12:15:32;089686821086;ICHI OCHA MELATI;1;3000;0;3000;2250;750;
2021-04-11 12:15:32;8998866609487;SOKLIN SOFTERGEN 280G;1;5000;0;5000;4425;575;
2021-04-11 12:15:32;8999999045265;RINSO MOLTO ROSE FRESH PWD 770GR;1;21600;0;21600;19338;2262;
2021-04-11 12:15:32;8999999524722;SUNLIGHT LIME NEW PCH 435ML;1;10000;0;10000;9100;900;
2021-04-11 12:15:32;001;PASEO SMART FACIAL SF 250S GT;1;10000;0;10000;9500;500;
2021-04-11 12:15:32;8998989300261;GUDANG GARAM SURYA 12 FILTER;1;18000;0;18000;16450;1550;
2021-04-11 12:15:32;123124;KOREK BIASA;1;2000;0;2000;1800;200;
2021-04-11 12:15:32;089686834055;FREISS JERUK;1;11000;0;11000;8750;2250;
2021-04-11 12:15:32;8993989311279;CLAS MILD 12;1;17000;0;17000;15700;1300;
2021-04-11 12:15:32;GL;GULA 1 LITER;1;11500;0;11500;10500;1000;
2021-04-11 12:15:32;8992775310212;GERY PASTA COKELAT;1;18000;0;18000;16029;1971;
2021-04-11 12:15:32;8998866202237;NOODLE SEDAAP TASTY AYAM GEPREK 124 GR;1;5000;0;5000;4167;833;
2021-04-11 12:15:32;KJ;KINDER JOY;1;2000;0;2000;1583;417;
2021-04-11 12:15:32;8995333060703;TERIGU KOMPAS 1KG;1;10500;0;10500;9816;684;
2021-04-11 12:15:32;HT;HOT-HOT;2;500;0;1000;700;300;
2021-04-11 12:16:11;8999999059309;LIFEBOUY TS TOTAL 10 DG 75G;2;3000;0;6000;5000;1000;
2021-04-11 12:16:11;8997028590014;ARGUS 220ML;1;500;0;500;302;198;
2021-04-11 12:31:47;JGR SHN;JOGER SHINY SACHET;2;500;0;1000;874;126;
2021-04-11 12:31:47;8998989300261;GUDANG GARAM SURYA 12 FILTER;1;18000;0;18000;16450;1550;
2021-04-11 12:31:47;MARS;MARSHMELLOW;4;500;0;2000;1732;268;
2021-04-11 12:31:47;8993989311279;CLAS MILD 12;1;17000;0;17000;15700;1300;
2021-04-11 12:31:47;8996001355237;SUPER STAR;1;11000;0;11000;9900;1100;
2021-04-11 12:31:47;8999999045265;RINSO MOLTO ROSE FRESH PWD 770GR;1;21600;0;21600;19338;2262;
2021-04-11 12:31:47;8999999524722;SUNLIGHT LIME NEW PCH 435ML;1;10000;0;10000;9100;900;
2021-04-11 12:31:47;8993007003063;ENAAK 500G;1;11000;0;11000;9625;1375;
2021-04-11 12:31:47;8999999195649;SARI WANGI 25X1.86G;1;6000;0;6000;5050;950;
2021-04-11 12:31:47;SF TAWAR ORI;SAFFANAH TAWAR ORI;1;9000;0;9000;8000;1000;
2021-04-11 12:31:47;8991004011906;KOPI BORONG;1;10000;0;10000;8333;1667;
2021-04-11 12:31:47;8992388101085;NU GREEN TEA ORIGINAL 330ML;1;3500;0;3500;2854;646;
2021-04-11 12:31:47;SS;SUPER SNAPS;1;1500;0;1500;1333;167;
2021-04-11 12:31:47;TG;TEH GELAS;1;1000;0;1000;729;271;
2021-04-11 12:31:47;8992694247255;ZWITSAL BATH NAT HAIR&BODY 200ML;1;20500;0;20500;18810;1690;
2021-04-11 12:31:47;8999909010567;234 16 FILTER;1;22000;0;22000;21500;500;
2021-04-11 12:31:47;9556001004673;MILO NESTLE MALAYSIA ACTIVE GO;1;85000;0;85000;80000;5000;
2021-04-11 12:32:40;6907992823652;JD CHOCOLATE MILKSHAKE;2;6000;0;12000;10400;1600;
2021-04-11 12:59:58;8998866200578;MIE SEDAAP KARI KENTAL;2;2500;0;5000;4526;474;
2021-04-11 12:59:58;8998866613729;EMERON LOVELY NTRL 100ML;1;3500;0;3500;2900;600;
2021-04-11 12:59:58;8998866808729;ROYALE SOFT WHITE;1;5000;0;5000;4500;500;
2021-04-11 12:59:58;8999999531478;MOLTO BLACK PURPLE;1;5500;0;5500;4800;700;
2021-04-11 12:59:58;8998989500128;GUDANG GARAM MERAH KECIL 12KS;2;13000;0;26000;23800;2200;
2021-04-11 12:59:58;8999999706180;PEPSODENT WHITE 190GR;2;10000;0;20000;18700;1300;
2021-04-11 12:59:58;8886013213208;FRENCH FREIS 2000;2;5000;0;10000;7500;2500;
2021-04-11 12:59:58;001;PASEO SMART FACIAL SF 250S GT;1;10000;0;10000;9500;500;
2021-04-11 12:59:58;8999801700030;SUSU FOYU;3;11500;0;34500;31350;3150;
2021-04-11 12:59:58;8998866606158;NUVO ACTIVE COOL 110G;2;3000;0;6000;5200;800;
2021-04-11 12:59:58;8999999526863;MOLTO ALL IN ONE PINK 11ML;1;5500;0;5500;4800;700;
2021-04-11 12:59:58;8998866201841;GOLDA DOLCE LATTE 200ML;1;3000;0;3000;2500;500;
2021-04-11 12:59:58;8999999502393;ROYCO FDS CHICKEN 8G;1;5000;0;5000;4500;500;
2021-04-11 12:59:58;8992736980164;SASA TEPUNG KENTUCKY 80G;2;3000;0;6000;4362;1638;
2021-04-11 12:59:58;8992736025162;SASA TEPUNG PISANG GORENG;1;5000;0;5000;4455;545;
2021-04-11 12:59:58;8992742360844;POLYTEX SABUT STENLESS;2;4000;0;8000;4400;3600;
2021-04-11 12:59:58;8992761139018;ADES 600ML;1;3500;0;3500;2292;1208;
2021-04-11 12:59:58;VTM;VITAMIN;1;500;0;500;425;75;
2021-04-11 12:59:58;8997018250218;JAHE MERAH;2;1000;0;2000;1666;334;
2021-04-11 12:59:58;8994834005923;SPIX 1000;5;1000;0;5000;4250;750;
2021-04-11 12:59:58;8999999558086;RINSO MOLTO FERFUME ESSENSE PWD 44G;6;1000;0;6000;4830;1170;
2021-04-11 12:59:58;8997028590014;ARGUS 220ML;4;500;0;2000;1208;792;
2021-04-11 12:59:58;8998866202770;MIE SEDAAP SALERO PADANG;1;2500;0;2500;2362;138;
2021-04-11 12:59:58;8991102987639;WFR TANGO LONG VNL 130G;1;5000;0;5000;3773;1227;
2021-04-11 12:59:58;8992775001653;GERY SALUT CHOCOLATE COCONUT;1;2000;0;2000;1476;524;
2021-04-11 12:59:58;8998989300261;GUDANG GARAM SURYA 12 FILTER;1;18000;0;18000;16450;1550;
2021-04-11 12:59:58;8998866608718;DAIA SOFTENER PINK;1;5000;0;5000;4450;550;
2021-04-11 12:59:58;MOLTO PINK;MOLTO ALL IN ONE 11 ML;4;500;0;2000;1600;400;
2021-04-11 12:59:58;8995333060703;TERIGU KOMPAS 1KG;1;10500;0;10500;9816;684;
2021-04-11 12:59:58;GL;GULA 1 LITER;2;11500;0;23000;21000;2000;
2021-04-11 12:59:58;8991004011906;KOPI BORONG;1;10000;0;10000;8333;1667;
2021-04-11 12:59:58;089686043051;INDOMIE COTO MAKASSAR;2;2800;0;5600;5050;550;
2021-04-11 12:59:58;089686010107;INDOMIE KALDU AYAM;2;2500;0;5000;4300;700;
2021-04-11 12:59:58;8996001302323;MALKIST ABON;1;6500;0;6500;4800;1700;
2021-04-11 12:59:58;8996001301579;MALKIST CKLT KELAPA PACK;1;6500;0;6500;5400;1100;
2021-04-11 12:59:58;8996001305041;ROMA SANDWICH CKLT;1;7000;0;7000;5000;2000;
2021-04-11 12:59:58;8996001301142;ROMA KELAPA;1;8000;0;8000;6628;1372;
2021-04-11 12:59:58;8996001312353;MALKIST KELAPA KOPYOR;1;6700;0;6700;5400;1300;
2021-04-11 12:59:58;8992775312469;GERY SALUT COKELAT;1;11000;0;11000;9983;1017;
2021-04-11 12:59:58;089686821086;ICHI OCHA MELATI;1;3000;0;3000;2250;750;
2021-04-11 13:01:42;8997021870892;HOT IN CREAM STRONG 120G;1;18500;0;18500;17000;1500;
2021-04-11 13:01:42;089686400816;SAMBAL EXTRA PEDAS 135ML;1;5500;0;5500;4950;550;
2021-04-11 13:01:42;8998866608008;KECAP MANIS SEDAAP BOTOL 135 ML;1;6500;0;6500;5875;625;
2021-04-11 14:01:56;MRC;MERICA LADA;6;1000;0;6000;5334;666;
2021-04-11 14:01:56;8996001305041;ROMA SANDWICH CKLT;1;7000;0;7000;5000;2000;
2021-04-11 14:01:56;8996001301142;ROMA KELAPA;1;8000;0;8000;6628;1372;
2021-04-11 14:01:56;8991102281430;PERMEN MINTZ DUOMINT;1;4500;0;4500;4000;500;
2021-04-11 14:01:56;001;PASEO SMART FACIAL SF 250S GT;1;10000;0;10000;9500;500;
2021-04-11 14:01:56;8992959117613;SFX DAUN SIRIH WING 1;1;5000;0;5000;4130;870;
2021-04-11 14:01:56;8998866604963;POWDET DAIA LEMON 290GR;1;5000;0;5000;4450;550;
2021-04-11 14:01:56;8999999059781;SUNLIGHT LIME NEW POUCH 210ML;1;5000;0;5000;4300;700;
2021-04-11 14:01:56;8992702000063;INDOMILK COKLAT 370G;1;10000;0;10000;9020;980;
2021-04-11 14:01:56;8992696404441;BEAR BRAND 189ML;1;8500;0;8500;7887;613;
2021-04-11 14:01:56;8999999030186;PEPSODENT ACTION 123 COMPLETE 190G;1;14000;0;14000;13200;800;
2021-04-11 14:01:56;8999999526856;MOLTO ALL IN ONE BLUE 11ML;1;5500;0;5500;4800;700;
2021-04-11 14:01:56;8999999017804;CITRA BW NATURAL WHITE LD 400ML;1;21000;0;21000;19000;2000;
2021-04-11 14:01:56;8998866200325;MIE SEDAAP SOTO;4;2500;0;10000;7808;2192;
2021-04-11 14:01:56;8998866200301;MIE SEDAAP GORENG;2;2500;0;5000;4046;954;
2021-04-11 14:01:56;8998866603546;SOKLIN FLOORCLENER UNGU 450ML;1;7000;0;7000;6385;615;
2021-04-11 14:05:02;8994867007161;ROKOK PENA GOLD 20;1;17000;0;17000;15000;2000;
2021-04-11 14:05:02;8999909096004;SAMPOERNA 16 FILTER;1;24000;0;24000;23000;1000;
2021-04-11 15:12:41;8994834005923;SPIX 1000;2;1000;0;2000;1700;300;
2021-04-11 15:12:41;8992761139018;ADES 600ML;1;3500;0;3500;2292;1208;
2021-04-11 15:12:41;8998866501026;MINYAK GORENG SEDAAP POUCH 1 L;3;15000;0;45000;42330;2670;
2021-04-11 15:12:41;089686010824;INDOMIE GORENG SPESIAL;3;2700;0;8100;7356;744;
2021-04-11 15:12:41;089686017748;SARIMIE GORENG ISI 2;2;3500;0;7000;6240;760;
2021-04-11 15:12:41;JGR SHN;JOGER SHINY SACHET;1;500;0;500;437;63;
2021-04-11 15:12:41;HT;HOT-HOT;2;500;0;1000;700;300;
2021-04-11 15:12:41;SOSIS;SO NICE SAPI;2;1000;0;2000;1880;120;
2021-04-11 15:12:41;SF TAWAR ORI;SAFFANAH TAWAR ORI;1;9000;0;9000;8000;1000;
2021-04-11 15:12:41;9556001047175;NESCAFE ORI 240ML;1;8500;0;8500;7337;1163;
2021-04-11 15:12:41;SF SOSIS;SAFFANAH ROTI SOSIS;2;6000;0;12000;11000;1000;
2021-04-11 15:12:41;089686021219;INTER MIE GORENG;4;1000;0;4000;3540;460;
2021-04-11 15:12:41;8997028590014;ARGUS 220ML;5;500;0;2500;1510;990;
2021-04-11 15:12:41;6907992825069;JD FRUITY;1;5000;0;5000;4400;600;
2021-04-11 15:12:41;8998866610087;JAVANA ORIGINAL 350ML;1;3000;0;3000;2150;850;
2021-04-11 15:12:41;8996001318430;BETTER 1000;1;1000;0;1000;820;180;
2021-04-11 15:42:59;8997013790092;BIMURA KERUPUK BAWANG 25G;1;1000;0;1000;874;126;
2021-04-11 15:42:59;6907992823652;JD CHOCOLATE MILKSHAKE;3;6000;0;18000;15600;2400;
2021-04-11 15:42:59;089686010107;INDOMIE KALDU AYAM;1;2500;0;2500;2150;350;
2021-04-11 15:42:59;089686011036;INDOMIE GORENG PEDAS;1;2700;0;2700;2452;248;
2021-04-11 15:42:59;8998866613699;EMERON LOVELY COOLBRIGHT 100ML;1;4300;0;4300;3800;500;
2021-04-11 15:42:59;8998866108126;POSH HIJAB WINTER MAGIC 150ML;1;19500;0;19500;17500;2000;
2021-04-11 15:42:59;8998866201841;GOLDA DOLCE LATTE 200ML;1;3000;0;3000;2500;500;
2021-04-11 15:42:59;JGR SHN;JOGER SHINY SACHET;4;500;0;2000;1748;252;
2021-04-11 15:42:59;8999999059781;SUNLIGHT LIME NEW POUCH 210ML;1;5000;0;5000;4300;700;
2021-04-11 15:42:59;8996001600375;LE MINERAL 330ML;2;2000;0;4000;2834;1166;
2021-04-11 15:42:59;8999909010567;234 16 FILTER;2;22000;0;44000;43000;1000;
2021-04-11 15:42:59;11222;LEM KOREA;1;9000;0;9000;8000;1000;
2021-04-11 15:42:59;8995102703534;TERASI DUO 6 GR;1;4000;0;4000;3720;280;
2021-04-11 15:42:59;8994867000179;ROKOK PENA MILD 16;1;14500;0;14500;13000;1500;
2021-04-11 15:42:59;8998866608756;SOKLIN SOFTENER TWILIGHT BLUE 14SCH;1;5000;0;5000;4560;440;
2021-04-11 15:42:59;8998866202343;MIE SEDAAP KOREAN SPICY;2;2500;0;5000;4046;954;
2021-04-11 15:42:59;8998866200301;MIE SEDAAP GORENG;3;2500;0;7500;6069;1431;
2021-04-11 15:42:59;089686021127;INTER MIE KALDU;1;1000;0;1000;813;187;
2021-04-11 15:42:59;089686021141;INTER MIE SOTO;2;1000;0;2000;1708;292;
2021-04-11 15:42:59;8997028590014;ARGUS 220ML;14;500;0;7000;4228;2772;
2021-04-11 15:42:59;8997013790108;BIMURA KACANG TELUR 25G;1;1000;0;1000;875;125;
2021-04-11 15:42:59;089686043051;INDOMIE COTO MAKASSAR;1;2800;0;2800;2525;275;
2021-04-11 15:42:59;8999801700030;SUSU FOYU;1;11500;0;11500;10450;1050;
2021-04-11 15:42:59;GL;GULA 1 LITER;1;11500;0;11500;10500;1000;
2021-04-11 15:42:59;8992736980164;SASA TEPUNG KENTUCKY 80G;1;3000;0;3000;2181;819;
2021-04-11 15:42:59;8995333000822;TERIGU KOMPAS SOFT 500GR;1;5500;0;5500;4967;533;
2021-04-11 15:42:59;8999999401238;RINSO ANTI NODA 770G;1;21200;0;21200;19338;1862;
2021-04-11 15:42:59;8999999518998;RINSO MOLTO PERFUME ESSENSE 770GR;1;21300;0;21300;19338;1962;
2021-04-11 15:42:59;8993560026066;DETTOL COOL;1;20000;0;20000;18524;1476;
2021-04-11 15:42:59;8998866603546;SOKLIN FLOORCLENER UNGU 450ML;1;7000;0;7000;6385;615;
2021-04-11 15:42:59;MG;MINYAK GOSOK SAFERTABAT;1;28000;0;28000;25000;3000;
2021-04-11 15:42:59;8999909096004;SAMPOERNA 16 FILTER;1;24000;0;24000;23000;1000;
2021-04-11 15:42:59;8991102987639;WFR TANGO LONG VNL 130G;1;5000;0;5000;3773;1227;
2021-04-11 15:42:59;8999999526863;MOLTO ALL IN ONE PINK 11ML;1;5500;0;5500;4800;700;
2021-04-11 15:42:59;8994867006997;ROKOK PENA BOLD 20BTG;1;17000;0;17000;15000;2000;
2021-04-11 15:42:59;SF TAWAR ORI;SAFFANAH TAWAR ORI;1;9000;0;9000;8000;1000;
2021-04-11 15:42:59;8992753102204;BKM COKLAT 370G;1;11300;0;11300;9500;1800;
2021-04-11 15:42:59;8999999059323;LIFEBOUY LEMONFRESH DG 75G;1;3000;0;3000;2500;500;
2021-04-11 15:42:59;8999999560584;LUX TS VELVET JASMINE 110G;1;4000;0;4000;3100;900;
2021-04-11 15:42:59;8994834005923;SPIX 1000;2;1000;0;2000;1700;300;
2021-04-11 15:42:59;SOSIS;SO NICE SAPI;1;1000;0;1000;940;60;
2021-04-11 15:42:59;8998989300261;GUDANG GARAM SURYA 12 FILTER;1;18000;0;18000;16450;1550;
2021-04-11 15:42:59;8994834003752;TICTIC;1;2000;0;2000;1700;300;
2021-04-11 15:42:59;8992959953334;SWEETY BRONZE XL42;1;80000;0;80000;75455;4545;
2021-04-11 15:42:59;8999909000544;MARLBORO F BLACK;1;29001;0;29001;27800;1201;
2021-04-11 15:42:59;HT;HOT-HOT;1;500;0;500;350;150;
2021-04-11 15:42:59;8993226365522;GARAM MEJA GYURI 200GR;1;2000;0;2000;1700;300;
2021-04-11 15:42:59;8997009510116;LEMON WATER;1;7000;0;7000;5694;1306;
2021-04-11 15:42:59;8998866201377;KRISBEE FRIES KENTANG GORENG 68 GR;1;5500;0;5500;4620;880;
2021-04-11 15:42:59;8998866201711;KRISBEE KRUNCHY JAGUNG BAKAR MENTEGA 75 GR;1;5500;0;5500;4400;1100;
2021-04-11 15:42:59;8998866693578;SOKLIN FLOORCLENER PINK 900ML;1;14000;0;14000;12436;1564;
2021-04-11 15:42:59;8996001355237;SUPER STAR;1;11000;0;11000;9900;1100;
2021-04-11 15:42:59;8996001351901;ZUPER KEJU SUSU;1;17000;0;17000;15500;1500;
2021-04-11 15:42:59;8998866609029;DAIA PUTIH GUSSWET 565G;2;10000;0;20000;17400;2600;
2021-04-11 15:42:59;8998866610278;DAIA VIOLET GUSSET 565G;1;10000;0;10000;8700;1300;
2021-04-11 15:42:59;8995333060772;TERIGU GATOT KACA 500GR;6;4500;0;27000;24390;2610;
2021-04-11 15:42:59;8998866200882;SUKSESMIE GORENG AYAM KRMS 133GR;6;3500;0;21000;18282;2718;
2021-04-11 15:42:59;089686041705;INDOMIE GORENG JUMBO;4;3500;0;14000;12572;1428;
2021-04-11 15:42:59;8999999504656;SARI MURNI 20X1.8G;1;5000;0;5000;4200;800;
2021-04-11 16:06:01;8992761122331;FRESTEA APPEL 500ML;1;6500;0;6500;4708;1792;
2021-04-11 16:21:25;089686021127;INTER MIE KALDU;1;1000;0;1000;813;187;
2021-04-11 16:21:25;8999999707859;CLOSEUP GREEN 160G;1;15000;0;15000;13600;1400;
2021-04-11 16:21:25;8993365131538;MADU TJ MURNI 150G;1;14800;0;14800;13430;1370;
2021-04-11 17:11:29;8992388133345;NU MILK TEA TEH TARIK 330ML;1;6000;0;6000;5125;875;
2021-04-11 17:11:29;8992696404441;BEAR BRAND 189ML;1;8500;0;8500;7887;613;
2021-04-11 17:11:29;SF GULUNG;SAFFANAH ROTI GULUNG;1;6000;0;6000;5500;500;
2021-04-11 18:12:07;8992761002039;FANTA STRAWBERRY PET 390 ML;1;5500;0;5500;4300;1200;
2021-04-11 18:12:47;8992761002039;FANTA STRAWBERRY PET 390 ML;1;5500;0;5500;4300;1200;
2021-04-11 18:13:23;8992761166038;MMP ORANGE 300ML;2;5000;0;10000;7500;2500;
2021-04-11 18:21:27;8993072153595;LARISST COTTON 35G;1;5000;0;5000;3300;1700;
2021-04-11 18:58:30;8992761139018;ADES 600ML;1;3500;0;3500;2292;1208;
2021-04-11 18:58:30;JGR SHN;JOGER SHINY SACHET;3;500;0;1500;1311;189;
2021-04-11 19:04:28;GL;GULA 1 LITER;2;11500;0;23000;21000;2000;
2021-04-11 19:41:14;8997009510116;LEMON WATER;1;7000;0;7000;5694;1306;
2021-04-11 20:28:23;8994867000162;ROKOK PUNDIMAS KRETEK16;2;10000;0;20000;17200;2800;
2021-04-11 20:41:55;8991102380805;FULLO  CKL PCK 8G;1;10000;0;10000;9000;1000;
2021-04-11 20:41:55;8991001121400;SILVERQUEEN ALMOND 65G;1;15000;0;15000;13200;1800;
2021-04-11 20:41:55;KJ;KINDER JOY;3;2000;0;6000;4749;1251;
2021-04-11 21:35:15;8992761166038;MMP ORANGE 300ML;2;5000;0;10000;7500;2500;
2021-04-11 21:45:24;8992761166038;MMP ORANGE 300ML;1;5000;0;5000;3750;1250;
2021-04-11 21:47:11;8992761111519;COCA COLA SLIM CAM 250ML;5;5000;0;25000;18750;6250;
2021-04-11 21:47:11;8992761111540;FANTA STRAWBERY SLIM CAM 250ML;5;5000;0;25000;18750;6250;
2021-04-11 21:47:11;8992761111533;SPRITE SLIM CAM250ML;5;5000;0;25000;18750;6250;
2021-04-11 22:09:10;8992761145026;SPRITE PET 250ML;1;3500;0;3500;2417;1083;
2021-04-11 22:09:20;8999909010567;234 16 FILTER;2;22000;0;44000;43000;1000;
2021-04-12 10:37:41;8999999706111;PEPSODENT WHITE 25G;1;2000;0;2000;1450;550;
2021-04-12 10:37:41;8998866103985;CIPT SIKP;1;3000;0;3000;2552;448;
2021-04-12 10:45:30;8998009010590;ULTRA CHO 125;1;3000;0;3000;2428;572;
2021-04-12 10:45:30;ff;FULLO BLASTO;2;1000;0;2000;1990;10;
2021-04-12 10:45:30;kp;KALPA;1;2000;0;2000;1666;334;
2021-04-12 11:30:43;8992761166205;FRESTEA GREEN HONEY 350ML;1;4500;0;4500;3000;1500;
2021-04-12 11:30:43;VTM;VITAMIN;1;500;0;500;425;75;
2021-04-12 12:12:56;8996001355237;SUPER STAR;1;11000;0;11000;9900;1100;
2021-04-12 12:12:56;COKLAT;COKLAT COIN;3;500;0;1500;1200;300;
2021-04-12 12:12:56;MARS;MARSHMELLOW;2;500;0;1000;866;134;
2021-04-12 12:12:56;JGR SHN;JOGER SHINY SACHET;1;500;0;500;437;63;
2021-04-12 12:27:19;8998989500128;GUDANG GARAM MERAH KECIL 12KS;1;13000;0;13000;11900;1100;
2021-04-12 12:27:19;6907992823676;JD PEACH;2;2000;0;4000;3400;600;
2021-04-12 13:12:22;8999909096004;SAMPOERNA 16 FILTER;1;24000;0;24000;23000;1000;
2021-04-12 13:58:11;8998866201933;MINYAK GORENG SEDAAP 5 L;1;72000;0;72000;70230;1770;
2021-04-12 14:00:36;8992717781001;NATA DE COCO;2;13000;0;26000;24166;1834;
2021-04-12 14:00:36;711844130128;ABC SAUS TOMAT 275 ML;1;10000;0;10000;8800;1200;
2021-04-12 14:00:36;711844120419;SAMBAL ABC 275 ML;1;12000;0;12000;10800;1200;
2021-04-12 14:33:02;8992761166205;FRESTEA GREEN HONEY 350ML;1;4500;0;4500;3000;1500;
2021-04-12 15:25:21;8992959117583;SFX DS REG FLOW WING 20;1;5000;0;5000;4288;712;
2021-04-12 15:25:55;8996001350423;ZUPER KEJU;1;9200;0;9200;8360;840;
2021-04-12 16:21:52;8886013213208;FRENCH FREIS 2000;1;5000;0;5000;3750;1250;
2021-04-12 16:21:52;8998866693608;SOKLIN FLOORCLENER HIJAU 900ML;1;14000;0;14000;12436;1564;
2021-04-12 16:21:52;8992702000018;INDOMILK 370G;1;10000;0;10000;9020;980;
2021-04-12 16:21:52;8991001780492;SELAMAT COKLAT;1;13000;0;13000;11800;1200;
2021-04-12 16:21:52;8998866100717;MAMALIME POUCH 780ML;1;15500;0;15500;13850;1650;
2021-04-12 16:39:12;8998866200813;NOODLE SEDAAP MIE GORENG CUP 85 GR;1;5000;0;5000;3917;1083;
2021-04-12 16:55:47;8998866201469;POTABEE REGULER BBQ BEEF 68 GR;1;8000;0;8000;7200;800;
2021-04-12 16:55:47;6907992823867;JD CRUNCHY CHOCOLATE MALT;1;5500;0;5500;4700;800;
2021-04-12 16:55:47;TG;TEH GELAS;2;1000;0;2000;1458;542;
2021-04-12 16:56:39;JGR SHN;JOGER SHINY SACHET;1;500;0;500;437;63;
2021-04-12 17:39:09;GL;GULA 1 LITER;2;11500;0;23000;21000;2000;
2021-04-12 17:39:09;BALON;BALON CABUT;1;1000;0;1000;900;100;
2021-04-12 17:39:09;6921101219235;YAKUAT JELLY;1;2000;0;2000;1750;250;
2021-04-12 18:18:02;SOSIS;SO NICE SAPI;1;1000;0;1000;940;60;
2021-04-12 18:18:02;8994834005923;SPIX 1000;1;1000;0;1000;850;150;
2021-04-12 18:18:02;8996200900092;HEROCYN 85GR;1;13000;0;13000;11650;1350;
2021-04-12 18:18:02;SF SOSIS;SAFFANAH ROTI SOSIS;1;6000;0;6000;5500;500;
2021-04-12 18:18:02;6907992825069;JD FRUITY;1;5000;0;5000;4400;600;
2021-04-12 18:18:02;8998989110167;SURYA GUDANG GARAM 16 FILTER;1;24000;0;24000;22100;1900;
2021-04-12 18:20:13;8998866202671;NOODLE SEDAAP MIE KOREAN SPICY SOUP CUP;2;5000;0;10000;8004;1996;
2021-04-12 18:34:16;8992761145026;SPRITE PET 250ML;1;3500;0;3500;2417;1083;
2021-04-12 18:34:16;COKLAT;COKLAT COIN;1;500;0;500;400;100;
2021-04-12 19:12:50;8998989300261;GUDANG GARAM SURYA 12 FILTER;1;18000;0;18000;16450;1550;
2021-04-12 19:12:50;kp;KALPA;1;2000;0;2000;1666;334;
2021-04-12 20:22:51;8998989500166;GUDANG GARAM MERAH BESAR 16KS;2;17000;0;34000;30600;3400;
2021-04-12 20:24:43;8998009010590;ULTRA CHO 125;1;3000;0;3000;2428;572;
2021-04-12 20:24:43;8992696404441;BEAR BRAND 189ML;1;8500;0;8500;7887;613;
2021-04-12 20:24:43;089686021219;INTER MIE GORENG;3;1000;0;3000;2655;345;
2021-04-12 20:38:02;SF TAWAR PND;SAFFANAH TAWAR PANDAN;1;9500;0;9500;8500;1000;
2021-04-12 20:38:02;8998866102605;KODOMO TB REG 2IN1;1;7500;0;7500;6600;900;
2021-04-12 21:19:15;8992761145019;COCA COLA PET 250ML;2;3500;0;7000;4834;2166;
2021-04-12 21:19:15;8992761166212;FRESTEA APPLE 350ML;1;4500;0;4500;3000;1500;
2021-04-12 21:19:15;8998866500708;FLORIDINA ORANGE;1;3000;0;3000;2500;500;
2021-04-12 22:28:22;GL;GULA 1 LITER;1;11500;0;11500;10500;1000;
2021-04-12 22:29:20;GL;GULA 1 LITER;5;11500;0;57500;52500;5000;
2021-04-12 22:29:20;9556001047175;NESCAFE ORI 240ML;1;8500;0;8500;7337;1163;
2021-04-12 22:29:20;8991102384841;WFR TANGO LONG CKLT 130G;1;5000;0;5000;3773;1227;
2021-04-12 22:29:43;9556001025272;NESCAFE LATTE 240ML;1;8500;0;8500;7437;1063;
2021-04-12 22:29:43;8994834005923;SPIX 1000;1;1000;0;1000;850;150;
2021-04-12 22:31:46;ARG;ARGUS 220ML;10;14500;0;145000;125000;20000;
2021-04-13 11:27:39;8999801700030;SUSU FOYU;1;11500;0;11500;10450;1050;
2021-04-13 11:27:39;8992933214116;NUTRIJELL MELON;1;6000;0;6000;5041;959;
2021-04-13 11:27:39;8992933213119;NUTRIJELL LECI;1;6000;0;6000;5041;959;
2021-04-13 11:27:39;9556001004673;MILO NESTLE MALAYSIA ACTIVE GO;1;85000;0;85000;80000;5000;
2021-04-13 11:27:39;8998866200325;MIE SEDAAP SOTO;2;2500;0;5000;3904;1096;
2021-04-13 13:29:30;9556040040038;SUSU F&N;1;33000;0;33000;30000;3000;
2021-04-13 13:29:30;8992696404441;BEAR BRAND 189ML;1;8500;0;8500;7887;613;
2021-04-13 13:29:30;SF BOX;SAFFANAH ROTI BOX;1;12000;0;12000;10500;1500;
2021-04-13 13:29:30;6907992823591;JD STRAW MILKSHAKE;1;5000;0;5000;4300;700;
2021-04-13 13:29:30;8995333032113;TERIGU GATOT KACA 1 KG;1;8500;0;8500;8012;488;
2021-04-13 13:29:30;8997028590014;ARGUS 220ML;4;500;0;2000;1208;792;
2021-04-13 13:29:30;8992736980164;SASA TEPUNG KENTUCKY 80G;1;3000;0;3000;2181;819;
2021-04-13 13:29:30;8997018250218;JAHE MERAH;1;1000;0;1000;833;167;
2021-04-13 13:29:30;GL;GULA 1 LITER;1;11500;0;11500;10500;1000;
2021-04-13 13:29:30;HT;HOT-HOT;1;500;0;500;350;150;
2021-04-13 13:29:30;BRS;BERAS BUMN 10KG;1;128000;0;128000;100000;28000;
2021-04-13 13:29:30;8991102385091;WFR TANGO CKLT 7G;1;8300;0;8300;7455;845;
2021-04-13 13:29:30;8992761145026;SPRITE PET 250ML;1;3500;0;3500;2417;1083;
2021-04-13 13:29:30;8990800020013;MENTOS MINT HALAL IND;1;5700;0;5700;5150;550;
2021-04-13 14:29:32;8999801700030;SUSU FOYU;1;11500;0;11500;10450;1050;
2021-04-13 14:29:32;8997018720018;SIRUP DHT;1;23000;0;23000;20958;2042;
2021-04-13 14:29:32;8998866607315;SOKLIN SOFTERGENT SAKURA 770G & PIRING;1;18000;0;18000;16680;1320;
2021-04-13 14:29:32;8997211400038;SANTAN COCONUT CREAM;1;4000;0;4000;3000;1000;
2021-04-13 14:29:32;8998008151065;MIWON 100 GR;1;3300;0;3300;2996;304;
2021-04-13 14:29:32;8992628605151;AMANDA MARGARINE;1;5000;0;5000;3806;1194;
2021-04-13 14:34:48;089686021219;INTER MIE GORENG;4;1000;0;4000;3540;460;
2021-04-13 15:03:11;8997211400038;SANTAN COCONUT CREAM;2;4000;0;8000;6000;2000;
2021-04-13 15:03:11;SNTN;SANTAN BUBUK;1;2500;0;2500;1500;1000;
2021-04-13 15:55:35;8997018720018;SIRUP DHT;1;23000;0;23000;20958;2042;
2021-04-13 15:58:22;ARG;ARGUS 220ML;10;14500;0;145000;125000;20000;
2021-04-13 16:23:38;8994867000162;ROKOK PUNDIMAS KRETEK16;1;10000;0;10000;8600;1400;
2021-04-13 16:58:59;8992753101207;BENDERA KENTAL MANIS 370G;1;11500;0;11500;9700;1800;
2021-04-13 16:58:59;8999999052959;PONDS WHITE BEAUTY FACIAL FOAM 50G;1;17000;0;17000;15600;1400;
2021-04-13 16:58:59;8999999538453;SUNSILK SHP SOFT AND  SMOOTH 55 ML;1;5000;0;5000;3750;1250;
2021-04-13 16:58:59;8999999549565;PONDS ROSE MICELLAR WTR 100ML;1;25000;0;25000;22800;2200;
2021-04-13 17:00:33;001;PASEO SMART FACIAL SF 250S GT;1;10000;0;10000;9500;500;
2021-04-13 17:00:33;9556040040038;SUSU F&N;1;33000;0;33000;30000;3000;
2021-04-13 17:00:33;8993007003063;ENAAK 500G;1;11000;0;11000;9625;1375;
2021-04-14 11:25:59;TGL;TEH GELAS DOS;1;20000;0;20000;17496;2504;
2021-04-14 11:40:06;GL;GULA 1 LITER;6;11500;0;69000;63000;6000;
2021-04-14 11:40:06;8998866608459;POWDET DAIA PUTIH BAG 290GR;1;5000;0;5000;4450;550;
2021-04-14 11:40:06;8998866888615;GIV BIRU KOTAK 76G;2;2000;0;4000;3640;360;
2021-04-14 11:40:06;SF SOSIS;SAFFANAH ROTI SOSIS;1;6000;0;6000;5500;500;
2021-04-14 11:55:50;8998989300261;GUDANG GARAM SURYA 12 FILTER;1;18000;0;18000;16450;1550;
2021-04-14 11:55:50;SF SOSIS;SAFFANAH ROTI SOSIS;1;6000;0;6000;5500;500;
2021-04-14 11:55:50;8999999537180;CLEAR SHP LEMON FRESH 9 ML;1;10500;0;10500;9300;1200;
2021-04-14 11:55:50;8998866202664;POTABEE WAGYU BEEF STEAK 68 GR;1;8000;0;8000;7200;800;
2021-04-14 11:55:50;8998866202060;POTABEE AYAM BAKAR PEDAS 35 GR;2;5000;0;10000;8300;1700;
2021-04-14 11:55:50;8886013213208;FRENCH FREIS 2000;1;5000;0;5000;3750;1250;
2021-04-14 11:55:50;8998866202671;NOODLE SEDAAP MIE KOREAN SPICY SOUP CUP;1;5000;0;5000;4002;998;
2021-04-14 11:55:50;8999999007768;FAIR&LOVELY MULTIVITAMIN  CREAM 9 ML;1;4500;0;4500;3200;1300;
2021-04-14 12:02:07;8999999706111;PEPSODENT WHITE 25G;1;2000;0;2000;1450;550;
2021-04-14 12:02:07;8992725910400;LISTERINE COOLMINT 100ML;1;7500;0;7500;6800;700;
2021-04-14 12:02:07;8991111101507;JB POWDER BLOSSOM 50G;1;3500;0;3500;3000;500;
2021-04-14 12:02:07;8998866106504;EMERON LOVELY NAT PINK;1;3500;0;3500;2900;600;
2021-04-14 12:02:07;8991111101316;JB OIL 50ML;1;9500;0;9500;8700;800;
2021-04-14 12:04:53;8992717900310;KARA SUN;1;2500;0;2500;2000;500;
2021-04-14 12:21:12;bb;BENG-BENG;2;1500;0;3000;2900;100;
2021-04-14 12:21:12;8992775001653;GERY SALUT CHOCOLATE COCONUT;1;2000;0;2000;1476;524;
2021-04-14 12:27:34;8997018720018;SIRUP DHT;1;23000;0;23000;20958;2042;
2021-04-14 12:27:34;8996001603376;ENERGEN KURMA;10;2000;0;20000;15000;5000;
2021-04-14 12:27:34;6291100212866;KURMA KHALAS;1;85000;0;85000;80000;5000;
2021-04-14 12:27:34;8996001440087;ENERGEN KACANG HIJAU;10;1500;0;15000;11500;3500;
2021-04-14 12:27:34;8998866200325;MIE SEDAAP SOTO;10;2500;0;25000;19520;5480;
2021-04-14 12:30:38;ARG;ARGUS 220ML;2;14500;0;29000;25000;4000;
2021-04-14 13:59:01;089686010107;INDOMIE KALDU AYAM;5;2500;0;12500;10750;1750;
2021-04-14 13:59:01;089686010824;INDOMIE GORENG SPESIAL;5;2700;0;13500;12260;1240;
2021-04-14 13:59:36;8995333032113;TERIGU GATOT KACA 1 KG;1;8500;0;8500;8012;488;
2021-04-14 13:59:36;8992753031900;BKM SCT PUTIH 40G;1;7500;0;7500;6900;600;
2021-04-14 14:25:12;001;PASEO SMART FACIAL SF 250S GT;1;10000;0;10000;9500;500;
2021-04-14 14:33:37;8999999706111;PEPSODENT WHITE 25G;1;2000;0;2000;1450;550;
2021-04-14 14:33:37;8998866106498;EMERON  LOVELY NTRL VT 100ML;1;3500;0;3500;2900;600;
2021-04-14 14:33:37;8998866610742;NOVO FAMILY PINK 76G;1;2000;0;2000;1820;180;
2021-04-14 14:33:37;8998866103985;CIPT SIKP;1;3000;0;3000;2552;448;
2021-04-14 14:33:37;8991111101507;JB POWDER BLOSSOM 50G;1;3500;0;3500;3000;500;
2021-04-14 14:33:37;089686043273;INDOMIE SAMBAL RICA;1;2700;0;2700;2452;248;
2021-04-14 14:33:37;8992775001042;PILUS GARUDA MI GORENG;1;5500;0;5500;4713;787;
2021-04-14 14:33:37;8992775311325;GERY SNACK&SEREAL 100G;1;7000;0;7000;5892;1108;
2021-04-14 14:35:05;8992761002015;COCA COLA PET 390ML;1;5500;0;5500;4333;1167;
2021-04-14 15:31:37;8998866501033;MINYAK GORENG SEDAAP POUCH 2L;1;28000;0;28000;27746;254;
2021-04-14 16:42:55;8998866201964;MINYAK GORENG SABRINA 2L POUCH;1;27500;0;27500;26753;747;
2021-04-14 16:52:38;001;PASEO SMART FACIAL SF 250S GT;1;10000;0;10000;9500;500;
2021-04-14 18:07:17;8996001301579;MALKIST CKLT KELAPA PACK;1;6500;0;6500;5400;1100;
2021-04-14 18:07:17;8996001302323;MALKIST ABON;1;6500;0;6500;4800;1700;
2021-04-14 18:08:50;8999801700030;SUSU FOYU;1;11500;0;11500;10450;1050;
2021-04-14 18:08:50;8994834005923;SPIX 1000;5;1000;0;5000;4250;750;
2021-04-14 18:09:41;8994834005923;SPIX 1000;1;1000;0;1000;850;150;
2021-04-14 18:12:31;8992761166212;FRESTEA APPLE 350ML;1;4500;0;4500;3000;1500;
2021-04-14 18:12:31;8994834005923;SPIX 1000;3;1000;0;3000;2550;450;
2021-04-14 18:12:31;HT;HOT-HOT;1;500;0;500;350;150;
2021-04-14 18:18:18;8992753102204;BKM COKLAT 370G;1;11300;0;11300;9500;1800;
2021-04-14 18:18:18;8999801700030;SUSU FOYU;2;11500;0;23000;20900;2100;
2021-04-14 18:18:18;8992628010139;BIMOLI 5L;1;75000;0;75000;72100;2900;
2021-04-14 18:25:29;711844610095;LARISSA UDANG 500 GR;2;11000;0;22000;19580;2420;
2021-04-14 19:37:00;GL;GULA 1 LITER;3;11500;0;34500;31500;3000;
2021-04-14 19:37:00;8998866201865;KRISBEE PILLOW CHOCOLAVA 120 GR;1;8000;0;8000;7250;750;
2021-04-14 21:11:41;8992761145019;COCA COLA PET 250ML;1;3500;0;3500;2417;1083;
2021-04-14 21:11:41;PRG;PARAGO;3;500;0;1500;1200;300;
2021-04-14 21:47:12;8998989300261;GUDANG GARAM SURYA 12 FILTER;2;18000;0;36000;32900;3100;
2021-04-14 21:47:12;8994834005923;SPIX 1000;2;1000;0;2000;1700;300;
2021-04-14 21:59:47;8998989110167;SURYA GUDANG GARAM 16 FILTER;2;24000;0;48000;44200;3800;
2021-04-14 21:59:47;8886013213208;FRENCH FREIS 2000;1;5000;0;5000;3750;1250;
2021-04-14 21:59:47;8992388133017;NU MILK TEA ORI 330ML;1;6000;0;6000;5125;875;
2021-04-14 22:01:26;8886013213208;FRENCH FREIS 2000;1;5000;0;5000;3750;1250;
2021-04-14 22:01:26;8851019210117;POCKY CHOCOLATE 47G;1;7300;0;7300;5671;1629;
2021-04-14 22:01:26;8991001770301;SELAMAT CLACK VANILA;1;13000;0;13000;11800;1200;
2021-04-14 22:01:26;8991001502933;CHACHA TUBE;2;7500;0;15000;12800;2200;
2021-04-15 13:56:17;8996001320051;KOPIKO COFFE CANDY;1;6200;0;6200;5600;600;
2021-04-15 15:24:43;001;PASEO SMART FACIAL SF 250S GT;1;10000;0;10000;9500;500;
2021-04-15 15:33:10;8996001600269;LE MINERAL 600ML;1;3000;0;3000;1688;1312;
2021-04-15 15:33:10;8998866603546;SOKLIN FLOORCLENER UNGU 450ML;1;7000;0;7000;6385;615;
2021-04-15 15:33:10;8993470279651;JOGER CHOCKY BAR;3;1000;0;3000;2601;399;
2021-04-15 15:33:10;8997021300092;LARISSA BAWANG 250GR;2;5500;0;11000;10250;750;
2021-04-15 15:33:10;711844610064;LARISSA SINGKONG 250GR;1;5000;0;5000;4545;455;
2021-04-15 15:33:10;8997002060168;KRP SINGKOG PDS PANDA DUO;1;8000;0;8000;7300;700;
2021-04-15 15:33:10;8992753102303;BKM SCT CKLT 40G;2;7500;0;15000;13800;1200;
2021-04-15 15:33:10;711844610095;LARISSA UDANG 500 GR;1;11000;0;11000;9790;1210;
2021-04-15 15:33:10;089686041705;INDOMIE GORENG JUMBO;2;3500;0;7000;6286;714;
2021-04-15 15:33:10;8993007000680;INDOMILK 1L;1;16500;0;16500;14792;1708;
2021-04-15 15:33:10;8998898830125;KKB ENER-G ANGGUR;4;5500;0;22000;19296;2704;
2021-04-15 15:33:10;8999999524722;SUNLIGHT LIME NEW PCH 435ML;1;10000;0;10000;9100;900;
2021-04-15 15:33:10;8999999037765;PEPSODENT WHITE 225G;1;12000;0;12000;10750;1250;
2021-04-15 15:33:10;8999999030179;PEPSODENT ACTION 123 COMPLETE 75G;1;6700;0;6700;5170;1530;
2021-04-15 15:33:10;18998866103982;CIPTADENT TB CRYSTAL CLEAN MED;1;3000;0;3000;2585;415;
2021-04-15 15:33:10;8998866888622;GIV MERAH KOTAK 76G;1;2000;0;2000;1820;180;
2021-04-15 15:57:29;8999999045616;MOLTO AIO PINK SCH;6;1000;0;6000;4800;1200;
2021-04-15 15:57:29;8993176110135;MINYAK TELON LANG 30ML;1;10000;0;10000;8167;1833;
2021-04-15 15:57:29;8992694247255;ZWITSAL BATH NAT HAIR&BODY 200ML;1;20500;0;20500;18810;1690;
2021-04-15 15:57:29;8996001350850;SUPER STAR SNAPS;1;16300;0;16300;14800;1500;
2021-04-15 15:57:29;8992775312469;GERY SALUT COKELAT;1;11000;0;11000;9983;1017;
2021-04-15 15:57:29;8998866608725;DAIA SOFTENER BAG 850G;1;18000;0;18000;15627;2373;
2021-04-15 16:01:28;8998866107495;ZINC HAIRFALL TREATH SHT 10ML;1;5000;0;5000;4500;500;
2021-04-15 16:01:28;8999999042646;RINSO MOLTO ROSE FRESH LIQ 40ML;1;5000;0;5000;4817;183;
2021-04-15 16:19:13;8993379254469;SABUN LERVIA 90G;1;3500;0;3500;2966;534;
2021-04-15 16:19:13;8999999036492;LUX BW PINK SOFT BTL 100ML;1;10000;0;10000;8690;1310;
2021-04-15 16:50:29;8991102281430;PERMEN MINTZ DUOMINT;1;4500;0;4500;4000;500;
2021-04-15 17:58:42;8992761139018;ADES 600ML;3;3500;0;10500;6876;3624;
2021-04-15 17:58:42;8996001600269;LE MINERAL 600ML;1;3000;0;3000;1688;1312;
2021-04-15 17:59:39;8999909000377;SAMPOERNA AVOLUTION;1;30000;0;30000;28450;1550;
2021-04-15 18:00:36;8998989300261;GUDANG GARAM SURYA 12 FILTER;1;18000;0;18000;16450;1550;
2021-04-15 18:00:36;123124;KOREK BIASA;1;2000;0;2000;1800;200;
2021-04-15 18:21:52;8998866202671;NOODLE SEDAAP MIE KOREAN SPICY SOUP CUP;2;5000;0;10000;8004;1996;
2021-04-15 18:21:52;089686043051;INDOMIE COTO MAKASSAR;1;2800;0;2800;2525;275;
2021-04-15 18:21:52;JGR SHN;JOGER SHINY SACHET;1;500;0;500;437;63;
2021-04-15 18:21:52;bb;BENG-BENG;1;1500;0;1500;1450;50;
2021-04-15 18:33:14;8996001600269;LE MINERAL 600ML;1;3000;0;3000;1688;1312;
2021-04-15 19:02:23;8997028590014;ARGUS 220ML;2;500;0;1000;604;396;
2021-04-15 19:02:23;JGR SHN;JOGER SHINY SACHET;2;500;0;1000;874;126;
2021-04-15 21:28:19;8998989300261;GUDANG GARAM SURYA 12 FILTER;1;18000;0;18000;16450;1550;
2021-04-15 21:50:04;8999909096004;SAMPOERNA 16 FILTER;1;24000;0;24000;23000;1000;
2021-04-15 21:59:27;8992959953082;SWEETY BRONZE L8;1;17000;0;17000;15380;1620;
2021-04-15 22:09:43;8999999520151;PEPSODENT TB FAMILY SOFT;1;2100;0;2100;1900;200;
2021-04-15 22:09:43;8999999706111;PEPSODENT WHITE 25G;1;2000;0;2000;1450;550;
2021-04-15 22:30:00;6907992823904;JD CRUNCHY CHOCOLATE VAN;1;8000;0;8000;6800;1200;
2021-04-15 22:30:00;6907992823867;JD CRUNCHY CHOCOLATE MALT;1;5500;0;5500;4700;800;
2021-04-15 22:30:00;6907992823843;JD MOCHA CRISPY;1;5000;0;5000;4400;600;
2021-04-15 22:31:08;SOSIS;SO NICE SAPI;2;1000;0;2000;1880;120;
2021-04-15 22:31:08;8991111101408;JB POWSER 50G;1;3500;0;3500;3000;500;
2021-04-15 22:31:08;8992759120264;LARISST 220;1;10000;0;10000;9200;800;
2021-04-15 22:31:08;8992761164539;NUTRIBOOST ORANGE 300ML;1;6500;0;6500;5300;1200;
2021-04-15 22:32:26;8999999048266;SUNSILK SHP SOFT&SMTH 170ML;1;19900;0;19900;18150;1750;
2021-04-16 11:39:58;8992628020152;BIMOLI POUCH 2L;1;30000;0;30000;29000;1000;
2021-04-16 11:39:58;GL;GULA 1 LITER;2;11500;0;23000;21000;2000;
2021-04-16 11:39:58;711844150027;ABC NANAS;1;15000;0;15000;12241;2759;
2021-04-16 11:39:58;8995333060703;TERIGU KOMPAS 1KG;1;10500;0;10500;9816;684;
2021-04-16 11:39:58;8993083929806;BISKITOP COKLAT;1;30000;0;30000;27000;3000;
2021-04-16 11:47:33;GL;GULA 1 LITER;15;11500;0;172500;157500;15000;
2021-04-16 11:58:28;8999801700030;SUSU FOYU;3;11500;0;34500;31350;3150;
2021-04-16 11:58:28;JGR;JOGER CHOCKY PASTA;1;20000;0;20000;18190;1810;
2021-04-16 11:58:28;8998899995120;BAYGON TEA BLOSSOM;1;38000;0;38000;35000;3000;
2021-04-16 11:58:28;711844150027;ABC NANAS;3;15000;0;45000;36723;8277;
2021-04-16 11:58:28;8998866202619;MIE SEDAAP KOREAN SPICY SOUP;2;2500;0;5000;4546;454;
2021-04-16 11:58:28;8850507001152;MOTU ATV;1;10000;0;10000;8000;2000;
2021-04-16 11:58:28;8998866693660;SOKLIN FLOORCLENER KUNING 900ML;1;14000;0;14000;12436;1564;
2021-04-16 11:58:28;8999999528881;CITRA HBL NAT GLOWING WHITE UV;1;20000;0;20000;17703;2297;
2021-04-16 12:01:46;8992761164546;NUTRIBOOST STRAWBERRY 300ML;1;6500;0;6500;5300;1200;
2021-04-16 12:03:01;8995333060703;TERIGU KOMPAS 1KG;2;10500;0;21000;19632;1368;
2021-04-16 12:38:54;8999999027056;LIFEBUOY ANTI KETOMBE 9ML;1;5000;0;5000;4500;500;
2021-04-16 12:38:54;8999999045623;MOLTO AIO BLUE SCH;5;1000;0;5000;4000;1000;
2021-04-16 12:38:54;8999999558062;RINSO ANTI NODA CLASSIC PWD 44G;5;1000;0;5000;4025;975;
2021-04-16 12:38:54;8999999050009;SUNLIGHT LIME NEW POUCH 95ML;2;2000;0;4000;3200;800;
2021-04-16 12:38:54;8999999059781;SUNLIGHT LIME NEW POUCH 210ML;3;5000;0;15000;12900;2100;
2021-04-16 12:38:54;711844610095;LARISSA UDANG 500 GR;1;11000;0;11000;9790;1210;
2021-04-16 12:38:54;8992628022156;BIMOLI KLASIK TOUCH 1 LT;1;15500;0;15500;14350;1150;
2021-04-16 12:38:54;001;PASEO SMART FACIAL SF 250S GT;1;10000;0;10000;9500;500;
2021-04-16 12:38:54;8999999017804;CITRA BW NATURAL WHITE LD 400ML;1;21000;0;21000;19000;2000;
2021-04-16 12:38:54;8992770034175;MASAKO 100GR;1;5000;0;5000;3500;1500;
2021-04-16 12:38:54;8995333060703;TERIGU KOMPAS 1KG;1;10500;0;10500;9816;684;
2021-04-16 12:38:54;GL;GULA 1 LITER;1;11500;0;11500;10500;1000;
2021-04-16 12:56:59;GL;GULA 1 LITER;4;11500;0;46000;42000;4000;
2021-04-16 12:56:59;8999999502393;ROYCO FDS CHICKEN 8G;1;5000;0;5000;4500;500;
2021-04-16 13:29:06;8992959953334;SWEETY BRONZE XL42;1;80000;0;80000;75455;4545;
2021-04-16 14:29:50;8998899995120;BAYGON TEA BLOSSOM;1;38000;0;38000;35000;3000;
2021-04-16 14:29:50;8997002060168;KRP SINGKOG PDS PANDA DUO;2;8000;0;16000;14600;1400;
2021-04-16 14:29:50;8995333032113;TERIGU GATOT KACA 1 KG;2;8500;0;17000;16024;976;
2021-04-16 14:29:50;8998866202312;NOODLE SEDAAP TASTY BAKMI AYAM 129 GR;2;5000;0;10000;8334;1666;
2021-04-16 15:29:50;8998866611718;EKONOMI PENCUCI PIRING  LIQ 780ML;1;12000;0;12000;10900;1100;
2021-04-16 15:29:50;8998866107495;ZINC HAIRFALL TREATH SHT 10ML;2;5000;0;10000;9000;1000;
2021-04-16 15:29:50;8993072153595;LARISST COTTON 35G;1;5000;0;5000;3300;1700;
2021-04-16 15:29:50;8999909003439;MARLBORO CRAFTED 12;2;8000;0;16000;10874;5126;
2021-04-16 15:29:50;123124;KOREK BIASA;1;2000;0;2000;1800;200;
2021-04-16 16:54:33;089686834253;FREISS MELON;1;16000;0;16000;14200;1800;
2021-04-16 17:17:14;8996001301579;MALKIST CKLT KELAPA PACK;2;6500;0;13000;10800;2200;
2021-04-16 17:17:14;8992775211434;PILUS GARUDA SAPI PANGGANG;1;5500;0;5500;4713;787;
2021-04-16 17:17:14;8992775211410;PILUS GARUDA PEDAS;1;5500;0;5500;4713;787;
2021-04-16 17:17:14;089686061079;POP MIE MINI AY BAWANG RL;2;3000;0;6000;5404;596;
2021-04-16 17:17:14;8991001780126;SELAMAT CKLAT 60G;4;5000;0;20000;17200;2800;
2021-04-16 17:31:30;8992222091961;PUCELLE MIST COL SPRAY 75ML;1;13000;0;13000;11650;1350;
2021-04-16 17:39:42;8994867000162;ROKOK PUNDIMAS KRETEK16;1;10000;0;10000;8600;1400;
2021-04-16 17:45:15;8996001320136;KOPIKO CAPP CANDY;1;6200;0;6200;5600;600;
2021-04-16 17:48:05;9556040040038;SUSU F&N;1;33000;0;33000;30000;3000;
2021-04-16 17:48:05;8993470671752;JOGER STICK DUO KACANG;1;1000;0;1000;850;150;
2021-04-16 18:05:44;8998866202237;NOODLE SEDAAP TASTY AYAM GEPREK 124 GR;2;5000;0;10000;8334;1666;
2021-04-16 19:27:01;8999999706449;CLOSEUP ICY WHITE 65G;1;9000;0;9000;7865;1135;
2021-04-16 19:38:59;8996001320136;KOPIKO CAPP CANDY;1;6200;0;6200;5600;600;
2021-04-16 21:03:30;8998866610087;JAVANA ORIGINAL 350ML;1;3000;0;3000;2150;850;
2021-04-16 21:30:55;8998866200882;SUKSESMIE GORENG AYAM KRMS 133GR;1;3500;0;3500;3047;453;
2021-04-16 21:30:55;8994834005923;SPIX 1000;6;1000;0;6000;5100;900;
2021-04-16 21:35:43;8992761147143;SPRITE WATERLYMON 425ML;3;5500;0;16500;12900;3600;
2021-04-16 21:35:43;8992761164539;NUTRIBOOST ORANGE 300ML;1;6500;0;6500;5300;1200;
2021-04-16 21:35:43;8992761164546;NUTRIBOOST STRAWBERRY 300ML;1;6500;0;6500;5300;1200;
2021-04-16 21:44:38;8993571003827;CAP 19 BEDAK SALICYL MENTHOL 100G;2;8000;0;16000;14000;2000;
2021-04-16 21:44:38;8996001301579;MALKIST CKLT KELAPA PACK;2;6500;0;13000;10800;2200;
2021-04-16 21:44:38;8992761145026;SPRITE PET 250ML;1;3500;0;3500;2417;1083;
2021-04-16 22:33:46;9556001025272;NESCAFE LATTE 240ML;1;8500;0;8500;7437;1063;
2021-04-16 22:33:46;8993470279651;JOGER CHOCKY BAR;1;1000;0;1000;867;133;
2021-04-16 22:34:11;123;BETREI JAM;1;5500;0;5500;5000;500;
2021-04-17 11:45:31;SF TAWAR ORI;SAFFANAH TAWAR ORI;1;9000;0;9000;8000;1000;
2021-04-17 11:45:31;8992957214307;SAFARI MECES;1;5500;0;5500;4500;1000;
2021-04-17 11:45:31;8999908284907;MY BABY MINYAK TELON 90ML;1;25000;0;25000;22700;2300;
2021-04-17 11:45:56;SOSIS;SO NICE SAPI;1;1000;0;1000;940;60;
2021-04-17 11:45:56;8998989500166;GUDANG GARAM MERAH BESAR 16KS;1;17000;0;17000;15300;1700;
2021-04-17 12:45:32;8998866200578;MIE SEDAAP KARI KENTAL;2;2500;0;5000;4526;474;
2021-04-17 13:23:22;JGR SHN;JOGER SHINY SACHET;1;500;0;500;437;63;
2021-04-17 13:23:22;COKLAT;COKLAT COIN;1;500;0;500;400;100;
2021-04-17 13:23:22;MARS;MARSHMELLOW;2;500;0;1000;866;134;
2021-04-17 13:23:22;8997218380074;ICHITAN MILK TEA;1;8000;0;8000;6583;1417;
2021-04-17 13:50:52;8998008151065;MIWON 100 GR;4;3300;0;13200;11984;1216;
2021-04-17 13:50:52;8992753102204;BKM COKLAT 370G;2;11300;0;22600;19000;3600;
2021-04-17 13:58:53;8997231980022;O'JELLY MINI STRAWBERRY;1;3000;0;3000;2250;750;
2021-04-17 13:58:53;TUSTEL;TUSUK TELINGA;1;1000;0;1000;833;167;
2021-04-17 13:58:53;SOSIS;SO NICE SAPI;2;1000;0;2000;1880;120;
2021-04-17 13:58:53;8994037703749;WENIS JERUK;1;8000;0;8000;6500;1500;
2021-04-17 16:42:53;089686834307;FREISS LECI;1;11000;0;11000;8750;2250;
2021-04-17 16:42:53;8999999059781;SUNLIGHT LIME NEW POUCH 210ML;1;5000;0;5000;4300;700;
2021-04-17 16:58:38;GL;GULA 1 LITER;10;11500;0;115000;105000;10000;
2021-04-17 17:01:54;8992959053232;CONFIDENCE CLLASIC NIGHT M8;1;42000;0;42000;38182;3818;
2021-04-17 17:03:39;8992775211410;PILUS GARUDA PEDAS;1;5500;0;5500;4713;787;
2021-04-17 17:03:39;8996001301142;ROMA KELAPA;1;8000;0;8000;6628;1372;
2021-04-17 17:03:39;8996001600399;LE MINERAL 1500ML;1;5000;0;5000;4042;958;
2021-04-17 17:50:04;711844610095;LARISSA UDANG 500 GR;4;11000;0;44000;39160;4840;
2021-04-17 17:50:04;8998989500166;GUDANG GARAM MERAH BESAR 16KS;1;17000;0;17000;15300;1700;
2021-04-17 18:57:04;8992775001660;WAFER CREAM COKLAT TABUR KEJU;1;19000;0;19000;17721;1279;
2021-04-17 18:57:04;8992761145026;SPRITE PET 250ML;1;3500;0;3500;2417;1083;
2021-04-17 18:57:04;8851019210117;POCKY CHOCOLATE 47G;1;7300;0;7300;5671;1629;
2021-04-17 20:08:31;8998866201520;KOPI TOP TORAJA MURNI;1;11000;0;11000;9600;1400;
2021-04-17 20:12:20;8992761145026;SPRITE PET 250ML;2;3500;0;7000;4834;2166;
2021-04-17 20:57:39;8998866201520;KOPI TOP TORAJA MURNI;1;11000;0;11000;9600;1400;
2021-04-17 20:58:16;8997028590014;ARGUS 220ML;2;500;0;1000;604;396;
2021-04-17 21:03:36;8999909000544;MARLBORO F BLACK;1;29001;0;29001;27800;1201;
2021-04-17 21:03:36;123124;KOREK BIASA;1;2000;0;2000;1800;200;
2021-04-18 11:58:40;8992696404441;BEAR BRAND 189ML;1;8500;0;8500;7887;613;
2021-04-18 11:58:40;BTS;BIMURA TARO SEAWEED 250G;1;10000;0;10000;9300;700;
2021-04-18 11:58:40;8998866610278;DAIA VIOLET GUSSET 565G;1;10000;0;10000;8700;1300;
2021-04-18 11:58:40;711844140059;ABC SAUS TIRAM 135 ML;1;8500;0;8500;7750;750;
2021-04-18 11:58:40;GL;GULA 1 LITER;10;11500;0;115000;105000;10000;
2021-04-18 11:58:40;8998866501033;MINYAK GORENG SEDAAP POUCH 2L;4;28000;0;112000;110984;1016;
2021-04-18 11:58:40;089686010107;INDOMIE KALDU AYAM;10;2500;0;25000;21500;3500;
2021-04-18 12:56:35;089686021127;INTER MIE KALDU;1;1000;0;1000;813;187;
2021-04-18 12:56:35;8993470411433;JOGER CLASSIC;1;1000;0;1000;850;150;
2021-04-18 12:56:35;8997028590014;ARGUS 220ML;2;500;0;1000;604;396;
2021-04-18 13:51:54;9999;ISOLASI LAKBAN;1;8000;0;8000;6500;1500;
2021-04-18 13:51:54;001;PASEO SMART FACIAL SF 250S GT;2;10000;0;20000;19000;1000;
2021-04-18 15:20:15;8999801700030;SUSU FOYU;1;11500;0;11500;10450;1050;
2021-04-18 15:20:15;JGR SHN;JOGER SHINY SACHET;1;500;0;500;437;63;
2021-04-18 16:03:46;8998866501033;MINYAK GORENG SEDAAP POUCH 2L;1;28000;0;28000;27746;254;
2021-04-18 16:17:06;8998989300261;GUDANG GARAM SURYA 12 FILTER;1;18000;0;18000;16450;1550;
2021-04-18 16:17:06;8996001301142;ROMA KELAPA;1;8000;0;8000;6628;1372;
2021-04-18 16:58:23;8993365121539;MADU TJ SUPER 150G;1;16800;0;16800;15220;1580;
2021-04-18 17:55:38;8998989300261;GUDANG GARAM SURYA 12 FILTER;1;18000;0;18000;16450;1550;
2021-04-18 18:58:05;8997231980022;O'JELLY MINI STRAWBERRY;2;3000;0;6000;4500;1500;
2021-04-18 21:29:20;6921101219235;YAKUAT JELLY;1;2000;0;2000;1750;250;
2021-04-18 21:39:08;8991004011906;KOPI BORONG;1;10000;0;10000;8333;1667;
2021-04-18 21:39:53;8991188943536;SASA SANTAN KELAPA 65ML;1;3000;0;3000;2437;563;
2021-04-18 22:03:14;8997231980022;O'JELLY MINI STRAWBERRY;1;3000;0;3000;2250;750;
2021-04-18 22:03:14;8994420107789;SARDEN SAUS TOMAT;1;7000;0;7000;5833;1167;
2021-04-18 22:03:14;TG APEL;TEH GELAS APEL;1;2000;0;2000;1178;822;
2021-04-18 22:03:14;ff;FULLO BLASTO;1;1000;0;1000;995;5;
2021-04-18 22:03:14;SF TAWAR COKLAT;SAFFANAH ROTI TAWAR COKLAT;1;13500;0;13500;12000;1500;
2021-04-19 11:18:03;8996001320136;KOPIKO CAPP CANDY;1;6200;0;6200;5600;600;
2021-04-19 11:18:03;8994021000915;CINCAO;3;3000;0;9000;5874;3126;
2021-04-19 11:18:03;8999999059316;LIFEBOUY TS MILDCARE 75G;3;3000;0;9000;7500;1500;
2021-04-19 11:18:03;8999999531508;MOLTO HYGIENE SC 10ML;2;500;0;1000;960;40;
2021-04-19 14:56:19;8992775712603;MYTEA POCI OOLONG;1;5000;0;5000;4410;590;
2021-04-19 15:06:39;8997231980022;O'JELLY MINI STRAWBERRY;1;3000;0;3000;2250;750;
2021-04-19 16:28:13;8998989500166;GUDANG GARAM MERAH BESAR 16KS;2;17000;0;34000;30600;3400;
2021-04-19 16:28:13;GL;GULA 1 LITER;1;11500;0;11500;10500;1000;
2021-04-19 16:39:05;8992775110140;GARUDA KACANG KULIT 160G;1;12000;0;12000;10012;1988;
2021-04-19 16:39:05;8998866202343;MIE SEDAAP KOREAN SPICY;1;2500;0;2500;2023;477;
2021-04-19 16:58:01;8997009510116;LEMON WATER;1;7000;0;7000;5694;1306;
2021-04-19 17:18:28;089686834055;FREISS JERUK;1;11000;0;11000;8750;2250;
2021-04-19 17:18:28;GL;GULA 1 LITER;2;11500;0;23000;21000;2000;
2021-04-19 17:18:28;8999999504656;SARI MURNI 20X1.8G;1;5000;0;5000;4200;800;
2021-04-19 17:38:19;8998989300261;GUDANG GARAM SURYA 12 FILTER;1;18000;0;18000;16450;1550;
2021-04-19 18:11:37;8992761164539;NUTRIBOOST ORANGE 300ML;1;6500;0;6500;5300;1200;
2021-04-19 18:11:37;8992761164546;NUTRIBOOST STRAWBERRY 300ML;1;6500;0;6500;5300;1200;
2021-04-19 18:18:40;8999909010567;234 16 FILTER;1;22000;0;22000;21500;500;
2021-04-19 18:19:54;8998989500128;GUDANG GARAM MERAH KECIL 12KS;1;13000;0;13000;11900;1100;
2021-04-19 18:57:45;8999999531492;MOLTO GLAMOUR;1;5000;0;5000;4800;200;
2021-04-19 18:57:45;8998989300261;GUDANG GARAM SURYA 12 FILTER;1;18000;0;18000;16450;1550;
2021-04-19 18:57:45;123124;KOREK BIASA;1;2000;0;2000;1800;200;
2021-04-19 18:59:01;TUSTEL;TUSUK TELINGA;1;1000;0;1000;833;167;
2021-04-19 19:19:10;8991102281416;PERMEN MINTZ PPMINT;1;4500;0;4500;4000;500;
2021-04-19 19:22:45;kp;KALPA;1;2000;0;2000;1666;334;
2021-04-19 21:08:27;8999999524722;SUNLIGHT LIME NEW PCH 435ML;1;10000;0;10000;9100;900;
2021-04-19 21:20:30;8996001318911;BETTER ISI 4;1;2000;0;2000;1700;300;
2021-04-19 21:20:30;089686043051;INDOMIE COTO MAKASSAR;1;2800;0;2800;2525;275;
2021-04-19 21:20:30;8997018250218;JAHE MERAH;2;1000;0;2000;1666;334;
2021-04-19 21:25:22;34678;SENDAL JEPIT;1;15000;0;15000;13500;1500;
2021-04-19 21:25:22;8998866613262;SUKSESMIE SOTO 111 GR;1;3500;0;3500;2770;730;
2021-04-19 21:28:31;8996001600375;LE MINERAL 330ML;1;2000;0;2000;1417;583;
2021-04-19 21:28:31;9556001174659;MILO ACT GO 240ML;1;8500;0;8500;7437;1063;
2021-04-19 21:28:31;8998866201483;POTABEE REGULER GRILLED SEAWEED 35GR;1;5000;0;5000;4150;850;
2021-04-19 21:34:56;8991102281416;PERMEN MINTZ PPMINT;1;4500;0;4500;4000;500;
2021-04-19 22:29:35;8991102228053;TEH GELAS BOTOL;1;3000;0;3000;1695;1305;
2021-04-19 22:29:35;BRS;BERAS BUMN 10KG;1;128000;0;128000;100000;28000;
2021-04-20 12:51:53;GLK;GULATA 50KG;1;620000;0;620000;592000;28000;
2021-04-20 12:51:53;8998866501026;MINYAK GORENG SEDAAP POUCH 1 L;12;15000;0;180000;169320;10680;
2021-04-20 12:58:11;GL;GULA 1 LITER;1;11500;0;11500;10500;1000;
2021-04-20 12:58:11;8998866607315;SOKLIN SOFTERGENT SAKURA 770G & PIRING;1;18000;0;18000;16680;1320;
2021-04-20 12:58:11;kp;KALPA;1;2000;0;2000;1666;334;
2021-04-20 12:58:11;8999999559533;LIFEBUOY BW TOTAL 10 90ML;1;5000;0;5000;4000;1000;
2021-04-20 12:58:11;8992959509005;SWEETY SILVER PANTS XL26;1;61500;0;61500;55910;5590;
2021-04-20 12:58:11;8992775203422;GARUDA ROSTA OVEN 100G;1;8000;0;8000;7322;678;
2021-04-20 12:58:11;8850507000094;POLICE BONCHA;1;2000;0;2000;800;1200;
2021-04-20 12:58:11;8997231980022;O'JELLY MINI STRAWBERRY;1;3000;0;3000;2250;750;
2021-04-20 12:58:11;8992696523081;MILO UHT 110ML;1;2500;0;2500;1962;538;
2021-04-20 12:58:11;8995102703534;TERASI DUO 6 GR;2;4000;0;8000;7440;560;
2021-04-20 12:58:11;089686044249;SUPERMI NUTRIMI STEAK AYAM;4;3500;0;14000;11200;2800;
2021-04-20 12:59:10;8996001600269;LE MINERAL 600ML;1;3000;0;3000;1688;1312;
2021-04-20 12:59:10;089686044249;SUPERMI NUTRIMI STEAK AYAM;2;3500;0;7000;5600;1400;
2021-04-20 14:21:43;8996001318430;BETTER 1000;3;1000;0;3000;2460;540;
2021-04-20 14:22:18;8991102228053;TEH GELAS BOTOL;1;3000;0;3000;1695;1305;
2021-04-20 15:31:49;8999999042639;RINSO ANTI NODA CLS LIQ 40ML;1;1000;0;1000;805;195;
2021-04-20 15:31:49;8998866608718;DAIA SOFTENER PINK;1;5000;0;5000;4450;550;
2021-04-20 15:31:49;8998866107495;ZINC HAIRFALL TREATH SHT 10ML;1;5000;0;5000;4500;500;
2021-04-20 15:31:49;8998989300261;GUDANG GARAM SURYA 12 FILTER;1;18000;0;18000;16450;1550;
2021-04-20 15:31:49;8998866611718;EKONOMI PENCUCI PIRING  LIQ 780ML;1;12000;0;12000;10900;1100;
2021-04-20 16:24:17;8992628022156;BIMOLI KLASIK TOUCH 1 LT;1;15500;0;15500;14350;1150;
2021-04-20 16:41:40;9556001004673;MILO NESTLE MALAYSIA ACTIVE GO;1;85000;0;85000;80000;5000;
2021-04-20 17:50:25;8992736025162;SASA TEPUNG PISANG GORENG;1;5000;0;5000;4455;545;
2021-04-20 18:34:26;8993058105013;EXTRA JOSS;1;12000;0;12000;9773;2227;
2021-04-20 19:16:30;8998989500166;GUDANG GARAM MERAH BESAR 16KS;2;17000;0;34000;30600;3400;
2021-04-20 19:16:30;8998989300261;GUDANG GARAM SURYA 12 FILTER;1;18000;0;18000;16450;1550;
2021-04-20 21:42:11;089686021127;INTER MIE KALDU;2;1000;0;2000;1626;374;
2021-04-20 21:42:11;089686043051;INDOMIE COTO MAKASSAR;1;2800;0;2800;2525;275;
2021-04-20 21:42:11;8998866202312;NOODLE SEDAAP TASTY BAKMI AYAM 129 GR;1;5000;0;5000;4167;833;
2021-04-20 21:56:29;8886013213208;FRENCH FREIS 2000;1;5000;0;5000;3750;1250;
2021-04-20 22:42:08;8992696404441;BEAR BRAND 189ML;1;8500;0;8500;7887;613;
2021-04-20 22:42:08;6907992823935;JD SWEETCORN;1;3500;0;3500;3000;500;
2021-04-21 12:41:24;BTS;BIMURA TARO SEAWEED 250G;1;10000;0;10000;9300;700;
2021-04-21 12:41:24;8991102385091;WFR TANGO CKLT 7G;1;8300;0;8300;7455;845;
2021-04-21 12:41:24;8991001780492;SELAMAT COKLAT;1;13000;0;13000;11800;1200;
2021-04-21 12:41:24;8998866500708;FLORIDINA ORANGE;2;3000;0;6000;5000;1000;
2021-04-21 12:42:37;8998866610261;DAIA VIOLET GUSSET BAG 290 GR;1;5000;0;5000;4450;550;
2021-04-21 12:42:37;MOLTO PINK;MOLTO ALL IN ONE 11 ML;2;500;0;1000;800;200;
2021-04-21 13:00:47;8992959953082;SWEETY BRONZE L8;1;17000;0;17000;15380;1620;
2021-04-21 13:03:56;8998989500166;GUDANG GARAM MERAH BESAR 16KS;1;17000;0;17000;15300;1700;
2021-04-21 13:11:12;8850507002951;BONCHA EGG SQUISHY;2;12000;0;24000;21682;2318;
2021-04-21 13:11:12;6907992825069;JD FRUITY;1;5000;0;5000;4400;600;
2021-04-21 13:11:12;8996001600269;LE MINERAL 600ML;1;3000;0;3000;1688;1312;
2021-04-21 13:11:12;8993274532105;BOLU;1;1000;0;1000;833;167;
2021-04-21 13:11:12;PRG;PARAGO;1;500;0;500;400;100;
2021-04-21 13:11:12;8992696404441;BEAR BRAND 189ML;1;8500;0;8500;7887;613;
2021-04-21 13:11:12;9556001174659;MILO ACT GO 240ML;1;8500;0;8500;7437;1063;
2021-04-21 13:11:12;6921101219235;YAKUAT JELLY;1;2000;0;2000;1750;250;
2021-04-21 13:13:42;8999999558062;RINSO ANTI NODA CLASSIC PWD 44G;5;1000;0;5000;4025;975;
2021-04-21 13:13:42;8998866608312;GIV PAPAYA KOTAK 76GR;1;2000;0;2000;1820;180;
2021-04-21 13:13:42;8992866707488;ZINC;1;5000;0;5000;4000;1000;
2021-04-21 13:32:04;8999909982000;SAMPOERNA 12 FILTER;1;18000;0;18000;16200;1800;
2021-04-21 13:32:04;8994021000915;CINCAO;2;3000;0;6000;3916;2084;
2021-04-21 14:00:49;8999909982000;SAMPOERNA 12 FILTER;1;18000;0;18000;16200;1800;
2021-04-21 15:49:52;8998866501033;MINYAK GORENG SEDAAP POUCH 2L;1;28000;0;28000;27746;254;
2021-04-21 16:31:18;8999999534097;PEPSODENT PGB FCM 75G;1;5000;0;5000;3850;1150;
2021-04-21 16:31:18;8992993524477;COLATTA FINEZA COMPOUND DARK 250G;1;18500;0;18500;17179;1321;
2021-04-21 17:55:15;BTS;BIMURA TARO SEAWEED 250G;1;10000;0;10000;9300;700;
2021-04-21 17:55:15;8992736980164;SASA TEPUNG KENTUCKY 80G;1;3000;0;3000;2181;819;
2021-04-21 18:05:07;123124;KOREK BIASA;1;2000;0;2000;1800;200;
2021-04-21 18:05:07;6907992823676;JD PEACH;1;2000;0;2000;1700;300;
2021-04-21 18:05:07;6907992823959;JD HAWTHORN BERRY;1;2000;0;2000;1700;300;
2021-04-21 18:05:07;8993989311699;CLAS MILD 16 FILTER;1;23000;0;23000;21700;1300;
2021-04-21 18:08:42;8996001600269;LE MINERAL 600ML;3;3000;0;9000;5064;3936;
2021-04-21 18:08:42;8996001600375;LE MINERAL 330ML;1;2000;0;2000;1417;583;
2021-04-21 21:25:59;8998989300261;GUDANG GARAM SURYA 12 FILTER;1;18000;0;18000;16450;1550;
2021-04-21 21:25:59;8994834005923;SPIX 1000;2;1000;0;2000;1700;300;
2021-04-21 22:31:43;COKLAT;COKLAT COIN;11;500;0;5500;4400;1100;
2021-04-21 22:31:43;8991001503114;CHACHA MILK CHOCOLATE 35G;1;5500;0;5500;4900;600;
2021-04-21 22:32:54;8992696422650;NESCAFE FRENCH VANILLA;1;5000;0;5000;4099;901;
2021-04-21 22:32:54;6907992825045;JD CRUNCHY MATCHA CHEESE;1;8000;0;8000;7000;1000;
2021-04-21 22:32:54;8998989110167;SURYA GUDANG GARAM 16 FILTER;2;24000;0;48000;44200;3800;
2021-04-21 22:32:54;BMO;BERAS MERAH ORGANIK;1;25000;0;25000;23500;1500;
2021-04-22 12:54:19;8998866202725;MILKU COKLAT PREMIUM 200ML;1;3000;0;3000;2375;625;
2021-04-22 12:54:19;8998866202732;MILKU STROBERI 200ML;1;3000;0;3000;2375;625;
2021-04-22 12:54:19;bb;BENG-BENG;1;1500;0;1500;1450;50;
2021-04-22 12:54:19;kp;KALPA;1;2000;0;2000;1666;334;
2021-04-22 12:56:17;8714700524002;MAIZENAKU;1;5000;0;5000;4200;800;
2021-04-22 12:56:17;8998866201469;POTABEE REGULER BBQ BEEF 68 GR;1;8000;0;8000;7200;800;
2021-04-22 12:56:17;8997011700123;BIHUN JAGUNG 300GR;1;6000;0;6000;4979;1021;
2021-04-22 12:56:17;8992222091961;PUCELLE MIST COL SPRAY 75ML;1;13000;0;13000;11650;1350;
2021-04-22 13:07:39;8996001318911;BETTER ISI 4;1;2000;0;2000;1700;300;
2021-04-22 13:18:49;8991111109121;JB POWDER BLOSSOM 75+25G;1;6000;0;6000;5430;570;
2021-04-22 13:18:49;MARS;MARSHMELLOW;1;500;0;500;433;67;
2021-04-22 13:18:49;089686010107;INDOMIE KALDU AYAM;1;2500;0;2500;2150;350;
2021-04-22 14:55:06;8992933211115;NUTRIJELL STRAWBERRY;2;6000;0;12000;10082;1918;
2021-04-22 14:55:06;GL;GULA 1 LITER;1;11500;0;11500;10500;1000;
2021-04-22 16:04:58;8991004011906;KOPI BORONG;1;10000;0;10000;8333;1667;
2021-04-22 16:04:58;8998866200646;KOPI TOP MURNI;1;11000;0;11000;9600;1400;
2021-04-22 16:04:58;8997011700123;BIHUN JAGUNG 300GR;1;6000;0;6000;4979;1021;
2021-04-22 16:08:20;KJ;KINDER JOY;1;2000;0;2000;1583;417;
2021-04-22 16:08:20;HT;HOT-HOT;2;500;0;1000;700;300;
2021-04-22 17:04:10;GL;GULA 1 LITER;6;11500;0;69000;63000;6000;
2021-04-22 17:23:15;8992775001653;GERY SALUT CHOCOLATE COCONUT;2;2000;0;4000;2952;1048;
2021-04-22 17:23:15;8998866108102;POSH GREEN BLOSSOM 150;1;19500;0;19500;17500;2000;
2021-04-22 17:23:15;8999999059309;LIFEBOUY TS TOTAL 10 DG 75G;1;3000;0;3000;2500;500;
2021-04-22 17:23:15;8992759120264;LARISST 220;1;10000;0;10000;9200;800;
2021-04-22 17:23:15;8992761145026;SPRITE PET 250ML;2;3500;0;7000;4834;2166;
2021-04-22 17:23:15;8994834006128;TICTIC PEDAS;1;2000;0;2000;1700;300;
2021-04-22 17:23:15;089686043204;INDOMIE MIE ACEH;1;2700;0;2700;2452;248;
2021-04-22 17:23:15;8996001355237;SUPER STAR;1;11000;0;11000;9900;1100;
2021-04-22 17:23:15;8996001305041;ROMA SANDWICH CKLT;1;7000;0;7000;5000;2000;
2021-04-22 17:54:13;6907992823829;JD MILKY MILK;2;3000;0;6000;5200;800;
2021-04-22 17:57:35;8998866202244;EKOMIE BUMBU KALDU AYAM;5;1000;0;5000;3990;1010;
2021-04-22 18:00:28;SF TAWAR KUPAS;SAFFANAH ROTI TAWAR KUPAS;1;10000;0;10000;9000;1000;
2021-04-22 18:12:28;8998866201841;GOLDA DOLCE LATTE 200ML;1;3000;0;3000;2500;500;
2021-04-22 18:12:28;ff;FULLO BLASTO;1;1000;0;1000;995;5;
2021-04-22 18:13:47;8998989110167;SURYA GUDANG GARAM 16 FILTER;1;24000;0;24000;22100;1900;
2021-04-22 18:13:47;8992761164539;NUTRIBOOST ORANGE 300ML;1;6500;0;6500;5300;1200;
2021-04-22 18:13:47;8992761145026;SPRITE PET 250ML;1;3500;0;3500;2417;1083;
2021-04-22 18:19:56;8998989300261;GUDANG GARAM SURYA 12 FILTER;1;18000;0;18000;16450;1550;
2021-04-22 19:42:13;8998866202312;NOODLE SEDAAP TASTY BAKMI AYAM 129 GR;1;5000;0;5000;4167;833;
2021-04-22 19:42:13;8998866202237;NOODLE SEDAAP TASTY AYAM GEPREK 124 GR;1;5000;0;5000;4167;833;
2021-04-22 19:48:32;8998866202237;NOODLE SEDAAP TASTY AYAM GEPREK 124 GR;1;5000;0;5000;4167;833;
2021-04-22 21:51:17;8999999516208;ROYCO FDS CHICKEN NEW 230G;3;10000;0;30000;27000;3000;
2021-04-22 21:51:37;8998009010590;ULTRA CHO 125;1;3000;0;3000;2428;572;
2021-04-22 22:01:25;089686021219;INTER MIE GORENG;4;1000;0;4000;3540;460;
2021-04-22 22:01:25;HT;HOT-HOT;2;500;0;1000;700;300;
2021-04-22 22:01:25;TL;TELUR;3;1500;0;4500;3900;600;
2021-04-22 22:01:56;8997013790108;BIMURA KACANG TELUR 25G;2;1000;0;2000;1750;250;
2021-04-22 22:01:56;JGR SHN;JOGER SHINY SACHET;2;500;0;1000;874;126;
2021-04-22 22:02:21;8992959953037;SWEETY BRONZE L1;1;3000;0;3000;2671;329;
2021-04-22 22:03:28;8997009510055;YOU C1000;1;10000;0;10000;9166;834;
2021-04-22 22:06:31;8992775211434;PILUS GARUDA SAPI PANGGANG;1;5500;0;5500;4713;787;
2021-04-22 22:06:31;8997009510055;YOU C1000;2;10000;0;20000;18332;1668;
2021-04-22 22:06:31;8992696404441;BEAR BRAND 189ML;1;8500;0;8500;7887;613;
2021-04-22 22:06:31;8992775110157;GARUDA KACANG KULIT;1;5000;0;5000;3925;1075;
2021-04-22 22:09:47;8998866201469;POTABEE REGULER BBQ BEEF 68 GR;1;8000;0;8000;7200;800;
2021-04-22 22:09:47;ARG;ARGUS 220ML;1;14500;0;14500;12500;2000;
2021-04-22 22:21:34;8996001312445;MALKIST CAPPUCINO;1;6500;0;6500;5400;1100;
2021-04-22 22:21:34;089686010107;INDOMIE KALDU AYAM;1;2500;0;2500;2150;350;
2021-04-22 22:21:34;8999999529710;CLEAR COOL SPORT MNTL 160ML;1;24800;0;24800;22700;2100;
2021-04-22 22:21:34;8994420107789;SARDEN SAUS TOMAT;1;7000;0;7000;5833;1167;
2021-04-22 22:23:11;8998989110167;SURYA GUDANG GARAM 16 FILTER;2;24000;0;48000;44200;3800;
2021-04-23 12:14:19;8992628010139;BIMOLI 5L;1;75000;0;75000;72100;2900;
2021-04-23 13:49:26;8997012321204;MAXX BUMBU BALADO;1;5000;0;5000;4100;900;
2021-04-23 13:49:26;6291100212866;KURMA KHALAS;1;60000;0;60000;55000;5000;
2021-04-23 13:49:26;8991004011906;KOPI BORONG;1;10000;0;10000;8333;1667;
2021-04-23 13:52:08;SWAL;SENDAL SWALLOW;1;18000;0;18000;16500;1500;
2021-04-23 14:48:11;8999999524722;SUNLIGHT LIME NEW PCH 435ML;1;10000;0;10000;9100;900;
2021-04-23 15:06:05;8992759120264;LARISST 220;1;10000;0;10000;9200;800;
2021-04-23 15:35:23;8999999558079;RINSO MOLTO ROSE FRESH PWD 44G;6;1000;0;6000;4830;1170;
2021-04-23 16:27:34;GL;GULA 1 LITER;1;11500;0;11500;10500;1000;
2021-04-23 16:27:34;8995333060703;TERIGU KOMPAS 1KG;1;10500;0;10500;9816;684;
2021-04-23 16:28:43;8992959117583;SFX DS REG FLOW WING 20;1;5000;0;5000;4288;712;
2021-04-23 16:28:43;8992761145019;COCA COLA PET 250ML;2;3500;0;7000;4834;2166;
2021-04-23 16:28:43;COKLAT;COKLAT COIN;2;500;0;1000;800;200;
2021-04-23 16:29:48;8994834003752;TICTIC;1;2000;0;2000;1700;300;
2021-04-23 16:41:18;ABC;BATERAI ABC BIRU;1;8500;0;8500;7500;1000;
2021-04-23 16:41:18;8993058105013;EXTRA JOSS;1;12000;0;12000;9773;2227;
2021-04-23 16:54:15;8998866611725;EKONOMI PENCUCI PIRING  LIQ 290ML;1;5000;0;5000;4200;800;
2021-04-23 17:10:30;8998989300261;GUDANG GARAM SURYA 12 FILTER;1;18000;0;18000;16450;1550;
2021-04-23 17:10:30;8997013790108;BIMURA KACANG TELUR 25G;1;1000;0;1000;875;125;
2021-04-23 17:10:30;8994834005923;SPIX 1000;1;1000;0;1000;850;150;
2021-04-23 17:55:17;8997018720018;SIRUP DHT;1;23000;0;23000;20958;2042;
2021-04-23 17:55:17;8992753100101;BKM FULL CREAM GOLD 370;1;15000;0;15000;14000;1000;
2021-04-23 18:01:09;8993989311699;CLAS MILD 16 FILTER;1;23000;0;23000;21700;1300;
2021-04-23 18:01:09;123124;KOREK BIASA;1;2000;0;2000;1800;200;
2021-04-23 18:06:04;8996001600269;LE MINERAL 600ML;2;3000;0;6000;3376;2624;
2021-04-23 18:06:04;8998866202725;MILKU COKLAT PREMIUM 200ML;1;3000;0;3000;2375;625;
2021-04-23 18:34:30;8992959953044;SWEETY BRONZE XL1;1;2500;0;2500;2250;250;
2021-04-23 18:34:30;8997231980022;O'JELLY MINI STRAWBERRY;1;3000;0;3000;2250;750;
2021-04-23 18:34:30;8996001440049;ENERGEN;1;1500;0;1500;1200;300;
2021-04-23 18:34:30;8998866202725;MILKU COKLAT PREMIUM 200ML;1;3000;0;3000;2375;625;
2021-04-24 11:58:17;HT;HOT-HOT;2;500;0;1000;700;300;
2021-04-24 11:58:17;VTM;VITAMIN;2;500;0;1000;850;150;
2021-04-24 12:43:58;8999999524722;SUNLIGHT LIME NEW PCH 435ML;1;10000;0;10000;9100;900;
2021-04-24 12:43:58;GL;GULA 1 LITER;1;11500;0;11500;10500;1000;
2021-04-24 12:43:58;8999999031602;SARI MURNI 20X1.6G;1;6000;0;6000;5400;600;
2021-04-24 12:43:58;8998989500166;GUDANG GARAM MERAH BESAR 16KS;1;17000;0;17000;15300;1700;
2021-04-24 13:52:08;8998866100717;MAMALIME POUCH 780ML;1;15500;0;15500;13850;1650;
2021-04-24 14:47:58;8997231980022;O'JELLY MINI STRAWBERRY;1;3000;0;3000;2250;750;
2021-04-24 14:47:58;GL;GULA 1 LITER;1;11500;0;11500;10500;1000;
2021-04-24 14:47:58;COKLAT;COKLAT COIN;1;500;0;500;400;100;
2021-04-24 14:54:01;TG APEL;TEH GELAS APEL;1;2000;0;2000;1178;822;
2021-04-24 14:54:01;8886013257400;TWISTKO;1;1000;0;1000;900;100;
2021-04-24 14:54:01;8997231980022;O'JELLY MINI STRAWBERRY;1;3000;0;3000;2250;750;
2021-04-24 14:54:01;COKLAT;COKLAT COIN;2;500;0;1000;800;200;
2021-04-24 15:20:56;8999801700030;SUSU FOYU;1;11500;0;11500;10450;1050;
2021-04-24 15:20:56;8995333032113;TERIGU GATOT KACA 1 KG;1;8500;0;8500;8012;488;
2021-04-24 15:20:56;8997018720018;SIRUP DHT;1;23000;0;23000;20958;2042;
2021-04-24 16:01:54;8998866501033;MINYAK GORENG SEDAAP POUCH 2L;1;28000;0;28000;27746;254;
2021-04-24 16:01:54;JGR SHN;JOGER SHINY SACHET;2;500;0;1000;874;126;
2021-04-24 16:24:25;8998866200837;NOODLE SEDAAPMIE SOTO CUP 81 GR;1;4500;0;4500;3650;850;
2021-04-24 16:24:25;HT;HOT-HOT;1;500;0;500;350;150;
2021-04-24 16:36:35;8991102987639;WFR TANGO LONG VNL 130G;1;5000;0;5000;3773;1227;
2021-04-24 16:36:35;8996001301142;ROMA KELAPA;1;8000;0;8000;6628;1372;
2021-04-24 16:49:26;8999999555122;MOLTO K-ROMANCE 20ML;1;1000;0;1000;800;200;
2021-04-24 16:49:26;8992979190986;TOTAL PUTIH SOFTENER;1;13000;0;13000;11532;1468;
2021-04-24 16:49:26;8998989300261;GUDANG GARAM SURYA 12 FILTER;1;18000;0;18000;16450;1550;
2021-04-24 16:49:26;089686010824;INDOMIE GORENG SPESIAL;2;2700;0;5400;4904;496;
2021-04-24 16:49:26;8998866202237;NOODLE SEDAAP TASTY AYAM GEPREK 124 GR;1;5000;0;5000;4167;833;
2021-04-24 16:49:26;6907992823904;JD CRUNCHY CHOCOLATE VAN;1;8000;0;8000;6800;1200;
2021-04-24 16:49:26;6907992823676;JD PEACH;1;2000;0;2000;1700;300;
2021-04-24 16:49:26;8991102714495;TANGO DRINK COKLAT;1;5000;0;5000;3818;1182;
2021-04-24 16:49:26;8991102228053;TEH GELAS BOTOL;1;3000;0;3000;1695;1305;
2021-04-24 16:49:26;8999999559533;LIFEBUOY BW TOTAL 10 90ML;1;5000;0;5000;4000;1000;
2021-04-24 16:49:26;8997011700123;BIHUN JAGUNG 300GR;1;6000;0;6000;4979;1021;
2021-04-24 16:49:26;8991001780126;SELAMAT CKLAT 60G;1;5000;0;5000;4300;700;
2021-04-24 16:49:26;8992933214116;NUTRIJELL MELON;2;6000;0;12000;10082;1918;
2021-04-24 17:49:03;GL;GULA 1 LITER;1;11500;0;11500;10500;1000;
2021-04-24 17:49:03;8999909096004;SAMPOERNA 16 FILTER;1;24000;0;24000;23000;1000;
2021-04-24 17:49:03;123124;KOREK BIASA;1;2000;0;2000;1800;200;
2021-04-24 18:31:31;GL;GULA 1 LITER;1;11500;0;11500;10500;1000;
2021-04-24 18:31:31;8992761145026;SPRITE PET 250ML;1;3500;0;3500;2417;1083;
2021-04-24 18:31:31;8992628010139;BIMOLI 5L;1;75000;0;75000;72100;2900;
2021-04-24 18:58:34;GL;GULA 1 LITER;2;11500;0;23000;21000;2000;
2021-04-24 18:58:34;8998989300261;GUDANG GARAM SURYA 12 FILTER;1;18000;0;18000;16450;1550;
2021-04-24 18:58:34;123124;KOREK BIASA;1;2000;0;2000;1800;200;
2021-04-24 18:59:08;8991102987639;WFR TANGO LONG VNL 130G;1;5000;0;5000;3773;1227;
2021-04-24 19:44:10;GL;GULA 1 LITER;2;11500;0;23000;21000;2000;
2021-04-24 19:51:14;8992222050418;GATSBY NORMAL 38GR;1;5000;0;5000;3850;1150;
2021-04-24 19:51:14;8998866201841;GOLDA DOLCE LATTE 200ML;1;3000;0;3000;2500;500;
2021-04-24 20:24:05;8999909010567;234 16 FILTER;1;22000;0;22000;21500;500;
2021-04-24 20:24:29;123124;KOREK BIASA;1;2000;0;2000;1800;200;
2021-04-24 21:50:44;8991001780133;TWISTER BLACK;1;5000;0;5000;4600;400;
2021-04-24 21:50:44;8998866201841;GOLDA DOLCE LATTE 200ML;1;3000;0;3000;2500;500;
2021-04-24 21:50:44;SF TAWAR ORI;SAFFANAH TAWAR ORI;1;9000;0;9000;8000;1000;
2021-04-25 11:58:06;8998866201483;POTABEE REGULER GRILLED SEAWEED 35GR;1;5000;0;5000;4150;850;
2021-04-25 11:58:06;8996001304136;SLAI OLAI BLUEBERRY;1;12000;0;12000;9900;2100;
2021-04-25 11:58:06;8998866610261;DAIA VIOLET GUSSET BAG 290 GR;1;5000;0;5000;4450;550;
2021-04-25 12:06:55;8996001318911;BETTER ISI 4;1;2000;0;2000;1700;300;
2021-04-25 13:01:58;8997021870052;FRESH CARE GREEN TEA 10ML;1;12000;0;12000;10000;2000;
2021-04-25 13:08:18;8992775002155;CHOCOLATOS DRINK;1;4000;0;4000;3520;480;
2021-04-25 13:08:18;8886013257400;TWISTKO;2;1000;0;2000;1800;200;
2021-04-25 13:08:18;8992696523067;MILO ACTVGO UHT 180ML;1;4500;0;4500;3515;985;
2021-04-25 13:08:18;8998866610261;DAIA VIOLET GUSSET BAG 290 GR;1;5000;0;5000;4450;550;
2021-04-25 13:08:18;8999999531508;MOLTO HYGIENE SC 10ML;2;500;0;1000;960;40;
2021-04-25 13:08:18;8999999059323;LIFEBOUY LEMONFRESH DG 75G;1;3000;0;3000;2500;500;
2021-04-25 13:08:18;MARS;MARSHMELLOW;1;500;0;500;433;67;
2021-04-25 13:08:18;JGR SHN;JOGER SHINY SACHET;1;500;0;500;437;63;
2021-04-25 13:08:18;ff;FULLO BLASTO;1;1000;0;1000;995;5;
2021-04-25 13:08:18;8992696521797SCT;MILO UHT ACT GO 22G;1;2000;0;2000;1412;588;
2021-04-25 13:08:18;8998866202060;POTABEE AYAM BAKAR PEDAS 35 GR;1;5000;0;5000;4150;850;
2021-04-25 13:25:49;8994834005923;SPIX 1000;2;1000;0;2000;1700;300;
2021-04-25 13:25:49;8998989300261;GUDANG GARAM SURYA 12 FILTER;1;18000;0;18000;16450;1550;
2021-04-25 13:57:52;8992933211115;NUTRIJELL STRAWBERRY;1;6000;0;6000;5041;959;
2021-04-25 14:00:37;8999999531508;MOLTO HYGIENE SC 10ML;4;500;0;2000;1920;80;
2021-04-25 14:00:37;8999999558086;RINSO MOLTO FERFUME ESSENSE PWD 44G;3;1000;0;3000;2415;585;
2021-04-25 14:59:43;8998866201865;KRISBEE PILLOW CHOCOLAVA 120 GR;1;8000;0;8000;7250;750;
2021-04-25 14:59:43;8991102987639;WFR TANGO LONG VNL 130G;1;5000;0;5000;3773;1227;
2021-04-25 14:59:43;8997013790108;BIMURA KACANG TELUR 25G;2;1000;0;2000;1750;250;
2021-04-25 15:46:48;ARG;ARGUS 220ML;5;14500;0;72500;62500;10000;
2021-04-25 15:49:25;8998866613569;SOFTENER SKL BLS FINE 14SHT;1;5000;0;5000;4560;440;
2021-04-25 15:49:25;8993379152017;SABUN CUCI SURYA 200G;1;3000;0;3000;2281;719;
2021-04-25 15:49:25;8996200900092;HEROCYN 85GR;1;13000;0;13000;11650;1350;
2021-04-25 15:51:07;8992979130012;TOTAL LEMON SOFTENER;1;13000;0;13000;11532;1468;
2021-04-25 15:51:07;8998866202404;NOODLE SEDAAP MIE KOREAN SPICY CHICKEN CUP;1;5000;0;5000;4002;998;
2021-04-25 16:29:02;8995333000822;TERIGU KOMPAS SOFT 500GR;1;5500;0;5500;4967;533;
2021-04-25 16:29:02;8993379152017;SABUN CUCI SURYA 200G;1;3000;0;3000;2281;719;
2021-04-25 16:56:33;8993379152017;SABUN CUCI SURYA 200G;1;3000;0;3000;2281;719;
2021-04-25 16:56:33;GL;GULA 1 LITER;3;11500;0;34500;31500;3000;
2021-04-25 16:56:33;8998989110167;SURYA GUDANG GARAM 16 FILTER;1;24000;0;24000;22100;1900;
2021-04-25 16:56:33;8998866608305;GIV BENGKOANG KOTAK 76G;1;2000;0;2000;1820;180;
2021-04-25 16:56:33;8998866804516;GIV LEMON KOTAK 76G;1;2000;0;2000;1820;180;
2021-04-25 18:08:34;8998989300261;GUDANG GARAM SURYA 12 FILTER;1;18000;0;18000;16450;1550;
2021-04-25 18:08:34;8992761166205;FRESTEA GREEN HONEY 350ML;1;4500;0;4500;3000;1500;
2021-04-25 18:08:34;8992761122331;FRESTEA APPEL 500ML;1;6500;0;6500;4708;1792;
2021-04-25 18:09:01;8998989300261;GUDANG GARAM SURYA 12 FILTER;1;18000;0;18000;16450;1550;
2021-04-25 18:09:01;8998989100120;GUDANG GARAM MINI;1;18000;0;18000;16600;1400;
2021-04-25 18:16:30;123124;KOREK BIASA;1;2000;0;2000;1800;200;
2021-04-25 18:16:30;089686043051;INDOMIE COTO MAKASSAR;1;2800;0;2800;2525;275;
2021-04-25 22:17:17;8996001600269;LE MINERAL 600ML;1;3000;0;3000;1688;1312;
2021-04-25 22:17:17;8997028590014;ARGUS 220ML;1;500;0;500;302;198;
2021-04-25 22:17:17;JGR SHN;JOGER SHINY SACHET;1;500;0;500;437;63;
2021-04-25 22:17:31;8992761002039;FANTA STRAWBERRY PET 390 ML;1;5500;0;5500;4300;1200;
2021-04-25 22:26:48;ARG;ARGUS 220ML;1;14500;0;14500;12500;2000;
2021-04-25 22:26:48;8992388133017;NU MILK TEA ORI 330ML;1;6000;0;6000;5125;875;
2021-04-25 22:26:48;8886013213208;FRENCH FREIS 2000;1;5000;0;5000;3750;1250;
2021-04-26 13:29:02;8992984850615;PEWARNA HIJAU TUA;1;6000;0;6000;5000;1000;
2021-04-26 13:35:53;8999999710880;PEPSODENT ACTION123 HERBAL 75G;1;7500;0;7500;6650;850;
2021-04-26 13:35:53;8999999706081;PEPSODENT WHITE 75G;1;5000;0;5000;3850;1150;
2021-04-26 13:35:53;8999999500399;LUX TS CAMELLIA WHITE;2;3500;0;7000;5600;1400;
2021-04-26 13:35:53;8998866609173;SOKLIN LIQUID SOFTERGENT POUCH 400ML;2;8500;0;17000;15430;1570;
2021-04-26 14:45:51;6907992825069;JD FRUITY;1;5000;0;5000;4400;600;
2021-04-26 15:01:26;8995102703534;TERASI DUO 6 GR;1;4000;0;4000;3720;280;
2021-04-26 15:01:26;8999999042592;RINSO MOLTO PERFUME ESSENSE LIQ 4OML;1;5500;0;5500;4817;683;
2021-04-26 15:01:26;8998866613569;SOFTENER SKL BLS FINE 14SHT;1;5000;0;5000;4560;440;
2021-04-26 15:01:26;8998866608749;SOFTENER SKL BLS TW VIOLET 14SCT;1;5000;0;5000;4560;440;
2021-04-26 15:21:24;8993470279651;JOGER CHOCKY BAR;30;1000;0;30000;26010;3990;
2021-04-26 15:30:33;BTS;BIMURA TARO SEAWEED 250G;1;10000;0;10000;9300;700;
2021-04-26 15:30:33;TL;TELUR;6;1500;0;9000;7800;1200;
2021-04-26 15:31:54;8999999057640;MOLTO EDP BLK PURPLE 20ML;5;1000;0;5000;4000;1000;
2021-04-26 15:31:54;BTS;BIMURA TARO SEAWEED 250G;1;10000;0;10000;9300;700;
2021-04-26 16:29:39;8997231980022;O'JELLY MINI STRAWBERRY;1;3000;0;3000;2250;750;
2021-04-26 16:42:42;089686043051;INDOMIE COTO MAKASSAR;3;2800;0;8400;7575;825;
2021-04-26 16:42:42;089686010107;INDOMIE KALDU AYAM;4;2500;0;10000;8600;1400;
2021-04-26 16:42:42;8998009010569;ULTRA CHO 200;4;5000;0;20000;15320;4680;
2021-04-26 17:11:02;GL;GULA 1 LITER;4;11500;0;46000;42000;4000;
2021-04-26 17:11:29;GL;GULA 1 LITER;4;11500;0;46000;42000;4000;
2021-04-26 17:17:31;8997231980022;O'JELLY MINI STRAWBERRY;1;3000;0;3000;2250;750;
2021-04-26 17:17:31;BAYFLAST;BAYPLAST;2;500;0;1000;700;300;
2021-04-26 18:02:42;8996001600375;LE MINERAL 330ML;1;2000;0;2000;1417;583;
2021-04-26 18:02:42;CLUB;AIR CLUB;1;3000;0;3000;1452;1548;
2021-04-26 18:05:33;8997007780689;JIZZY MINERAL;1;3000;0;3000;1187;1813;
2021-04-26 18:05:33;8993989311699;CLAS MILD 16 FILTER;1;23000;0;23000;21700;1300;
2021-04-26 18:05:33;123124;KOREK BIASA;1;2000;0;2000;1800;200;
2021-04-26 18:12:18;8993989311279;CLAS MILD 12;1;17000;0;17000;15700;1300;
2021-04-26 18:12:18;123124;KOREK BIASA;1;2000;0;2000;1800;200;
2021-04-26 18:12:18;089686821086;ICHI OCHA MELATI;2;3000;0;6000;4500;1500;
2021-04-26 18:12:18;8992775001783;GERY SALUT MALKIST;1;6500;0;6500;5516;984;
2021-04-26 18:12:18;8992984920110;CUKA DAPUR DUA BELIBIS;1;4500;0;4500;3250;1250;
2021-04-26 18:57:12;8997021870076;FRESH CARE SANDAL WOOD 10ML;1;12000;0;12000;10000;2000;
2021-04-26 18:57:12;8998989300261;GUDANG GARAM SURYA 12 FILTER;1;18000;0;18000;16450;1550;
2021-04-26 19:18:54;8998989500166;GUDANG GARAM MERAH BESAR 16KS;1;17000;0;17000;15300;1700;
2021-04-26 19:21:42;GL;GULA 1 LITER;1;11500;0;11500;10500;1000;
2021-04-26 19:25:45;6907992823959;JD HAWTHORN BERRY;1;2000;0;2000;1700;300;
2021-04-26 19:46:01;6907992825076;JD WATERMELON APPLE;1;2000;0;2000;1700;300;
2021-04-26 20:10:18;HT;HOT-HOT;2;500;0;1000;700;300;
2021-04-26 20:10:18;8993072153595;LARISST COTTON 35G;1;5000;0;5000;3300;1700;
2021-04-26 20:10:18;6907992825076;JD WATERMELON APPLE;1;2000;0;2000;1700;300;
2021-04-26 20:10:18;6907992823676;JD PEACH;1;2000;0;2000;1700;300;
2021-04-26 20:11:15;MARS;MARSHMELLOW;4;500;0;2000;1732;268;
2021-04-26 20:25:31;6907992824963;JD MILKY CHOCOLATE;3;3000;0;9000;7800;1200;
2021-04-26 20:25:31;6921101219235;YAKUAT JELLY;1;2000;0;2000;1750;250;
2021-04-26 20:25:31;6907992823669;JD MILKY STRAW;1;3000;0;3000;2600;400;
2021-04-26 20:46:47;8999999559557;LUX BW MAGICAL ORCHID 85ML;1;5000;0;5000;4000;1000;
2021-04-26 21:01:39;089686021141;INTER MIE SOTO;2;1000;0;2000;1708;292;
2021-04-26 21:02:49;TG MARKISA;TEH GELAS MARKISA;1;2000;0;2000;1178;822;
2021-04-26 21:02:49;PRG;PARAGO;2;500;0;1000;800;200;
2021-04-26 21:05:00;PRG;PARAGO;1;500;0;500;400;100;
2021-04-26 21:05:00;HT;HOT-HOT;1;500;0;500;350;150;
2021-04-26 21:08:12;8996001600399;LE MINERAL 1500ML;1;5000;0;5000;4042;958;
2021-04-26 21:32:30;8998989121163;SURYA PRO MERAH;1;20000;0;20000;18600;1400;
2021-04-26 21:32:30;089686011036;INDOMIE GORENG PEDAS;1;2700;0;2700;2452;248;
2021-04-26 21:36:54;GL;GULA 1 LITER;1;11500;0;11500;10500;1000;
2021-04-26 21:36:54;8992747180225;VIXAL PEMB PORS BIRU 720ML;1;18000;0;18000;16940;1060;
2021-04-26 21:36:54;8998866679572;SOKLIN LANTAI MERAH 780ML;1;12000;0;12000;10020;1980;
2021-04-26 21:36:54;8992775001042;PILUS GARUDA MI GORENG;1;5000;0;5000;4810;190;
2021-04-26 21:56:55;ABC;BATERAI ABC BIRU;1;8500;0;8500;7500;1000;
2021-04-26 21:58:09;8998866106504;EMERON LOVELY NAT PINK;1;3500;0;3500;2900;600;
2021-04-26 21:58:09;8998866202312;NOODLE SEDAAP TASTY BAKMI AYAM 129 GR;1;5000;0;5000;4167;833;
2021-04-26 21:58:09;TUSTEL;TUSUK TELINGA;1;1000;0;1000;833;167;
2021-04-26 21:58:09;HT;HOT-HOT;1;500;0;500;350;150;
2021-04-26 22:13:10;GL;GULA 1 LITER;2;11500;0;23000;21000;2000;
2021-04-26 22:31:36;8998866501033;MINYAK GORENG SEDAAP POUCH 2L;1;28000;0;28000;27746;254;
2021-04-26 22:31:36;089686010107;INDOMIE KALDU AYAM;1;2500;0;2500;2150;350;
2021-04-26 22:31:36;8997231980022;O'JELLY MINI STRAWBERRY;1;3000;0;3000;2250;750;
2021-04-26 22:31:36;089686043204;INDOMIE MIE ACEH;1;2700;0;2700;2452;248;
2021-04-26 22:31:36;8992388112401;MIE ABC SELERA PEDAS- GORENG AYAM PEDAS LIMAU;2;2600;0;5200;4736;464;
2021-04-26 22:31:36;8998866200301;MIE SEDAAP GORENG;1;2500;0;2500;2023;477;
2021-04-26 22:31:36;089686043273;INDOMIE SAMBAL RICA;1;2700;0;2700;2452;248;
2021-04-26 22:31:36;089686011036;INDOMIE GORENG PEDAS;1;2700;0;2700;2452;248;
2021-04-26 22:31:36;kp;KALPA;1;2000;0;2000;1666;334;
2021-04-26 22:31:36;TL;TELUR;3;1500;0;4500;3900;600;
2021-04-27 12:28:57;8997007780689;JIZZY MINERAL;1;3000;0;3000;1187;1813;
2021-04-27 12:28:57;8998866200820;NOODLE SEDAAP MIE AYAM BAWANG TLR CUP 77 GR;2;4500;0;9000;7300;1700;
2021-04-27 13:54:14;8998866201841;GOLDA DOLCE LATTE 200ML;1;3000;0;3000;2500;500;
2021-04-27 14:58:14;6907992825069;JD FRUITY;1;5000;0;5000;4400;600;
2021-04-27 15:31:33;8997018720018;SIRUP DHT;1;23000;0;23000;20958;2042;
2021-04-27 15:44:16;8997021300092;LARISSA BAWANG 250GR;1;5500;0;5500;5125;375;
2021-04-27 15:44:16;TL;TELUR;6;1500;0;9000;7800;1200;
2021-04-27 15:45:14;8998866808729;ROYALE SOFT WHITE;1;5000;0;5000;4500;500;
2021-04-27 16:01:35;8998866200837;NOODLE SEDAAPMIE SOTO CUP 81 GR;1;4500;0;4500;3650;850;
2021-04-27 16:01:35;PRG;PARAGO;1;500;0;500;400;100;
2021-04-27 16:32:16;8992775001042;PILUS GARUDA MI GORENG;1;5000;0;5000;4810;190;
2021-04-27 16:32:16;8992775211434;PILUS GARUDA SAPI PANGGANG;1;5500;0;5500;4713;787;
2021-04-27 16:32:16;8998866611237;FRES&NATURAL DARKBLUE 100ML;1;11500;0;11500;10310;1190;
2021-04-27 16:43:50;8995333032113;TERIGU GATOT KACA 1 KG;1;8500;0;8500;8012;488;
2021-04-27 16:43:50;6921101219235;YAKUAT JELLY;1;2000;0;2000;1750;250;
2021-04-27 16:43:50;8999999559861;AXE DARK POCKET FRAG 17ML;1;10000;0;10000;8000;2000;
2021-04-27 16:47:57;8999999558079;RINSO MOLTO ROSE FRESH PWD 44G;6;1000;0;6000;4830;1170;
2021-04-27 17:00:29;8998866107099;WET WIPES KODOMO BABY 50SHT CLSSC;1;15000;0;15000;13650;1350;
2021-04-27 17:05:44;CLUB;AIR CLUB;1;3000;0;3000;1452;1548;
2021-04-27 17:05:44;8997007780689;JIZZY MINERAL;1;3000;0;3000;1187;1813;
2021-04-27 17:05:44;8991001780126;SELAMAT CKLAT 60G;1;5000;0;5000;4300;700;
2021-04-27 17:05:44;8992775913000GT;CHOCOLATOS CKLT DRINK;1;18000;0;18000;15862;2138;
2021-04-27 17:05:44;8992775000250GT;CHOCOLATOS MATCHA DRINK;1;18000;0;18000;15862;2138;
2021-04-27 17:05:44;8999999544416;MOLTO CARE;1;20000;0;20000;18570;1430;
2021-04-27 17:05:44;8999999706180;PEPSODENT WHITE 190GR;1;10000;0;10000;9350;650;
2021-04-27 17:05:44;SF TAWAR COKLAT;SAFFANAH ROTI TAWAR COKLAT;1;13500;0;13500;12000;1500;
2021-04-27 17:05:44;8992761136185;FANTA 1L;1;10000;0;10000;9000;1000;
2021-04-27 17:07:44;8992753631209;OMELA 370;1;9500;0;9500;8400;1100;
2021-04-27 17:54:20;8999999195649;SARI WANGI 25X1.86G;1;6000;0;6000;5050;950;
2021-04-27 17:54:20;8998989300261;GUDANG GARAM SURYA 12 FILTER;2;18000;0;36000;32900;3100;
2021-04-27 17:54:20;8991188943062;SASA 250G;2;10000;0;20000;17000;3000;
2021-04-27 18:05:19;8993007003063;ENAAK 500G;1;11000;0;11000;9625;1375;
2021-04-27 18:05:19;8991002103764;GOOD DAY CAPPUCINO 10X25G;1;1500;0;1500;1395;105;
2021-04-27 18:05:19;JGR SHN;JOGER SHINY SACHET;1;500;0;500;437;63;
2021-04-27 18:07:51;8993989311699;CLAS MILD 16 FILTER;1;23000;0;23000;21700;1300;
2021-04-27 18:07:51;123124;KOREK BIASA;1;2000;0;2000;1800;200;
2021-04-27 18:07:51;8994867006997;ROKOK PENA BOLD 20BTG;1;17000;0;17000;15000;2000;
2021-04-27 18:11:26;8992761147143;SPRITE WATERLYMON 425ML;1;5500;0;5500;4300;1200;
2021-04-27 18:55:12;8998989500166;GUDANG GARAM MERAH BESAR 16KS;3;17000;0;51000;45900;5100;
2021-04-27 18:55:12;8993274532105;BOLU;2;1000;0;2000;1666;334;
2021-04-27 19:37:24;8999999526856;MOLTO ALL IN ONE BLUE 11ML;1;5500;0;5500;4800;700;
2021-04-27 19:37:24;8998866609043;DAIA SOFTENER GUSSET 565G;1;10000;0;10000;8700;1300;
2021-04-27 19:37:24;8996001338056;TAMARIN;1;6000;0;6000;5100;900;
2021-04-27 19:47:07;MARS;MARSHMELLOW;4;500;0;2000;1732;268;
2021-04-27 21:03:09;8998009040023;TEH KOTAK;1;5000;0;5000;2827;2173;
2021-04-27 21:05:13;8998866202725;MILKU COKLAT PREMIUM 200ML;1;3000;0;3000;2375;625;
2021-04-27 21:05:13;8886013257400;TWISTKO;1;1000;0;1000;900;100;
2021-04-27 21:05:13;HT;HOT-HOT;3;500;0;1500;1050;450;
2021-04-27 21:05:13;COKLAT;COKLAT COIN;3;500;0;1500;1200;300;
2021-04-27 21:05:21;MARS;MARSHMELLOW;2;500;0;1000;866;134;
2021-04-27 21:08:40;8998989100120;GUDANG GARAM MINI;1;18000;0;18000;16600;1400;
2021-04-27 21:08:40;MARS;MARSHMELLOW;2;500;0;1000;866;134;
2021-04-27 21:08:40;PRG;PARAGO;2;500;0;1000;800;200;
2021-04-27 21:13:40;JGR SHN;JOGER SHINY SACHET;2;500;0;1000;874;126;
2021-04-27 21:19:05;MARS;MARSHMELLOW;4;500;0;2000;1732;268;
2021-04-27 21:20:01;RB;RED BOLD;1;19000;0;19000;17900;1100;
2021-04-27 21:50:32;8998009010590;ULTRA CHO 125;1;3000;0;3000;2428;572;
2021-04-27 21:53:54;8993989311279;CLAS MILD 12;1;17000;0;17000;15700;1300;
2021-04-27 21:53:54;8993989311699;CLAS MILD 16 FILTER;1;23000;0;23000;21700;1300;
2021-04-27 21:54:11;GL;GULA 1 LITER;5;11500;0;57500;52500;5000;
2021-04-27 21:57:00;6907992824963;JD MILKY CHOCOLATE;1;3000;0;3000;2600;400;
2021-04-27 21:57:00;6907992823652;JD CHOCOLATE MILKSHAKE;1;6000;0;6000;5200;800;
2021-04-28 11:19:36;8996001318911;BETTER ISI 4;1;2000;0;2000;1700;300;
2021-04-28 11:19:36;8996001318430;BETTER 1000;1;1000;0;1000;820;180;
2021-04-28 12:38:30;8998866610087;JAVANA ORIGINAL 350ML;1;3000;0;3000;2150;850;
2021-04-28 12:38:30;BTS;BIMURA TARO SEAWEED 250G;2;10000;0;20000;18600;1400;
2021-04-28 12:38:30;8991102387286SCT;TANGO LONG CKLT 47G;1;2000;0;2000;1551;449;
2021-04-28 12:39:02;8992717900310;KARA SUN;2;2500;0;5000;4000;1000;
2021-04-28 12:39:02;8999909096004;SAMPOERNA 16 FILTER;1;24000;0;24000;23000;1000;
2021-04-28 15:00:28;8998866202053;POTABEE AYAM BAKAR PEDAS 68GR;1;8000;0;8000;7200;800;
2021-04-28 15:00:28;8992696521629;DNCO COKLT UHT 180ML;1;5000;0;5000;3533;1467;
2021-04-28 15:00:28;8992696425316;NESCAFE BLACK;1;5000;0;5000;4099;901;
2021-04-28 15:00:28;8992696419742;NESCAFE COFFE CREAM;1;5000;0;5000;4099;901;
2021-04-28 15:00:28;8991102714631;TANGO TETRA CKLT;1;5000;0;5000;4545;455;
2021-04-28 15:00:28;8992696422650;NESCAFE FRENCH VANILLA;1;5000;0;5000;4099;901;
2021-04-28 15:16:07;8996001301142;ROMA KELAPA;1;8000;0;8000;6628;1372;
2021-04-28 15:16:07;8998866608558;SOKLIN SOFTERGENT BIRU 770G & PIRING;1;18000;0;18000;16055;1945;
2021-04-28 15:16:07;8995333000822;TERIGU KOMPAS SOFT 500GR;1;5500;0;5500;4967;533;
2021-04-28 15:16:07;TBM;NESTA TBM;1;5000;0;5000;4000;1000;
2021-04-28 15:16:07;8997011700123;BIHUN JAGUNG 300GR;1;6000;0;6000;4979;1021;
2021-04-28 15:36:38;8998866107495;ZINC HAIRFALL TREATH SHT 10ML;1;5000;0;5000;4500;500;
2021-04-28 15:36:38;8998866808729;ROYALE SOFT WHITE;1;5000;0;5000;4500;500;
2021-04-28 15:36:38;8998866608749;SOFTENER SKL BLS TW VIOLET 14SCT;1;5000;0;5000;4560;440;
2021-04-28 16:44:58;8992959053331;CONFIDENCE CLASSIC NIGHT L7;1;42000;0;42000;38182;3818;
2021-04-28 17:07:20;8999999008475;SUNLIGHT LIME NEW REF 1600ML;1;33000;0;33000;29800;3200;
2021-04-28 17:07:21;8998009020186;BUAVITA GUAVA 250ML;2;7000;0;14000;12166;1834;
2021-04-28 17:07:21;8998866501033;MINYAK GORENG SEDAAP POUCH 2L;1;28000;0;28000;27746;254;
2021-04-28 17:22:29;P;PAKET RAMADHAN 50 RIBU;1;50000;0;50000;50000;0;
2021-04-28 17:26:51;8999999195649;SARI WANGI 25X1.86G;1;6000;0;6000;5050;950;
2021-04-28 17:26:51;8992761136185;FANTA 1L;1;10000;0;10000;9000;1000;
2021-04-28 17:26:51;8998866501026;MINYAK GORENG SEDAAP POUCH 1 L;1;15000;0;15000;14110;890;
2021-04-28 17:26:51;8995333032113;TERIGU GATOT KACA 1 KG;1;8500;0;8500;8012;488;
2021-04-28 17:26:51;GL;GULA 1 LITER;1;11500;0;11500;10500;1000;
2021-04-28 18:13:48;8998989300261;GUDANG GARAM SURYA 12 FILTER;1;18000;0;18000;16450;1550;
2021-04-28 18:13:48;8997028590014;ARGUS 220ML;4;500;0;2000;1208;792;
2021-04-28 18:13:48;123124;KOREK BIASA;1;2000;0;2000;1800;200;
2021-04-28 18:13:48;8996001600399;LE MINERAL 1500ML;2;5000;0;10000;8084;1916;
2021-04-28 18:16:35;8991001780133;TWISTER BLACK;1;5000;0;5000;4600;400;
2021-04-28 18:41:30;8999099920714;SGM 1+ VANILA 900;2;80000;0;160000;157020;2980;
2021-04-28 18:41:30;8999099920691;SGM 1+ MADU 1000G;3;85000;0;255000;235530;19470;
2021-04-28 19:24:01;BTS;BIMURA TARO SEAWEED 250G;1;10000;0;10000;9300;700;
2021-04-28 19:24:01;8998866200301;MIE SEDAAP GORENG;2;2500;0;5000;4046;954;
2021-04-28 19:24:01;TL;TELUR;6;1500;0;9000;7800;1200;
2021-04-28 19:32:37;8998989300261;GUDANG GARAM SURYA 12 FILTER;1;18000;0;18000;16450;1550;
2021-04-28 19:32:37;8997013790108;BIMURA KACANG TELUR 25G;1;1000;0;1000;875;125;
2021-04-28 19:32:37;BTS;BIMURA TARO SEAWEED 250G;1;10000;0;10000;9300;700;
2021-04-28 19:36:49;8995333000822;TERIGU KOMPAS SOFT 500GR;1;5500;0;5500;4967;533;
2021-04-28 19:36:49;8991102022347;SIKAT GIGI FORMULA RIPPLE;1;5000;0;5000;4583;417;
2021-04-28 19:44:32;TUSTEL;TUSUK TELINGA;1;1000;0;1000;833;167;
2021-04-28 19:52:56;8992959509005;SWEETY SILVER PANTS XL26;1;61500;0;61500;55910;5590;
2021-04-28 19:52:56;8999801700030;SUSU FOYU;1;11500;0;11500;10450;1050;
2021-04-28 19:52:56;8992628020152;BIMOLI POUCH 2L;1;30000;0;30000;29000;1000;
2021-04-28 19:52:56;711844120419;SAMBAL ABC 275 ML;1;12000;0;12000;10800;1200;
2021-04-28 19:59:31;8997013790108;BIMURA KACANG TELUR 25G;1;1000;0;1000;875;125;
2021-04-28 19:59:31;8994834005923;SPIX 1000;1;1000;0;1000;850;150;
2021-04-28 20:44:08;8998989300261;GUDANG GARAM SURYA 12 FILTER;1;18000;0;18000;16450;1550;
2021-04-28 20:44:08;001;PASEO SMART FACIAL SF 250S GT;1;10000;0;10000;9500;500;
2021-04-28 20:56:05;ABC SPW;BATERAI ABC SPW;1;4500;0;4500;3893;607;
2021-04-28 20:56:05;8992628020152;BIMOLI POUCH 2L;1;30000;0;30000;29000;1000;
2021-04-28 21:06:09;MARS;MARSHMELLOW;2;500;0;1000;866;134;
2021-04-28 21:10:27;089686043273;INDOMIE SAMBAL RICA;1;2700;0;2700;2452;248;
2021-04-28 21:10:27;8992761145019;COCA COLA PET 250ML;1;3500;0;3500;2417;1083;
2021-04-28 21:15:59;8993989311699;CLAS MILD 16 FILTER;1;23000;0;23000;21700;1300;
2021-04-28 21:45:52;8992388112401;MIE ABC SELERA PEDAS- GORENG AYAM PEDAS LIMAU;2;2600;0;5200;4736;464;
2021-04-28 21:45:52;PRG;PARAGO;1;500;0;500;400;100;
2021-04-28 21:45:52;MARS;MARSHMELLOW;1;500;0;500;433;67;
2021-04-28 21:59:09;8998866202725;MILKU COKLAT PREMIUM 200ML;1;3000;0;3000;2375;625;
2021-04-28 21:59:09;KJ;KINDER JOY;2;2000;0;4000;3166;834;
2021-04-28 21:59:09;ff;FULLO BLASTO;2;1000;0;2000;1990;10;
2021-04-28 21:59:09;bb;BENG-BENG;1;1500;0;1500;1450;50;
2021-04-28 22:12:47;089686017748;SARIMIE GORENG ISI 2;2;3500;0;7000;6240;760;
2021-04-28 22:30:20;089686049053;SARIMI PUAS;1;3000;0;3000;2400;600;
2021-04-29 11:51:29;8991102989428GT;TANGO CKLT 24G GT;2;7500;0;15000;12184;2816;
2021-04-29 11:51:29;8991102385091;WFR TANGO CKLT 7G;1;8300;0;8300;7455;845;
2021-04-29 11:51:29;8991102989312;WFR TANGO SBJ 7G;1;8300;0;8300;7455;845;
2021-04-29 11:51:29;8995333060772;TERIGU GATOT KACA 500GR;3;4500;0;13500;12195;1305;
2021-04-29 11:51:29;8998866202237;NOODLE SEDAAP TASTY AYAM GEPREK 124 GR;1;5000;0;5000;4167;833;
2021-04-29 11:51:29;8998866202312;NOODLE SEDAAP TASTY BAKMI AYAM 129 GR;1;5000;0;5000;4167;833;
2021-04-29 11:51:29;8992753031900;BKM SCT PUTIH 40G;4;7500;0;30000;27600;2400;
2021-04-29 11:51:29;8998866609029;DAIA PUTIH GUSSWET 565G;1;10000;0;10000;8700;1300;
2021-04-29 11:51:29;8998866609043;DAIA SOFTENER GUSSET 565G;1;10000;0;10000;8700;1300;
2021-04-29 11:51:29;8998866610278;DAIA VIOLET GUSSET 565G;1;10000;0;10000;8700;1300;
2021-04-29 11:51:29;8998866202770;MIE SEDAAP SALERO PADANG;5;2500;0;12500;11810;690;
2021-04-29 13:12:46;8998866501033;MINYAK GORENG SEDAAP POUCH 2L;1;28000;0;28000;27746;254;
2021-04-29 15:09:45;8998866501033;MINYAK GORENG SEDAAP POUCH 2L;1;28000;0;28000;27746;254;
2021-04-29 15:09:45;8999801700054;SUSU FOYU 1 KG;1;22000;0;22000;20104;1896;
2021-04-29 15:09:45;8995333032113;TERIGU GATOT KACA 1 KG;1;8500;0;8500;8012;488;
2021-04-29 15:09:45;8997018720018;SIRUP DHT;1;23000;0;23000;20958;2042;
2021-04-29 15:12:02;089686021127;INTER MIE KALDU;2;1000;0;2000;1626;374;
2021-04-29 15:12:02;8992753100101;BKM FULL CREAM GOLD 370;1;15000;0;15000;14000;1000;
2021-04-29 15:12:02;8992761145026;SPRITE PET 250ML;1;3500;0;3500;2417;1083;
2021-04-29 15:12:02;8997013790092;BIMURA KERUPUK BAWANG 25G;2;1000;0;2000;1748;252;
2021-04-29 15:12:02;MARS;MARSHMELLOW;1;500;0;500;433;67;
2021-04-29 15:12:02;8997211400038;SANTAN COCONUT CREAM;1;4000;0;4000;3000;1000;
2021-04-29 15:25:46;8999908204202;MY BABY MINYAK TELON 60ML;1;18000;0;18000;16900;1100;
2021-04-29 16:16:12;8992984920110;CUKA DAPUR DUA BELIBIS;2;4500;0;9000;6500;2500;
2021-04-29 16:34:23;8992959508893;SWEETY SILVER PANTS S 9;1;14500;0;14500;13107;1393;
2021-04-29 16:36:31;089686834307;FREISS LECI;1;11000;0;11000;8750;2250;
2021-04-29 17:04:23;089686021127;INTER MIE KALDU;1;1000;0;1000;813;187;
2021-04-29 17:04:36;089686021127;INTER MIE KALDU;4;1000;0;4000;3252;748;
2021-04-29 17:05:19;9556040040038;SUSU F&N;1;33000;0;33000;30000;3000;
2021-04-29 17:05:19;8992775002735;CHOCOLATOS SUSU COKELAT;1;4000;0;4000;3520;480;
2021-04-29 17:06:22;8992761136185;FANTA 1L;1;10000;0;10000;9000;1000;
2021-04-29 17:06:22;GL;GULA 1 LITER;1;11500;0;11500;10500;1000;
2021-04-29 17:06:22;8999999195649;SARI WANGI 25X1.86G;1;6000;0;6000;5050;950;
2021-04-29 17:06:22;8995333032113;TERIGU GATOT KACA 1 KG;1;8500;0;8500;8012;488;
2021-04-29 17:06:22;8998866501026;MINYAK GORENG SEDAAP POUCH 1 L;1;15000;0;15000;14110;890;
2021-04-29 17:08:06;11222;LEM KOREA;1;9000;0;9000;8000;1000;
2021-04-29 17:32:51;GL;GULA 1 LITER;4;11500;0;46000;42000;4000;
2021-04-29 17:35:23;8851019210117;POCKY CHOCOLATE 47G;2;7300;0;14600;11342;3258;
2021-04-29 17:51:16;8998989300261;GUDANG GARAM SURYA 12 FILTER;1;18000;0;18000;16450;1550;
2021-04-29 17:56:30;089686043051;INDOMIE COTO MAKASSAR;1;2800;0;2800;2525;275;
2021-04-29 17:56:30;089686021219;INTER MIE GORENG;2;1000;0;2000;1770;230;
2021-04-29 17:56:30;8993989311699;CLAS MILD 16 FILTER;1;23000;0;23000;21700;1300;
2021-04-29 18:02:37;8995150101696;M+SUSU ORIGINAL;1;5000;0;5000;4000;1000;
2021-04-29 18:48:25;8991102281430;PERMEN MINTZ DUOMINT;1;4500;0;4500;4000;500;
2021-04-29 19:10:37;8997009510116;LEMON WATER;1;7000;0;7000;5694;1306;
2021-04-29 21:21:57;8992388112401;MIE ABC SELERA PEDAS- GORENG AYAM PEDAS LIMAU;1;2600;0;2600;2368;232;
2021-04-29 21:21:57;JGR SHN;JOGER SHINY SACHET;1;500;0;500;437;63;
2021-04-29 21:29:49;089686043273;INDOMIE SAMBAL RICA;3;2700;0;8100;7356;744;
2021-04-29 21:29:49;8992761002022;SPRITE PET 390ML;1;5500;0;5500;4300;1200;
2021-04-29 21:29:49;8999909096004;SAMPOERNA 16 FILTER;1;24000;0;24000;23000;1000;
2021-04-29 21:53:57;8994420100018;SARDEN SAUS PEDAS;1;7000;0;7000;5833;1167;
2021-04-29 21:53:57;089686021127;INTER MIE KALDU;3;1000;0;3000;2439;561;
2021-04-29 21:53:57;TL;TELUR;3;1500;0;4500;3900;600;
2021-04-29 21:56:37;8992775311486;CHOCOLATOS DARK 16G;1;18000;0;18000;15173;2827;
2021-04-29 21:56:37;8992775305164;MALKIST GREEN TEA;1;6500;0;6500;5500;1000;
2021-04-29 21:56:37;8996001305003;SARI GANDUM SANDWICH;1;6000;0;6000;5100;900;
2021-04-29 21:56:37;8991102989381;TANGO LONG BUBBLEGUM 130G;1;5000;0;5000;4345;655;
2021-04-29 21:56:37;8998009020186;BUAVITA GUAVA 250ML;1;7000;0;7000;6083;917;
2021-04-29 21:56:37;8992775110157;GARUDA KACANG KULIT;1;5000;0;5000;3925;1075;
2021-04-29 21:56:37;089686021219;INTER MIE GORENG;1;1000;0;1000;885;115;
2021-04-29 22:29:46;8999999719418;VASELINE HW UV LIGHTENING 200ML;1;24200;0;24200;21853;2347;
2021-04-29 22:29:46;8999999558062;RINSO ANTI NODA CLASSIC PWD 44G;1;5000;0;5000;4830;170;
2021-04-30 11:28:49;8993470411433;JOGER CLASSIC;28;1000;0;28000;23800;4200;
2021-04-30 13:07:10;8998866200837;NOODLE SEDAAPMIE SOTO CUP 81 GR;3;4500;0;13500;10950;2550;
2021-04-30 13:07:10;HT;HOT-HOT;2;500;0;1000;700;300;
2021-04-30 13:07:10;MARS;MARSHMELLOW;1;500;0;500;433;67;
2021-04-30 13:07:10;8997013790092;BIMURA KERUPUK BAWANG 25G;2;1000;0;2000;1748;252;
2021-04-30 14:06:07;GL;GULA 1 LITER;1;11500;0;11500;10500;1000;
2021-04-30 14:06:07;COKLAT;COKLAT COIN;1;500;0;500;400;100;
2021-04-30 14:50:51;8992761139018;ADES 600ML;1;3500;0;3500;2292;1208;
2021-04-30 15:10:22;8992628010139;BIMOLI 5L;1;75000;0;75000;72100;2900;
2021-04-30 15:10:22;8999801700054;SUSU FOYU 1 KG;1;22000;0;22000;20104;1896;
2021-04-30 17:36:49;8992761111540;FANTA STRAWBERY SLIM CAM 250ML;1;5000;0;5000;3750;1250;
2021-04-30 17:36:49;8998989110167;SURYA GUDANG GARAM 16 FILTER;1;24000;0;24000;22100;1900;
2021-04-30 17:36:49;8998989300261;GUDANG GARAM SURYA 12 FILTER;1;18000;0;18000;16450;1550;
2021-04-30 18:01:47;8998989300261;GUDANG GARAM SURYA 12 FILTER;1;18000;0;18000;16450;1550;
2021-04-30 18:20:47;8992761139018;ADES 600ML;1;3500;0;3500;2292;1208;
2021-04-30 18:20:47;8996001600375;LE MINERAL 330ML;3;2000;0;6000;4251;1749;
2021-04-30 18:34:58;711844120433;SAMBAL ABC 600 ML;1;22000;0;22000;20300;1700;
2021-04-30 19:52:19;SWAL;SENDAL SWALLOW;1;18000;0;18000;16500;1500;
2021-04-30 19:52:35;8999909982000;SAMPOERNA 12 FILTER;1;18000;0;18000;16200;1800;
2021-04-30 20:15:42;8998866201483;POTABEE REGULER GRILLED SEAWEED 35GR;1;5000;0;5000;4150;850;
2021-04-30 20:15:42;8999999524722;SUNLIGHT LIME NEW PCH 435ML;1;10000;0;10000;9100;900;
2021-04-30 20:15:42;8992770034151;MASAKO 250GR;1;10000;0;10000;8000;2000;
2021-04-30 20:15:42;8999999049423;REXONA MEN RO SPORT DEFENSE 45 ML;1;15000;0;15000;13550;1450;
2021-04-30 20:15:42;8992775110157;GARUDA KACANG KULIT;1;5000;0;5000;3925;1075;
2021-04-30 20:15:42;8991102303309;WFR TANGO SBJ 176G;1;10000;0;10000;8694;1306;
2021-04-30 20:38:03;8998989500166;GUDANG GARAM MERAH BESAR 16KS;2;17000;0;34000;30600;3400;
2021-04-30 20:38:03;6907992823904;JD CRUNCHY CHOCOLATE VAN;2;8000;0;16000;13600;2400;
2021-04-30 21:00:11;089686021141;INTER MIE SOTO;1;1000;0;1000;854;146;
2021-04-30 21:00:11;089686021219;INTER MIE GORENG;1;1000;0;1000;885;115;
2021-04-30 21:02:55;089686011036;INDOMIE GORENG PEDAS;1;2700;0;2700;2452;248;
2021-04-30 21:02:55;089686021219;INTER MIE GORENG;2;1000;0;2000;1770;230;
2021-04-30 21:03:27;6907992823829;JD MILKY MILK;1;3000;0;3000;2600;400;
2021-04-30 21:03:27;6907992825076;JD WATERMELON APPLE;1;2000;0;2000;1700;300;
2021-04-30 21:03:27;8997231980022;O'JELLY MINI STRAWBERRY;1;3000;0;3000;2250;750;
2021-04-30 21:05:32;089686044249;SUPERMI NUTRIMI STEAK AYAM;1;3500;0;3500;2800;700;
2021-04-30 21:24:18;8998866201469;POTABEE REGULER BBQ BEEF 68 GR;1;8000;0;8000;7200;800;
2021-04-30 21:24:18;8991102308861;FULLO BLASTO;1;16000;0;16000;14545;1455;
2021-04-30 21:24:18;8998866202664;POTABEE WAGYU BEEF STEAK 68 GR;1;8000;0;8000;7200;800;
2021-04-30 21:25:36;8997231980022;O'JELLY MINI STRAWBERRY;1;3000;0;3000;2250;750;
2021-04-30 21:26:14;8997231980022;O'JELLY MINI STRAWBERRY;1;3000;0;3000;2250;750;
2021-04-30 21:48:05;8998866612173;SOKLIN SOFTERGENT 770G & PIRING;1;18000;0;18000;16055;1945;
2021-04-30 21:48:05;001;PASEO SMART FACIAL SF 250S GT;1;10000;0;10000;9500;500;
2021-04-30 21:56:45;089686021219;INTER MIE GORENG;1;1000;0;1000;885;115;
2021-04-30 21:56:45;8997013790108;BIMURA KACANG TELUR 25G;1;1000;0;1000;875;125;
2021-04-30 21:56:45;8997013790092;BIMURA KERUPUK BAWANG 25G;1;1000;0;1000;874;126;
2021-04-30 22:00:28;089686021219;INTER MIE GORENG;3;1000;0;3000;2655;345;
2021-04-30 22:00:28;TL;TELUR;2;1500;0;3000;2600;400;
2021-04-30 22:01:19;8992775305164;MALKIST GREEN TEA;1;6500;0;6500;5500;1000;
2021-04-30 22:01:19;8992775311325;GERY SNACK&SEREAL 100G;1;7000;0;7000;6012;988;
2021-04-30 22:29:05;6921101219235;YAKUAT JELLY;1;2000;0;2000;1750;250;
2021-04-30 22:37:35;8992761164539;NUTRIBOOST ORANGE 300ML;1;6500;0;6500;5300;1200;
2021-04-30 22:37:35;8993470672827;SAKU-SAKU SAPI PANGGANG;1;2000;0;2000;1530;470;
2021-04-30 22:37:35;8993470672858;SAKU-SAKU RASA BALADO;1;2000;0;2000;1530;470;
2021-05-01 11:03:13;8992959107515;SFX NON WING 23CM 8;1;4000;0;4000;3288;712;
2021-05-01 11:03:13;8997027300089;NOMOS;1;4000;0;4000;2963;1037;
2021-05-01 11:03:13;8997013790092;BIMURA KERUPUK BAWANG 25G;1;1000;0;1000;874;126;
2021-05-01 11:03:13;089686021141;INTER MIE SOTO;1;1000;0;1000;854;146;
2021-05-01 11:03:13;089686021219;INTER MIE GORENG;1;1000;0;1000;885;115;
2021-05-01 11:03:13;8997028590014;ARGUS 220ML;2;500;0;1000;604;396;
2021-05-01 11:15:00;HT;HOT-HOT;2;500;0;1000;700;300;
2021-05-01 11:15:00;MARS;MARSHMELLOW;1;500;0;500;433;67;
2021-05-01 11:15:00;8991102989428SCT;TANGO CKLT 24G SCT;1;1000;0;1000;609;391;
2021-05-01 11:47:01;GL;GULA 1 LITER;15;11500;0;172500;157500;15000;
2021-05-01 11:47:01;8991102384841;WFR TANGO LONG CKLT 130G;1;5000;0;5000;4345;655;
2021-05-01 11:47:01;8991102987639;WFR TANGO LONG VNL 130G;1;5000;0;5000;3773;1227;
2021-05-01 13:04:27;GL;GULA 1 LITER;1;11500;0;11500;10500;1000;
2021-05-01 13:05:46;8998866202770;MIE SEDAAP SALERO PADANG;1;2500;0;2500;2362;138;
2021-05-01 13:05:46;8998866200578;MIE SEDAAP KARI KENTAL;1;2500;0;2500;2263;237;
2021-05-01 13:05:46;8998866200301;MIE SEDAAP GORENG;1;2500;0;2500;2023;477;
2021-05-01 13:05:46;8998866200325;MIE SEDAAP SOTO;1;2500;0;2500;1952;548;
2021-05-01 14:46:00;089686011036;INDOMIE GORENG PEDAS;1;2700;0;2700;2452;248;
2021-05-01 15:21:46;GL;GULA 1 LITER;1;11500;0;11500;10500;1000;
2021-05-01 15:28:28;TL;TELUR;6;1500;0;9000;7800;1200;
2021-05-01 15:28:28;8998866501026;MINYAK GORENG SEDAAP POUCH 1 L;1;15000;0;15000;14110;890;
2021-05-01 15:28:28;8998009010569;ULTRA CHO 200;1;5000;0;5000;3830;1170;
2021-05-01 15:28:28;8998866201889;KRISBEE PILLOW STRAWBERRY ICE CREAM 120GR;1;8000;0;8000;7250;750;
2021-05-01 15:28:28;RBB;ROSE BRAND;1;9000;0;9000;8000;1000;
2021-05-01 15:28:28;6907992823843;JD MOCHA CRISPY;1;5000;0;5000;4400;600;
2021-05-01 16:23:56;8995102703534;TERASI DUO 6 GR;1;4000;0;4000;3720;280;
2021-05-01 20:20:16;8991002103764;GOOD DAY CAPPUCINO 10X25G;2;1500;0;3000;2790;210;
2021-05-01 20:20:16;089686021141;INTER MIE SOTO;3;1000;0;3000;2562;438;
2021-05-01 20:20:16;089686021219;INTER MIE GORENG;1;1000;0;1000;885;115;
2021-05-01 20:54:28;8992761145019;COCA COLA PET 250ML;1;3500;0;3500;2417;1083;
2021-05-01 21:15:17;8993274532105;BOLU;4;1000;0;4000;3332;668;
2021-05-01 21:15:17;6907992823829;JD MILKY MILK;1;3000;0;3000;2600;400;
2021-05-01 21:16:29;8991102022347;SIKAT GIGI FORMULA RIPPLE;1;5000;0;5000;4583;417;
2021-05-01 21:16:29;8998866888622;GIV MERAH KOTAK 76G;1;2000;0;2000;1820;180;
2021-05-01 21:16:29;6907992825076;JD WATERMELON APPLE;1;2000;0;2000;1700;300;
2021-05-01 21:16:29;6907992823959;JD HAWTHORN BERRY;1;2000;0;2000;1700;300;
2021-05-01 21:16:29;MARS;MARSHMELLOW;2;500;0;1000;866;134;
2021-05-01 21:38:38;089686021219;INTER MIE GORENG;3;1000;0;3000;2655;345;
2021-05-01 21:38:38;8994420100018;SARDEN SAUS PEDAS;1;7000;0;7000;5833;1167;
2021-05-01 22:52:28;089686010190;INDOMIE KARI AYAM;1;2800;0;2800;2522;278;
2021-05-02 11:55:50;8991102213189;BLASTER UNGU;1;5000;0;5000;3106;1894;
2021-05-02 12:16:48;8998866613729;EMERON LOVELY NTRL 100ML;1;3500;0;3500;2900;600;
2021-05-02 12:53:05;8997009510116;LEMON WATER;1;7000;0;7000;5694;1306;
2021-05-02 12:53:05;8994834005923;SPIX 1000;2;1000;0;2000;1700;300;
2021-05-02 12:53:05;8886013257400;TWISTKO;1;1000;0;1000;900;100;
2021-05-02 14:08:36;8992959074206;HN PANTS S20;1;25000;0;25000;22576;2424;
2021-05-02 14:08:36;8998866601436;PODET DAIA BUNGA BAG 850GR & PIRING;1;18000;0;18000;15627;2373;
2021-05-02 14:08:36;8992959610107;HN PANTS L 48;1;77000;0;77000;72425;4575;
2021-05-02 14:08:36;P;PAKET RAMADHAN 50 RIBU;2;50000;0;100000;100000;0;
2021-05-02 14:08:36;BMO;BERAS MERAH ORGANIK;1;25000;0;25000;23500;1500;
2021-05-02 14:08:36;GL;GULA 1 LITER;1;11500;0;11500;10500;1000;
2021-05-02 14:08:36;8992696521797GT;MILO ACT GO SCT 22G;1;17500;0;17500;15536;1964;
2021-05-02 14:08:36;8998009040023;TEH KOTAK;1;5000;0;5000;2827;2173;
2021-05-02 14:58:15;8998866200646;KOPI TOP MURNI;1;11000;0;11000;9600;1400;
2021-05-02 15:22:09;8992761164546;NUTRIBOOST STRAWBERRY 300ML;1;6500;0;6500;5300;1200;
2021-05-02 15:22:09;8991102387286SCT;TANGO LONG CKLT 47G;1;2000;0;2000;1551;449;
2021-05-02 15:22:09;8993989311699;CLAS MILD 16 FILTER;1;23000;0;23000;21700;1300;
2021-05-02 15:30:26;8999999514648;LUX BWSAKURA BLOOM LD REFF 450 ML;1;25000;0;25000;22110;2890;
2021-05-02 15:30:26;8999999048501;SUNSILK RFR ANTI DDRF 170ML;1;22200;0;22200;20020;2180;
2021-05-02 15:30:26;8993072254056;MELROSE COTTON BUDS KCL;1;3000;0;3000;2450;550;
2021-05-02 15:30:26;TK;TOPUN KOTAN;1;14000;0;14000;13000;1000;
2021-05-02 15:52:16;8991102384841;WFR TANGO LONG CKLT 130G;1;5000;0;5000;4345;655;
2021-05-02 15:52:16;8991102987639;WFR TANGO LONG VNL 130G;1;5000;0;5000;3773;1227;
2021-05-02 15:52:16;8991102989381;TANGO LONG BUBBLEGUM 130G;1;5000;0;5000;4345;655;
2021-05-02 15:52:16;8992775610008;TING-TING GARUDA 2.5G;1;7500;0;7500;6296;1204;
2021-05-02 16:18:05;8998866501033;MINYAK GORENG SEDAAP POUCH 2L;1;28000;0;28000;27746;254;
2021-05-02 16:28:28;8992628010139;BIMOLI 5L;1;75000;0;75000;72100;2900;
2021-05-02 17:27:30;8997018720018;SIRUP DHT;1;23000;0;23000;20958;2042;
2021-05-02 17:27:30;8997218380074;ICHITAN MILK TEA;1;8000;0;8000;6583;1417;
2021-05-02 18:01:04;8998989300261;GUDANG GARAM SURYA 12 FILTER;1;18000;0;18000;16450;1550;
2021-05-02 18:01:04;123124;KOREK BIASA;1;2000;0;2000;1800;200;
2021-05-02 18:01:42;8991102387286SCT;TANGO LONG CKLT 47G;1;2000;0;2000;1551;449;
2021-05-02 18:03:34;8998989300261;GUDANG GARAM SURYA 12 FILTER;1;18000;0;18000;16450;1550;
2021-05-02 19:10:25;8992388101085;NU GREEN TEA ORIGINAL 330ML;1;3500;0;3500;2854;646;
2021-05-02 19:10:25;8997231980022;O'JELLY MINI STRAWBERRY;1;3000;0;3000;2250;750;
2021-05-02 19:10:25;TG MARKISA;TEH GELAS MARKISA;1;2000;0;2000;1178;822;
2021-05-02 19:17:33;8998989300261;GUDANG GARAM SURYA 12 FILTER;1;18000;0;18000;16450;1550;
2021-05-02 19:23:04;8992761139018;ADES 600ML;2;3500;0;7000;4584;2416;
2021-05-02 19:27:51;8998866611718;EKONOMI PENCUCI PIRING  LIQ 780ML;1;12000;0;12000;10900;1100;
2021-05-02 20:57:25;8997009510055;YOU C1000;1;10000;0;10000;9166;834;
2021-05-02 21:00:21;8994420100018;SARDEN SAUS PEDAS;1;7000;0;7000;5833;1167;
2021-05-02 21:00:21;089686021219;INTER MIE GORENG;5;1000;0;5000;4425;575;
2021-05-02 21:00:21;8999999558079;RINSO MOLTO ROSE FRESH PWD 44G;5;1000;0;5000;4025;975;
2021-05-02 21:00:21;089686043051;INDOMIE COTO MAKASSAR;1;2800;0;2800;2525;275;
2021-05-02 21:14:46;8999909003439;MARLBORO CRAFTED 12;1;8000;0;8000;5437;2563;
2021-05-02 21:14:46;8997231980022;O'JELLY MINI STRAWBERRY;1;3000;0;3000;2250;750;
2021-05-02 21:14:46;HT;HOT-HOT;2;500;0;1000;700;300;
2021-05-02 21:17:22;6907992823829;JD MILKY MILK;1;3000;0;3000;2600;400;
2021-05-02 21:17:22;6907992824963;JD MILKY CHOCOLATE;1;3000;0;3000;2600;400;
2021-05-02 21:34:37;8997018250218;JAHE MERAH;2;1000;0;2000;1666;334;
2021-05-02 21:34:37;SMC;BIMURA MAKARONI CINCIN 250G;1;10000;0;10000;9300;700;
2021-05-02 21:34:37;TLR;TELUR;1;43000;0;43000;39000;4000;
2021-05-02 21:36:11;BMO;BERAS MERAH ORGANIK;1;25000;0;25000;23500;1500;
2021-05-02 21:41:10;8997231980022;O'JELLY MINI STRAWBERRY;2;3000;0;6000;4500;1500;
2021-05-02 21:41:10;MARS;MARSHMELLOW;4;500;0;2000;1732;268;
2021-05-02 21:51:55;BALON;BALON CABUT;2;1000;0;2000;1800;200;
2021-05-02 21:51:55;KJ;KINDER JOY;1;2000;0;2000;1583;417;
2021-05-02 22:17:30;8991001502933;CHACHA TUBE;2;7500;0;15000;12800;2200;
2021-05-02 22:18:46;8992957220117;COKLAT BERUANG;1;2000;0;2000;1700;300;
2021-05-02 22:18:46;8992957220087;COKLAT SINGA;1;2000;0;2000;1700;300;
2021-05-02 22:31:30;8992761166052;FRESTEA MELATI 350ML;1;4500;0;4500;3000;1500;
2021-05-02 22:31:30;8996001600399;LE MINERAL 1500ML;1;5000;0;5000;4042;958;
2021-05-02 22:36:21;8997231980022;O'JELLY MINI STRAWBERRY;1;3000;0;3000;2250;750;
2021-05-03 10:34:32;8991102989428GT;TANGO CKLT 24G GT;2;7500;0;15000;12184;2816;
2021-05-03 10:34:32;8991102994422;TANGO WALUT CHOCOBNN 18G;1;9000;0;9000;8661;339;
2021-05-03 10:34:32;8992753102303;BKM SCT CKLT 40G;2;7500;0;15000;13800;1200;
2021-05-03 10:37:56;MOBIL;GULA GULA HP;2;2000;0;4000;3400;600;
2021-05-03 11:02:12;8997013790108;BIMURA KACANG TELUR 25G;1;1000;0;1000;875;125;
2021-05-03 11:02:12;8998866618298;DAIA CLEAN&FRESH HJB 320GR;1;5000;0;5000;4450;550;
2021-05-03 11:58:35;8991111102832;JB POWDER BEDTIME 300G;1;14500;0;14500;13120;1380;
2021-05-03 11:58:35;8992753102204;BKM COKLAT 370G;1;11300;0;11300;9500;1800;
2021-05-03 11:58:35;089686017748;SARIMIE GORENG ISI 2;1;3500;0;3500;3120;380;
2021-05-03 11:58:35;8998866200882;SUKSESMIE GORENG AYAM KRMS 133GR;1;3500;0;3500;3047;453;
2021-05-03 11:58:35;8996001305041;ROMA SANDWICH CKLT;1;7000;0;7000;5000;2000;
2021-05-03 12:00:12;8998866202770;MIE SEDAAP SALERO PADANG;1;2500;0;2500;2362;138;
2021-05-03 12:00:12;JGR SHN;JOGER SHINY SACHET;1;500;0;500;437;63;
2021-05-03 14:01:13;BC;BONIBOL COKELAT;1;85000;0;85000;70000;15000;
2021-05-03 14:07:10;6907992823652;JD CHOCOLATE MILKSHAKE;1;6000;0;6000;5200;800;
2021-05-03 14:07:10;8997028590014;ARGUS 220ML;4;500;0;2000;1208;792;
2021-05-03 14:09:28;8997028590014;ARGUS 220ML;4;500;0;2000;1208;792;
2021-05-03 14:09:28;089686021141;INTER MIE SOTO;3;1000;0;3000;2562;438;
2021-05-03 14:18:21;8992933219111;NUTRIJELL CINCAU;1;6000;0;6000;5000;1000;
2021-05-03 14:18:21;8992933214116;NUTRIJELL MELON;1;6000;0;6000;5041;959;
2021-05-03 14:18:21;8992933218114;NUTRIJELL GRAPE;1;6000;0;6000;4950;1050;
2021-05-03 14:28:39;8998866202343;MIE SEDAAP KOREAN SPICY;1;2500;0;2500;2023;477;
2021-05-03 14:40:51;8996001600375;LE MINERAL 330ML;1;2000;0;2000;1417;583;
2021-05-03 14:40:51;MARS;MARSHMELLOW;1;500;0;500;433;67;
2021-05-03 14:43:17;8998866501033;MINYAK GORENG SEDAAP POUCH 2L;1;28000;0;28000;27746;254;
2021-05-03 15:00:46;JGR SHN;JOGER SHINY SACHET;2;500;0;1000;874;126;
2021-05-03 15:14:02;8997028590014;ARGUS 220ML;4;500;0;2000;1208;792;
2021-05-03 15:47:43;9556001004673;MILO NESTLE MALAYSIA ACTIVE GO;1;85000;0;85000;80000;5000;
2021-05-03 16:16:04;MARS;MARSHMELLOW;10;500;0;5000;4330;670;
2021-05-03 16:16:15;MARS;MARSHMELLOW;1;500;0;500;433;67;
2021-05-03 16:16:15;HT;HOT-HOT;1;500;0;500;350;150;
2021-05-03 16:25:33;8999801700054;SUSU FOYU 1 KG;1;22000;0;22000;20104;1896;
2021-05-03 16:52:52;GL;GULA 1 LITER;1;11500;0;11500;10500;1000;
2021-05-03 17:36:21;8992628010139;BIMOLI 5L;1;75000;0;75000;72100;2900;
2021-05-03 18:02:16;8992761139018;ADES 600ML;1;3500;0;3500;2292;1208;
2021-05-03 18:38:34;711844120037;SAMBAL ABC 135 ML;1;7000;0;7000;5600;1400;
2021-05-03 18:38:34;8999999048488;SUNSILK SHP REFRESH ANTI DDRF 70+21ML;1;10000;0;10000;9075;925;
2021-05-03 19:15:09;8997231980022;O'JELLY MINI STRAWBERRY;1;3000;0;3000;2250;750;
2021-05-03 19:15:09;8993274532105;BOLU;1;1000;0;1000;833;167;
2021-05-03 19:26:55;8996001370063;CHOKI-CHOKI;1;18200;0;18200;16500;1700;
2021-05-03 19:29:23;8997231980022;O'JELLY MINI STRAWBERRY;2;3000;0;6000;4500;1500;
2021-05-03 19:30:18;8998866610278;DAIA VIOLET GUSSET 565G;1;10000;0;10000;8700;1300;
2021-05-03 19:35:08;8992628010139;BIMOLI 5L;1;75000;0;75000;72100;2900;
2021-05-03 19:37:21;8997231980022;O'JELLY MINI STRAWBERRY;2;3000;0;6000;4500;1500;
2021-05-03 19:43:58;8993058105013;EXTRA JOSS;1;12000;0;12000;9773;2227;
2021-05-03 19:47:47;8998898830125;KKB ENER-G ANGGUR;1;5500;0;5500;4824;676;
2021-05-03 20:20:21;8994867007161;ROKOK PENA GOLD 20;1;17000;0;17000;15000;2000;
2021-05-03 20:20:21;8997231980022;O'JELLY MINI STRAWBERRY;3;3000;0;9000;6750;2250;
2021-05-03 20:27:50;8997021870052;FRESH CARE GREEN TEA 10ML;1;12000;0;12000;10000;2000;
2021-05-03 20:27:50;6907992823843;JD MOCHA CRISPY;1;5000;0;5000;4400;600;
2021-05-03 20:56:23;8991102213189;BLASTER UNGU;1;5000;0;5000;3106;1894;
2021-05-03 20:56:23;8992761145019;COCA COLA PET 250ML;1;3500;0;3500;2417;1083;
2021-05-03 20:59:10;BALON;BALON CABUT;3;1000;0;3000;2700;300;
2021-05-03 20:59:10;PRG;PARAGO;2;500;0;1000;800;200;
2021-05-03 20:59:10;JGR SHN;JOGER SHINY SACHET;2;500;0;1000;874;126;
2021-05-03 21:13:01;8991102987639;WFR TANGO LONG VNL 130G;1;5000;0;5000;3773;1227;
2021-05-03 21:13:01;711844150003;ABC ORANGE;1;12000;0;12000;9900;2100;
2021-05-03 21:13:01;8993072153595;LARISST COTTON 35G;1;5000;0;5000;3300;1700;
2021-05-03 21:14:21;6907992823829;JD MILKY MILK;1;3000;0;3000;2600;400;
2021-05-03 21:19:36;8992696523081;MILO UHT 110ML;1;2500;0;2500;1962;538;
2021-05-03 21:19:36;8886013257400;TWISTKO;1;1000;0;1000;900;100;
2021-05-03 21:19:36;MOBIL;GULA GULA HP;1;2000;0;2000;1700;300;
2021-05-03 21:42:44;8993989311279;CLAS MILD 12;1;17000;0;17000;15700;1300;
2021-05-03 21:45:21;8998866610711;NOVO ACTIVE CLEAN 110G;1;3000;0;3000;2600;400;
2021-05-03 21:45:21;8992694242502;ZWITZAL SOAP CALSSIC 70G;1;3800;0;3800;3410;390;
2021-05-03 21:45:21;8992959953037;SWEETY BRONZE L1;1;3000;0;3000;2671;329;
2021-05-03 21:46:47;8998866202244;EKOMIE BUMBU KALDU AYAM;5;1000;0;5000;3990;1010;
2021-05-03 22:09:12;089686021127;INTER MIE KALDU;2;1000;0;2000;1626;374;
2021-05-03 22:09:12;089686021219;INTER MIE GORENG;1;1000;0;1000;885;115;
2021-05-03 22:09:12;089686021141;INTER MIE SOTO;1;1000;0;1000;854;146;
2021-05-03 22:09:12;8998866202244;EKOMIE BUMBU KALDU AYAM;1;1000;0;1000;798;202;
2021-05-03 22:14:21;089686011036;INDOMIE GORENG PEDAS;2;2700;0;5400;4904;496;
2021-05-03 22:14:21;089686044249;SUPERMI NUTRIMI STEAK AYAM;1;3500;0;3500;2800;700;
2021-05-03 22:44:39;8997013790108;BIMURA KACANG TELUR 25G;1;1000;0;1000;875;125;
2021-05-03 22:44:39;MARS;MARSHMELLOW;2;500;0;1000;866;134;
2021-05-04 11:14:26;8995333060703;TERIGU KOMPAS 1KG;4;10500;0;42000;39264;2736;
2021-05-04 11:14:26;8992993523098;COLATTA CHOCO CHIPS 150G;1;11000;0;11000;9885;1115;
2021-05-04 11:14:26;8992993260351;COLATTA COMPOUND DARK 250G;1;18500;0;18500;16714;1786;
2021-05-04 11:25:35;8992946512223;SHINZUI;1;4000;0;4000;2500;1500;
2021-05-04 11:25:35;8999999706111;PEPSODENT WHITE 25G;1;2000;0;2000;1450;550;
2021-05-04 11:28:15;8991102387286SCT;TANGO LONG CKLT 47G;1;2000;0;2000;1551;449;
2021-05-04 11:28:15;089686646047;SUNMARIE;1;7000;0;7000;6626;374;
2021-05-04 11:31:45;MARS;MARSHMELLOW;1;500;0;500;433;67;
2021-05-04 11:33:14;8997028590014;ARGUS 220ML;1;500;0;500;302;198;
2021-05-04 11:33:58;8997028590014;ARGUS 220ML;1;500;0;500;302;198;
2021-05-04 11:34:52;8997028590014;ARGUS 220ML;1;500;0;500;302;198;
2021-05-04 11:35:17;8997028590014;ARGUS 220ML;1;500;0;500;302;198;
2021-05-04 11:36:38;8997028590014;ARGUS 220ML;1;500;0;500;302;198;
2021-05-04 12:29:14;8999999502409;ROYCO FDS BEEF 9G;1;500;0;500;375;125;
2021-05-04 12:29:14;8991102387286SCT;TANGO LONG CKLT 47G;1;2000;0;2000;1551;449;
2021-05-04 12:55:57;8992957352153;CHOCO CHIPS 45G;1;4500;0;4500;2850;1650;
2021-05-04 12:55:57;8992770034151;MASAKO 250GR;1;10000;0;10000;8000;2000;
2021-05-04 12:55:57;711844110083;KECAP ABC 275 ML;1;14500;0;14500;13400;1100;
2021-05-04 12:55:57;8999999706180;PEPSODENT WHITE 190GR;1;10000;0;10000;9350;650;
2021-05-04 12:55:57;8999999059781;SUNLIGHT LIME NEW POUCH 210ML;1;5000;0;5000;4300;700;
2021-05-04 15:43:02;8999999049409;REXONA MEN ICE COOL 45 ML;1;15000;0;15000;13550;1450;
2021-05-04 15:43:02;8994867007161;ROKOK PENA GOLD 20;1;17000;0;17000;15000;2000;
2021-05-04 15:51:04;GL;GULA 1 LITER;1;11500;0;11500;10500;1000;
2021-05-04 16:00:21;8999801700054;SUSU FOYU 1 KG;1;22000;0;22000;20104;1896;
2021-05-04 16:07:19;8993176110081;MINYAK KAYU PUTIH 30ML;1;12000;0;12000;9091;2909;
2021-05-04 16:41:00;BAYFLAST;BAYPLAST;2;500;0;1000;700;300;
2021-05-04 16:54:32;8998866200561;EKOMIE SUPER 600GR;2;10000;0;20000;17230;2770;
2021-05-04 17:18:24;8992959971109;SFX COMFORT SLIM 36CM 12+1;1;16500;0;16500;15152;1348;
2021-05-04 17:19:46;8999909003439;MARLBORO CRAFTED 12;1;8000;0;8000;5437;2563;
2021-05-04 17:42:00;6907992823973;JD PINEAPPLE;1;5000;0;5000;4300;700;
2021-05-04 17:42:00;6907992823607;JD CHOCO CAPTAIN;1;5500;0;5500;4700;800;
2021-05-04 17:42:00;8998989500166;GUDANG GARAM MERAH BESAR 16KS;2;17000;0;34000;30600;3400;
2021-05-04 17:43:08;8998989300261;GUDANG GARAM SURYA 12 FILTER;1;18500;0;18500;17200;1300;
2021-05-04 17:43:08;089686400816;SAMBAL EXTRA PEDAS 135ML;1;5500;0;5500;4950;550;
2021-05-04 17:49:59;8998866200882;SUKSESMIE GORENG AYAM KRMS 133GR;1;3500;0;3500;3047;453;
2021-05-04 17:49:59;8992775000250SCT;CHOCOLATOS MATCHA DRINK SCT;3;2000;0;6000;4758;1242;
2021-05-04 17:51:03;8998989110167;SURYA GUDANG GARAM 16 FILTER;1;24000;0;24000;22100;1900;
2021-05-04 17:55:04;8992957214307;SAFARI MECES;2;5500;0;11000;9000;2000;
2021-05-04 19:23:48;6921101219235;YAKUAT JELLY;1;2000;0;2000;1750;250;
2021-05-04 19:38:51;8998989300261;GUDANG GARAM SURYA 12 FILTER;1;18500;0;18500;17200;1300;
2021-05-04 21:01:23;BALON;BALON CABUT;4;1000;0;4000;3600;400;
2021-05-04 21:01:23;JGR SHN;JOGER SHINY SACHET;2;500;0;1000;874;126;
2021-05-04 21:01:23;YOUTOP;YOUTOP;1;1000;0;1000;875;125;
2021-05-04 21:01:23;COKLAT;COKLAT COIN;2;500;0;1000;800;200;
2021-05-04 21:11:27;bb;BENG-BENG;1;1500;0;1500;1450;50;
2021-05-04 21:11:27;8994834003752;TICTIC;3;2000;0;6000;5100;900;
2021-05-04 21:33:50;8992775110140;GARUDA KACANG KULIT 160G;1;12000;0;12000;10012;1988;
2021-05-04 21:39:20;8999999003067;VASELINE SPF24 100ML;1;19500;0;19500;17600;1900;
2021-05-04 21:46:10;BALON;BALON CABUT;6;1000;0;6000;5400;600;
2021-05-04 21:55:41;8991102384841;WFR TANGO LONG CKLT 130G;1;5000;0;5000;4345;655;
2021-05-04 21:55:41;8992761111540;FANTA STRAWBERY SLIM CAM 250ML;1;5000;0;5000;3750;1250;
2021-05-04 21:55:41;8998989110167;SURYA GUDANG GARAM 16 FILTER;1;24000;0;24000;22100;1900;
2021-05-04 22:02:25;8991001770301;SELAMAT CLACK VANILA;1;13000;0;13000;11800;1200;
2021-05-04 22:02:25;8992775110140;GARUDA KACANG KULIT 160G;1;12000;0;12000;10012;1988;
2021-05-05 11:03:37;8992775000250SCT;CHOCOLATOS MATCHA DRINK SCT;6;2000;0;12000;9516;2484;
2021-05-05 11:03:37;8992775913000GT;CHOCOLATOS CKLT DRINK;1;18000;0;18000;15862;2138;
2021-05-05 14:35:48;KURMA;KURMA;1;60000;0;60000;55000;5000;
2021-05-05 14:35:48;8999999195656;SARI WANGI 50X1.85;1;10000;0;10000;9500;500;
2021-05-05 14:35:48;8992753102204;BKM COKLAT 370G;1;11300;0;11300;9500;1800;
2021-05-05 14:35:48;8992753100101;BKM FULL CREAM GOLD 370;1;15000;0;15000;14000;1000;
2021-05-05 14:38:09;8999999001193;LIFEBUOY BW TOTAL10 LD REFF 450 ML;1;25000;0;25000;22110;2890;
2021-05-05 14:40:49;8998866202930;SEDAAP AYAM JERIT CUP;1;4500;0;4500;3738;762;
2021-05-05 14:40:49;MARS;MARSHMELLOW;2;500;0;1000;866;134;
2021-05-05 14:40:49;089686044249;SUPERMI NUTRIMI STEAK AYAM;1;3500;0;3500;2800;700;
2021-05-05 14:40:49;8994834006128;TICTIC PEDAS;1;2000;0;2000;1700;300;
2021-05-05 16:22:30;089686061024;POP MIE MINI SOTO RL;1;3000;0;3000;2702;298;
2021-05-05 16:22:30;8994834005923;SPIX 1000;1;1000;0;1000;850;150;
2021-05-05 16:22:30;8998009010569;ULTRA CHO 200;1;5000;0;5000;3830;1170;
2021-05-05 16:24:47;8886013257400;TWISTKO;5;1000;0;5000;4500;500;
2021-05-05 16:32:18;8991102230308;BLASTER PINK;1;5000;0;5000;3106;1894;
2021-05-05 16:47:15;8992775913000SCT;CHOCOLATOS CKLT DRINK SCT;2;2000;0;4000;3172;828;
2021-05-05 16:47:15;8999801700030;SUSU FOYU;1;11500;0;11500;10450;1050;
2021-05-05 17:50:09;8992775913000SCT;CHOCOLATOS CKLT DRINK SCT;1;2000;0;2000;1586;414;
2021-05-05 17:50:09;JGR SHN;JOGER SHINY SACHET;6;500;0;3000;2622;378;
2021-05-05 17:58:20;001;PASEO SMART FACIAL SF 250S GT;1;10000;0;10000;9500;500;
2021-05-05 17:58:20;8998989300261;GUDANG GARAM SURYA 12 FILTER;1;18500;0;18500;17200;1300;
2021-05-05 17:58:20;JGR SHN;JOGER SHINY SACHET;3;500;0;1500;1311;189;
2021-05-05 17:59:24;8998989300261;GUDANG GARAM SURYA 12 FILTER;1;18500;0;18500;17200;1300;
2021-05-05 18:04:12;8999801700054;SUSU FOYU 1 KG;1;22000;0;22000;20104;1896;
2021-05-05 18:29:47;8992761166212;FRESTEA APPLE 350ML;1;4500;0;4500;3000;1500;
2021-05-05 18:29:47;BMCC;BIMURA POTATO CINCIN 250G;1;10000;0;10000;9300;700;
2021-05-05 18:29:47;8998866107457;POSH SUMMER LOVE 150ML;1;19500;0;19500;17500;2000;
2021-05-05 18:29:47;MARS;MARSHMELLOW;2;500;0;1000;866;134;
2021-05-05 18:30:36;8994834005923;SPIX 1000;1;1000;0;1000;850;150;
2021-05-05 18:30:36;8886013257400;TWISTKO;2;1000;0;2000;1800;200;
2021-05-05 19:19:04;8991002105409;KOPI KAPAL API;1;20000;0;20000;18888;1112;
2021-05-05 19:19:04;8991004011906;KOPI BORONG;1;10000;0;10000;8333;1667;
2021-05-05 19:37:44;8992761111540;FANTA STRAWBERY SLIM CAM 250ML;1;5000;0;5000;3750;1250;
2021-05-05 19:37:44;BMCC;BIMURA POTATO CINCIN 250G;1;10000;0;10000;9300;700;
2021-05-05 19:41:28;8993072153595;LARISST COTTON 35G;1;5000;0;5000;3300;1700;
2021-05-05 19:41:28;8999999059781;SUNLIGHT LIME NEW POUCH 210ML;1;5000;0;5000;4300;700;
2021-05-05 20:12:31;8998989300230;SIGNATURE BESAR;1;20000;0;20000;18600;1400;
2021-05-05 20:29:46;ABC;BATERAI ABC BIRU;1;8500;0;8500;7500;1000;
2021-05-05 20:50:19;8992775913000SCT;CHOCOLATOS CKLT DRINK SCT;7;2000;0;14000;11102;2898;
2021-05-05 20:50:19;8992775211410;PILUS GARUDA PEDAS;1;5000;0;5000;4886;114;
2021-05-05 21:04:16;6907992823652;JD CHOCOLATE MILKSHAKE;1;6000;0;6000;5200;800;
2021-05-05 21:04:16;HT;HOT-HOT;2;500;0;1000;700;300;
2021-05-05 21:04:16;JGR SHN;JOGER SHINY SACHET;2;500;0;1000;874;126;
2021-05-05 22:14:41;6907992823829;JD MILKY MILK;1;3000;0;3000;2600;400;
2021-05-05 22:14:41;8997231980022;O'JELLY MINI STRAWBERRY;1;3000;0;3000;2250;750;
2021-05-05 22:14:41;8997231980015;O'JELLY MINI APPLE;1;3000;0;3000;2250;750;
2021-05-05 22:14:41;SMC;BIMURA MAKARONI CINCIN 250G;1;10000;0;10000;9300;700;
2021-05-06 12:34:39;8998989300261;GUDANG GARAM SURYA 12 FILTER;1;18500;0;18500;17200;1300;
2021-05-06 12:34:39;8994023000050;MEGKEJU SERBAGUNA 165G;1;12000;0;12000;10339;1661;
2021-05-06 12:34:39;8992696521797SCT;MILO UHT ACT GO 22G;1;2000;0;2000;1412;588;
2021-05-06 12:34:39;8886013257400;TWISTKO;2;1000;0;2000;1800;200;
2021-05-06 12:34:39;8998866202244;EKOMIE BUMBU KALDU AYAM;1;1000;0;1000;798;202;
2021-05-06 12:34:39;TUSTEL;TUSUK TELINGA;1;1000;0;1000;833;167;
2021-05-06 12:34:39;TL;TELUR;15;1500;0;22500;19500;3000;
2021-05-06 12:34:39;8992696520103;DNCO CKLT FORT SCH 39G;2;3000;0;6000;5294;706;
2021-05-06 12:35:11;089686011036;INDOMIE GORENG PEDAS;1;2700;0;2700;2452;248;
2021-05-06 12:36:07;8992993250048;BENDICO COCOA POWDER 90G;1;18000;0;18000;16203;1797;
2021-05-06 12:37:42;8992775001042;PILUS GARUDA MI GORENG;1;5000;0;5000;4810;190;
2021-05-06 12:37:42;8998866609180;SOKLIN SOFTERGENT POUCH 750ML;1;18000;0;18000;16435;1565;
2021-05-06 12:43:26;001;PASEO SMART FACIAL SF 250S GT;1;10000;0;10000;9500;500;
2021-05-06 12:49:20;8998989110167;SURYA GUDANG GARAM 16 FILTER;1;24000;0;24000;22100;1900;
2021-05-06 13:20:51;089686043273;INDOMIE SAMBAL RICA;2;2700;0;5400;4904;496;
2021-05-06 13:20:51;8992761139018;ADES 600ML;1;3500;0;3500;2292;1208;
2021-05-06 13:20:51;MARS;MARSHMELLOW;2;500;0;1000;866;134;
2021-05-06 14:27:04;8998866608756;SOKLIN SOFTENER TWILIGHT BLUE 14SCH;1;5000;0;5000;4560;440;
2021-05-06 14:27:38;8992628010139;BIMOLI 5L;1;75000;0;75000;72100;2900;
2021-05-06 15:46:55;8998866501033;MINYAK GORENG SEDAAP POUCH 2L;1;28000;0;28000;27746;254;
2021-05-06 16:19:06;BDG;BELLAROSA DANTE GOLD;1;95000;0;95000;85000;10000;
2021-05-06 16:22:46;8850507001152;MOTU ATV;1;10000;0;10000;8000;2000;
2021-05-06 16:38:02;8992696521629;DNCO COKLT UHT 180ML;1;5000;0;5000;3533;1467;
2021-05-06 16:38:02;8996001355817;BENG-BENG MAXX;1;27000;0;27000;24500;2500;
2021-05-06 16:38:02;8999999195656;SARI WANGI 50X1.85;1;10000;0;10000;9500;500;
2021-05-06 16:43:48;8993365121539;MADU TJ SUPER 150G;1;16800;0;16800;15220;1580;
2021-05-06 16:43:48;8992696521797GT;MILO ACT GO SCT 22G;1;17500;0;17500;15536;1964;
2021-05-06 16:43:48;ABC SPW;BATERAI ABC SPW;1;4500;0;4500;3893;607;
2021-05-06 16:44:50;8996001302323;MALKIST ABON;1;6500;0;6500;4800;1700;
2021-05-06 16:47:37;8999999195656;SARI WANGI 50X1.85;1;10000;0;10000;9500;500;
2021-05-06 16:47:37;8997018720018;SIRUP DHT;1;23000;0;23000;20958;2042;
2021-05-06 16:47:37;GL;GULA 1 LITER;2;11500;0;23000;21000;2000;
2021-05-06 16:47:37;8998866202930;SEDAAP AYAM JERIT CUP;1;4500;0;4500;3738;762;
2021-05-06 17:31:25;8999999048280;SUNSILK SHP RFR ANTI DDRF 9 ML;1;10500;0;10500;9300;1200;
2021-05-06 17:54:29;8996001600399;LE MINERAL 1500ML;1;5000;0;5000;4042;958;
2021-05-06 18:03:23;8998989300261;GUDANG GARAM SURYA 12 FILTER;1;18500;0;18500;17200;1300;
2021-05-06 18:09:47;6907992824963;JD MILKY CHOCOLATE;4;3000;0;12000;10400;1600;
2021-05-06 18:09:47;8997007780689;JIZZY MINERAL;1;3000;0;3000;1187;1813;
2021-05-06 18:22:45;8991001780140;TWISTER CHOCO;1;5000;0;5000;4600;400;
2021-05-06 18:22:45;8992761145019;COCA COLA PET 250ML;1;3500;0;3500;2417;1083;
2021-05-06 19:21:07;8999909982000;SAMPOERNA 12 FILTER;1;18000;0;18000;16000;2000;
2021-05-06 19:21:07;123124;KOREK BIASA;1;2000;0;2000;1800;200;
2021-05-06 19:21:07;8993058105013;EXTRA JOSS;1;12000;0;12000;9773;2227;
2021-05-06 19:41:03;089686021219;INTER MIE GORENG;5;1000;0;5000;4425;575;
2021-05-06 19:41:03;8999999524722;SUNLIGHT LIME NEW PCH 435ML;1;10000;0;10000;9100;900;
2021-05-06 19:41:03;8999999045623;MOLTO AIO BLUE SCH;6;1000;0;6000;4800;1200;
2021-05-06 19:41:03;089686048704;SARIMIE GORENG AYAM KCP ISI 2;1;3500;0;3500;3120;380;
2021-05-06 19:41:03;8992979130012;TOTAL LEMON SOFTENER;1;13000;0;13000;11532;1468;
2021-05-06 19:41:03;8999999048280;SUNSILK SHP RFR ANTI DDRF 9 ML;1;10500;0;10500;9300;1200;
2021-05-06 19:41:03;8999999706661;PEPSODENT TB DBL CARE SENSITIVE;1;11500;0;11500;10400;1100;
2021-05-06 19:41:03;8999999059781;SUNLIGHT LIME NEW POUCH 210ML;1;5000;0;5000;4300;700;
2021-05-06 19:41:03;8992759120264;LARISST 220;1;10000;0;10000;9200;800;
2021-05-06 19:41:03;8998866501033;MINYAK GORENG SEDAAP POUCH 2L;1;28000;0;28000;27746;254;
2021-05-06 19:41:03;8995333060703;TERIGU KOMPAS 1KG;1;10500;0;10500;9816;684;
2021-05-06 19:41:03;8993379254469;SABUN LERVIA 90G;1;5000;0;5000;3077;1923;
2021-05-06 19:41:03;8998866602549;NUVO FAMILY BIRU 76G;4;2000;0;8000;7280;720;
2021-05-06 19:41:03;8993226365522;GARAM MEJA GYURI 200GR;1;2000;0;2000;1700;300;
2021-05-06 19:41:03;8999999502409;ROYCO FDS BEEF 9G;6;500;0;3000;2250;750;
2021-05-06 19:41:03;TLR;TELUR;1;43000;0;43000;39000;4000;
2021-05-06 21:06:50;8996001355985;BENG-BENG SHARE IT;1;27000;0;27000;25000;2000;
2021-05-06 21:06:50;8992775913000SCT;CHOCOLATOS CKLT DRINK SCT;3;2000;0;6000;4758;1242;
2021-05-06 21:06:50;8994834005923;SPIX 1000;1;1000;0;1000;850;150;
2021-05-06 21:06:50;8991102989534;TANGO VANILA 24G;2;1000;0;2000;1218;782;
2021-05-06 21:18:43;8992775913000SCT;CHOCOLATOS CKLT DRINK SCT;1;2000;0;2000;1586;414;
2021-05-06 21:18:43;6907992823829;JD MILKY MILK;1;3000;0;3000;2600;400;
2021-05-06 21:18:43;8993470672858;SAKU-SAKU RASA BALADO;1;2000;0;2000;1530;470;
2021-05-06 21:52:26;8999909000377;SAMPOERNA AVOLUTION;1;30000;0;30000;28450;1550;
2021-05-06 21:57:35;8998866202770;MIE SEDAAP SALERO PADANG;1;2500;0;2500;2362;138;
2021-05-06 21:57:35;COKLAT;COKLAT COIN;1;500;0;500;400;100;
2021-05-06 21:58:46;8992775001042;PILUS GARUDA MI GORENG;1;5000;0;5000;4810;190;
2021-05-06 21:58:46;8998866202404;NOODLE SEDAAP MIE KOREAN SPICY CHICKEN CUP;1;5000;0;5000;4002;998;
2021-05-06 22:17:46;711844150003;ABC ORANGE;1;12000;0;12000;9900;2100;
2021-05-07 11:42:04;8992775913000SCT;CHOCOLATOS CKLT DRINK SCT;1;2000;0;2000;1586;414;
2021-05-07 11:52:06;8992933211115;NUTRIJELL STRAWBERRY;2;6000;0;12000;10082;1918;
2021-05-07 11:52:06;8992933241112;NUTRIJELL COKLAT;2;7000;0;14000;12832;1168;
2021-05-07 11:52:06;8992933219111;NUTRIJELL CINCAU;2;6000;0;12000;10000;2000;
2021-05-07 11:52:06;8992933214116;NUTRIJELL MELON;2;6000;0;12000;10082;1918;
2021-05-07 11:52:06;8992933218114;NUTRIJELL GRAPE;2;6000;0;12000;9900;2100;
2021-05-07 11:52:06;8992628020152;BIMOLI POUCH 2L;1;30000;0;30000;29000;1000;
2021-05-07 11:52:06;18992628503171;SIMAS 5KG;1;78000;0;78000;76100;1900;
2021-05-07 11:52:06;001;PASEO SMART FACIAL SF 250S GT;1;10000;0;10000;9500;500;
2021-05-07 11:52:06;8999999390198;SUNLIGHT LIME NEW POUCH 755ML;1;17000;0;17000;15400;1600;
2021-05-07 11:57:57;089686043273;INDOMIE SAMBAL RICA;1;2700;0;2700;2452;248;
2021-05-07 12:08:16;089686044249;SUPERMI NUTRIMI STEAK AYAM;1;3500;0;3500;2800;700;
2021-05-07 12:08:16;8992959953198;SWEETY BRONZE  XL2 6+2;1;60000;0;60000;54091;5909;
2021-05-07 12:08:16;8998866610261;DAIA VIOLET GUSSET BAG 290 GR;1;5000;0;5000;4450;550;
2021-05-07 12:08:16;8994023000050;MEGKEJU SERBAGUNA 165G;1;12000;0;12000;10339;1661;
2021-05-07 12:08:16;8993154790021;DELLA CHA;5;2000;0;10000;8570;1430;
2021-05-07 12:08:16;8998866200882;SUKSESMIE GORENG AYAM KRMS 133GR;2;3500;0;7000;6094;906;
2021-05-07 12:13:12;TG;TEH GELAS;2;1000;0;2000;1458;542;
2021-05-07 12:13:12;8994834005923;SPIX 1000;1;1000;0;1000;850;150;
2021-05-07 12:13:12;8993470672827;SAKU-SAKU SAPI PANGGANG;1;2000;0;2000;1530;470;
2021-05-07 12:16:28;001;PASEO SMART FACIAL SF 250S GT;1;10000;0;10000;9500;500;
2021-05-07 12:16:28;711844150003;ABC ORANGE;2;12000;0;24000;19800;4200;
2021-05-07 12:16:28;GL;GULA 1 LITER;1;11500;0;11500;10500;1000;
2021-05-07 12:18:19;GL;GULA 1 LITER;5;11500;0;57500;52500;5000;
2021-05-07 16:23:27;8992959117583;SFX DS REG FLOW WING 20;1;5000;0;5000;4288;712;
2021-05-07 16:23:27;8998866202725;MILKU COKLAT PREMIUM 200ML;1;3000;0;3000;2375;625;
2021-05-07 16:23:27;8992753031900;BKM SCT PUTIH 40G;1;7500;0;7500;6900;600;
2021-05-07 16:27:44;8999999519865;DOVE DEO WMN RO CUCUMBER  40 ML;1;16500;0;16500;15000;1500;
2021-05-07 16:27:44;8996001600597;KOPIKO LUCKY DAY;1;5000;0;5000;4283;717;
2021-05-07 16:27:44;8997213203118;INLITE 12W;1;46000;0;46000;42000;4000;
2021-05-07 16:27:44;8997213203095;INLITE 7W;1;34000;0;34000;31000;3000;
2021-05-07 16:44:44;8999999042592;RINSO MOLTO PERFUME ESSENSE LIQ 4OML;1;5500;0;5500;4817;683;
2021-05-07 16:44:44;8998989110167;SURYA GUDANG GARAM 16 FILTER;1;24000;0;24000;22100;1900;
2021-05-07 16:49:03;GL;GULA 1 LITER;3;11500;0;34500;31500;3000;
2021-05-07 16:55:41;8993083929806;BISKITOP COKLAT;1;30000;0;30000;27000;3000;
2021-05-07 17:04:17;8992775002735;CHOCOLATOS SUSU COKELAT;1;4000;0;4000;3520;480;
2021-05-07 17:06:45;8992959953075;SWEETY BRONZE M9;1;17000;0;17000;15190;1810;
2021-05-07 17:13:07;GL;GULA 1 LITER;5;11500;0;57500;52500;5000;
2021-05-07 17:13:21;8998989110167;SURYA GUDANG GARAM 16 FILTER;1;24000;0;24000;22100;1900;
2021-05-08 12:17:59;8992761136161;COCACOLA 1L;1;10000;0;10000;9000;1000;
2021-05-08 12:17:59;8998866202725;MILKU COKLAT PREMIUM 200ML;1;3000;0;3000;2375;625;
2021-05-08 12:17:59;8992696520103;DNCO CKLT FORT SCH 39G;1;3000;0;3000;2647;353;
2021-05-08 12:17:59;8996001600269;LE MINERAL 600ML;1;3000;0;3000;1688;1312;
2021-05-08 12:17:59;8998866202732;MILKU STROBERI 200ML;1;3000;0;3000;2375;625;
2021-05-08 12:17:59;8992775110157;GARUDA KACANG KULIT;1;5000;0;5000;3925;1075;
2021-05-08 12:19:36;8992993260351;COLATTA COMPOUND DARK 250G;1;18500;0;18500;16714;1786;
2021-05-08 12:37:45;8999999706180;PEPSODENT WHITE 190GR;1;10000;0;10000;9350;650;
2021-05-08 12:37:45;8992222091961;PUCELLE MIST COL SPRAY 75ML;1;13000;0;13000;11650;1350;
2021-05-08 12:37:45;8992979120013;TOTAL BUNGA SOFTENER;1;13000;0;13000;11532;1468;
2021-05-08 12:37:45;001;PASEO SMART FACIAL SF 250S GT;1;10000;0;10000;9500;500;
2021-05-08 12:37:45;8999999552527;ZWITSAL KIDS BB CLN&FRSH BLUE 280 ML;1;21500;0;21500;19855;1645;
2021-05-08 12:37:45;8997002060168;KRP SINGKOG PDS PANDA DUO;1;8000;0;8000;7300;700;
2021-05-08 12:37:45;8992959117583;SFX DS REG FLOW WING 20;1;5000;0;5000;4288;712;
2021-05-08 12:37:45;8999801700030;SUSU FOYU;5;11500;0;57500;52250;5250;
2021-05-08 12:37:45;8991188943543;SASA SANTAN KELAPA 200ML;1;9500;0;9500;8400;1100;
2021-05-08 12:37:45;8991002103764;GOOD DAY CAPPUCINO 10X25G;10;1500;0;15000;13950;1050;
2021-05-08 12:37:45;8714700524002;MAIZENAKU;1;5000;0;5000;4200;800;
2021-05-08 12:37:45;8994023000050;MEGKEJU SERBAGUNA 165G;1;12000;0;12000;10339;1661;
2021-05-08 12:37:45;KT;KUNING TELUR;1;2500;0;2500;2000;500;
2021-05-08 12:48:08;711844150027;ABC NANAS;1;15000;0;15000;12241;2759;
2021-05-08 12:51:31;8994935000049;MINYAK GORENG DAMAI 5L;1;75000;0;75000;73780;1220;
2021-05-08 13:04:09;8886013257400;TWISTKO;1;1000;0;1000;900;100;
2021-05-08 13:04:09;MOBIL;GULA GULA HP;1;2000;0;2000;1700;300;
2021-05-08 13:04:09;KJ;KINDER JOY;1;2000;0;2000;1583;417;
2021-05-08 13:06:25;8998866200561;EKOMIE SUPER 600GR;3;10000;0;30000;25845;4155;
2021-05-08 13:06:25;8995333060703;TERIGU KOMPAS 1KG;1;10500;0;10500;9816;684;
2021-05-08 13:19:46;8999999529703;CLEAR MEN COOL SPORT MTHL 80ML;1;11000;0;11000;10000;1000;
2021-05-08 14:12:06;711844110113;KECAP ABC 135 ML;1;7000;0;7000;6400;600;
2021-05-08 14:59:36;8999999007768;FAIR&LOVELY MULTIVITAMIN  CREAM 9 ML;2;4500;0;9000;6400;2600;
2021-05-08 15:02:57;711844150027;ABC NANAS;2;15000;0;30000;24482;5518;
2021-05-08 15:12:30;8992761145019;COCA COLA PET 250ML;1;3500;0;3500;2417;1083;
2021-05-08 15:14:53;GL;GULA 1 LITER;1;11500;0;11500;10500;1000;
2021-05-08 15:44:57;GL;GULA 1 LITER;4;11500;0;46000;42000;4000;
2021-05-08 15:44:57;8999801700054;SUSU FOYU 1 KG;1;22000;0;22000;20104;1896;
2021-05-08 16:02:46;8994834006128;TICTIC PEDAS;1;2000;0;2000;1700;300;
2021-05-08 16:55:07;8999999048280;SUNSILK SHP RFR ANTI DDRF 9 ML;1;10500;0;10500;9300;1200;
2021-05-08 16:58:53;8998989500166;GUDANG GARAM MERAH BESAR 16KS;1;17000;0;17000;15300;1700;
2021-05-08 17:08:35;8992770084064;SAJIKU TEPUNG BUMBU 240G;1;7000;0;7000;6000;1000;
2021-05-08 17:22:46;8995333000822;TERIGU KOMPAS SOFT 500GR;1;5500;0;5500;4967;533;
2021-05-08 17:43:12;001;PASEO SMART FACIAL SF 250S GT;1;10000;0;10000;9500;500;
2021-05-08 17:45:26;8992753184002;FF MILKY STRW 115G;1;3000;0;3000;2178;822;
2021-05-08 17:45:26;8992753182008;FF MILKY CKLT 115ML;3;3000;0;9000;6537;2463;
2021-05-08 19:31:14;8998989300261;GUDANG GARAM SURYA 12 FILTER;1;18500;0;18500;17200;1300;
2021-05-08 19:31:14;8992775311325;GERY SNACK&SEREAL 100G;1;7000;0;7000;6012;988;
2021-05-08 19:31:14;8997231980022;O'JELLY MINI STRAWBERRY;1;3000;0;3000;2250;750;
2021-05-08 19:31:14;8993470672827;SAKU-SAKU SAPI PANGGANG;1;2000;0;2000;1530;470;
2021-05-08 19:31:14;8993470672858;SAKU-SAKU RASA BALADO;1;2000;0;2000;1530;470;
2021-05-08 19:31:14;8994834005923;SPIX 1000;1;1000;0;1000;850;150;
2021-05-08 19:32:11;GL;GULA 1 LITER;5;11500;0;57500;52500;5000;
2021-05-08 19:39:01;8996001600269;LE MINERAL 600ML;1;3000;0;3000;1688;1312;
2021-05-08 19:39:01;8992761139018;ADES 600ML;1;3500;0;3500;2292;1208;
2021-05-08 19:39:01;8992761166052;FRESTEA MELATI 350ML;1;4500;0;4500;3000;1500;
2021-05-08 19:39:01;8990800004563;MENTOS 40X50 BUAH IND;1;5700;0;5700;5150;550;
2021-05-08 19:46:30;001;PASEO SMART FACIAL SF 250S GT;1;10000;0;10000;9500;500;
2021-05-08 19:49:01;8997231980015;O'JELLY MINI APPLE;1;3000;0;3000;2250;750;
2021-05-08 19:49:01;8997231980022;O'JELLY MINI STRAWBERRY;1;3000;0;3000;2250;750;
2021-05-08 19:49:01;8997028590014;ARGUS 220ML;2;500;0;1000;604;396;
2021-05-08 20:10:23;8996001600399;LE MINERAL 1500ML;1;5000;0;5000;4042;958;
2021-05-08 20:21:55;8992761139018;ADES 600ML;1;3500;0;3500;2292;1208;
2021-05-08 20:21:55;8992761166212;FRESTEA APPLE 350ML;1;4500;0;4500;3000;1500;
2021-05-08 20:21:55;HT;HOT-HOT;2;500;0;1000;700;300;
2021-05-08 21:01:32;8997231980022;O'JELLY MINI STRAWBERRY;2;3000;0;6000;4500;1500;
2021-05-08 21:01:32;8996001318911;BETTER ISI 4;1;2000;0;2000;1700;300;
2021-05-08 21:25:27;MARS;MARSHMELLOW;2;500;0;1000;866;134;
2021-05-08 21:45:51;8997231980022;O'JELLY MINI STRAWBERRY;2;3000;0;6000;4500;1500;
2021-05-08 21:45:51;8998866200325;MIE SEDAAP SOTO;1;2500;0;2500;1952;548;
2021-05-08 21:45:51;6907992823652;JD CHOCOLATE MILKSHAKE;1;6000;0;6000;5200;800;
2021-05-08 21:47:03;6907992823652;JD CHOCOLATE MILKSHAKE;2;6000;0;12000;10400;1600;
2021-05-08 21:47:03;6907992823591;JD STRAW MILKSHAKE;1;5000;0;5000;4300;700;
2021-05-08 21:47:03;JD VM;JD VANILLA MILKSHAKE;1;5000;0;5000;4300;700;
2021-05-08 21:47:03;8992770061034;SAJIKU;2;2000;0;4000;3000;1000;
2021-05-08 21:47:28;8998009040023;TEH KOTAK;1;5000;0;5000;2827;2173;
2021-05-08 21:52:23;PTK;MINI NAIL CLIPPER BESAR THREE SEVEN;1;7000;0;7000;6000;1000;
2021-05-08 21:52:23;089686010107;INDOMIE KALDU AYAM;2;2500;0;5000;4300;700;
2021-05-08 21:52:23;089686011494;INDOMIE SOTO PADANG;1;2600;0;2600;2317;283;
2021-05-08 21:52:24;089686043051;INDOMIE COTO MAKASSAR;1;2800;0;2800;2525;275;
2021-05-08 21:52:24;YOUTOP;YOUTOP;1;1000;0;1000;875;125;
2021-05-08 22:09:33;8992696523067;MILO ACTVGO UHT 180ML;1;4500;0;4500;3515;985;
2021-05-08 22:09:33;8993379200879;SABUN HARMONY MELON 70G;1;2000;0;2000;1652;348;
2021-05-08 22:09:33;8992761164546;NUTRIBOOST STRAWBERRY 300ML;1;6500;0;6500;5300;1200;
2021-05-08 22:22:51;D;TEH PUCUK HARUM 350ML;1;67200;0;67200;55536;11664;
2021-05-08 22:25:18;089686043051;INDOMIE COTO MAKASSAR;1;2800;0;2800;2525;275;
2021-05-08 22:25:18;TL;TELUR;1;1500;0;1500;1300;200;
2021-05-08 22:51:50;089686611878;QTELA TEMPE;1;6000;0;6000;5370;630;
2021-05-08 22:51:50;8996001600146;TEH PUCUK HARUM 350ML;1;3000;0;3000;2314;686;
2021-05-08 22:51:50;8997025914042;ATB MARIE SUSU 185G;1;7000;0;7000;4554;2446;
2021-05-08 22:51:50;8997025410063;BRITISH PROPOLIS;1;250000;0;250000;180000;70000;
2021-05-08 22:53:47;711844610095;LARISSA UDANG 500 GR;2;11000;0;22000;19580;2420;
2021-05-08 22:53:47;8994935000049;MINYAK GORENG DAMAI 5L;1;75000;0;75000;73780;1220;
2021-05-09 11:37:12;8991001780140;TWISTER CHOCO;2;5000;0;10000;9200;800;
2021-05-09 11:38:01;KURMA;KURMA;1;60000;0;60000;55000;5000;
2021-05-09 11:38:01;8998989300261;GUDANG GARAM SURYA 12 FILTER;1;18500;0;18500;17200;1300;
2021-05-09 11:38:01;089686611519;QTELA SINGKONG;1;5000;0;5000;4266;734;
2021-05-09 12:40:24;8996001402023SCT;TB TORA SUSU SCT;3;1500;0;4500;2544;1956;
2021-05-09 12:40:24;8991102230308;BLASTER PINK;1;5000;0;5000;3106;1894;
2021-05-09 12:40:24;8992752112013;MIZONE;1;5000;0;5000;3800;1200;
2021-05-09 13:18:20;8997021870076;FRESH CARE SANDAL WOOD 10ML;1;12000;0;12000;10000;2000;
2021-05-09 13:41:56;8998989300261;GUDANG GARAM SURYA 12 FILTER;1;18500;0;18500;17200;1300;
2021-05-09 13:41:56;8992761145019;COCA COLA PET 250ML;1;3500;0;3500;2417;1083;
2021-05-09 14:21:15;8998866202053;POTABEE AYAM BAKAR PEDAS 68GR;1;8000;0;8000;7200;800;
2021-05-09 14:21:15;8998866201377;KRISBEE FRIES KENTANG GORENG 68 GR;1;5500;0;5500;4620;880;
2021-05-09 14:21:15;8992761139018;ADES 600ML;1;3500;0;3500;2292;1208;
2021-05-09 14:21:15;089686611519;QTELA SINGKONG;1;5000;0;5000;4266;734;
2021-05-09 14:21:15;8886013213208;FRENCH FREIS 2000;1;5000;0;5000;3750;1250;
2021-05-09 15:11:55;8999999390198;SUNLIGHT LIME NEW POUCH 755ML;1;17000;0;17000;15400;1600;
2021-05-09 15:11:55;8998866200646;KOPI TOP MURNI;1;11000;0;11000;9600;1400;
2021-05-09 15:17:25;8999999529284;MOLTO EDP FRENCH LILY SC 10ML;1;5500;0;5500;4800;700;
2021-05-09 15:17:25;8999801700030;SUSU FOYU;1;11500;0;11500;10450;1050;
2021-05-09 15:17:25;ROYCO;ROYCO RASA AYAM;3;500;0;1500;1125;375;
2021-05-09 15:17:25;8999999556341;MOLTO EDP PINK ROSE 20ML;2;1000;0;2000;1600;400;
2021-05-09 15:17:25;8999909096004;SAMPOERNA 16 FILTER;1;24000;0;24000;23000;1000;
2021-05-09 15:17:25;8992761002015;COCA COLA PET 390ML;1;5500;0;5500;4333;1167;
2021-05-09 16:06:53;8991102213189;BLASTER UNGU;1;5000;0;5000;3106;1894;
2021-05-09 16:28:28;8998866611718;EKONOMI PENCUCI PIRING  LIQ 780ML;1;12000;0;12000;10900;1100;
2021-05-09 16:28:28;BTS;BIMURA TARO SEAWEED 250G;1;10000;0;10000;9300;700;
2021-05-09 16:44:18;ARG;ARGUS 220ML;4;14500;0;58000;50000;8000;
2021-05-09 17:22:10;8998989110167;SURYA GUDANG GARAM 16 FILTER;1;24000;0;24000;22100;1900;
2021-05-09 17:22:10;8996001600610;TORA MILKY LATTE 180ML;1;3500;0;3500;2750;750;
2021-05-09 17:27:18;8998866608749;SOFTENER SKL BLS TW VIOLET 14SCT;1;5000;0;5000;4560;440;
2021-05-09 17:51:14;8992628022156;BIMOLI KLASIK TOUCH 1 LT;1;15500;0;15500;14350;1150;
2021-05-09 17:51:14;8998989300261;GUDANG GARAM SURYA 12 FILTER;1;18500;0;18500;17200;1300;
2021-05-09 17:51:45;8998898830125;KKB ENER-G ANGGUR;1;5500;0;5500;4824;676;
2021-05-09 17:51:45;8999801700030;SUSU FOYU;1;11500;0;11500;10450;1050;
2021-05-09 17:54:46;8996001355985;BENG-BENG SHARE IT;1;27000;0;27000;25000;2000;
2021-05-09 17:54:46;8992222050418;GATSBY NORMAL 38GR;1;5000;0;5000;3850;1150;
2021-05-09 17:55:07;8992775913000SCT;CHOCOLATOS CKLT DRINK SCT;2;2000;0;4000;3172;828;
2021-05-09 17:55:48;6907992823867;JD CRUNCHY CHOCOLATE MALT;1;5500;0;5500;4700;800;
2021-05-09 17:58:50;8999999045920;LIFEBUOY TS TOTAL 10 110GR;2;4000;0;8000;7000;1000;
2021-05-09 17:58:50;8999999533717;CITRA TS FRESH WHITE 70G;1;2200;0;2200;1900;300;
2021-05-09 18:06:51;8992761166212;FRESTEA APPLE 350ML;1;4500;0;4500;3000;1500;
2021-05-09 18:08:05;TG;TEH GELAS;1;1000;0;1000;729;271;
2021-05-09 18:17:15;8992761166229;FRESTEA MARKISA 350ML;2;4500;0;9000;6000;3000;
2021-05-09 18:17:15;8992761164546;NUTRIBOOST STRAWBERRY 300ML;1;6500;0;6500;5300;1200;
2021-05-09 18:31:33;8993058105013;EXTRA JOSS;1;12000;0;12000;9773;2227;
2021-05-09 18:53:31;8993176110081;MINYAK KAYU PUTIH 30ML;1;12000;0;12000;9091;2909;
2021-05-09 18:53:49;8992761111540;FANTA STRAWBERY SLIM CAM 250ML;1;5000;0;5000;3750;1250;
2021-05-09 18:53:49;8992761139018;ADES 600ML;1;3500;0;3500;2292;1208;
2021-05-09 18:53:49;MARS;MARSHMELLOW;1;500;0;500;433;67;
2021-05-09 19:10:56;8991102281416;PERMEN MINTZ PPMINT;1;4500;0;4500;4000;500;
2021-05-09 19:12:08;8999909000971;MAGNUM MILD 20;1;24000;0;24000;22750;1250;
2021-05-09 19:24:06;8997231980022;O'JELLY MINI STRAWBERRY;1;3000;0;3000;2250;750;
2021-05-09 19:25:22;8998866501033;MINYAK GORENG SEDAAP POUCH 2L;1;28000;0;28000;27746;254;
2021-05-09 19:25:22;089686021219;INTER MIE GORENG;3;1000;0;3000;2655;345;
2021-05-09 19:25:22;8993226365522;GARAM MEJA GYURI 200GR;1;2000;0;2000;1700;300;
2021-05-09 19:36:37;8992775913000SCT;CHOCOLATOS CKLT DRINK SCT;1;2000;0;2000;1586;414;
2021-05-09 19:56:47;8991004011906;KOPI BORONG;1;10000;0;10000;8333;1667;
2021-05-09 19:56:47;8999999001179;LIFEBUOY BW COOLFRESH LD REFF 450 ML;1;25000;0;25000;22110;2890;
2021-05-09 19:56:47;8998866610261;DAIA VIOLET GUSSET BAG 290 GR;1;5000;0;5000;4450;550;
2021-05-09 19:56:47;6907992823829;JD MILKY MILK;1;3000;0;3000;2600;400;
2021-05-09 19:56:47;8997231980015;O'JELLY MINI APPLE;1;3000;0;3000;2250;750;
2021-05-09 19:56:47;PRG;PARAGO;2;500;0;1000;800;200;
2021-05-09 19:58:37;ARG;ARGUS 220ML;1;14500;0;14500;12500;2000;
2021-05-09 19:58:37;JGR SHN;JOGER SHINY SACHET;1;500;0;500;437;63;
2021-05-09 19:58:37;8998866108102;POSH GREEN BLOSSOM 150;1;19500;0;19500;17500;2000;
2021-05-09 20:02:11;8991102281430;PERMEN MINTZ DUOMINT;2;4500;0;9000;8000;1000;
2021-05-09 20:09:15;8997231980022;O'JELLY MINI STRAWBERRY;1;3000;0;3000;2250;750;
2021-05-09 20:15:36;JGR SHN;JOGER SHINY SACHET;2;500;0;1000;874;126;
2021-05-09 20:27:34;8997231980022;O'JELLY MINI STRAWBERRY;2;3000;0;6000;4500;1500;
2021-05-09 20:27:34;8997231980015;O'JELLY MINI APPLE;1;3000;0;3000;2250;750;
2021-05-09 20:30:57;BG;BERAS GURIH PASAR RAME;1;60000;0;60000;56000;4000;
2021-05-09 20:30:57;8993176110135;MINYAK TELON LANG 30ML;1;10000;0;10000;8167;1833;
2021-05-09 20:30:57;8991102308861;FULLO BLASTO;1;16000;0;16000;14545;1455;
2021-05-09 20:36:08;8850007014546;JB PODER ACTIVE FRESH 300G;1;14000;0;14000;13120;880;
2021-05-09 20:37:05;8992959953082;SWEETY BRONZE L8;1;17000;0;17000;15380;1620;
2021-05-09 20:37:05;8997021870090;FRESH CARE LAVENDER 10ML;1;12000;0;12000;10000;2000;
2021-05-09 21:04:16;089686011036;INDOMIE GORENG PEDAS;1;2700;0;2700;2452;248;
2021-05-09 21:04:16;8998989500128;GUDANG GARAM MERAH KECIL 12KS;3;13000;0;39000;35700;3300;
2021-05-09 21:04:16;8851019210193;POCKY CHOCO BANANA 47G;1;7300;0;7300;5671;1629;
2021-05-09 21:04:16;MARS;MARSHMELLOW;4;500;0;2000;1732;268;
2021-05-09 21:06:01;8998989300261;GUDANG GARAM SURYA 12 FILTER;1;18500;0;18500;17200;1300;
2021-05-09 21:06:01;8993470279651;JOGER CHOCKY BAR;1;1000;0;1000;867;133;
2021-05-09 21:06:01;8997009510055;YOU C1000;1;10000;0;10000;9166;834;
2021-05-09 21:07:50;8998989110167;SURYA GUDANG GARAM 16 FILTER;1;24000;0;24000;22100;1900;
2021-05-09 21:07:50;8997231980015;O'JELLY MINI APPLE;1;3000;0;3000;2250;750;
2021-05-09 21:07:50;8992761166038;MMP ORANGE 300ML;1;5000;0;5000;3750;1250;
2021-05-09 21:07:50;9556001025272;NESCAFE LATTE 240ML;1;8500;0;8500;7834;666;
2021-05-09 21:14:51;8999909096004;SAMPOERNA 16 FILTER;1;24000;0;24000;23000;1000;
2021-05-09 21:27:03;RB;RED BOLD;1;19000;0;19000;17900;1100;
2021-05-09 21:27:03;8996001600597;KOPIKO LUCKY DAY;1;5000;0;5000;4283;717;
2021-05-09 21:27:23;8993470279651;JOGER CHOCKY BAR;1;1000;0;1000;867;133;
2021-05-09 22:34:00;8994834005923;SPIX 1000;1;1000;0;1000;850;150;
2021-05-10 11:14:03;123124;KOREK BIASA;1;2000;0;2000;1800;200;
2021-05-10 11:14:03;8998989300261;GUDANG GARAM SURYA 12 FILTER;1;18500;0;18500;17200;1300;
2021-05-10 11:46:27;711844110083;KECAP ABC 275 ML;1;14500;0;14500;13400;1100;
2021-05-10 11:46:27;8999999528843;CITRA PEARLY WHITE  60ML;1;6200;0;6200;5625;575;
2021-05-10 11:46:27;8999999045616;MOLTO AIO PINK SCH;2;1000;0;2000;1600;400;
2021-05-10 11:46:27;8999999538453;SUNSILK SHP SOFT AND  SMOOTH 55 ML;1;5000;0;5000;3750;1250;
2021-05-10 12:13:03;8998989300261;GUDANG GARAM SURYA 12 FILTER;1;18500;0;18500;17200;1300;
2021-05-10 12:13:03;8991102989428SCT;TANGO CKLT 24G SCT;1;1000;0;1000;609;391;
2021-05-10 12:13:03;HT;HOT-HOT;1;500;0;500;350;150;
2021-05-10 12:45:52;8998989300261;GUDANG GARAM SURYA 12 FILTER;1;18500;0;18500;17200;1300;
2021-05-10 12:45:52;089686041705;INDOMIE GORENG JUMBO;1;3500;0;3500;3143;357;
2021-05-10 12:45:52;8996001600221;KOPIKO 78;1;5000;0;5000;4283;717;
2021-05-10 13:29:36;8998866202244;EKOMIE BUMBU KALDU AYAM;6;1000;0;6000;4788;1212;
2021-05-10 13:29:36;8998866804516;GIV LEMON KOTAK 76G;2;2000;0;4000;3640;360;
2021-05-10 13:46:26;8996001301142;ROMA KELAPA;1;8000;0;8000;6628;1372;
2021-05-10 13:46:26;8998866200301;MIE SEDAAP GORENG;2;2500;0;5000;4046;954;
2021-05-10 15:17:26;8999801700030;SUSU FOYU;1;11500;0;11500;10450;1050;
2021-05-10 15:17:26;8994935000049;MINYAK GORENG DAMAI 5L;1;75000;0;75000;73780;1220;
2021-05-10 15:17:26;8992753102204;BKM COKLAT 370G;1;11300;0;11300;9500;1800;
2021-05-10 15:17:26;8999999504656;SARI MURNI 20X1.8G;1;5000;0;5000;4200;800;
2021-05-10 15:17:47;BAYFLAST;BAYPLAST;4;500;0;2000;1400;600;
2021-05-10 15:22:08;8998866501033;MINYAK GORENG SEDAAP POUCH 2L;1;28000;0;28000;27746;254;
2021-05-10 15:22:59;8992761139018;ADES 600ML;1;3500;0;3500;2292;1208;
2021-05-10 15:22:59;8998866200882;SUKSESMIE GORENG AYAM KRMS 133GR;1;3500;0;3500;3047;453;
2021-05-10 15:22:59;8992775712603;MYTEA POCI OOLONG;1;5000;0;5000;4410;590;
2021-05-10 15:22:59;HT;HOT-HOT;1;500;0;500;350;150;
2021-05-10 15:22:59;6907992825076;JD WATERMELON APPLE;1;2000;0;2000;1700;300;
2021-05-10 15:34:21;8992775211410;PILUS GARUDA PEDAS;1;5000;0;5000;4886;114;
2021-05-10 15:37:24;8996001338056;TAMARIN;1;6000;0;6000;5100;900;
2021-05-10 15:37:24;8992959953044;SWEETY BRONZE XL1;1;2500;0;2500;2250;250;
2021-05-10 15:37:24;8998866200301;MIE SEDAAP GORENG;2;2500;0;5000;4046;954;
2021-05-10 15:37:58;HT;HOT-HOT;1;500;0;500;350;150;
2021-05-10 16:16:16;089686043204;INDOMIE MIE ACEH;1;2700;0;2700;2452;248;
2021-05-10 16:16:16;8998866200301;MIE SEDAAP GORENG;1;2500;0;2500;2023;477;
2021-05-10 16:16:29;6907992824963;JD MILKY CHOCOLATE;1;3000;0;3000;2600;400;
2021-05-10 16:43:56;8998866501033;MINYAK GORENG SEDAAP POUCH 2L;2;28000;0;56000;55492;508;
2021-05-10 17:15:32;9556001004673;MILO NESTLE MALAYSIA ACTIVE GO;1;85000;0;85000;80000;5000;
2021-05-10 17:32:27;8997009510055;YOU C1000;1;10000;0;10000;9166;834;
2021-05-10 18:18:28;8998989300261;GUDANG GARAM SURYA 12 FILTER;1;18500;0;18500;17200;1300;
2021-05-10 18:18:28;8997009510116;LEMON WATER;1;7000;0;7000;5694;1306;
2021-05-10 18:18:28;JGR SHN;JOGER SHINY SACHET;6;500;0;3000;2622;378;
2021-05-10 18:18:28;123124;KOREK BIASA;1;2000;0;2000;1800;200;
2021-05-10 18:18:28;8997231980022;O'JELLY MINI STRAWBERRY;1;3000;0;3000;2250;750;
2021-05-10 18:18:28;bb;BENG-BENG;1;1500;0;1500;1450;50;
2021-05-10 18:18:28;HT;HOT-HOT;1;500;0;500;350;150;
2021-05-10 18:27:05;8992761139018;ADES 600ML;1;3500;0;3500;2292;1208;
2021-05-10 18:27:05;8886013257400;TWISTKO;1;1000;0;1000;900;100;
2021-05-10 18:27:05;8994834005923;SPIX 1000;2;1000;0;2000;1700;300;
2021-05-10 19:13:36;8999999519735;PEPSODENT TB BAMBOO SALT;1;13200;0;13200;11990;1210;
2021-05-10 19:13:36;8993560026103;DETTOL SKINCARE;1;20000;0;20000;18524;1476;
2021-05-10 19:13:36;8998866107099;WET WIPES KODOMO BABY 50SHT CLSSC;1;15000;0;15000;13650;1350;
2021-05-10 19:13:36;8992775001042;PILUS GARUDA MI GORENG;1;5000;0;5000;4810;190;
2021-05-10 19:13:36;8850007090267;JB BATH MILK 400ML (REFILL);1;24500;0;24500;23390;1110;
2021-05-10 19:13:36;8994834005923;SPIX 1000;4;1000;0;4000;3400;600;
2021-05-10 19:13:36;8850507002197;TOK TAK FRUIT CANDY;1;7500;0;7500;6250;1250;
2021-05-10 19:18:09;8850507002197;TOK TAK FRUIT CANDY;1;7500;0;7500;6250;1250;
2021-05-10 19:18:09;8997231980022;O'JELLY MINI STRAWBERRY;1;3000;0;3000;2250;750;
2021-05-10 19:35:47;8996001600146;TEH PUCUK HARUM 350ML;1;3000;0;3000;2314;686;
2021-05-10 19:37:20;8998866201865;KRISBEE PILLOW CHOCOLAVA 120 GR;1;8000;0;8000;7250;750;
2021-05-10 19:37:20;8992775315057;GERY SALUT MALKIST COKLAT;1;6500;0;6500;5516;984;
2021-05-10 19:37:20;8998009010231;ULTRA CHO 250;2;6000;0;12000;9568;2432;
2021-05-10 19:37:20;KJ;KINDER JOY;2;2000;0;4000;3166;834;
2021-05-10 19:39:30;8997231980022;O'JELLY MINI STRAWBERRY;1;3000;0;3000;2250;750;
2021-05-10 19:52:57;8992761166212;FRESTEA APPLE 350ML;1;4500;0;4500;3000;1500;
2021-05-10 19:52:57;8992775211410;PILUS GARUDA PEDAS;1;5000;0;5000;4886;114;
2021-05-10 19:52:57;8886013257400;TWISTKO;2;1000;0;2000;1800;200;
2021-05-10 20:27:27;001;PASEO SMART FACIAL SF 250S GT;1;10000;0;10000;9500;500;
2021-05-10 21:16:51;GL;GULA 1 LITER;4;11500;0;46000;42000;4000;
2021-05-10 21:47:38;8994834005923;SPIX 1000;2;1000;0;2000;1700;300;
2021-05-10 22:34:32;8997009510055;YOU C1000;1;10000;0;10000;9166;834;
2021-05-10 22:34:32;8992696404441;BEAR BRAND 189ML;1;9000;0;9000;7887;1113;
2021-05-11 12:00:49;8992628020152;BIMOLI POUCH 2L;1;30000;0;30000;29000;1000;
2021-05-11 12:00:49;TBR;TEPUNG BERAS;1;8000;0;8000;8000;0;
2021-05-11 12:00:49;TK;TEPUNG KETAN;2;13000;0;26000;26000;0;
2021-05-11 12:00:49;8995333060703;TERIGU KOMPAS 1KG;2;10500;0;21000;19632;1368;
2021-05-11 12:00:49;GL;GULA 1 LITER;2;11500;0;23000;21000;2000;
2021-05-11 12:00:49;711844150003;ABC ORANGE;2;12000;0;24000;19800;4200;
2021-05-11 12:12:15;089686060027;POP MIE AYAM JUMBO;1;4500;0;4500;3833;667;
2021-05-11 12:12:15;8992761145019;COCA COLA PET 250ML;1;3500;0;3500;2417;1083;
2021-05-11 12:12:15;8998866201452;POTABEE REGULER BBQ BEEF 35GR;1;5000;0;5000;4150;850;
2021-05-11 12:17:31;NC;NAURA COKELAT;1;85000;0;85000;75000;10000;
2021-05-11 12:17:31;711844150027;ABC NANAS;3;13000;0;39000;36723;2277;
2021-05-11 12:17:31;711844150003;ABC ORANGE;3;12000;0;36000;29700;6300;
2021-05-11 12:17:31;8991102384841;WFR TANGO LONG CKLT 130G;1;5000;0;5000;4345;655;
2021-05-11 12:17:31;8998989300261;GUDANG GARAM SURYA 12 FILTER;1;18500;0;18500;17200;1300;
2021-05-11 12:45:50;TG;TEH GELAS;1;1000;0;1000;729;271;
2021-05-11 12:47:15;TORT;TORTILA;1;1000;0;1000;1000;0;
2021-05-11 12:48:52;711844610095;LARISSA UDANG 500 GR;3;11000;0;33000;29370;3630;
2021-05-11 12:48:52;8999999195656;SARI WANGI 50X1.85;1;10000;0;10000;9500;500;
2021-05-11 12:48:52;8999999195649;SARI WANGI 25X1.86G;1;6000;0;6000;5050;950;
2021-05-11 12:49:12;TG;TEH GELAS;1;1000;0;1000;729;271;
2021-05-11 12:49:12;TORT;TORTILA;1;1000;0;1000;1000;0;
2021-05-11 12:58:24;8714700524002;MAIZENAKU;1;5000;0;5000;4200;800;
2021-05-11 13:06:47;8994867006997;ROKOK PENA BOLD 20BTG;1;17000;0;17000;15000;2000;
2021-05-11 13:20:47;8999999027261;LIFEBUOY BW LEMONFRESH LD REFF 450 ML;1;25000;0;25000;22110;2890;
2021-05-11 13:20:47;PTK;MINI NAIL CLIPPER BESAR THREE SEVEN;1;7000;0;7000;6000;1000;
2021-05-11 13:20:47;PTKK;MINI NAIL CLIPPER  KECIL THREE SEVEN;1;5000;0;5000;4500;500;
2021-05-11 13:20:47;8718291777199;PHILIPS 8W;1;41000;0;41000;38000;3000;
2021-05-11 15:04:31;8993226112508;GARAM REFINA;1;3000;0;3000;2461;539;
2021-05-11 15:04:31;8993226365522;GARAM MEJA GYURI 200GR;1;2000;0;2000;1700;300;
2021-05-11 16:03:26;6907992825076;JD WATERMELON APPLE;2;2000;0;4000;3400;600;
2021-05-11 17:17:21;MOBIL;GULA GULA HP;1;2000;0;2000;1700;300;
2021-05-11 17:30:06;LT;LIPSTIK HANASUI;1;27000;0;27000;27000;0;
2021-05-11 17:30:06;8999999016128;RINSO MOLTO ROSE FRESH 750ML;1;15000;0;15000;12507;2493;
2021-05-11 17:30:06;8993324850449;BABY LOVE COTTON BUDS;1;5000;0;5000;4500;500;
2021-05-11 17:30:06;8998866106979;CIPTADENT TB CHARCOAL PROTEC;1;6000;0;6000;5250;750;
2021-05-11 17:30:06;8999999557447;PEPSODENT ACTION123 SIWAK 110G;1;9000;0;9000;8000;1000;
2021-05-11 17:30:06;8999999555450;VIXAL PEMB PORS BIRU 190ML;1;5000;0;5000;4200;800;
2021-05-11 17:30:06;8886020001126;SWALLOW KAMP WHITE 150G;1;14000;0;14000;13000;1000;
2021-05-11 17:30:06;8850507002197;TOK TAK FRUIT CANDY;1;7500;0;7500;6250;1250;
2021-05-11 18:02:00;8996001410042SCT;TB TORA MOKA SCT;3;1500;0;4500;2610;1890;
2021-05-11 18:05:20;8992761139018;ADES 600ML;2;3500;0;7000;4584;2416;
2021-05-11 18:05:20;8994834005923;SPIX 1000;1;1000;0;1000;850;150;
2021-05-11 18:11:15;76164217;MARLBORO MERAH;1;30000;0;30000;27700;2300;
2021-05-11 18:11:15;123124;KOREK BIASA;1;2000;0;2000;1800;200;
2021-05-11 18:13:27;123124;KOREK BIASA;1;2000;0;2000;1800;200;
2021-05-11 18:13:27;8993989311279;CLAS MILD 12;1;17000;0;17000;15700;1300;
2021-05-11 18:13:27;HT;HOT-HOT;2;500;0;1000;700;300;
2021-05-11 18:32:28;8996001410042SCT;TB TORA MOKA SCT;2;1500;0;3000;1740;1260;
2021-05-11 18:32:28;8998866501033;MINYAK GORENG SEDAAP POUCH 2L;1;28000;0;28000;27746;254;
2021-05-11 18:32:28;GL;GULA 1 LITER;1;11500;0;11500;10500;1000;
2021-05-11 18:32:28;8998866202695;KOPI MAYOR;1;6000;0;6000;4500;1500;
2021-05-11 18:33:26;JGR SHN;JOGER SHINY SACHET;3;500;0;1500;1311;189;
2021-05-11 18:45:24;8998989300261;GUDANG GARAM SURYA 12 FILTER;1;18500;0;18500;17200;1300;
2021-05-11 18:45:24;KJ;KINDER JOY;1;2000;0;2000;1583;417;
2021-05-11 18:46:54;8998989500128;GUDANG GARAM MERAH KECIL 12KS;1;13000;0;13000;11900;1100;
2021-05-11 18:54:18;8997011700123;BIHUN JAGUNG 300GR;1;6000;0;6000;4979;1021;
2021-05-11 18:54:18;7118441101378;KECAP ABC 520 ML;2;19000;0;38000;35600;2400;
2021-05-11 18:54:18;8993335523363;TOTAL ALMEERA 250G;4;5000;0;20000;16400;3600;
2021-05-11 19:09:32;001;PASEO SMART FACIAL SF 250S GT;1;10000;0;10000;9500;500;
2021-05-11 20:14:19;6907992823829;JD MILKY MILK;3;3000;0;9000;7800;1200;
2021-05-11 20:14:19;6907992823669;JD MILKY STRAW;1;3000;0;3000;2600;400;
2021-05-11 20:14:19;6907992825076;JD WATERMELON APPLE;1;2000;0;2000;1700;300;
2021-05-11 20:14:19;MARS;MARSHMELLOW;2;500;0;1000;866;134;
2021-05-11 20:14:19;8997231980022;O'JELLY MINI STRAWBERRY;2;3000;0;6000;4500;1500;
2021-05-11 20:47:49;8886013257400;TWISTKO;1;1000;0;1000;900;100;
2021-05-11 20:47:49;8992628010139;BIMOLI 5L;1;77000;0;77000;75862;1138;
2021-05-11 20:47:49;8993058105013;EXTRA JOSS;1;12000;0;12000;9773;2227;
2021-05-11 21:16:04;8997231980022;O'JELLY MINI STRAWBERRY;2;3000;0;6000;4500;1500;
2021-05-11 21:16:04;089686049053;SARIMI PUAS;1;3000;0;3000;2400;600;
2021-05-11 21:19:19;8994834005923;SPIX 1000;1;1000;0;1000;850;150;
2021-05-11 21:19:19;8997231980022;O'JELLY MINI STRAWBERRY;1;3000;0;3000;2250;750;
2021-05-11 21:20:37;8998866600521;SOKLIN FLOORCLENER KUNING 400ML;1;6000;0;6000;5025;975;
2021-05-11 21:20:37;8999999538439;CLEAR SHP CSC UNISEX 55ML;1;4200;0;4200;3750;450;
2021-05-11 21:20:37;8994867000179;ROKOK PENA MILD 16;1;14500;0;14500;13000;1500;
2021-05-11 21:27:35;8992761139018;ADES 600ML;2;3500;0;7000;4584;2416;
2021-05-11 21:27:35;089686611878;QTELA TEMPE;1;6000;0;6000;5370;630;
2021-05-11 21:27:35;8996001318430;BETTER 1000;1;1000;0;1000;820;180;
2021-05-11 21:27:35;8992761164539;NUTRIBOOST ORANGE 300ML;1;6500;0;6500;5300;1200;
2021-05-11 21:27:35;8997009510017;YOU C1000 LEMON;1;10000;0;10000;9166;834;
2021-05-11 21:27:35;HT;HOT-HOT;1;500;0;500;350;150;
2021-05-11 21:30:12;8999909010567;234 16 FILTER;1;22000;0;22000;21500;500;
2021-05-11 21:35:02;8993989311279;CLAS MILD 12;1;17000;0;17000;15700;1300;
2021-05-11 21:35:02;8996001440087;ENERGEN KACANG HIJAU;1;1500;0;1500;1150;350;
2021-05-11 21:35:02;8996001440049;ENERGEN;1;1500;0;1500;1200;300;
2021-05-11 21:54:25;6907992823966;JD BLUEBERRY;1;3500;0;3500;3000;500;
2021-05-11 21:54:25;6907992823935;JD SWEETCORN;1;3500;0;3500;3000;500;
2021-05-11 22:36:28;8991102213189;BLASTER UNGU;1;5000;0;5000;3106;1894;
2021-05-11 22:37:22;8991102384841;WFR TANGO LONG CKLT 130G;1;5000;0;5000;4345;655;
2021-05-11 22:37:22;089686611519;QTELA SINGKONG;3;5000;0;15000;12798;2202;
2021-05-11 22:43:31;8998989300261;GUDANG GARAM SURYA 12 FILTER;1;18500;0;18500;17200;1300;
2021-05-12 14:14:07;8992696404441;BEAR BRAND 189ML;1;9000;0;9000;7887;1113;
2021-05-12 14:14:07;8997009510055;YOU C1000;1;10000;0;10000;9166;834;
2021-05-12 14:14:07;8999999045913;LIFEBUOY MILDCARE 110GR;1;15000;0;15000;14245;755;
2021-05-12 14:14:07;8999999045265;RINSO MOLTO ROSE FRESH PWD 770GR;1;21600;0;21600;19338;2262;
2021-05-12 14:14:07;8998866202930;SEDAAP AYAM JERIT CUP;1;4500;0;4500;3738;762;
2021-05-12 14:14:07;ARG;ARGUS 220ML;2;14500;0;29000;25000;4000;
2021-05-12 14:14:07;8998866612173;SOKLIN SOFTERGENT 770G & PIRING;1;18000;0;18000;16055;1945;
2021-05-12 14:14:07;8991102213189;BLASTER UNGU;1;5000;0;5000;3106;1894;
2021-05-12 14:14:07;HT;HOT-HOT;1;500;0;500;350;150;
2021-05-12 14:14:07;8998866200837;NOODLE SEDAAPMIE SOTO CUP 81 GR;1;4500;0;4500;3650;850;
2021-05-12 15:03:43;8996001410042SCT;TB TORA MOKA SCT;3;1500;0;4500;2610;1890;
2021-05-12 15:21:59;11;PASEO SMART FHSTD PERF 6P 12S;1;5000;0;5000;4264;736;
2021-05-12 15:24:13;BB;PASEO SMARTY FACIAL TRAVEL PACK 50S GT;1;3000;0;3000;1980;1020;
2021-05-12 15:38:15;8991102230308;BLASTER PINK;1;5000;0;5000;3106;1894;
2021-05-12 15:47:21;8999999059781;SUNLIGHT LIME NEW POUCH 210ML;1;5000;0;5000;4300;700;
2021-05-12 16:18:34;001;PASEO SMART FACIAL SF 250S GT;1;10000;0;10000;9500;500;
2021-05-12 16:18:34;089686044249;SUPERMI NUTRIMI STEAK AYAM;1;3500;0;3500;2800;700;
2021-05-12 16:18:34;089686011036;INDOMIE GORENG PEDAS;1;2700;0;2700;2452;248;
2021-05-12 16:18:34;8886013213208;FRENCH FREIS 2000;1;5000;0;5000;3750;1250;
2021-05-12 16:21:09;8992628010139;BIMOLI 5L;1;77000;0;77000;75862;1138;
2021-05-12 17:24:03;8998866201377;KRISBEE FRIES KENTANG GORENG 68 GR;1;5500;0;5500;4620;880;
2021-05-12 17:58:18;6907992823874;JD CRUNCHY CHOCO BLUEBERRY;1;5500;0;5500;4700;800;
2021-05-12 18:00:44;8992761139018;ADES 600ML;3;3500;0;10500;6876;3624;
2021-05-12 18:00:44;8886013257400;TWISTKO;1;1000;0;1000;900;100;
2021-05-12 18:00:44;8994834005923;SPIX 1000;1;1000;0;1000;850;150;
2021-05-12 18:00:44;089686021219;INTER MIE GORENG;1;1000;0;1000;885;115;
2021-05-12 18:00:44;JGR SHN;JOGER SHINY SACHET;1;500;0;500;437;63;
2021-05-12 18:19:44;8991102213189;BLASTER UNGU;1;5000;0;5000;3106;1894;
2021-05-12 18:20:01;8992761166212;FRESTEA APPLE 350ML;1;4500;0;4500;3000;1500;
2021-05-12 18:27:24;8992696419742;NESCAFE COFFE CREAM;1;5000;0;5000;4099;901;
2021-05-12 18:27:24;JD VM;JD VANILLA MILKSHAKE;1;5000;0;5000;4300;700;
2021-05-12 18:27:24;8992696521797SCT;MILO UHT ACT GO 22G;5;2000;0;10000;7060;2940;
2021-05-12 18:27:24;8996001600146;TEH PUCUK HARUM 350ML;1;3000;0;3000;2314;686;
2021-05-12 18:27:24;8886020001294;SWALLOW KAMP WARNA 150G;1;14000;0;14000;13200;800;
2021-05-12 18:27:24;8997011700345;MIE KERING LANGIT BIRU;1;23000;0;23000;21000;2000;
2021-05-12 18:27:24;8992993525740;HAAN PUDING MANGGO POUCH 145G;2;8000;0;16000;14370;1630;
2021-05-12 18:27:24;8992957352153;CHOCO CHIPS 45G;1;4500;0;4500;2850;1650;
2021-05-12 18:50:04;089686021219;INTER MIE GORENG;1;1000;0;1000;885;115;
2021-05-12 19:01:14;8992761136161;COCACOLA 1L;1;10000;0;10000;9000;1000;
2021-05-12 19:01:14;8992761136178;SPRITE 1L;1;10000;0;10000;9000;1000;
2021-05-12 19:02:17;8992696523067;MILO ACTVGO UHT 180ML;4;4500;0;18000;14060;3940;
2021-05-12 19:12:56;8999999559854;AXE BLACK POCKET FRAG 17ML;1;10000;0;10000;8000;2000;
2021-05-12 19:28:21;8850507002968;A1 KING TRUCK;1;16500;0;16500;15500;1000;
2021-05-12 19:28:21;6921101219235;YAKUAT JELLY;1;2000;0;2000;1750;250;
2021-05-12 19:28:21;8991102714631;TANGO TETRA CKLT;1;5000;0;5000;4545;455;
2021-05-12 19:28:21;8992761122331;FRESTEA APPEL 500ML;1;6500;0;6500;4708;1792;
2021-05-12 19:40:18;9556001025272;NESCAFE LATTE 240ML;1;8500;0;8500;7834;666;
2021-05-12 19:40:18;8997021870090;FRESH CARE LAVENDER 10ML;1;12000;0;12000;10000;2000;
2021-05-12 19:42:28;8992761136178;SPRITE 1L;2;10000;0;20000;18000;2000;
2021-05-12 19:42:28;8992761136185;FANTA 1L;1;10000;0;10000;9000;1000;
2021-05-12 19:47:19;8997231980022;O'JELLY MINI STRAWBERRY;1;3000;0;3000;2250;750;
2021-05-12 19:47:19;6907992823829;JD MILKY MILK;2;3000;0;6000;5200;800;
2021-05-12 19:47:19;6907992825076;JD WATERMELON APPLE;1;2000;0;2000;1700;300;
2021-05-12 19:47:19;8992775002155;CHOCOLATOS DRINK;1;4000;0;4000;3520;480;
2021-05-12 19:47:19;8996001600146;TEH PUCUK HARUM 350ML;1;3000;0;3000;2314;686;
2021-05-12 19:47:19;PRG;PARAGO;2;500;0;1000;800;200;
2021-05-12 19:48:34;8997231980022;O'JELLY MINI STRAWBERRY;4;3000;0;12000;9000;3000;
2021-05-12 19:49:07;8991102213189;BLASTER UNGU;2;5000;0;10000;6212;3788;
2021-05-12 19:49:46;089686611878;QTELA TEMPE;1;6000;0;6000;5370;630;
2021-05-12 19:55:38;8997009510116;LEMON WATER;1;7000;0;7000;5694;1306;
2021-05-12 20:00:00;089686611878;QTELA TEMPE;3;6000;0;18000;16110;1890;
2021-05-12 20:27:51;8992761139018;ADES 600ML;1;3500;0;3500;2292;1208;
2021-05-12 20:27:51;711844150003;ABC ORANGE;1;12000;0;12000;9900;2100;
2021-05-12 20:27:51;8997226412019;EMINA CHEESE 165G;1;17000;0;17000;15000;2000;
2021-05-12 20:34:15;8998866202732;MILKU STROBERI 200ML;1;3000;0;3000;2375;625;
2021-05-12 21:05:35;8992759120264;LARISST 220;1;10000;0;10000;9200;800;
2021-05-12 21:05:35;089686611878;QTELA TEMPE;1;6000;0;6000;5370;630;
2021-05-12 21:05:35;6907992823652;JD CHOCOLATE MILKSHAKE;1;6000;0;6000;5200;800;
2021-05-12 21:05:35;GL;GULA 1 LITER;1;11500;0;11500;10500;1000;
2021-05-12 21:19:22;ARG;ARGUS 220ML;2;14500;0;29000;25000;4000;
2021-05-12 21:57:46;8992761166212;FRESTEA APPLE 350ML;1;4500;0;4500;3000;1500;
2021-05-12 21:57:46;8992775002735;CHOCOLATOS SUSU COKELAT;1;4000;0;4000;3520;480;
2021-05-12 22:02:44;001;PASEO SMART FACIAL SF 250S GT;2;10000;0;20000;19000;1000;
2021-05-16 12:49:23;8994834003752;TICTIC;2;2000;0;4000;3400;600;
2021-05-16 12:49:23;8998866201377;KRISBEE FRIES KENTANG GORENG 68 GR;2;5500;0;11000;9240;1760;
2021-05-16 12:49:23;8886013213208;FRENCH FREIS 2000;1;5000;0;5000;3750;1250;
2021-05-16 12:49:23;8991001121400;SILVERQUEEN ALMOND 65G;1;15000;0;15000;13200;1800;
2021-05-16 12:49:23;8991001780065;TWISTER BLACK 140G;1;13000;0;13000;11700;1300;
2021-05-16 12:49:23;8991188943062;SASA 250G;1;10000;0;10000;8500;1500;
2021-05-16 12:49:23;ARG;ARGUS 220ML;2;14500;0;29000;25000;4000;
2021-05-16 12:49:23;6921101219235;YAKUAT JELLY;1;2000;0;2000;1750;250;
2021-05-16 12:49:23;8999909010567;234 16 FILTER;1;22000;0;22000;21500;500;
2021-05-16 12:49:23;8998009010590;ULTRA CHO 125;1;3000;0;3000;2428;572;
2021-05-16 12:49:23;6907992823867;JD CRUNCHY CHOCOLATE MALT;1;5500;0;5500;4700;800;
2021-05-16 12:49:23;MARS;MARSHMELLOW;1;500;0;500;433;67;
2021-05-16 12:49:23;8997231980022;O'JELLY MINI STRAWBERRY;1;3000;0;3000;2250;750;
2021-05-16 12:49:23;6907992823966;JD BLUEBERRY;1;3500;0;3500;3000;500;
2021-05-16 12:49:23;8992957220087;COKLAT SINGA;1;2000;0;2000;1700;300;
2021-05-16 12:49:23;8992957220063;COKLAT BANGO;1;2000;0;2000;1700;300;
2021-05-16 12:49:23;8998866202725;MILKU COKLAT PREMIUM 200ML;1;3000;0;3000;2375;625;
2021-05-16 12:49:23;PRG;PARAGO;1;500;0;500;400;100;
2021-05-16 12:49:23;bb;BENG-BENG;1;1500;0;1500;1450;50;
2021-05-16 12:49:23;8994834006128;TICTIC PEDAS;1;2000;0;2000;1700;300;
2021-05-16 12:49:23;SMC;BIMURA MAKARONI CINCIN 250G;1;10000;0;10000;9300;700;
2021-05-16 12:49:23;8991102385060;TANGO WAFFLE CHOX;1;9000;0;9000;8498;502;
2021-05-16 12:49:23;8997025911058;HATARI SHP KELAPA;1;6000;0;6000;4911;1089;
2021-05-16 12:49:23;089686834253;FREISS MELON;1;16000;0;16000;14200;1800;
2021-05-16 12:49:23;8999999023997;CITRA BW FRESH WHITE 220ML;1;12000;0;12000;10700;1300;
2021-05-16 12:49:23;8999999007768;FAIR&LOVELY MULTIVITAMIN  CREAM 9 ML;2;4500;0;9000;6400;2600;
2021-05-16 13:26:28;089686611519;QTELA SINGKONG;2;5000;0;10000;8532;1468;
2021-05-16 13:26:28;8992979130012;TOTAL LEMON SOFTENER;1;13000;0;13000;11532;1468;
2021-05-16 13:26:28;089686043617;INDOMIE MIEGHRTTI;1;2700;0;2700;2452;248;
2021-05-16 13:26:28;8992388133345;NU MILK TEA TEH TARIK 330ML;1;6000;0;6000;5125;875;
2021-05-16 13:26:28;8992775002735;CHOCOLATOS SUSU COKELAT;1;4000;0;4000;3520;480;
2021-05-16 13:26:28;089686049053;SARIMI PUAS;1;3000;0;3000;2400;600;
2021-05-16 13:26:28;8999999524807;SUNLIGHT HABBATUSSAUDA POUCH 755ML;1;17000;0;17000;15400;1600;
2021-05-16 13:26:28;8998989500128;GUDANG GARAM MERAH KECIL 12KS;2;14000;0;28000;26000;2000;
2021-05-16 13:26:28;6907992823843;JD MOCHA CRISPY;3;5000;0;15000;13200;1800;
2021-05-16 13:26:28;8991115012021;BB STRAWBERRY CREAM;1;8500;0;8500;7600;900;
2021-05-16 13:26:28;8999909982000;SAMPOERNA 12 FILTER;1;18000;0;18000;16000;2000;
2021-05-16 13:26:28;8998866201490;POTABEE REGULER GRILLED SEAWED 68 GR;2;8000;0;16000;14400;1600;
2021-05-16 13:26:28;8998866201469;POTABEE REGULER BBQ BEEF 68 GR;1;8000;0;8000;7200;800;
2021-05-16 13:26:28;8998009010569;ULTRA CHO 200;3;5000;0;15000;11490;3510;
2021-05-16 13:26:28;8999909010567;234 16 FILTER;2;22000;0;44000;43000;1000;
2021-05-16 13:26:28;8998666003089SCT;TB GILUX MIX SCT;5;1000;0;5000;4000;1000;
2021-05-16 13:26:28;123124;KOREK BIASA;1;2000;0;2000;1800;200;
2021-05-16 13:26:28;TL;TELUR;8;1500;0;12000;10400;1600;
2021-05-16 13:26:28;089686010107;INDOMIE KALDU AYAM;1;2500;0;2500;2150;350;
2021-05-16 13:26:28;089686021127;INTER MIE KALDU;4;1000;0;4000;3252;748;
2021-05-16 13:26:28;8992628010139;BIMOLI 5L;2;77000;0;154000;151724;2276;
2021-05-16 13:26:28;8993058105013;EXTRA JOSS;1;12000;0;12000;9773;2227;
2021-05-16 13:26:28;8994867007161;ROKOK PENA GOLD 20;1;17000;0;17000;15000;2000;
2021-05-16 13:26:28;8992761164539;NUTRIBOOST ORANGE 300ML;1;6500;0;6500;5300;1200;
2021-05-16 13:26:28;8992761164546;NUTRIBOOST STRAWBERRY 300ML;1;6500;0;6500;5300;1200;
2021-05-16 13:26:28;8992870311091;SALONPAS;1;6000;0;6000;4806;1194;
2021-05-16 13:26:28;8996001350423;ZUPER KEJU;1;9200;0;9200;8360;840;
2021-05-16 13:26:28;8992696521797SCT;MILO UHT ACT GO 22G;3;2000;0;6000;4236;1764;
2021-05-16 13:26:28;089686043051;INDOMIE COTO MAKASSAR;3;2800;0;8400;7575;825;
2021-05-16 13:26:28;8996001600399;LE MINERAL 1500ML;2;5000;0;10000;8084;1916;
2021-05-16 13:26:28;8998866604963;POWDET DAIA LEMON 290GR;1;5000;0;5000;4450;550;
2021-05-16 13:26:28;089686017748;SARIMIE GORENG ISI 2;2;3500;0;7000;6240;760;
2021-05-16 13:26:28;TG;TEH GELAS;1;1000;0;1000;729;271;
2021-05-16 13:26:28;8999999059781;SUNLIGHT LIME NEW POUCH 210ML;1;5000;0;5000;4300;700;
2021-05-16 13:26:28;8991111111995;C&C TONER 100ML;1;14000;0;14000;12900;1100;
2021-05-16 13:26:28;8992806145417;SCOTCH BRITE;1;3500;0;3500;2407;1093;
2021-05-16 13:26:28;8992222091961;PUCELLE MIST COL SPRAY 75ML;1;13000;0;13000;11650;1350;
2021-05-16 13:26:28;8993072153595;LARISST COTTON 35G;1;5000;0;5000;3300;1700;
2021-05-16 13:26:28;8998866202770;MIE SEDAAP SALERO PADANG;10;2500;0;25000;23620;1380;
2021-05-16 13:26:28;8991102994422;TANGO WALUT CHOCOBNN 18G;1;9000;0;9000;8661;339;
2021-05-16 13:26:28;8998866200578;MIE SEDAAP KARI KENTAL;5;2500;0;12500;11315;1185;
2021-05-16 13:26:28;8996001355817;BENG-BENG MAXX;1;27000;0;27000;24500;2500;
2021-05-16 13:26:28;8998866202237;NOODLE SEDAAP TASTY AYAM GEPREK 124 GR;2;5000;0;10000;8334;1666;
2021-05-16 13:26:28;8992775001615;CHOCOLATOS SWEET CHEESE;1;18000;0;18000;15483;2517;
2021-05-16 13:26:28;8997009510055;YOU C1000;1;10000;0;10000;9166;834;
2021-05-16 13:26:28;711844610095;LARISSA UDANG 500 GR;1;11000;0;11000;9790;1210;
2021-05-16 13:26:28;8991188943536;SASA SANTAN KELAPA 65ML;3;3000;0;9000;7311;1689;
2021-05-16 13:26:28;8991111112398;C&C OIL CONTROL FILM FLORAL 15;1;10000;0;10000;8010;1990;
2021-05-16 13:26:28;ARG;ARGUS 220ML;6;14500;0;87000;75000;12000;
2021-05-16 13:26:28;8998866200646;KOPI TOP MURNI;1;11000;0;11000;9600;1400;
2021-05-16 13:26:28;8934868015024;REXONA DEO LOTION FREE SPIRIT 9G;1;4500;0;4500;3900;600;
2021-05-16 13:26:28;8999909096004;SAMPOERNA 16 FILTER;1;24000;0;24000;23000;1000;
2021-05-16 13:26:28;711844150027;ABC NANAS;1;13000;0;13000;12241;759;
2021-05-16 13:27:14;8998989300261;GUDANG GARAM SURYA 12 FILTER;2;18500;0;37000;34400;2600;
2021-05-16 14:59:37;GL;GULA 1 LITER;1;11500;0;11500;10500;1000;
2021-05-16 14:59:37;8992761002022;SPRITE PET 390ML;1;5500;0;5500;4300;1200;
2021-05-16 15:33:12;8995102703534;TERASI DUO 6 GR;1;4000;0;4000;3720;280;
2021-05-16 15:47:11;8992946512223;SHINZUI;1;4000;0;4000;2500;1500;
2021-05-16 15:47:11;8998866611152;CREAM EKONOMI VIOLET 455G;1;5500;0;5500;4750;750;
2021-05-16 15:47:11;6907992823829;JD MILKY MILK;1;3000;0;3000;2600;400;
2021-05-16 15:47:38;8850507000094;POLICE BONCHA;1;2000;0;2000;800;1200;
2021-05-16 15:58:46;8994834003752;TICTIC;3;2000;0;6000;5100;900;
2021-05-16 15:58:46;8994834006128;TICTIC PEDAS;2;2000;0;4000;3400;600;
2021-05-16 15:58:46;8992761122331;FRESTEA APPEL 500ML;1;6500;0;6500;4708;1792;
2021-05-16 15:58:46;6907992823652;JD CHOCOLATE MILKSHAKE;1;6000;0;6000;5200;800;
2021-05-16 15:59:04;HT;HOT-HOT;1;500;0;500;350;150;
2021-05-16 16:07:55;8992696404441;BEAR BRAND 189ML;1;9000;0;9000;7887;1113;
2021-05-16 16:21:02;8992959953020;SWEETY BRONZE M1;2;3000;0;6000;5342;658;
2021-05-16 17:05:22;6907992824963;JD MILKY CHOCOLATE;1;3000;0;3000;2600;400;
2021-05-16 17:05:22;8886013257400;TWISTKO;1;1000;0;1000;900;100;
2021-05-16 17:05:22;6907992823966;JD BLUEBERRY;1;3500;0;3500;3000;500;
2021-05-16 17:05:22;6907992823829;JD MILKY MILK;1;3000;0;3000;2600;400;
2021-05-16 17:05:22;8994834005923;SPIX 1000;3;1000;0;3000;2550;450;
2021-05-16 17:05:22;8991001503114;CHACHA MILK CHOCOLATE 35G;1;5500;0;5500;4900;600;
2021-05-16 17:40:43;8997025911058;HATARI SHP KELAPA;1;6000;0;6000;4911;1089;
2021-05-16 17:40:59;8992696404441;BEAR BRAND 189ML;2;9000;0;18000;15774;2226;
2021-05-16 17:53:31;6907992823904;JD CRUNCHY CHOCOLATE VAN;1;8000;0;8000;6800;1200;
2021-05-16 18:28:25;6921101219235;YAKUAT JELLY;1;2000;0;2000;1750;250;
2021-05-16 18:28:25;8997025911058;HATARI SHP KELAPA;1;6000;0;6000;4911;1089;
2021-05-16 18:28:25;8998866500708;FLORIDINA ORANGE;1;3000;0;3000;2500;500;
2021-05-16 18:28:25;8999908389008;HEMAVITON C1000;1;8000;0;8000;6000;2000;
2021-05-16 18:28:51;8991102384841;WFR TANGO LONG CKLT 130G;1;5000;0;5000;4345;655;
2021-05-16 18:28:51;8991102987639;WFR TANGO LONG VNL 130G;1;5000;0;5000;3773;1227;
2021-05-16 18:31:42;8994834005923;SPIX 1000;1;1000;0;1000;850;150;
2021-05-16 18:31:42;VTM;VITAMIN;2;500;0;1000;850;150;
2021-05-16 18:47:09;8998866202404;NOODLE SEDAAP MIE KOREAN SPICY CHICKEN CUP;1;5000;0;5000;4002;998;
2021-05-16 18:55:39;8998866202930;SEDAAP AYAM JERIT CUP;1;4500;0;4500;3738;762;
2021-05-16 18:59:19;TL;TELUR;3;1500;0;4500;3900;600;
2021-05-16 18:59:19;HT;HOT-HOT;1;500;0;500;350;150;
2021-05-16 19:26:43;8993989311279;CLAS MILD 12;1;17000;0;17000;15700;1300;
2021-05-16 19:32:26;8997231980022;O'JELLY MINI STRAWBERRY;2;3000;0;6000;4500;1500;
2021-05-16 19:32:26;VTM;VITAMIN;2;500;0;1000;850;150;
2021-05-16 20:00:49;8999099920691;SGM 1+ MADU 1000G;1;85000;0;85000;78510;6490;
2021-05-16 20:29:11;089686060126;POP MIE BASO JUMBO;1;4500;0;4500;3833;667;
2021-05-16 20:31:21;GL;GULA 1 LITER;4;11500;0;46000;42000;4000;
2021-05-16 20:31:21;6921101219235;YAKUAT JELLY;1;2000;0;2000;1750;250;
2021-05-16 20:31:21;8886013213208;FRENCH FREIS 2000;1;5000;0;5000;3750;1250;
2021-05-16 21:36:41;8999999042646;RINSO MOLTO ROSE FRESH LIQ 40ML;1;5000;0;5000;4817;183;
2021-05-16 21:36:41;8998866608756;SOKLIN SOFTENER TWILIGHT BLUE 14SCH;1;5000;0;5000;4560;440;
2021-05-16 21:37:31;8998866201827;JAVANA GULA BATU 350ML;1;3000;0;3000;2150;850;
2021-05-16 21:40:52;8991102989428SCT;TANGO CKLT 24G SCT;1;1000;0;1000;609;391;
2021-05-16 22:17:51;089686044249;SUPERMI NUTRIMI STEAK AYAM;1;3500;0;3500;2800;700;
2021-05-16 22:17:51;089686010343;INDOMIE SOTO MIE;1;2600;0;2600;2367;233;
2021-05-16 22:17:51;089686010824;INDOMIE GORENG SPESIAL;1;2700;0;2700;2452;248;
2021-05-16 22:27:32;8998009020186;BUAVITA GUAVA 250ML;1;7000;0;7000;6083;917;
2021-05-16 22:27:32;089686611519;QTELA SINGKONG;1;5000;0;5000;4266;734;
2021-05-16 22:27:32;8996001600146;TEH PUCUK HARUM 350ML;1;3000;0;3000;2314;686;
2021-05-16 22:28:27;8991102989428SCT;TANGO CKLT 24G SCT;2;1000;0;2000;1218;782;
2021-05-16 22:45:58;8991689668006;SWALLOW;1;3500;0;3500;3500;0;
2021-05-16 22:45:58;8992933241112;NUTRIJELL COKLAT;2;7000;0;14000;12832;1168;
2021-05-16 22:45:58;8992993525740;HAAN PUDING MANGGO POUCH 145G;1;8000;0;8000;7185;815;
2021-05-16 22:45:58;8992992102423;WIPPY CREAM 200G;2;28000;0;56000;51980;4020;
2021-05-16 22:45:58;8998866200882;SUKSESMIE GORENG AYAM KRMS 133GR;2;3500;0;7000;6094;906;
2021-05-16 22:47:27;8992870311091;SALONPAS;1;6000;0;6000;4806;1194;
2021-05-16 22:47:27;HT;HOT-HOT;1;500;0;500;350;150;
2021-05-16 22:58:35;8998866200578;MIE SEDAAP KARI KENTAL;2;2500;0;5000;4526;474;
2021-05-16 22:58:35;8998866202619;MIE SEDAAP KOREAN SPICY SOUP;1;2500;0;2500;2273;227;
2021-05-17 17:24:28;8991102230308;BLASTER PINK;1;5000;0;5000;3106;1894;
2021-05-17 19:02:04;8999999034061;ZWITSAL BAT NAT HAIR&BODY  300ML;1;28700;0;28700;26125;2575;
2021-05-17 19:02:04;8999908284907;MY BABY MINYAK TELON 90ML;1;25000;0;25000;22700;2300;
2021-05-17 19:02:04;8998989110167;SURYA GUDANG GARAM 16 FILTER;1;25000;0;25000;23200;1800;
2021-05-17 19:02:04;8998866200882;SUKSESMIE GORENG AYAM KRMS 133GR;1;3500;0;3500;3047;453;
2021-05-17 19:08:26;8999999059781;SUNLIGHT LIME NEW POUCH 210ML;1;5000;0;5000;4300;700;
2021-05-17 19:08:26;8992628605151;AMANDA MARGARINE;1;5000;0;5000;3806;1194;
2021-05-17 19:08:26;8992957352153;CHOCO CHIPS 45G;1;4500;0;4500;2850;1650;
2021-05-17 19:08:26;8992761166038;MMP ORANGE 300ML;1;5000;0;5000;3750;1250;
2021-05-17 19:08:26;HT;HOT-HOT;4;500;0;2000;1400;600;
2021-05-17 19:08:26;6907992823843;JD MOCHA CRISPY;1;5000;0;5000;4400;600;
2021-05-17 19:08:26;6907992823669;JD MILKY STRAW;1;3000;0;3000;2600;400;
2021-05-17 19:08:26;8998866202343;MIE SEDAAP KOREAN SPICY;1;2500;0;2500;2023;477;
2021-05-17 19:08:26;8992775311615;CHOCOLATOS;1;12000;0;12000;9983;2017;
2021-05-17 19:08:26;BTS;BIMURA TARO SEAWEED 250G;2;10000;0;20000;18600;1400;
2021-05-17 19:09:05;8992959953105;SWEETY BRONZE XXL6;1;16000;0;16000;15230;770;
2021-05-17 19:13:09;8998866200882;SUKSESMIE GORENG AYAM KRMS 133GR;2;3500;0;7000;6094;906;
2021-05-17 19:13:09;VTM;VITAMIN;1;500;0;500;425;75;
2021-05-17 19:13:09;8991102281430;PERMEN MINTZ DUOMINT;1;4500;0;4500;4000;500;
2021-05-17 19:13:09;8991102281416;PERMEN MINTZ PPMINT;1;4500;0;4500;4000;500;
2021-05-17 19:13:09;8991102989381;TANGO LONG BUBBLEGUM 130G;1;5000;0;5000;4345;655;
2021-05-17 19:13:09;8992775913000SCT;CHOCOLATOS CKLT DRINK SCT;1;2000;0;2000;1586;414;
2021-05-17 19:13:09;8999999534097;PEPSODENT PGB FCM 75G;1;5000;0;5000;3850;1150;
2021-05-17 19:13:09;8998989500128;GUDANG GARAM MERAH KECIL 12KS;1;14000;0;14000;13000;1000;
2021-05-17 19:13:09;RB;RED BOLD;1;19000;0;19000;17900;1100;
2021-05-17 19:13:09;8998866200844;NOODLE SEDAAP MIE KARI SPESIAL CUP 81 GR;1;4500;0;4500;3650;850;
2021-05-17 19:13:09;8998866200837;NOODLE SEDAAPMIE SOTO CUP 81 GR;1;4500;0;4500;3650;850;
2021-05-17 19:13:09;8992959953082;SWEETY BRONZE L8;1;17000;0;17000;15380;1620;
2021-05-17 19:32:29;8992761166212;FRESTEA APPLE 350ML;1;4500;0;4500;3000;1500;
2021-05-17 19:32:29;JGR SHN;JOGER SHINY SACHET;1;500;0;500;437;63;
2021-05-17 19:33:17;8998866200882;SUKSESMIE GORENG AYAM KRMS 133GR;2;3500;0;7000;6094;906;
2021-05-17 19:37:21;8997231980022;O'JELLY MINI STRAWBERRY;1;3000;0;3000;2250;750;
2021-05-17 19:37:21;8992775001653;GERY SALUT CHOCOLATE COCONUT;1;2000;0;2000;1476;524;
2021-05-17 19:37:21;VTM;VITAMIN;5;500;0;2500;2125;375;
2021-05-17 19:37:21;bb;BENG-BENG;1;1500;0;1500;1450;50;
2021-05-17 19:37:21;HT;HOT-HOT;1;500;0;500;350;150;
2021-05-17 20:19:40;089686043617;INDOMIE MIEGHRTTI;3;2700;0;8100;7356;744;
2021-05-17 20:28:19;ARG;ARGUS 220ML;6;14500;0;87000;75000;12000;
2021-05-17 20:42:30;PUDING;VITA PUDDING;1;5000;0;5000;3750;1250;
2021-05-17 20:54:40;8991102303309;WFR TANGO SBJ 176G;1;10000;0;10000;8694;1306;
2021-05-17 21:10:40;089686611519;QTELA SINGKONG;1;5000;0;5000;4266;734;
2021-05-17 21:45:54;8999999502003;SARIMURNI RL RB 1,8G;1;1500;0;1500;1207;293;
2021-05-17 21:45:54;089686011494;INDOMIE SOTO PADANG;1;2600;0;2600;2317;283;
2021-05-17 21:45:54;BAYFLAST;BAYPLAST;2;500;0;1000;700;300;
2021-05-17 21:45:54;TL;TELUR;1;1500;0;1500;1300;200;
2021-05-17 21:52:22;089686011494;INDOMIE SOTO PADANG;1;2600;0;2600;2317;283;
2021-05-17 21:57:37;8998866202732;MILKU STROBERI 200ML;1;3000;0;3000;2375;625;
2021-05-17 21:57:37;8998866202725;MILKU COKLAT PREMIUM 200ML;1;3000;0;3000;2375;625;
2021-05-17 21:57:37;8998866201452;POTABEE REGULER BBQ BEEF 35GR;1;5000;0;5000;4150;850;
2021-05-17 21:57:37;PRG;PARAGO;11;500;0;5500;4400;1100;
2021-05-18 12:25:43;8998866608718;DAIA SOFTENER PINK;1;5000;0;5000;4450;550;
2021-05-18 12:25:43;MOLTO PINK;MOLTO ALL IN ONE 11 ML;2;500;0;1000;800;200;
2021-05-18 12:25:43;MOBIL;GULA GULA HP;1;2000;0;2000;1700;300;
2021-05-18 12:28:53;8991188943536;SASA SANTAN KELAPA 65ML;2;3000;0;6000;4874;1126;
2021-05-18 12:28:53;BTS;BIMURA TARO SEAWEED 250G;1;10000;0;10000;9300;700;
2021-05-18 12:28:53;8992775913000SCT;CHOCOLATOS CKLT DRINK SCT;2;2000;0;4000;3172;828;
2021-05-18 12:28:53;8994834005923;SPIX 1000;1;1000;0;1000;850;150;
2021-05-18 12:28:53;8992761139018;ADES 600ML;1;3500;0;3500;2292;1208;
2021-05-18 12:28:53;8997028590014;ARGUS 220ML;4;500;0;2000;1208;792;
2021-05-18 12:31:53;8998989300261;GUDANG GARAM SURYA 12 FILTER;1;18500;0;18500;17200;1300;
2021-05-18 12:36:40;8993989311699;CLAS MILD 16 FILTER;1;23000;0;23000;21700;1300;
2021-05-18 13:24:45;8999909010567;234 16 FILTER;1;22000;0;22000;21500;500;
2021-05-18 14:06:06;GL;GULA 1 LITER;3;11500;0;34500;31500;3000;
2021-05-18 14:06:06;8993058105013;EXTRA JOSS;1;12000;0;12000;9773;2227;
2021-05-18 14:40:39;089686010107;INDOMIE KALDU AYAM;1;2500;0;2500;2150;350;
2021-05-18 16:36:58;9556001025272;NESCAFE LATTE 240ML;1;8500;0;8500;7834;666;
2021-05-18 16:36:58;8992761166212;FRESTEA APPLE 350ML;1;4500;0;4500;3000;1500;
2021-05-18 16:36:58;VCL;VITAMIN C500 LEMON;1;1000;0;1000;575;425;
2021-05-18 16:36:58;8997009510055;YOU C1000;1;10000;0;10000;9166;834;
2021-05-18 16:36:58;8998898280401;TOLAK ANGIN FLU;3;3500;0;10500;8124;2376;
2021-05-18 16:51:38;8998866202732;MILKU STROBERI 200ML;1;3000;0;3000;2375;625;
2021-05-18 17:20:59;8994935000049;MINYAK GORENG DAMAI 5L;1;75000;0;75000;73780;1220;
2021-05-18 17:31:12;GL;GULA 1 LITER;1;11500;0;11500;10500;1000;
2021-05-18 17:49:17;8996001600375;LE MINERAL 330ML;1;2000;0;2000;1417;583;
2021-05-18 18:21:06;8999909003439;MARLBORO CRAFTED 12;1;8000;0;8000;7250;750;
2021-05-18 19:32:24;8998866501033;MINYAK GORENG SEDAAP POUCH 2L;1;28000;0;28000;27746;254;
2021-05-18 19:59:17;8997231980022;O'JELLY MINI STRAWBERRY;1;3000;0;3000;2250;750;
2021-05-18 19:59:17;8992696521797SCT;MILO UHT ACT GO 22G;2;2000;0;4000;2824;1176;
2021-05-18 19:59:17;8998866202923;FLORIDINA COCO;1;3000;0;3000;2500;500;
2021-05-18 19:59:17;8997231980015;O'JELLY MINI APPLE;1;3000;0;3000;2250;750;
2021-05-18 20:20:47;8999909096004;SAMPOERNA 16 FILTER;1;24000;0;24000;23000;1000;
2021-05-18 20:54:18;8992761139018;ADES 600ML;1;3500;0;3500;2292;1208;
2021-05-18 21:07:03;089686043617;INDOMIE MIEGHRTTI;1;2700;0;2700;2452;248;
2021-05-18 21:07:03;8998866200325;MIE SEDAAP SOTO;1;2500;0;2500;1952;548;
2021-05-18 21:07:03;COKLAT;COKLAT COIN;1;500;0;500;400;100;
2021-05-18 21:31:03;8998866202725;MILKU COKLAT PREMIUM 200ML;1;3000;0;3000;2375;625;
2021-05-18 21:31:03;8998898337440;TOLAK ANGIN CARE 10ML;1;10000;0;10000;7893;2107;
2021-05-18 21:31:03;089686611878;QTELA TEMPE;1;6000;0;6000;5370;630;
2021-05-18 21:31:03;089686611519;QTELA SINGKONG;1;5000;0;5000;4266;734;
2021-05-18 21:31:03;6907992823935;JD SWEETCORN;1;3500;0;3500;3000;500;
2021-05-18 21:31:03;8996001600146;TEH PUCUK HARUM 350ML;1;3000;0;3000;2314;686;
2021-05-18 21:31:03;089686021219;INTER MIE GORENG;3;1000;0;3000;2655;345;
2021-05-18 21:32:33;8992959953044;SWEETY BRONZE XL1;2;2500;0;5000;4500;500;
2021-05-18 21:48:19;089686010824;INDOMIE GORENG SPESIAL;4;2700;0;10800;9808;992;
2021-05-18 21:48:19;089686010343;INDOMIE SOTO MIE;4;2600;0;10400;9468;932;
2021-05-18 21:49:45;8998866202732;MILKU STROBERI 200ML;1;3000;0;3000;2375;625;
2021-05-18 22:29:00;9556001025272;NESCAFE LATTE 240ML;1;8500;0;8500;7834;666;
2021-05-18 22:29:00;8991102384841;WFR TANGO LONG CKLT 130G;1;5000;0;5000;4345;655;
2021-05-18 22:29:00;6907992823935;JD SWEETCORN;1;3500;0;3500;3000;500;
2021-05-19 11:04:24;123124;KOREK BIASA;1;2000;0;2000;1800;200;
2021-05-19 11:29:22;AMPLOP;AMPLOP;4;250;0;1000;560;440;
2021-05-19 11:43:18;8993989311699;CLAS MILD 16 FILTER;1;23000;0;23000;21700;1300;
2021-05-19 11:53:17;8993083929837;BISKITOP BLACK COOKIES;1;27000;0;27000;23700;3300;
2021-05-19 11:53:17;8991102989312;WFR TANGO SBJ 7G;1;8300;0;8300;7455;845;
2021-05-19 12:06:46;8998989300261;GUDANG GARAM SURYA 12 FILTER;1;18500;0;18500;17200;1300;
2021-05-19 12:06:46;8992959953082;SWEETY BRONZE L8;1;17000;0;17000;15380;1620;
2021-05-19 12:17:53;8998989300261;GUDANG GARAM SURYA 12 FILTER;2;18500;0;37000;34400;2600;
2021-05-19 12:36:28;TL;TELUR;3;1500;0;4500;3900;600;
2021-05-19 14:02:50;ff;FULLO BLASTO;1;1000;0;1000;995;5;
2021-05-19 14:02:50;ABC SPW;BATERAI ABC SPW;1;4500;0;4500;3893;607;
2021-05-19 14:02:50;8992775002735;CHOCOLATOS SUSU COKELAT;1;4000;0;4000;3520;480;
2021-05-19 14:02:50;8992946512223;SHINZUI;1;4000;0;4000;2500;1500;
2021-05-19 14:02:50;TUSTEL;TUSUK TELINGA;1;1000;0;1000;833;167;
2021-05-19 14:10:22;8992761166212;FRESTEA APPLE 350ML;1;4500;0;4500;3000;1500;
2021-05-19 14:10:22;8998009020186;BUAVITA GUAVA 250ML;1;7000;0;7000;6083;917;
2021-05-19 14:10:22;8998989500128;GUDANG GARAM MERAH KECIL 12KS;1;14000;0;14000;13000;1000;
2021-05-19 14:10:22;8999999390198;SUNLIGHT LIME NEW POUCH 755ML;1;17000;0;17000;15400;1600;
2021-05-19 14:10:22;001;PASEO SMART FACIAL SF 250S GT;1;10000;0;10000;9500;500;
2021-05-19 14:10:22;8998866609036;DAIA BUNGA GUSSET 565G;1;10000;0;10000;8700;1300;
2021-05-19 14:10:22;8999801700030;SUSU FOYU;1;11500;0;11500;10450;1050;
2021-05-19 14:10:22;9311931024036;COFFEEMIX SCT;1;1500;0;1500;1200;300;
2021-05-19 14:22:39;8992761136185;FANTA 1L;4;10000;0;40000;36000;4000;
2021-05-19 14:22:39;8992761136161;COCACOLA 1L;1;10000;0;10000;9000;1000;
2021-05-19 14:24:48;8999909010567;234 16 FILTER;2;22000;0;44000;43000;1000;
2021-05-19 14:44:17;8999999516208;ROYCO FDS CHICKEN NEW 230G;1;10000;0;10000;9000;1000;
2021-05-19 14:44:17;8997009510055;YOU C1000;1;10000;0;10000;9166;834;
2021-05-19 14:44:17;BK;BUMBU KACANG;1;5000;0;5000;5000;0;
2021-05-19 14:44:17;GL;GULA 1 LITER;1;11500;0;11500;10500;1000;
2021-05-19 14:44:17;8999999524722;SUNLIGHT LIME NEW PCH 435ML;1;10000;0;10000;9100;900;
2021-05-19 14:44:17;8998866803694;SOKLIN SOFTERGENT PURPLE BAG 770 & PIRING;1;18000;0;18000;16680;1320;
2021-05-19 14:44:17;001;PASEO SMART FACIAL SF 250S GT;1;10000;0;10000;9500;500;
2021-05-19 14:44:17;8993053641042;PASEO BABY WIPES GAZETTE 50S;1;17000;0;17000;15400;1600;
2021-05-19 14:44:17;8995333032113;TERIGU GATOT KACA 1 KG;1;8500;0;8500;8012;488;
2021-05-19 14:44:17;8998866200561;EKOMIE SUPER 600GR;1;10000;0;10000;8615;1385;
2021-05-19 14:44:17;8998866202664;POTABEE WAGYU BEEF STEAK 68 GR;1;8000;0;8000;7200;800;
2021-05-19 14:44:17;8998866201827;JAVANA GULA BATU 350ML;1;3000;0;3000;2150;850;
2021-05-19 17:00:22;6907992823591;JD STRAW MILKSHAKE;1;5000;0;5000;4300;700;
2021-05-19 17:00:22;6907992823652;JD CHOCOLATE MILKSHAKE;1;6000;0;6000;5200;800;
2021-05-19 18:05:56;8999909096004;SAMPOERNA 16 FILTER;1;24000;0;24000;23000;1000;
2021-05-19 18:08:32;8992696430860;KOKO KRUNCH 80G;1;9000;0;9000;8063;937;
2021-05-19 18:08:32;8992957220025;GOLDEN CITY MINI;1;3000;0;3000;2500;500;
2021-05-19 18:08:32;8991102281416;PERMEN MINTZ PPMINT;1;4500;0;4500;4000;500;
2021-05-19 18:08:32;8992761002039;FANTA STRAWBERRY PET 390 ML;1;5500;0;5500;4300;1200;
2021-05-19 19:31:10;8992725910400;LISTERINE COOLMINT 100ML;1;7500;0;7500;6800;700;
2021-05-19 19:31:10;8998866108119;POSH HIJAB PURPLE WISH 150ML;1;19500;0;19500;17500;2000;
2021-05-19 19:31:10;8992761166038;MMP ORANGE 300ML;1;5000;0;5000;3750;1250;
2021-05-19 19:31:10;8992761002022;SPRITE PET 390ML;1;5500;0;5500;4300;1200;
2021-05-19 19:32:05;8998866108119;POSH HIJAB PURPLE WISH 150ML;1;19500;0;19500;17500;2000;
2021-05-19 19:32:05;8992725910400;LISTERINE COOLMINT 100ML;1;7500;0;7500;6800;700;
2021-05-19 19:32:27;8998866202930;SEDAAP AYAM JERIT CUP;2;4500;0;9000;7476;1524;
2021-05-19 19:32:27;8992957220087;COKLAT SINGA;1;2000;0;2000;1700;300;
2021-05-19 19:40:58;8993989311699;CLAS MILD 16 FILTER;1;23000;0;23000;21700;1300;
2021-05-19 20:19:08;8997231980015;O'JELLY MINI APPLE;1;3000;0;3000;2250;750;
2021-05-19 20:19:08;TL;TELUR;3;1500;0;4500;3900;600;
2021-05-19 20:19:08;089686010107;INDOMIE KALDU AYAM;1;2500;0;2500;2150;350;
2021-05-19 20:24:53;8992959508312;SWEETY SILVER PANTS XL RTG;1;15500;0;15500;13944;1556;
2021-05-19 20:30:05;8997009510055;YOU C1000;1;10000;0;10000;9166;834;
2021-05-19 20:30:05;8992696404441;BEAR BRAND 189ML;1;9000;0;9000;7887;1113;
2021-05-19 20:34:28;8997231980022;O'JELLY MINI STRAWBERRY;1;3000;0;3000;2250;750;
2021-05-19 20:49:34;8992761002039;FANTA STRAWBERRY PET 390 ML;1;5500;0;5500;4300;1200;
2021-05-19 20:49:34;bb;BENG-BENG;3;1500;0;4500;4350;150;
2021-05-19 20:49:34;8996001318911;BETTER ISI 4;1;2000;0;2000;1700;300;
2021-05-19 21:36:11;8991102281416;PERMEN MINTZ PPMINT;1;4500;0;4500;4000;500;
2021-05-19 21:36:11;8996001600269;LE MINERAL 600ML;1;3000;0;3000;1688;1312;
2021-05-19 21:36:11;8992761166229;FRESTEA MARKISA 350ML;1;4500;0;4500;3000;1500;
2021-05-19 21:48:55;8998866200561;EKOMIE SUPER 600GR;1;10000;0;10000;8615;1385;
2021-05-19 22:02:22;6907992823669;JD MILKY STRAW;1;3000;0;3000;2600;400;
2021-05-19 22:27:56;8998866202664;POTABEE WAGYU BEEF STEAK 68 GR;1;8000;0;8000;7200;800;
2021-05-19 22:27:56;8886013257400;TWISTKO;2;1000;0;2000;1800;200;
2021-05-19 22:30:22;8998989300261;GUDANG GARAM SURYA 12 FILTER;1;18500;0;18500;17200;1300;
2021-05-19 22:30:22;8998866200882;SUKSESMIE GORENG AYAM KRMS 133GR;1;3500;0;3500;3047;453;
2021-05-20 12:52:34;9556001004673;MILO NESTLE MALAYSIA ACTIVE GO;1;85000;0;85000;80000;5000;
2021-05-20 12:53:02;8998898337440;TOLAK ANGIN CARE 10ML;2;10000;0;20000;15786;4214;
2021-05-20 13:51:25;8999999042646;RINSO MOLTO ROSE FRESH LIQ 40ML;1;6000;0;6000;4817;1183;
2021-05-20 13:51:25;8998866611718;EKONOMI PENCUCI PIRING  LIQ 780ML;1;12000;0;12000;10900;1100;
2021-05-20 13:51:25;8992388133017;NU MILK TEA ORI 330ML;1;6000;0;6000;5125;875;
2021-05-20 13:52:18;8991001502933;CHACHA TUBE;2;7500;0;15000;12800;2200;
2021-05-20 13:55:39;8991001005694;SELAMAT 20X15G;1;18000;0;18000;16000;2000;
2021-05-20 13:55:39;8992959953334;SWEETY BRONZE XL42;1;80000;0;80000;75455;4545;
2021-05-20 14:50:42;8998866202671;NOODLE SEDAAP MIE KOREAN SPICY SOUP CUP;2;5000;0;10000;8004;1996;
2021-05-20 14:50:42;8992761166212;FRESTEA APPLE 350ML;2;4500;0;9000;6000;3000;
2021-05-20 14:50:42;8991001502933;CHACHA TUBE;1;7500;0;7500;6400;1100;
2021-05-20 14:50:42;123124;KOREK BIASA;1;2000;0;2000;1800;200;
2021-05-20 16:16:11;8996001600269;LE MINERAL 600ML;1;3000;0;3000;1688;1312;
2021-05-20 16:18:46;GL;GULA 1 LITER;1;11500;0;11500;10500;1000;
2021-05-20 16:18:46;8991004011906;KOPI BORONG;1;10000;0;10000;8333;1667;
2021-05-20 16:18:46;8998989500128;GUDANG GARAM MERAH KECIL 12KS;2;14000;0;28000;26000;2000;
2021-05-20 17:07:18;8992959850046;CONFI PANTS M10;1;80000;0;80000;75120;4880;
2021-05-20 17:07:18;8993176110081;MINYAK KAYU PUTIH 30ML;1;12000;0;12000;9091;2909;
2021-05-20 17:07:18;001;PASEO SMART FACIAL SF 250S GT;1;10000;0;10000;9500;500;
2021-05-20 17:48:48;8992761122430;FRESTEA GREEN HONEY 500ML;1;6500;0;6500;4708;1792;
2021-05-20 17:48:48;8998866500135;HERSPROTEX SOFTCARE WINGS;1;5500;0;5500;4820;680;
2021-05-20 17:48:48;8991001780140;TWISTER CHOCO;1;5000;0;5000;4600;400;
2021-05-20 17:48:48;8991001503107;CHACHA PEANUT 35GR;1;5500;0;5500;4900;600;
2021-05-20 17:48:48;8991001780126;SELAMAT CKLAT 60G;1;5000;0;5000;4300;700;
2021-05-20 17:48:48;8992761111533;SPRITE SLIM CAM250ML;1;5000;0;5000;3750;1250;
2021-05-20 17:48:48;8992775001653;GERY SALUT CHOCOLATE COCONUT;2;2000;0;4000;2952;1048;
2021-05-20 17:52:20;8997009510055;YOU C1000;1;10000;0;10000;9166;834;
2021-05-20 18:17:47;8998009010590;ULTRA CHO 125;1;3000;0;3000;2428;572;
2021-05-20 18:17:47;8998009010569;ULTRA CHO 200;1;5000;0;5000;3830;1170;
2021-05-20 18:26:39;089686010107;INDOMIE KALDU AYAM;2;2500;0;5000;4300;700;
2021-05-20 18:39:46;TG APEL;TEH GELAS APEL;1;2000;0;2000;1178;822;
2021-05-20 18:39:46;8999999502003;SARIMURNI RL RB 1,8G;1;1500;0;1500;1207;293;
2021-05-20 18:39:46;6907992825069;JD FRUITY;1;5000;0;5000;4400;600;
2021-05-20 18:39:46;8991001503107;CHACHA PEANUT 35GR;1;5500;0;5500;4900;600;
2021-05-20 18:39:46;8992761002039;FANTA STRAWBERRY PET 390 ML;1;5500;0;5500;4300;1200;
2021-05-20 18:39:46;8991001502933;CHACHA TUBE;1;7500;0;7500;6400;1100;
2021-05-20 18:39:46;8996001600146;TEH PUCUK HARUM 350ML;1;3000;0;3000;2314;686;
2021-05-20 18:39:46;089686044249;SUPERMI NUTRIMI STEAK AYAM;1;3500;0;3500;2800;700;
2021-05-20 18:50:09;8998009010590;ULTRA CHO 125;1;3000;0;3000;2428;572;
2021-05-20 18:50:09;8998009010569;ULTRA CHO 200;1;5000;0;5000;3830;1170;
2021-05-20 18:50:09;8992761164539;NUTRIBOOST ORANGE 300ML;1;6500;0;6500;5300;1200;
2021-05-20 18:50:09;8991102387286SCT;TANGO LONG CKLT 47G;4;2000;0;8000;6204;1796;
2021-05-20 18:50:09;8991102714631;TANGO TETRA CKLT;1;5000;0;5000;4545;455;
2021-05-20 18:52:53;8998989300261;GUDANG GARAM SURYA 12 FILTER;1;18500;0;18500;17200;1300;
2021-05-20 20:26:31;8994935000285;MINYAK GORENG DUNIA 4500ML;1;70000;0;70000;66433;3567;
2021-05-20 20:26:31;711844610095;LARISSA UDANG 500 GR;2;11000;0;22000;19580;2420;
2021-05-20 20:39:42;8999999390198;SUNLIGHT LIME NEW POUCH 755ML;1;17000;0;17000;15400;1600;
2021-05-20 20:40:46;8994867007161;ROKOK PENA GOLD 20;1;17000;0;17000;15000;2000;
2021-05-20 20:40:46;HT;HOT-HOT;1;500;0;500;350;150;
2021-05-20 21:03:53;8992959850053;CONFIDENCE ADULT PANTS L10;1;100000;0;100000;92960;7040;
2021-05-20 21:03:53;KJ;KINDER JOY;1;2000;0;2000;1583;417;
2021-05-20 21:09:26;8992959953044;SWEETY BRONZE XL1;2;2500;0;5000;4500;500;
2021-05-20 21:14:28;bb;BENG-BENG;4;1500;0;6000;5800;200;
2021-05-20 22:10:25;8994834005923;SPIX 1000;1;1000;0;1000;850;150;
2021-05-20 22:10:25;8998866202923;FLORIDINA COCO;1;3000;0;3000;2500;500;
2021-05-20 22:12:13;8992775110157;GARUDA KACANG KULIT;1;5000;0;5000;3925;1075;
2021-05-20 22:12:13;8992761139018;ADES 600ML;1;3500;0;3500;2292;1208;
2021-05-20 22:12:13;TG APEL;TEH GELAS APEL;1;2000;0;2000;1178;822;
2021-05-20 22:12:13;8999908389008;HEMAVITON C1000;1;8000;0;8000;6000;2000;
2021-05-20 22:12:13;8992761164539;NUTRIBOOST ORANGE 300ML;1;6500;0;6500;5300;1200;
2021-05-20 22:12:13;8997025915124;HATARI PEANUT 125G;1;7000;0;7000;6037;963;
2021-05-20 22:12:13;6291100212866;KURMA KHALAS;1;85000;0;85000;80000;5000;
2021-05-20 22:12:13;8996001600375;LE MINERAL 330ML;1;2000;0;2000;1417;583;
2021-05-20 22:12:13;8996001600269;LE MINERAL 600ML;1;3000;0;3000;1688;1312;
2021-05-20 22:12:13;8996001600399;LE MINERAL 1500ML;1;5000;0;5000;4042;958;
2021-05-20 22:18:52;TL;TELUR;16;1500;0;24000;20800;3200;
2021-05-20 22:29:27;8997231980022;O'JELLY MINI STRAWBERRY;1;3000;0;3000;2250;750;
2021-05-21 11:53:16;8991102230308;BLASTER PINK;1;5000;0;5000;3106;1894;
2021-05-21 11:53:16;8991102213189;BLASTER UNGU;1;5000;0;5000;3106;1894;
2021-05-21 12:11:21;089686611519;QTELA SINGKONG;1;5000;0;5000;4266;734;
2021-05-21 12:11:21;8999999502409;ROYCO FDS BEEF 9G;2;500;0;1000;750;250;
2021-05-21 12:11:21;8991188943536;SASA SANTAN KELAPA 65ML;2;3000;0;6000;4874;1126;
2021-05-21 12:19:11;8992761111533;SPRITE SLIM CAM250ML;1;5000;0;5000;3750;1250;
2021-05-21 12:23:38;8998866202671;NOODLE SEDAAP MIE KOREAN SPICY SOUP CUP;1;5000;0;5000;4002;998;
2021-05-21 13:11:18;8998009010590;ULTRA CHO 125;1;3000;0;3000;2428;572;
2021-05-21 13:11:18;HT;HOT-HOT;2;500;0;1000;700;300;
2021-05-21 13:11:18;COKLAT;COKLAT COIN;2;500;0;1000;800;200;
2021-05-21 13:24:44;8999999526856;MOLTO ALL IN ONE BLUE 11ML;2;5500;0;11000;9600;1400;
2021-05-21 14:19:44;GL;GULA 1 LITER;1;11500;0;11500;10500;1000;
2021-05-21 14:43:56;8886057883665;KRATING DAENG;1;6000;0;6000;4286;1714;
2021-05-21 14:43:56;8992761164546;NUTRIBOOST STRAWBERRY 300ML;1;6500;0;6500;5300;1200;
2021-05-21 14:43:56;8992761002022;SPRITE PET 390ML;1;5500;0;5500;4300;1200;
2021-05-21 14:51:07;8994867000179;ROKOK PENA MILD 16;1;14500;0;14500;13000;1500;
2021-05-21 14:51:07;123124;KOREK BIASA;1;2000;0;2000;1800;200;
2021-05-21 14:51:07;8992775110157;GARUDA KACANG KULIT;1;5000;0;5000;3925;1075;
2021-05-21 14:57:04;8999999042646;RINSO MOLTO ROSE FRESH LIQ 40ML;1;6000;0;6000;4817;1183;
2021-05-21 15:30:51;8999999059781;SUNLIGHT LIME NEW POUCH 210ML;1;5000;0;5000;4300;700;
2021-05-21 16:04:13;8996001355985;BENG-BENG SHARE IT;1;27000;0;27000;25000;2000;
2021-05-21 16:34:13;8998989300261;GUDANG GARAM SURYA 12 FILTER;1;18500;0;18500;17200;1300;
2021-05-21 17:15:53;089686043051;INDOMIE COTO MAKASSAR;2;2800;0;5600;5050;550;
2021-05-21 17:15:53;8991004011906;KOPI BORONG;1;10000;0;10000;8333;1667;
2021-05-21 17:15:53;089686010107;INDOMIE KALDU AYAM;2;2500;0;5000;4300;700;
2021-05-21 17:15:53;8999999502393;ROYCO FDS CHICKEN 8G;1;5000;0;5000;4500;500;
2021-05-21 17:15:53;GL;GULA 1 LITER;2;11500;0;23000;21000;2000;
2021-05-21 17:15:53;8998866501033;MINYAK GORENG SEDAAP POUCH 2L;1;28000;0;28000;27746;254;
2021-05-21 17:16:49;TK;TEPUNG KETAN;1;13000;0;13000;13000;0;
2021-05-21 17:23:09;8998866605106;CLING BIRU BTL 440ML;1;8500;0;8500;7600;900;
2021-05-21 17:24:12;8992761122430;FRESTEA GREEN HONEY 500ML;1;6500;0;6500;4708;1792;
2021-05-21 17:24:12;8992761166052;FRESTEA MELATI 350ML;1;4500;0;4500;3000;1500;
2021-05-21 17:27:04;8992761145019;COCA COLA PET 250ML;1;3500;0;3500;2417;1083;
2021-05-21 17:28:30;8992933214116;NUTRIJELL MELON;2;6000;0;12000;10082;1918;
2021-05-21 17:28:30;8990800020013;MENTOS MINT HALAL IND;1;5700;0;5700;5150;550;
2021-05-21 17:28:30;8999801700030;SUSU FOYU;1;11500;0;11500;10450;1050;
2021-05-21 17:44:33;8992959954058;SWEETY BRONZE NB 44;1;48000;0;48000;45682;2318;
2021-05-21 17:55:52;8992761164539;NUTRIBOOST ORANGE 300ML;1;6500;0;6500;5300;1200;
2021-05-21 17:55:52;8998866200882;SUKSESMIE GORENG AYAM KRMS 133GR;1;3500;0;3500;3047;453;
2021-05-21 18:31:11;8993470411433;JOGER CLASSIC;1;1000;0;1000;850;150;
2021-05-21 18:31:11;089686043273;INDOMIE SAMBAL RICA;1;2700;0;2700;2452;248;
2021-05-21 18:35:39;COKLAT;COKLAT COIN;3;500;0;1500;1200;300;
2021-05-21 18:35:39;bb;BENG-BENG;1;1500;0;1500;1450;50;
2021-05-21 18:35:39;8994834003752;TICTIC;1;2000;0;2000;1700;300;
2021-05-21 18:36:01;COKLAT;COKLAT COIN;2;500;0;1000;800;200;
2021-05-21 18:36:01;8993470411433;JOGER CLASSIC;1;1000;0;1000;850;150;
2021-05-21 18:45:22;8999999537180;CLEAR SHP LEMON FRESH 9 ML;1;10500;0;10500;9300;1200;
2021-05-21 18:45:22;8999999571887;MOLTO EDP PURPLE 10ML;1;5000;0;5000;4800;200;
2021-05-21 18:45:22;8999999390198;SUNLIGHT LIME NEW POUCH 755ML;1;17000;0;17000;15400;1600;
2021-05-21 18:57:17;8994834003752;TICTIC;1;2000;0;2000;1700;300;
2021-05-21 18:57:17;8992957220087;COKLAT SINGA;1;2000;0;2000;1700;300;
2021-05-21 19:02:03;8886013257400;TWISTKO;2;1000;0;2000;1800;200;
2021-05-21 20:01:28;8997231980022;O'JELLY MINI STRAWBERRY;1;3000;0;3000;2250;750;
2021-05-21 20:01:28;COKLAT;COKLAT COIN;2;500;0;1000;800;200;
2021-05-21 20:01:28;6907992823829;JD MILKY MILK;1;3000;0;3000;2600;400;
2021-05-21 20:01:28;8993470671752;JOGER STICK DUO KACANG;1;1000;0;1000;850;150;
2021-05-21 20:40:13;8998866603683;FRES&NATURAL SOAP MERAH 65G;1;1800;0;1800;1425;375;
2021-05-21 20:42:53;8997231980022;O'JELLY MINI STRAWBERRY;1;3000;0;3000;2250;750;
2021-05-21 20:42:53;kp;KALPA;1;2000;0;2000;1666;334;
2021-05-21 20:42:53;bb;BENG-BENG;1;1500;0;1500;1450;50;
2021-05-21 20:42:53;JGR SHN;JOGER SHINY SACHET;1;500;0;500;437;63;
2021-05-21 21:14:09;8994867007161;ROKOK PENA GOLD 20;1;17000;0;17000;15000;2000;
2021-05-21 21:37:50;8992761002039;FANTA STRAWBERRY PET 390 ML;1;5500;0;5500;4300;1200;
2021-05-21 21:45:38;8992761136161;COCACOLA 1L;2;10000;0;20000;18000;2000;
2021-05-21 22:29:42;8996001600146;TEH PUCUK HARUM 350ML;1;3000;0;3000;2314;686;
2021-05-21 22:29:42;8997218380135;ICHITAN GREEN TEA;1;8000;0;8000;6583;1417;
2021-05-21 22:29:42;8999908204202;MY BABY MINYAK TELON 60ML;1;18000;0;18000;16900;1100;
2021-05-21 22:29:42;8998989300261;GUDANG GARAM SURYA 12 FILTER;1;18500;0;18500;17200;1300;
2021-05-22 12:14:39;8991001502933;CHACHA TUBE;3;7500;0;22500;19200;3300;
2021-05-22 13:06:18;8999999059316;LIFEBUOY TS MILDCARE 75G;2;3000;0;6000;5280;720;
2021-05-22 13:06:18;8993379210854;SABUN HARMONY APPLE 70G;1;2000;0;2000;1652;348;
2021-05-22 13:51:38;8999999027049;LIFEBUOY PRWTN RMBT RNTK 9ML;1;5000;0;5000;4500;500;
2021-05-22 16:22:43;8998866609487;SOKLIN SOFTERGEN 280G;1;5000;0;5000;4425;575;
2021-05-22 16:22:53;8992761166038;MMP ORANGE 300ML;1;5000;0;5000;3750;1250;
2021-05-22 16:28:49;8993083140058;BISKITOP COCONUT;1;27000;0;27000;25200;1800;
2021-05-22 18:03:28;8998866610377;ISOPLUS;1;3000;0;3000;2350;650;
2021-05-22 18:05:04;MOBIL;GULA GULA HP;1;2000;0;2000;1700;300;
2021-05-22 18:05:04;8991001502933;CHACHA TUBE;1;7500;0;7500;6400;1100;
2021-05-22 18:05:04;8991001111883;SILVERQUEEN CHUNKYBAR 33G;1;8000;0;8000;7150;850;
2021-05-22 18:44:57;8998989300261;GUDANG GARAM SURYA 12 FILTER;1;18500;0;18500;17200;1300;
2021-05-22 18:44:57;8999999195656;SARI WANGI 50X1.85;1;10000;0;10000;9500;500;
2021-05-22 18:59:43;8998989300261;GUDANG GARAM SURYA 12 FILTER;1;18500;0;18500;17200;1300;
2021-05-22 18:59:43;8998009010569;ULTRA CHO 200;1;5000;0;5000;3830;1170;
2021-05-22 18:59:43;8998009040023;TEH KOTAK;1;5000;0;5000;2827;2173;
2021-05-22 19:02:31;COKLAT;COKLAT COIN;6;500;0;3000;2400;600;
2021-05-22 19:12:08;11222;LEM KOREA;1;10000;0;10000;8000;2000;
2021-05-22 19:31:20;8992761002039;FANTA STRAWBERRY PET 390 ML;1;5500;0;5500;4300;1200;
2021-05-22 19:31:20;8992959953044;SWEETY BRONZE XL1;2;2500;0;5000;4500;500;
2021-05-22 19:57:59;6907992823652;JD CHOCOLATE MILKSHAKE;1;6000;0;6000;5200;800;
2021-05-22 19:57:59;8998866201483;POTABEE REGULER GRILLED SEAWEED 35GR;1;5000;0;5000;4150;850;
2021-05-22 19:57:59;8997231980022;O'JELLY MINI STRAWBERRY;1;3000;0;3000;2250;750;
2021-05-22 20:03:49;8997231980022;O'JELLY MINI STRAWBERRY;1;3000;0;3000;2250;750;
2021-05-22 20:03:49;8993470671752;JOGER STICK DUO KACANG;1;1000;0;1000;850;150;
2021-05-22 20:03:49;bb;BENG-BENG;1;1500;0;1500;1450;50;
2021-05-22 20:03:49;COKLAT;COKLAT COIN;6;500;0;3000;2400;600;
2021-05-22 20:03:49;6907992823829;JD MILKY MILK;1;3000;0;3000;2600;400;
2021-05-22 20:03:49;JGR SHN;JOGER SHINY SACHET;1;500;0;500;437;63;
2021-05-22 20:13:13;8992933215113;NUTRIJELL TANPA RASA;1;6000;0;6000;4950;1050;
2021-05-22 20:13:13;8992933213119;NUTRIJELL LECI;1;6000;0;6000;5041;959;
2021-05-22 20:13:13;GL;GULA 1 LITER;2;11500;0;23000;21000;2000;
2021-05-22 20:13:13;8999999059781;SUNLIGHT LIME NEW POUCH 210ML;1;5000;0;5000;4300;700;
2021-05-22 20:13:13;8991004011906;KOPI BORONG;1;10000;0;10000;8333;1667;
2021-05-22 20:13:13;8993470671752;JOGER STICK DUO KACANG;1;1000;0;1000;850;150;
2021-05-22 20:13:13;8998989500128;GUDANG GARAM MERAH KECIL 12KS;2;14000;0;28000;26000;2000;
2021-05-22 20:13:13;8998866610261;DAIA VIOLET GUSSET BAG 290 GR;1;5000;0;5000;4450;550;
2021-05-22 20:13:13;8991102281430;PERMEN MINTZ DUOMINT;1;4500;0;4500;4000;500;
2021-05-22 20:13:13;8990800020013;MENTOS MINT HALAL IND;1;5700;0;5700;5150;550;
2021-05-22 20:13:13;8998866610438;SOKLIN SOFTERGENT RED BAG 770G & PIRING;1;18000;0;18000;16680;1320;
2021-05-22 20:13:13;089686017748;SARIMIE GORENG ISI 2;2;3500;0;7000;6240;760;
2021-05-22 20:13:13;8997231980022;O'JELLY MINI STRAWBERRY;2;3000;0;6000;4500;1500;
2021-05-22 20:13:13;089686043051;INDOMIE COTO MAKASSAR;2;2800;0;5600;5050;550;
2021-05-22 20:13:13;089686044249;SUPERMI NUTRIMI STEAK AYAM;2;3500;0;7000;5600;1400;
2021-05-22 20:13:13;8999999502003;SARIMURNI RL RB 1,8G;1;1500;0;1500;1207;293;
2021-05-22 20:13:13;8992775002735;CHOCOLATOS SUSU COKELAT;1;4000;0;4000;3520;480;
2021-05-22 20:13:13;8998866202725;MILKU COKLAT PREMIUM 200ML;1;3000;0;3000;2375;625;
2021-05-22 20:13:13;8998866202732;MILKU STROBERI 200ML;1;3000;0;3000;2375;625;
2021-05-22 20:13:13;8992761166212;FRESTEA APPLE 350ML;1;4500;0;4500;3000;1500;
2021-05-22 20:13:13;8994834003752;TICTIC;1;2000;0;2000;1700;300;
2021-05-22 20:13:13;8993365121539;MADU TJ SUPER 150G;1;16800;0;16800;15220;1580;
2021-05-22 20:36:07;8992959508992;SWEETY SILVER PANTS L 28;1;56800;0;56800;51819;4981;
2021-05-22 20:36:07;8998866200646;KOPI TOP MURNI;1;11000;0;11000;9600;1400;
2021-05-22 21:02:01;8998866202732;MILKU STROBERI 200ML;1;3000;0;3000;2375;625;
2021-05-22 21:13:01;BB;PASEO SMARTY FACIAL TRAVEL PACK 50S GT;1;3000;0;3000;1980;1020;
2021-05-22 22:07:05;8998866202244;EKOMIE BUMBU KALDU AYAM;5;1000;0;5000;3990;1010;
2021-05-22 22:07:05;089686021219;INTER MIE GORENG;1;1000;0;1000;885;115;
2021-05-22 22:12:59;8999909096004;SAMPOERNA 16 FILTER;1;24000;0;24000;23000;1000;
2021-05-22 22:13:19;GL;GULA 1 LITER;1;11500;0;11500;10500;1000;
2021-05-22 22:21:10;COKLAT;COKLAT COIN;10;500;0;5000;4000;1000;
2021-05-22 22:23:40;6907992823867;JD CRUNCHY CHOCOLATE MALT;1;5500;0;5500;4700;800;
2021-05-22 22:29:09;8992761136161;COCACOLA 1L;1;10000;0;10000;9000;1000;
2021-05-22 22:29:09;8992761136178;SPRITE 1L;1;10000;0;10000;9000;1000;
2021-05-22 22:40:45;089686011036;INDOMIE GORENG PEDAS;1;2700;0;2700;2452;248;
2021-05-22 22:49:26;8993379200855;SABUN HARMONY STRAWBERRY 70G;2;2000;0;4000;3304;696;
2021-05-22 22:49:26;8993379152017;SABUN CUCI SURYA 200G;1;3000;0;3000;2281;719;
2021-05-22 22:49:26;8999999035532;VASELINE NIGHT REPAIR 200ML;1;33800;0;33800;30855;2945;
2021-05-22 22:49:26;8991001111883;SILVERQUEEN CHUNKYBAR 33G;1;8000;0;8000;7150;850;
2021-05-22 22:49:26;8996001600146;TEH PUCUK HARUM 350ML;1;3000;0;3000;2314;686;
2021-05-22 22:49:26;8992761139018;ADES 600ML;1;3500;0;3500;2292;1208;
2021-05-22 22:49:26;8998009020186;BUAVITA GUAVA 250ML;1;7000;0;7000;6083;917;
2021-05-22 22:49:26;8992775110157;GARUDA KACANG KULIT;1;5000;0;5000;3925;1075;
2021-05-23 11:54:40;8996001600269;LE MINERAL 600ML;1;3000;0;3000;1688;1312;
2021-05-23 14:09:29;6907992823843;JD MOCHA CRISPY;1;5000;0;5000;4400;600;
2021-05-23 14:09:29;6907992823867;JD CRUNCHY CHOCOLATE MALT;1;5500;0;5500;4700;800;
2021-05-23 14:10:49;8991111101316;JB OIL 50ML;1;9500;0;9500;8700;800;
2021-05-23 14:38:02;6907992823850;JD CHOCO CIRLE;1;5500;0;5500;4700;800;
2021-05-23 14:38:02;6907992823591;JD STRAW MILKSHAKE;1;5000;0;5000;4300;700;
2021-05-23 14:38:35;8992761145019;COCA COLA PET 250ML;1;3500;0;3500;2417;1083;
2021-05-23 14:38:35;8992761164546;NUTRIBOOST STRAWBERRY 300ML;1;6500;0;6500;5300;1200;
2021-05-23 14:40:38;8886020033431;KAPUR AJAIB ANTI KECOA DAN NYAMUK;1;3000;0;3000;2700;300;
2021-05-23 15:15:24;6907992823669;JD MILKY STRAW;1;3000;0;3000;2600;400;
2021-05-23 15:15:24;6907992824963;JD MILKY CHOCOLATE;1;3000;0;3000;2600;400;
2021-05-23 15:15:24;COKLAT;COKLAT COIN;2;500;0;1000;800;200;
2021-05-23 15:58:43;8992761164539;NUTRIBOOST ORANGE 300ML;1;6500;0;6500;5300;1200;
2021-05-23 15:58:43;8992761002022;SPRITE PET 390ML;1;5500;0;5500;4300;1200;
2021-05-23 15:58:43;8992761166205;FRESTEA GREEN HONEY 350ML;1;4500;0;4500;3000;1500;
2021-05-23 16:03:36;8992761139018;ADES 600ML;1;3500;0;3500;2292;1208;
2021-05-23 16:03:36;8886013257400;TWISTKO;1;1000;0;1000;900;100;
2021-05-23 16:03:36;YP;YUPI;2;250;0;500;416;84;
2021-05-23 18:39:25;089686044249;SUPERMI NUTRIMI STEAK AYAM;1;3500;0;3500;2800;700;
2021-05-23 18:41:57;8992696419742;NESCAFE COFFE CREAM;1;5000;0;5000;4099;901;
2021-05-23 19:22:09;8992959953044;SWEETY BRONZE XL1;2;2500;0;5000;4500;500;
2021-05-23 19:24:03;089686044249;SUPERMI NUTRIMI STEAK AYAM;1;3500;0;3500;2800;700;
2021-05-23 19:24:03;8999999016128;RINSO MOLTO ROSE FRESH 750ML;1;15000;0;15000;12507;2493;
2021-05-23 19:24:03;8993560026011;DETTOL FRESH;1;20000;0;20000;18524;1476;
2021-05-23 19:24:03;8999999059781;SUNLIGHT LIME NEW POUCH 210ML;1;5000;0;5000;4300;700;
2021-05-23 19:24:03;8999999557447;PEPSODENT ACTION123 SIWAK 110G;1;9000;0;9000;8000;1000;
2021-05-23 19:24:03;8998866106351;ZINC MEN ACTIVE COOL 70ML;1;8500;0;8500;7550;950;
2021-05-23 19:24:03;8999999519735;PEPSODENT TB BAMBOO SALT;1;13200;0;13200;11990;1210;
2021-05-23 19:24:03;8992946512223;SHINZUI;1;4000;0;4000;2500;1500;
2021-05-23 19:24:03;8992222054973;GATSBY STYLING POMADE 30GR;1;15000;0;15000;13000;2000;
2021-05-23 20:02:26;8994834006128;TICTIC PEDAS;1;2000;0;2000;1700;300;
2021-05-23 20:02:26;8997231980022;O'JELLY MINI STRAWBERRY;1;3000;0;3000;2250;750;
2021-05-23 20:02:26;PRG;PARAGO;2;500;0;1000;800;200;
2021-05-23 20:02:26;8993470411433;JOGER CLASSIC;1;1000;0;1000;850;150;
2021-05-23 20:02:26;YP;YUPI;2;250;0;500;416;84;
2021-05-23 20:02:26;JGR SHN;JOGER SHINY SACHET;1;500;0;500;437;63;
2021-05-23 20:02:26;HT;HOT-HOT;1;500;0;500;350;150;
2021-05-23 20:02:26;COKLAT;COKLAT COIN;1;500;0;500;400;100;
2021-05-23 21:05:18;8991102381024;FULLO VNL PCK;1;10000;0;10000;9000;1000;
2021-05-23 21:06:13;8992696404441;BEAR BRAND 189ML;2;9000;0;18000;15774;2226;
2021-05-23 21:12:51;089686043051;INDOMIE COTO MAKASSAR;1;2800;0;2800;2525;275;
2021-05-23 21:12:51;089686043273;INDOMIE SAMBAL RICA;1;2700;0;2700;2452;248;
2021-05-23 21:12:51;8998989300261;GUDANG GARAM SURYA 12 FILTER;1;18500;0;18500;17200;1300;
2021-05-23 21:12:51;8993176110081;MINYAK KAYU PUTIH 30ML;1;12000;0;12000;9091;2909;
2021-05-23 21:36:05;711844150027;ABC NANAS;1;13000;0;13000;12241;759;
2021-05-23 21:40:37;8996001600375;LE MINERAL 330ML;1;2000;0;2000;1417;583;
2021-05-23 22:30:16;8992761164546;NUTRIBOOST STRAWBERRY 300ML;2;6500;0;13000;10600;2400;
2021-05-23 22:30:16;8992761166205;FRESTEA GREEN HONEY 350ML;1;4500;0;4500;3000;1500;
2021-05-23 22:30:16;8991102300421;WFR TANGO COKLAT 176GR;1;10000;0;10000;8694;1306;
2021-05-23 22:30:16;8850507000094;POLICE BONCHA;2;2000;0;4000;1600;2400;
2021-05-24 13:18:22;8994867007161;ROKOK PENA GOLD 20;1;17000;0;17000;15000;2000;
2021-05-24 13:44:24;8998866501033;MINYAK GORENG SEDAAP POUCH 2L;6;28000;0;168000;166476;1524;
2021-05-24 14:54:28;089686010343;INDOMIE SOTO MIE;1;2600;0;2600;2367;233;
2021-05-24 14:54:28;089686010824;INDOMIE GORENG SPESIAL;2;2700;0;5400;4904;496;
2021-05-24 15:00:14;8998866201377;KRISBEE FRIES KENTANG GORENG 68 GR;1;5500;0;5500;4620;880;
2021-05-24 15:00:14;8998989500166;GUDANG GARAM MERAH BESAR 16KS;1;18000;0;18000;17000;1000;
2021-05-24 15:14:12;8998866200851;NOODLE SEDAAP MIE BAKSO SPESIAL CUP 77 GR;2;4500;0;9000;7300;1700;
2021-05-24 15:14:12;8998866202671;NOODLE SEDAAP MIE KOREAN SPICY SOUP CUP;1;5000;0;5000;4002;998;
2021-05-24 15:14:12;8998866202404;NOODLE SEDAAP MIE KOREAN SPICY CHICKEN CUP;1;5000;0;5000;4002;998;
2021-05-24 15:16:43;8999999528850;CITRA NAT GLOW WHITE 60ML;1;6200;0;6200;5625;575;
2021-05-24 15:16:43;8998866105484;EMERON LOVELY MOISTURE&BRIGHT;1;4300;0;4300;3800;500;
2021-05-24 15:16:43;VTM;VITAMIN;1;500;0;500;425;75;
2021-05-24 15:22:25;YP;YUPI;8;250;0;2000;1664;336;
2021-05-24 15:22:45;YP;YUPI;16;250;0;4000;3328;672;
2021-05-24 15:22:45;PRG;PARAGO;2;500;0;1000;800;200;
2021-05-24 15:47:00;VCL;VITAMIN C500 LEMON;1;1000;0;1000;575;425;
2021-05-24 15:47:00;VCO;VITAMIN C500 ORANGE;1;1000;0;1000;575;425;
2021-05-24 16:14:16;8999999534097;PEPSODENT PGB FCM 75G;1;5000;0;5000;3850;1150;
2021-05-24 16:44:47;089686010343;INDOMIE SOTO MIE;2;2600;0;5200;4734;466;
2021-05-24 16:44:47;8996001410042GT;TB TORA MOKA;1;13000;0;13000;8700;4300;
2021-05-24 16:46:49;8998866200561;EKOMIE SUPER 600GR;1;10000;0;10000;8615;1385;
2021-05-24 16:46:49;8997011700123;BIHUN JAGUNG 300GR;1;6000;0;6000;4979;1021;
2021-05-24 16:46:49;8999999533731;CITRA TS NATURE WHITE 70G;2;2200;0;4400;3800;600;
2021-05-24 16:46:49;8992979190986;TOTAL PUTIH SOFTENER;1;13000;0;13000;11532;1468;
2021-05-24 17:11:01;8994834006128;TICTIC PEDAS;1;2000;0;2000;1700;300;
2021-05-24 17:11:01;8998866202725;MILKU COKLAT PREMIUM 200ML;1;3000;0;3000;2375;625;
2021-05-24 17:32:39;8998989300261;GUDANG GARAM SURYA 12 FILTER;1;18500;0;18500;17200;1300;
2021-05-24 17:32:39;VTM;VITAMIN;1;500;0;500;425;75;
2021-05-24 17:48:02;8998866202732;MILKU STROBERI 200ML;1;3000;0;3000;2375;625;
2021-05-24 17:48:57;8992628020152;BIMOLI POUCH 2L;1;31000;0;31000;29800;1200;
2021-05-24 17:55:16;8996001600399;LE MINERAL 1500ML;1;5000;0;5000;4042;958;
2021-05-24 17:55:16;001;PASEO SMART FACIAL SF 250S GT;1;10000;0;10000;9500;500;
2021-05-24 17:55:16;8998009020186;BUAVITA GUAVA 250ML;2;7000;0;14000;12166;1834;
2021-05-24 17:55:16;8991102989428SCT;TANGO CKLT 24G SCT;1;1000;0;1000;609;391;
2021-05-24 18:23:56;8994834006128;TICTIC PEDAS;1;2000;0;2000;1700;300;
2021-05-24 18:23:56;8886013257400;TWISTKO;2;1000;0;2000;1800;200;
2021-05-24 18:23:56;8994834005923;SPIX 1000;1;1000;0;1000;850;150;
2021-05-24 18:38:23;TG;TEH GELAS;1;1000;0;1000;729;271;
2021-05-24 18:38:23;8992696404441;BEAR BRAND 189ML;1;9000;0;9000;7887;1113;
2021-05-24 18:50:45;8997231980022;O'JELLY MINI STRAWBERRY;1;3000;0;3000;2250;750;
2021-05-24 18:50:45;8997231980015;O'JELLY MINI APPLE;1;3000;0;3000;2250;750;
2021-05-24 18:59:59;GL;GULA 1 LITER;4;11500;0;46000;42000;4000;
2021-05-24 19:12:46;8886013213208;FRENCH FREIS 2000;3;5000;0;15000;11250;3750;
2021-05-24 19:18:33;8992725910417;LISTERINE FRESH BURST 100ML;1;7500;0;7500;6800;700;
2021-05-24 19:18:33;VCO;VITAMIN C500 ORANGE;1;1000;0;1000;575;425;
2021-05-24 19:34:48;711844610095;LARISSA UDANG 500 GR;3;11000;0;33000;29370;3630;
2021-05-24 19:52:47;8997231980022;O'JELLY MINI STRAWBERRY;1;3000;0;3000;2250;750;
2021-05-24 19:52:47;MOBIL;GULA GULA HP;1;2000;0;2000;1700;300;
2021-05-24 19:53:39;8993072153595;LARISST COTTON 35G;1;5000;0;5000;3300;1700;
2021-05-24 20:00:48;8995333060703;TERIGU KOMPAS 1KG;2;10500;0;21000;19632;1368;
2021-05-24 20:00:48;8998866201865;KRISBEE PILLOW CHOCOLAVA 120 GR;1;8000;0;8000;7250;750;
2021-05-24 20:00:48;8998866600521;SOKLIN FLOORCLENER KUNING 400ML;1;6000;0;6000;5025;975;
2021-05-24 20:00:48;8997226412019;EMINA CHEESE 165G;1;17000;0;17000;15000;2000;
2021-05-24 20:15:59;8998866202725;MILKU COKLAT PREMIUM 200ML;1;3000;0;3000;2375;625;
2021-05-24 20:15:59;8994834006128;TICTIC PEDAS;1;2000;0;2000;1700;300;
2021-05-24 21:05:18;ARG;ARGUS 220ML;2;14500;0;29000;25000;4000;
2021-05-24 21:06:03;VCO;VITAMIN C500 ORANGE;1;1000;0;1000;575;425;
2021-05-24 21:32:32;8992959072202;HN PANTS L 20;1;35000;0;35000;32576;2424;
2021-05-24 21:52:09;8998989300261;GUDANG GARAM SURYA 12 FILTER;1;18500;0;18500;17200;1300;
2021-05-24 21:52:42;PRG;PARAGO;2;500;0;1000;800;200;
2021-05-24 21:52:42;COKLAT;COKLAT COIN;1;500;0;500;400;100;
2021-05-24 21:52:42;YP;YUPI;2;250;0;500;416;84;
2021-05-24 22:06:33;ff;FULLO BLASTO;1;1000;0;1000;995;5;
2021-05-24 22:24:18;8992775110157;GARUDA KACANG KULIT;1;5000;0;5000;3925;1075;
2021-05-24 22:24:18;8992775211410;PILUS GARUDA PEDAS;1;5000;0;5000;4886;114;
2021-05-25 12:25:42;8997027490018;LADAMAS MERICA BUBUK;1;9500;0;9500;8898;602;
2021-05-25 12:25:42;8992753102204;BKM COKLAT 370G;1;11300;0;11300;9500;1800;
2021-05-25 12:25:42;BK;BUMBU KACANG;1;5000;0;5000;5000;0;
2021-05-25 12:25:42;8992959117569;SFX DS REG FLOW NW 8;1;4000;0;4000;3530;470;
2021-05-25 12:25:42;8992959117583;SFX DS REG FLOW WING 20;1;5000;0;5000;4288;712;
2021-05-25 12:25:42;8991102380805;FULLO  CKL PCK 8G;1;10000;0;10000;9000;1000;
2021-05-25 12:25:42;8999908204202;MY BABY MINYAK TELON 60ML;1;18000;0;18000;16900;1100;
2021-05-25 12:25:42;8997231980022;O'JELLY MINI STRAWBERRY;1;3000;0;3000;2250;750;
2021-05-25 12:25:42;8999999524722;SUNLIGHT LIME NEW PCH 435ML;1;10000;0;10000;9100;900;
2021-05-25 12:25:42;8998866202060;POTABEE AYAM BAKAR PEDAS 35 GR;2;5000;0;10000;8300;1700;
2021-05-25 12:25:42;8992959509005;SWEETY SILVER PANTS XL26;1;61500;0;61500;55910;5590;
2021-05-25 12:25:42;8992959953198;SWEETY BRONZE  XL2 6+2;1;60000;0;60000;54091;5909;
2021-05-25 12:52:40;8998989500166;GUDANG GARAM MERAH BESAR 16KS;1;18000;0;18000;17000;1000;
2021-05-25 12:52:40;bb;BENG-BENG;1;1500;0;1500;1450;50;
2021-05-25 12:52:40;BTS;BIMURA TARO SEAWEED 250G;1;10000;0;10000;9300;700;
2021-05-25 12:52:40;8992761002039;FANTA STRAWBERRY PET 390 ML;1;5500;0;5500;4300;1200;
2021-05-25 13:31:52;bb;BENG-BENG;2;1500;0;3000;2900;100;
2021-05-25 13:58:57;8992933241112;NUTRIJELL COKLAT;2;7000;0;14000;12832;1168;
2021-05-25 13:58:57;8999801700030;SUSU FOYU;1;11500;0;11500;10450;1050;
2021-05-25 13:58:57;8991188943536;SASA SANTAN KELAPA 65ML;2;3000;0;6000;4874;1126;
2021-05-25 13:58:57;8997018720018;SIRUP DHT;1;23000;0;23000;20958;2042;
2021-05-25 13:58:57;8997028900837;SABUN PAPAYA;1;10000;0;10000;9375;625;
2021-05-25 13:58:57;8993379200855;SABUN HARMONY STRAWBERRY 70G;1;2000;0;2000;1652;348;
2021-05-25 14:44:47;8998989300261;GUDANG GARAM SURYA 12 FILTER;1;18500;0;18500;17200;1300;
2021-05-25 14:56:43;GL;GULA 1 LITER;2;11500;0;23000;21000;2000;
2021-05-25 14:56:43;8998989300261;GUDANG GARAM SURYA 12 FILTER;3;18500;0;55500;51600;3900;
2021-05-25 14:56:43;8991102303309;WFR TANGO SBJ 176G;2;10000;0;20000;17388;2612;
2021-05-25 14:56:43;8993470279651;JOGER CHOCKY BAR;2;1000;0;2000;1734;266;
2021-05-25 14:56:43;8998009020186;BUAVITA GUAVA 250ML;1;7000;0;7000;6083;917;
2021-05-25 14:56:43;8993470671752;JOGER STICK DUO KACANG;1;1000;0;1000;850;150;
2021-05-25 14:56:43;8993571004732;SALAS SALEP CAP19 6G;1;7000;0;7000;6000;1000;
2021-05-25 14:56:43;8992761002022;SPRITE PET 390ML;1;5500;0;5500;4300;1200;
2021-05-25 14:56:43;8999909096004;SAMPOERNA 16 FILTER;1;24000;0;24000;23000;1000;
2021-05-25 14:56:43;8998898810721;KKB ENER-G C1000;1;8000;0;8000;6690;1310;
2021-05-25 14:56:43;JGR SHN;JOGER SHINY SACHET;4;500;0;2000;1748;252;
2021-05-25 14:56:43;8886013257400;TWISTKO;1;1000;0;1000;900;100;
2021-05-25 14:56:43;8999999195656;SARI WANGI 50X1.85;1;10000;0;10000;9500;500;
2021-05-25 14:56:43;8998989500128;GUDANG GARAM MERAH KECIL 12KS;1;14000;0;14000;13000;1000;
2021-05-25 14:56:43;8994935000285;MINYAK GORENG DUNIA 4500ML;2;70000;0;140000;132866;7134;
2021-05-25 14:56:43;8998866200646;KOPI TOP MURNI;1;11000;0;11000;9600;1400;
2021-05-25 14:56:43;8992222052979;GATSBY WATER GLOSS MERAH;1;5000;0;5000;3700;1300;
2021-05-25 14:56:43;8998866501033;MINYAK GORENG SEDAAP POUCH 2L;1;28000;0;28000;27746;254;
2021-05-25 14:56:43;8992959953181;SWEETY BRONZE L30+2;1;55000;0;55000;53410;1590;
2021-05-25 14:56:43;8992761164539;NUTRIBOOST ORANGE 300ML;1;6500;0;6500;5300;1200;
2021-05-25 14:56:43;6907992823843;JD MOCHA CRISPY;1;5000;0;5000;4400;600;
2021-05-25 14:58:38;8993989311699;CLAS MILD 16 FILTER;1;23000;0;23000;21700;1300;
2021-05-25 16:06:18;8992761166212;FRESTEA APPLE 350ML;1;4500;0;4500;3000;1500;
2021-05-25 16:06:18;089686611519;QTELA SINGKONG;1;5000;0;5000;4266;734;
2021-05-25 16:06:18;HT;HOT-HOT;1;500;0;500;350;150;
2021-05-25 16:32:48;8997231980015;O'JELLY MINI APPLE;1;3000;0;3000;2250;750;
2021-05-25 16:32:48;8886013257400;TWISTKO;1;1000;0;1000;900;100;
2021-05-25 16:32:48;8998866202732;MILKU STROBERI 200ML;1;3000;0;3000;2375;625;
2021-05-25 16:45:57;001;PASEO SMART FACIAL SF 250S GT;1;10000;0;10000;9500;500;
2021-05-25 16:47:11;089686611878;QTELA TEMPE;1;6000;0;6000;5370;630;
2021-05-25 16:47:11;8998866600521;SOKLIN FLOORCLENER KUNING 400ML;1;6000;0;6000;5025;975;
2021-05-25 16:47:25;TG;TEH GELAS;1;1000;0;1000;729;271;
2021-05-25 17:07:27;8991111109107;JB POWDER BEDTIME 75+25g;1;6000;0;6000;5440;560;
2021-05-25 17:07:27;BB;PASEO SMARTY FACIAL TRAVEL PACK 50S GT;1;3000;0;3000;1980;1020;
2021-05-25 17:35:30;089686611519;QTELA SINGKONG;1;5000;0;5000;4266;734;
2021-05-25 17:48:59;8993053641042;PASEO BABY WIPES GAZETTE 50S;1;17000;0;17000;15400;1600;
2021-05-25 17:48:59;001;PASEO SMART FACIAL SF 250S GT;1;10000;0;10000;9500;500;
2021-05-25 17:49:47;8993053641042;PASEO BABY WIPES GAZETTE 50S;1;17000;0;17000;15400;1600;
2021-05-25 18:35:17;8997231980022;O'JELLY MINI STRAWBERRY;1;3000;0;3000;2250;750;
2021-05-25 18:35:17;8997231980015;O'JELLY MINI APPLE;1;3000;0;3000;2250;750;
2021-05-25 18:35:17;8998866202770;MIE SEDAAP SALERO PADANG;1;2500;0;2500;2362;138;
2021-05-25 18:41:42;8998866201827;JAVANA GULA BATU 350ML;1;3000;0;3000;2150;850;
2021-05-25 18:51:42;8997231980015;O'JELLY MINI APPLE;1;3000;0;3000;2250;750;
2021-05-25 19:42:45;8999999534097;PEPSODENT PGB FCM 75G;1;5000;0;5000;3850;1150;
2021-05-25 19:42:45;8998866608305;GIV BENGKOANG KOTAK 76G;1;2000;0;2000;1820;180;
2021-05-25 19:42:45;8998866888615;GIV BIRU KOTAK 76G;1;2000;0;2000;1820;180;
2021-05-25 19:42:45;8998866602389;GIV UNGU KOTAK 76G;1;2000;0;2000;1820;180;
2021-05-25 19:42:45;8998866888639;GIV HIJAU KOTAK 76G;1;2000;0;2000;1820;180;
2021-05-25 19:42:45;8998866609142;GIV MULBERRY SILK KOTAK 76G;1;2000;0;2000;1820;180;
2021-05-25 19:42:45;8991111152073;LISTERINE GREEN TEA 100ML;1;8000;0;8000;7600;400;
2021-05-25 19:46:15;8997231980015;O'JELLY MINI APPLE;1;3000;0;3000;2250;750;
2021-05-25 19:46:15;PRG;PARAGO;4;500;0;2000;1600;400;
2021-05-25 19:56:43;6907992823843;JD MOCHA CRISPY;1;5000;0;5000;4400;600;
2021-05-25 19:56:43;8996001600146;TEH PUCUK HARUM 350ML;1;3000;0;3000;2314;686;
2021-05-25 20:31:23;8999909002821;MALBORO BLACK 16;1;22000;0;22000;20850;1150;
2021-05-25 20:45:19;8998866601429;POWDET DAIA BUNGA BAG 290GR;2;5000;0;10000;8900;1100;
2021-05-25 20:45:19;8997231980015;O'JELLY MINI APPLE;2;3000;0;6000;4500;1500;
2021-05-25 20:45:19;YP;YUPI;4;250;0;1000;832;168;
2021-05-25 20:53:54;8998989500166;GUDANG GARAM MERAH BESAR 16KS;2;18000;0;36000;34000;2000;
2021-05-25 20:55:08;COKLAT;COKLAT COIN;2;500;0;1000;800;200;
2021-05-25 20:55:08;PRG;PARAGO;2;500;0;1000;800;200;
2021-05-25 21:02:41;089686021219;INTER MIE GORENG;2;1000;0;2000;1770;230;
2021-05-25 21:02:41;8998866200301;MIE SEDAAP GORENG;1;2500;0;2500;2023;477;
2021-05-25 21:02:41;8996001301142;ROMA KELAPA;1;8000;0;8000;6628;1372;
2021-05-25 21:02:41;089686043204;INDOMIE MIE ACEH;2;2700;0;5400;4904;496;
2021-05-25 21:02:41;8996001318911;BETTER ISI 4;1;18000;0;18000;17000;1000;
2021-05-25 21:03:51;ARG;ARGUS 220ML;6;14500;0;87000;75000;12000;
2021-05-25 21:07:11;8998989300261;GUDANG GARAM SURYA 12 FILTER;1;18500;0;18500;17200;1300;
2021-05-25 21:07:11;VCO;VITAMIN C500 ORANGE;1;1000;0;1000;575;425;
2021-05-25 21:09:41;8993989311279;CLAS MILD 12;1;17000;0;17000;15700;1300;
2021-05-25 21:09:41;VCO;VITAMIN C500 ORANGE;1;1000;0;1000;575;425;
2021-05-25 21:50:44;089686010107;INDOMIE KALDU AYAM;4;2500;0;10000;8600;1400;
2021-05-25 22:06:52;8992870311091;SALONPAS;1;6000;0;6000;4806;1194;
2021-05-25 22:06:52;8997025914042;ATB MARIE SUSU 185G;1;7000;0;7000;4554;2446;
2021-05-25 22:06:52;6907992825076;JD WATERMELON APPLE;1;2000;0;2000;1700;300;
2021-05-25 22:06:52;8992696404441;BEAR BRAND 189ML;1;9000;0;9000;7887;1113;
2021-05-25 22:06:52;8997009510055;YOU C1000;1;10000;0;10000;9166;834;
2021-05-25 22:06:52;089686611878;QTELA TEMPE;1;6000;0;6000;5370;630;
2021-05-26 12:09:19;6907992823935;JD SWEETCORN;1;3500;0;3500;3000;500;
2021-05-26 12:09:19;8997231980015;O'JELLY MINI APPLE;1;3000;0;3000;2250;750;
2021-05-26 12:13:07;8998866608718;DAIA SOFTENER PINK;1;5000;0;5000;4450;550;
2021-05-26 12:13:07;MLTO PINK;MOLTO ALL IN ONE;1;1000;0;1000;800;200;
2021-05-26 12:13:07;8997231980022;O'JELLY MINI STRAWBERRY;2;3000;0;6000;4500;1500;
2021-05-26 12:13:07;8998989300261;GUDANG GARAM SURYA 12 FILTER;1;18500;0;18500;17200;1300;
2021-05-26 12:13:07;8993470671752;JOGER STICK DUO KACANG;1;1000;0;1000;850;150;
2021-05-26 12:13:07;8999999502003;SARIMURNI RL RB 1,8G;1;1500;0;1500;1207;293;
2021-05-26 12:13:07;8991102303309;WFR TANGO SBJ 176G;1;10000;0;10000;8694;1306;
2021-05-26 12:13:07;8996001305041;ROMA SANDWICH CKLT;1;7000;0;7000;5000;2000;
2021-05-26 12:13:07;8991004011906;KOPI BORONG;1;10000;0;10000;8333;1667;
2021-05-26 12:13:07;ARG;ARGUS 220ML;1;14500;0;14500;12500;2000;
2021-05-26 12:13:07;089686611519;QTELA SINGKONG;1;5000;0;5000;4266;734;
2021-05-26 12:14:53;8999999514518;RINSO MOLTO PERF ESSENCE 215ML;1;5000;0;5000;4250;750;
2021-05-26 12:40:20;8998866200301;MIE SEDAAP GORENG;1;2500;0;2500;2023;477;
2021-05-26 12:40:20;089686043204;INDOMIE MIE ACEH;1;2700;0;2700;2452;248;
2021-05-26 12:40:20;089686011036;INDOMIE GORENG PEDAS;1;2700;0;2700;2452;248;
2021-05-26 12:40:20;HT;HOT-HOT;4;500;0;2000;1400;600;
2021-05-26 12:53:10;KURMA;KURMA;1;60000;0;60000;55000;5000;
2021-05-26 12:53:10;8998989110167;SURYA GUDANG GARAM 16 FILTER;1;25000;0;25000;23200;1800;
2021-05-26 12:54:16;COKLAT;COKLAT COIN;8;500;0;4000;3200;800;
2021-05-26 12:54:16;8997231980022;O'JELLY MINI STRAWBERRY;1;3000;0;3000;2250;750;
2021-05-26 12:54:16;8997231980015;O'JELLY MINI APPLE;1;3000;0;3000;2250;750;
2021-05-26 13:00:47;8997231980022;O'JELLY MINI STRAWBERRY;1;3000;0;3000;2250;750;
2021-05-26 13:24:21;8991001111883;SILVERQUEEN CHUNKYBAR 33G;1;8000;0;8000;7150;850;
2021-05-26 13:24:21;HT;HOT-HOT;4;500;0;2000;1400;600;
2021-05-26 13:36:52;8994935000285;MINYAK GORENG DUNIA 4500ML;1;70000;0;70000;66433;3567;
2021-05-26 13:36:52;8992696404441;BEAR BRAND 189ML;1;9000;0;9000;7887;1113;
2021-05-26 14:36:14;8992959107515;SFX NON WING 23CM 8;1;4000;0;4000;3288;712;
2021-05-26 14:36:14;VCL;VITAMIN C500 LEMON;1;1000;0;1000;575;425;
2021-05-26 15:06:22;8992759120264;LARISST 220;1;10000;0;10000;9200;800;
2021-05-26 15:06:22;8996001600269;LE MINERAL 600ML;1;3000;0;3000;1688;1312;
2021-05-26 15:06:22;6907992823829;JD MILKY MILK;1;3000;0;3000;2600;400;
2021-05-26 15:06:22;COKLAT;COKLAT COIN;2;500;0;1000;800;200;
2021-05-26 17:18:16;8992761164546;NUTRIBOOST STRAWBERRY 300ML;1;6500;0;6500;5300;1200;
2021-05-26 17:18:16;089686611519;QTELA SINGKONG;1;5000;0;5000;4266;734;
2021-05-26 17:18:16;8998866201452;POTABEE REGULER BBQ BEEF 35GR;1;5000;0;5000;4150;850;
2021-05-26 17:18:16;HT;HOT-HOT;1;500;0;500;350;150;
2021-05-26 17:28:21;8992959974018;SFX SIRIH 36CM 12+1;1;17000;0;17000;15958;1042;
2021-05-26 17:28:21;8991102387286SCT;TANGO LONG CKLT 47G;1;2000;0;2000;1551;449;
2021-05-26 17:28:21;8991102989428SCT;TANGO CKLT 24G SCT;1;1000;0;1000;609;391;
2021-05-26 17:29:05;8999999037765;PEPSODENT WHITE 225G;1;12000;0;12000;10750;1250;
2021-05-26 17:31:04;8994834006128;TICTIC PEDAS;1;2000;0;2000;1700;300;
2021-05-26 17:31:04;ff;FULLO BLASTO;2;1000;0;2000;1990;10;
2021-05-26 17:31:04;8993470671752;JOGER STICK DUO KACANG;1;1000;0;1000;850;150;
2021-05-26 17:47:09;8999999195656;SARI WANGI 50X1.85;1;10000;0;10000;9500;500;
2021-05-26 18:24:30;089686611878;QTELA TEMPE;1;6000;0;6000;5370;630;
2021-05-26 18:24:30;8993470279651;JOGER CHOCKY BAR;1;1000;0;1000;867;133;
2021-05-26 18:24:30;001;PASEO SMART FACIAL SF 250S GT;1;10000;0;10000;9500;500;
2021-05-26 18:33:23;PTK;MINI NAIL CLIPPER BESAR THREE SEVEN;1;7000;0;7000;6000;1000;
2021-05-26 18:33:23;8997025911058;HATARI SHP KELAPA;1;6000;0;6000;4911;1089;
2021-05-26 18:53:27;COKLAT;COKLAT COIN;1;500;0;500;400;100;
2021-05-26 18:53:27;HT;HOT-HOT;1;500;0;500;350;150;
2021-05-26 18:53:27;PRG;PARAGO;2;500;0;1000;800;200;
2021-05-26 21:00:07;8998866202770;MIE SEDAAP SALERO PADANG;1;2500;0;2500;2362;138;
2021-05-26 21:00:07;8999999559540;LIFEBUOY BW LEMONFRESH 90ML;2;5000;0;10000;8000;2000;
2021-05-26 22:19:58;8998989110167;SURYA GUDANG GARAM 16 FILTER;1;25000;0;25000;23200;1800;
2021-05-26 22:19:58;6907992825076;JD WATERMELON APPLE;1;2000;0;2000;1700;300;
2021-05-26 22:19:58;8999908389008;HEMAVITON C1000;1;8000;0;8000;6000;2000;
2021-05-26 22:19:58;YP;YUPI;8;250;0;2000;1664;336;
2021-05-26 22:19:58;TL;TELUR;10;1500;0;15000;13000;2000;
2021-05-26 22:20:38;8997231980022;O'JELLY MINI STRAWBERRY;1;3000;0;3000;2250;750;
2021-05-26 22:20:38;8994834005923;SPIX 1000;1;1000;0;1000;850;150;
2021-05-27 13:41:09;8999909002821;MARLBORO BLACK 16;1;22000;0;22000;20850;1150;
2021-05-27 14:07:22;8999909096004;SAMPOERNA 16 FILTER;1;24000;0;24000;23000;1000;
2021-05-27 14:07:22;8998989110167;SURYA GUDANG GARAM 16 FILTER;1;25000;0;25000;23200;1800;
2021-05-27 14:38:48;8998866501033;MINYAK GORENG SEDAAP POUCH 2L;1;28000;0;28000;27746;254;
2021-05-27 15:00:23;8992959953129;SWEETY BRONZE M20;1;35000;0;35000;33020;1980;
2021-05-27 15:00:23;8993053641042;PASEO BABY WIPES GAZETTE 50S;1;17000;0;17000;15400;1600;
2021-05-27 15:00:23;BB;PASEO SMARTY FACIAL TRAVEL PACK 50S GT;1;3000;0;3000;1980;1020;
2021-05-27 15:00:23;001;PASEO SMART FACIAL SF 250S GT;1;10000;0;10000;9500;500;
2021-05-27 15:00:23;8999999706111;PEPSODENT WHITE 25G;1;2000;0;2000;1450;550;
2021-05-27 15:00:23;8999999031930;PEPSODENT TB TRIPLE CLEAN;1;3500;0;3500;2850;650;
2021-05-27 15:00:23;8999999036492;LUX BW PINK SOFT BTL 100ML;1;10000;0;10000;8690;1310;
2021-05-27 15:01:38;089686043051;INDOMIE COTO MAKASSAR;1;2800;0;2800;2525;275;
2021-05-27 15:01:38;089686043617;INDOMIE MIEGHRTTI;1;2700;0;2700;2452;248;
2021-05-27 15:46:20;8999999031930;PEPSODENT TB TRIPLE CLEAN;1;3500;0;3500;2850;650;
2021-05-27 15:46:20;76164217;MARLBORO MERAH;1;30000;0;30000;27700;2300;
2021-05-27 16:19:16;8992957220087;COKLAT SINGA;1;2000;0;2000;1700;300;
2021-05-27 16:24:22;8990800016757;BB TUTI FRUITTY COSMO;1;8500;0;8500;7600;900;
2021-05-27 16:24:22;8998009020186;BUAVITA GUAVA 250ML;1;7000;0;7000;6083;917;
2021-05-27 16:24:22;8992696523067;MILO ACTVGO UHT 180ML;2;4500;0;9000;7030;1970;
2021-05-27 16:24:22;8998009040023;TEH KOTAK;1;5000;0;5000;2827;2173;
2021-05-27 16:24:22;8992696523081;MILO UHT 110ML;1;2500;0;2500;1962;538;
2021-05-27 16:39:48;8991001111883;SILVERQUEEN CHUNKYBAR 33G;1;8000;0;8000;7150;850;
2021-05-27 16:39:48;8997231980022;O'JELLY MINI STRAWBERRY;2;3000;0;6000;4500;1500;
2021-05-27 16:39:48;8994834006128;TICTIC PEDAS;3;2000;0;6000;5100;900;
2021-05-27 16:39:48;8994834003752;TICTIC;1;2000;0;2000;1700;300;
2021-05-27 16:51:04;8998989500166;GUDANG GARAM MERAH BESAR 16KS;1;18000;0;18000;17000;1000;
2021-05-27 16:58:19;8999999059316;LIFEBUOY TS MILDCARE 75G;2;3000;0;6000;5280;720;
2021-05-27 16:58:19;8998989300261;GUDANG GARAM SURYA 12 FILTER;1;18500;0;18500;17200;1300;
2021-05-27 17:07:09;VCO;VITAMIN C500 ORANGE;1;1000;0;1000;575;425;
2021-05-27 17:27:27;8992775002155;CHOCOLATOS DRINK;1;4000;0;4000;3520;480;
2021-05-27 17:27:27;001;PASEO SMART FACIAL SF 250S GT;1;10000;0;10000;9500;500;
2021-05-27 17:27:27;8998866609487;SOKLIN SOFTERGEN 280G;1;5000;0;5000;4425;575;
2021-05-27 17:51:59;8998009020186;BUAVITA GUAVA 250ML;3;7000;0;21000;18249;2751;
2021-05-27 17:52:14;8991111102962;JB STARTERKIT BB GIFT SET;1;87000;0;87000;82880;4120;
2021-05-27 18:36:18;711844610095;LARISSA UDANG 500 GR;2;11000;0;22000;19580;2420;
2021-05-27 18:42:42;8997231980022;O'JELLY MINI STRAWBERRY;1;3000;0;3000;2250;750;
2021-05-27 18:42:42;COKLAT;COKLAT COIN;4;500;0;2000;1600;400;
2021-05-27 18:51:37;8993989311279;CLAS MILD 12;1;17000;0;17000;15700;1300;
2021-05-27 21:30:30;8997009510055;YOU C1000;1;10000;0;10000;9166;834;
2021-05-27 21:37:03;8992761002039;FANTA STRAWBERRY PET 390 ML;1;5500;0;5500;4300;1200;
2021-05-27 21:37:03;8992959953044;SWEETY BRONZE XL1;2;2500;0;5000;4500;500;
2021-05-27 21:37:03;bb;BENG-BENG;3;1500;0;4500;4350;150;
2021-05-27 22:23:57;ARG;ARGUS 220ML;6;14500;0;87000;75000;12000;
2021-05-27 22:23:57;8993058105013;EXTRA JOSS;1;12000;0;12000;9773;2227;
2021-05-28 09:14:02;RB;RED BOLD;1;19000;0;19000;17900;1100;
2021-05-28 09:14:02;8993989311699;CLAS MILD 16 FILTER;1;23000;0;23000;21700;1300;
2021-05-28 09:14:02;9556001025272;NESCAFE LATTE 240ML;1;8500;0;8500;7834;666;
2021-05-28 09:14:02;VCO;VITAMIN C500 ORANGE;2;1000;0;2000;1150;850;
2021-05-28 10:16:33;8992696407053;DNCO 3+ MADU 800G;1;84500;0;84500;82333;2167;
2021-05-28 11:10:55;8992761002022;SPRITE PET 390ML;1;5500;0;5500;4300;1200;
2021-05-28 11:11:53;8997231980022;O'JELLY MINI STRAWBERRY;1;3000;0;3000;2250;750;
2021-05-28 11:11:53;8997231980015;O'JELLY MINI APPLE;1;3000;0;3000;2250;750;
2021-05-28 11:11:53;PRG;PARAGO;2;500;0;1000;800;200;
2021-05-28 12:48:36;8992761166212;FRESTEA APPLE 350ML;2;4500;0;9000;6000;3000;
2021-05-28 12:48:36;8886013257400;TWISTKO;1;1000;0;1000;900;100;
2021-05-28 13:07:25;6907992823676;JD PEACH;2;2000;0;4000;3400;600;
2021-05-28 13:07:25;8997231980022;O'JELLY MINI STRAWBERRY;1;3000;0;3000;2250;750;
2021-05-28 13:09:42;8997231980022;O'JELLY MINI STRAWBERRY;1;3000;0;3000;2250;750;
2021-05-28 13:09:42;8997231980015;O'JELLY MINI APPLE;1;3000;0;3000;2250;750;
2021-05-28 13:09:42;PRG;PARAGO;2;500;0;1000;800;200;
2021-05-28 13:13:26;8997231980022;O'JELLY MINI STRAWBERRY;1;3000;0;3000;2250;750;
2021-05-28 13:13:26;ff;FULLO BLASTO;1;1000;0;1000;995;5;
2021-05-28 13:14:30;089686010107;INDOMIE KALDU AYAM;6;2500;0;15000;12900;2100;
2021-05-28 13:21:13;8998989500166;GUDANG GARAM MERAH BESAR 16KS;1;18000;0;18000;17000;1000;
2021-05-28 14:09:10;8993083929905;BISKITOP WAFER;1;30000;0;30000;27000;3000;
2021-05-28 14:09:10;8996001600641;TORA CAPPUCINO;1;3500;0;3500;2750;750;
2021-05-28 14:15:23;8992775110157;GARUDA KACANG KULIT;1;5000;0;5000;3925;1075;
2021-05-28 14:15:23;8994834003752;TICTIC;1;2000;0;2000;1700;300;
2021-05-28 14:15:23;8992761002022;SPRITE PET 390ML;1;5500;0;5500;4300;1200;
2021-05-28 14:15:23;6907992823676;JD PEACH;1;2000;0;2000;1700;300;
2021-05-28 14:15:23;8992761139018;ADES 600ML;1;3500;0;3500;2292;1208;
2021-05-28 14:58:41;8997231980022;O'JELLY MINI STRAWBERRY;1;3000;0;3000;2250;750;
2021-05-28 14:58:41;8997231980015;O'JELLY MINI APPLE;1;3000;0;3000;2250;750;
2021-05-28 15:38:02;8996001600399;LE MINERAL 1500ML;2;5000;0;10000;8084;1916;
2021-05-28 15:38:27;8997028590014;ARGUS 220ML;2;500;0;1000;604;396;
2021-05-28 16:39:47;VCL;VITAMIN C500 LEMON;1;1000;0;1000;575;425;
2021-05-28 16:39:47;089686043051;INDOMIE COTO MAKASSAR;1;2800;0;2800;2525;275;
2021-05-28 16:39:47;8991102989534;TANGO VANILA 24G;1;1000;0;1000;609;391;
2021-05-28 16:49:20;8999999195649;SARI WANGI 25X1.86G;1;6000;0;6000;5050;950;
2021-05-28 16:49:20;8999999059781;SUNLIGHT LIME NEW POUCH 210ML;1;5000;0;5000;4300;700;
2021-05-28 16:49:20;089686010107;INDOMIE KALDU AYAM;5;2500;0;12500;10750;1750;
2021-05-28 17:10:49;8998009020186;BUAVITA GUAVA 250ML;1;7000;0;7000;6083;917;
2021-05-28 17:18:46;8992775110157;GARUDA KACANG KULIT;1;5000;0;5000;3925;1075;
2021-05-28 17:18:46;8994834005923;SPIX 1000;1;1000;0;1000;850;150;
2021-05-28 18:36:52;8997028590014;ARGUS 220ML;4;500;0;2000;1208;792;
2021-05-28 18:36:52;VCO;VITAMIN C500 ORANGE;1;1000;0;1000;575;425;
2021-05-28 18:45:56;8998866200325;MIE SEDAAP SOTO;1;2500;0;2500;1952;548;
2021-05-28 18:45:56;8998866200578;MIE SEDAAP KARI KENTAL;1;2500;0;2500;2263;237;
2021-05-28 18:45:56;8998866202770;MIE SEDAAP SALERO PADANG;1;2500;0;2500;2362;138;
2021-05-28 18:45:56;001;PASEO SMART FACIAL SF 250S GT;1;10000;0;10000;9500;500;
2021-05-28 18:46:39;8998009010590;ULTRA CHO 125;3;3000;0;9000;7284;1716;
2021-05-28 18:46:39;8998009010569;ULTRA CHO 200;2;5000;0;10000;7660;2340;
2021-05-28 18:48:37;VTM;VITAMIN;1;500;0;500;425;75;
2021-05-28 19:07:23;8998009040023;TEH KOTAK;1;5000;0;5000;2827;2173;
2021-05-28 19:07:23;089686611519;QTELA SINGKONG;1;5000;0;5000;4266;734;
2021-05-28 19:07:23;8992775311325;GERY SNACK&SEREAL 100G;1;7000;0;7000;6012;988;
2021-05-28 19:08:18;VCO;VITAMIN C500 ORANGE;1;1000;0;1000;575;425;
2021-05-28 19:34:43;8999999031930;PEPSODENT TB TRIPLE CLEAN;1;3500;0;3500;2850;650;
2021-05-28 19:34:43;6901997923072;SILET SEAGULL;1;6000;0;6000;5500;500;
2021-05-28 19:34:43;8991111109114;JB BEDTIME 150+50G;1;10000;0;10000;9210;790;
2021-05-28 19:34:43;YP;YUPI;2;250;0;500;416;84;
2021-05-28 22:07:23;8997009510055;YOU C1000;1;10000;0;10000;9166;834;
2021-05-28 22:24:06;8994867007161;ROKOK PENA GOLD 20;1;17000;0;17000;15000;2000;
2021-05-29 11:42:37;8998989300261;GUDANG GARAM SURYA 12 FILTER;1;18500;0;18500;17200;1300;
2021-05-29 11:45:38;8991102989428SCT;TANGO CKLT 24G SCT;1;1000;0;1000;609;391;
2021-05-29 11:45:38;8993470671752;JOGER STICK DUO KACANG;1;1000;0;1000;850;150;
2021-05-29 11:45:38;kp;KALPA;1;2000;0;2000;1666;334;
2021-05-29 11:45:38;8998989500166;GUDANG GARAM MERAH BESAR 16KS;1;18000;0;18000;17000;1000;
2021-05-29 11:56:46;8999999706111;PEPSODENT WHITE 25G;1;2000;0;2000;1450;550;
2021-05-29 11:56:46;8999999059316;LIFEBUOY TS MILDCARE 75G;1;3000;0;3000;2640;360;
2021-05-29 11:56:59;8998009020186;BUAVITA GUAVA 250ML;1;7000;0;7000;6083;917;
2021-05-29 12:26:26;ARG;ARGUS 220ML;1;14500;0;14500;12500;2000;
2021-05-29 12:26:26;8994907000428;KECAP SACHET ABC;4;500;0;2000;1416;584;
2021-05-29 14:16:10;8998866200578;MIE SEDAAP KARI KENTAL;1;2500;0;2500;2263;237;
2021-05-29 14:17:39;8993989311279;CLAS MILD 12;1;17000;0;17000;15700;1300;
2021-05-29 14:40:12;8999999526863;MOLTO ALL IN ONE PINK 11ML;1;5500;0;5500;4800;700;
2021-05-29 14:40:12;8999999042639;RINSO ANTI NODA CLS LIQ 40ML;5;1000;0;5000;4025;975;
2021-05-29 14:42:53;8992761111533;SPRITE SLIM CAM250ML;2;5000;0;10000;7500;2500;
2021-05-29 14:42:53;8992775001042;PILUS GARUDA MI GORENG;1;5000;0;5000;4810;190;
2021-05-29 14:46:33;8991102987875;WFR TANGO POUCH CKL 115G;1;8000;0;8000;6786;1214;
2021-05-29 14:46:33;8992775211410;PILUS GARUDA PEDAS;1;5000;0;5000;4886;114;
2021-05-29 14:46:33;8998866613699;EMERON LOVELY COOLBRIGHT 100ML;1;4300;0;4300;3800;500;
2021-05-29 14:46:33;JGR SHN;JOGER SHINY SACHET;5;500;0;2500;2185;315;
2021-05-29 15:57:35;8999999037765;PEPSODENT WHITE 225G;2;12000;0;24000;21500;2500;
2021-05-29 15:57:35;8999999055769;FAIR&LOVELY MVIT FC FOAM 50 G;1;12500;0;12500;11180;1320;
2021-05-29 15:58:28;8998989110167;SURYA GUDANG GARAM 16 FILTER;1;25000;0;25000;23200;1800;
2021-05-29 15:58:28;BMO;BERAS MERAH ORGANIK;1;25000;0;25000;23500;1500;
2021-05-29 15:59:20;ABC;BATERAI ABC BIRU;1;8500;0;8500;7500;1000;
2021-05-29 15:59:31;8996001600146;TEH PUCUK HARUM 350ML;2;3000;0;6000;4628;1372;
2021-05-29 16:01:49;6907992823676;JD PEACH;1;2000;0;2000;1700;300;
2021-05-29 16:01:49;6907992823621;JD CREAMY YOGURT;1;3000;0;3000;2600;400;
2021-05-29 16:02:00;8999999007768;FAIR&LOVELY MULTIVITAMIN  CREAM 9 ML;2;4500;0;9000;6400;2600;
2021-05-29 16:47:01;8998989300261;GUDANG GARAM SURYA 12 FILTER;1;18500;0;18500;17200;1300;
2021-05-29 16:47:01;VCO;VITAMIN C500 ORANGE;2;1000;0;2000;1150;850;
2021-05-29 17:52:58;8991102380805;FULLO  CKL PCK 8G;1;10000;0;10000;9000;1000;
2021-05-29 17:52:58;8998866202725;MILKU COKLAT PREMIUM 200ML;1;3000;0;3000;2375;625;
2021-05-29 17:52:58;VCO;VITAMIN C500 ORANGE;1;1000;0;1000;575;425;
2021-05-29 17:52:58;6907992823843;JD MOCHA CRISPY;1;5000;0;5000;4400;600;
2021-05-29 17:55:09;8997218380074;ICHITAN MILK TEA;1;8000;0;8000;6583;1417;
2021-05-29 17:55:09;8998866201865;KRISBEE PILLOW CHOCOLAVA 120 GR;1;8000;0;8000;7250;750;
2021-05-29 17:56:01;8999999023997;CITRA BW FRESH WHITE 220ML;1;12000;0;12000;10700;1300;
2021-05-29 17:56:01;8998866610278;DAIA VIOLET GUSSET 565G;1;10000;0;10000;8700;1300;
2021-05-29 18:00:13;089686611878;QTELA TEMPE;1;6000;0;6000;5370;630;
2021-05-29 18:00:13;089686611519;QTELA SINGKONG;1;5000;0;5000;4266;734;
2021-05-29 18:00:13;8997210107877;VORTEX SMART 3;1;10000;0;10000;9500;500;
2021-05-29 18:00:13;8992761122331;FRESTEA APPEL 500ML;1;6500;0;6500;4708;1792;
2021-05-29 18:52:05;8998989500166;GUDANG GARAM MERAH BESAR 16KS;1;18000;0;18000;17000;1000;
2021-05-29 19:03:40;8994834003752;TICTIC;1;2000;0;2000;1700;300;
2021-05-29 19:03:40;VTM;VITAMIN;2;500;0;1000;850;150;
2021-05-29 19:03:40;YP;YUPI;4;250;0;1000;832;168;
2021-05-29 19:03:40;ff;FULLO BLASTO;2;1000;0;2000;1990;10;
2021-05-29 19:03:40;8992775002735;CHOCOLATOS SUSU COKELAT;1;4000;0;4000;3520;480;
2021-05-29 19:04:27;8992775002155;CHOCOLATOS DRINK;1;4000;0;4000;3520;480;
2021-05-29 19:04:27;ff;FULLO BLASTO;1;1000;0;1000;995;5;
2021-05-29 19:16:12;8998989500166;GUDANG GARAM MERAH BESAR 16KS;1;18000;0;18000;17000;1000;
2021-05-29 19:33:52;8991102303309;WFR TANGO SBJ 176G;1;10000;0;10000;8694;1306;
2021-05-29 19:54:56;8998666003089GT;TB GILUX MIX;1;9000;0;9000;8000;1000;
2021-05-29 20:05:09;8994834003752;TICTIC;1;2000;0;2000;1700;300;
2021-05-29 20:05:09;8998009010590;ULTRA CHO 125;1;3000;0;3000;2428;572;
2021-05-29 20:05:09;AMPLOP;AMPLOP;4;250;0;1000;560;440;
2021-05-29 20:05:09;8997009510055;YOU C1000;1;10000;0;10000;9166;834;
2021-05-29 20:05:09;8992696404441;BEAR BRAND 189ML;1;9000;0;9000;7887;1113;
2021-05-29 20:05:09;089686021127;INTER MIE KALDU;1;1000;0;1000;813;187;
2021-05-29 20:05:09;8991188943536;SASA SANTAN KELAPA 65ML;1;3000;0;3000;2437;563;
2021-05-29 20:05:09;8993274532105;BOLU;1;1000;0;1000;833;167;
2021-05-29 20:05:09;TUSTEL;TUSUK TELINGA;1;1000;0;1000;833;167;
2021-05-29 20:05:09;8998866200882;SUKSESMIE GORENG AYAM KRMS 133GR;1;3500;0;3500;3047;453;
2021-05-29 20:05:09;8998989300261;GUDANG GARAM SURYA 12 FILTER;1;18500;0;18500;17200;1300;
2021-05-29 20:05:09;089686010343;INDOMIE SOTO MIE;4;2600;0;10400;9468;932;
2021-05-29 20:05:09;8992761139018;ADES 600ML;3;3500;0;10500;6876;3624;
2021-05-29 20:05:09;JGR;JOGER CHOCKY PASTA;1;20000;0;20000;18190;1810;
2021-05-29 20:05:09;YP;YUPI;2;250;0;500;416;84;
2021-05-29 20:05:09;JGR SHN;JOGER SHINY SACHET;1;500;0;500;437;63;
2021-05-29 20:05:09;PRG;PARAGO;1;500;0;500;400;100;
2021-05-29 20:05:10;8992984920110;CUKA DAPUR DUA BELIBIS;1;4500;0;4500;3250;1250;
2021-05-29 20:07:32;8993989311699;CLAS MILD 16 FILTER;1;23000;0;23000;21700;1300;
2021-05-29 20:07:32;9556001025272;NESCAFE LATTE 240ML;1;8500;0;8500;7834;666;
2021-05-29 20:07:32;8992696404441;BEAR BRAND 189ML;1;9000;0;9000;7887;1113;
2021-05-29 20:07:32;HT;HOT-HOT;1;500;0;500;350;150;
2021-05-29 20:07:33;8998989300261;GUDANG GARAM SURYA 12 FILTER;1;18500;0;18500;17200;1300;
2021-05-29 20:07:33;8992761139018;ADES 600ML;1;3500;0;3500;2292;1208;
2021-05-29 20:07:33;8886013257400;TWISTKO;1;1000;0;1000;900;100;
2021-05-29 20:07:33;8992957220186;COKLAT RUSA;2;2000;0;4000;3400;600;
2021-05-29 20:07:33;VTM;VITAMIN;1;500;0;500;425;75;
2021-05-29 20:07:33;8993989311279;CLAS MILD 12;1;17000;0;17000;15700;1300;
2021-05-29 20:07:33;8994935000285;MINYAK GORENG DUNIA 4500ML;1;70000;0;70000;66433;3567;
2021-05-29 20:08:42;8886013257400;TWISTKO;5;1000;0;5000;4500;500;
2021-05-29 20:08:42;8992696422735;DNCO CKLT UHT 110ML;3;2500;0;7500;6123;1377;
2021-05-29 20:09:08;HT;HOT-HOT;1;500;0;500;350;150;
2021-05-29 20:11:48;BTS;BIMURA TARO SEAWEED 250G;1;10000;0;10000;9300;700;
2021-05-29 20:11:48;8997231980022;O'JELLY MINI STRAWBERRY;1;3000;0;3000;2250;750;
2021-05-29 20:11:48;8992696523081;MILO UHT 110ML;1;2500;0;2500;1962;538;
2021-05-29 20:11:48;8998898830125;KKB ENER-G ANGGUR;1;5500;0;5500;4824;676;
2021-05-29 20:34:12;8992696430860;KOKO KRUNCH 80G;1;9000;0;9000;8063;937;
2021-05-29 20:34:12;8992696523081;MILO UHT 110ML;1;2500;0;2500;1962;538;
2021-05-29 20:39:07;8999909010567;234 16 FILTER;1;22000;0;22000;21500;500;
2021-05-29 20:39:07;8998989121163;SURYA PRO MERAH;1;20000;0;20000;18600;1400;
2021-05-29 20:39:07;8998898101409;TOLAK ANGIN SIDOMUNCUL;5;3500;0;17500;13540;3960;
2021-05-29 21:20:54;8997211230147;KERUPUK BAWANG VITARASA;1;10000;0;10000;8580;1420;
2021-05-29 21:50:41;8997027300089;NOMOS;1;4000;0;4000;2963;1037;
2021-05-29 21:50:41;8996001600399;LE MINERAL 1500ML;1;5000;0;5000;4042;958;
2021-05-30 13:04:21;8996001600665;COOL TIME;1;3500;0;3500;2750;750;
2021-05-30 13:04:21;HT;HOT-HOT;1;500;0;500;350;150;
2021-05-30 13:15:28;8994907000428;KECAP SACHET ABC;2;500;0;1000;708;292;
2021-05-30 13:41:09;BTS;BIMURA TARO SEAWEED 250G;1;10000;0;10000;9300;700;
2021-05-30 14:47:41;BTS;BIMURA TARO SEAWEED 250G;1;10000;0;10000;9300;700;
2021-05-30 15:03:54;8992959304235;SFX COMFORT SLIM 29CM 8S;1;8000;0;8000;7387;613;
2021-05-30 15:03:54;8992696404441;BEAR BRAND 189ML;2;9000;0;18000;15774;2226;
2021-05-30 15:03:54;001;PASEO SMART FACIAL SF 250S GT;1;10000;0;10000;9500;500;
2021-05-30 15:57:19;GL;GULA 1 LITER;1;11500;0;11500;10500;1000;
2021-05-30 15:57:19;VTM;VITAMIN;1;500;0;500;425;75;
2021-05-30 16:24:35;089686010190;INDOMIE KARI AYAM;2;2800;0;5600;5044;556;
2021-05-30 17:04:25;8994867000179;ROKOK PENA MILD 16;2;14500;0;29000;26000;3000;
2021-05-30 17:19:56;8992696404441;BEAR BRAND 189ML;1;9000;0;9000;7887;1113;
2021-05-30 17:19:56;6907992823669;JD MILKY STRAW;3;3000;0;9000;7800;1200;
2021-05-30 17:19:56;6907992824963;JD MILKY CHOCOLATE;2;3000;0;6000;5200;800;
2021-05-30 17:19:56;8998866202695;KOPI MAYOR;1;6000;0;6000;4500;1500;
2021-05-30 17:19:56;8992222050418;GATSBY NORMAL 38GR;1;5000;0;5000;3850;1150;
2021-05-30 17:19:56;8998866106474;POSH BLAZE PINK 150ML;1;19500;0;19500;17500;2000;
2021-05-30 17:19:56;8991111101507;JB POWDER BLOSSOM 50G;1;3500;0;3500;3000;500;
2021-05-30 17:19:56;8996001302316;MALKIST ABON SCT;1;1000;0;1000;840;160;
2021-05-30 17:19:56;HT;HOT-HOT;2;500;0;1000;700;300;
2021-05-30 17:19:56;PRG;PARAGO;1;500;0;500;400;100;
2021-05-30 17:19:56;8999909982000;SAMPOERNA 12 FILTER;1;18000;0;18000;16000;2000;
2021-05-30 17:19:56;8999999008475;SUNLIGHT LIME NEW REF 1600ML;1;33000;0;33000;29800;3200;
2021-05-30 17:19:56;8992959953327;SWEETY BRONZE L52;1;85000;0;85000;80304;4696;
2021-05-30 17:19:56;8998866501033;MINYAK GORENG SEDAAP POUCH 2L;1;28000;0;28000;27746;254;
2021-05-30 17:19:56;8999999524722;SUNLIGHT LIME NEW PCH 435ML;1;10000;0;10000;9100;900;
2021-05-30 17:19:56;711844150027;ABC NANAS;1;13000;0;13000;12241;759;
2021-05-30 17:19:56;8993470671752;JOGER STICK DUO KACANG;1;1000;0;1000;850;150;
2021-05-30 17:19:56;8998866202732;MILKU STROBERI 200ML;2;3000;0;6000;4750;1250;
2021-05-30 17:19:56;GL;GULA 1 LITER;1;11500;0;11500;10500;1000;
2021-05-30 17:19:56;8998989500166;GUDANG GARAM MERAH BESAR 16KS;1;18000;0;18000;17000;1000;
2021-05-30 17:39:33;089686611519;QTELA SINGKONG;1;5000;0;5000;4266;734;
2021-05-30 17:47:35;8997028590014;ARGUS 220ML;2;500;0;1000;604;396;
2021-05-30 18:15:07;GL;GULA 1 LITER;10;11500;0;115000;105000;10000;
2021-05-30 18:15:07;8992959508855;SWEETY SILVER PANTS XL 18;1;47800;0;47800;43353;4447;
2021-05-30 18:15:07;8850507002968;A1 KING TRUCK;1;16500;0;16500;15500;1000;
2021-05-30 20:39:04;8999999195649;SARI WANGI 25X1.86G;1;6000;0;6000;5050;950;
2021-05-30 20:39:04;VCO;VITAMIN C500 ORANGE;1;1000;0;1000;575;425;
2021-05-30 21:38:20;8998866202770;MIE SEDAAP SALERO PADANG;1;2500;0;2500;2362;138;
2021-05-30 21:38:20;8998866200301;MIE SEDAAP GORENG;1;2500;0;2500;2023;477;
2021-05-30 21:38:20;8998866200325;MIE SEDAAP SOTO;2;2500;0;5000;3904;1096;
2021-05-30 21:39:33;8999999049423;REXONA MEN RO SPORT DEFENSE 45 ML;1;15000;0;15000;13550;1450;
2021-05-30 21:39:33;8999999706449;CLOSEUP ICY WHITE 65G;1;9000;0;9000;7865;1135;
2021-05-30 21:39:33;8999999048167;SUNSILK SHP BLACK SHINE 9ML;1;10500;0;10500;9300;1200;
2021-05-30 21:39:33;8996001600221;KOPIKO 78;1;5000;0;5000;4283;717;
2021-05-30 21:40:11;JGR SHN;JOGER SHINY SACHET;1;500;0;500;437;63;
2021-05-30 21:58:25;8992628022156;BIMOLI KLASIK TOUCH 1 LT;1;15500;0;15500;14350;1150;
2021-05-30 21:59:03;ARD;SENDAL ARDILES;1;15000;0;15000;13500;1500;
2021-05-31 12:29:07;ARG;ARGUS 220ML;3;14500;0;43500;37500;6000;
2021-05-31 12:30:14;ARG;ARGUS 220ML;1;14500;0;14500;12500;2000;
2021-05-31 12:38:55;8998989300261;GUDANG GARAM SURYA 12 FILTER;1;18500;0;18500;17200;1300;
2021-05-31 12:38:55;VCO;VITAMIN C500 ORANGE;2;1000;0;2000;1150;850;
2021-05-31 12:51:24;HT;HOT-HOT;2;500;0;1000;700;300;
2021-05-31 12:51:24;8999909002821;MARLBORO BLACK 16;1;22000;0;22000;20850;1150;
2021-05-31 13:05:03;8991002307209;COFFE CANDY;2;5000;0;10000;9000;1000;
2021-05-31 13:33:54;8992959508930;SWEETY SILVER PANTS L 54;1;108000;0;108000;99697;8303;
2021-05-31 15:13:50;8998866200325;MIE SEDAAP SOTO;5;2500;0;12500;9760;2740;
2021-05-31 15:13:50;8998866202619;MIE SEDAAP KOREAN SPICY SOUP;5;2500;0;12500;11365;1135;
2021-05-31 15:13:50;089686041705;INDOMIE GORENG JUMBO;4;3500;0;14000;12572;1428;
2021-05-31 15:13:50;8991102994422;TANGO WALUT CHOCOBNN 18G;1;9000;0;9000;8661;339;
2021-05-31 15:13:50;8996001355008;BENG-BENG SP20G;1;29000;0;29000;26500;2500;
2021-05-31 15:13:50;8991102387286GT;TANGO LONG CKLT 47G;1;17000;0;17000;15517;1483;
2021-05-31 15:13:50;8999999195649;SARI WANGI 25X1.86G;2;6000;0;12000;10100;1900;
2021-05-31 15:13:50;8995333060772;TERIGU GATOT KACA 500GR;2;4500;0;9000;8130;870;
2021-05-31 15:43:43;8998989300261;GUDANG GARAM SURYA 12 FILTER;1;18500;0;18500;17200;1300;
2021-05-31 16:11:44;8998866601535;BLEACHING SOKLIN PEMUTIH 500ML;1;7000;0;7000;4880;2120;
2021-05-31 16:38:16;GL;GULA 1 LITER;1;11500;0;11500;10500;1000;
2021-05-31 16:38:16;VCO;VITAMIN C500 ORANGE;2;1000;0;2000;1150;850;
2021-05-31 17:08:09;8992696521797SCT;MILO UHT ACT GO 22G;1;2000;0;2000;1412;588;
2021-05-31 17:09:15;8996001305041;ROMA SANDWICH CKLT;1;7000;0;7000;5000;2000;
2021-05-31 17:09:15;8992957220087;COKLAT SINGA;1;2000;0;2000;1700;300;
2021-05-31 17:09:15;JGR SHN;JOGER SHINY SACHET;1;500;0;500;437;63;
2021-05-31 17:09:15;YP;YUPI;1;250;0;250;208;42;
2021-05-31 17:09:22;YP;YUPI;1;250;0;250;208;42;
2021-05-31 17:18:25;8998866501033;MINYAK GORENG SEDAAP POUCH 2L;1;28000;0;28000;27746;254;
2021-05-31 17:45:28;8992770034151;MASAKO 250GR;1;10000;0;10000;8000;2000;
2021-05-31 17:49:50;9556001025272;NESCAFE LATTE 240ML;1;8500;0;8500;7834;666;
2021-05-31 17:49:50;8997231980022;O'JELLY MINI STRAWBERRY;1;3000;0;3000;2250;750;
2021-05-31 17:49:50;8991001503114;CHACHA MILK CHOCOLATE 35G;1;5500;0;5500;4900;600;
2021-05-31 17:49:50;ff;FULLO BLASTO;1;1000;0;1000;995;5;
2021-05-31 18:18:04;8998866202930;SEDAAP AYAM JERIT CUP;1;4500;0;4500;3738;762;
2021-05-31 18:18:04;HT;HOT-HOT;1;500;0;500;350;150;
2021-05-31 18:29:29;VTM;VITAMIN;2;500;0;1000;850;150;
2021-05-31 18:30:59;8999999195656;SARI WANGI 50X1.85;1;10000;0;10000;9500;500;
2021-05-31 18:38:33;8998866202930;SEDAAP AYAM JERIT CUP;1;4500;0;4500;3738;762;
2021-05-31 18:38:33;8998866202671;NOODLE SEDAAP MIE KOREAN SPICY SOUP CUP;1;5000;0;5000;4002;998;
2021-05-31 18:38:33;HT;HOT-HOT;1;500;0;500;350;150;
2021-05-31 18:51:10;6907992823669;JD MILKY STRAW;1;3000;0;3000;2600;400;
2021-05-31 18:51:10;6907992824963;JD MILKY CHOCOLATE;2;3000;0;6000;5200;800;
2021-05-31 19:00:53;6907992824963;JD MILKY CHOCOLATE;1;3000;0;3000;2600;400;
2021-05-31 19:00:53;VTM;VITAMIN;2;500;0;1000;850;150;
2021-05-31 19:13:36;089686049053;SARIMI PUAS;1;3000;0;3000;2400;600;
2021-05-31 19:25:51;8991102022347;SIKAT GIGI FORMULA RIPPLE;1;5000;0;5000;4583;417;
2021-05-31 19:25:51;8999999534097;PEPSODENT PGB FCM 75G;1;5000;0;5000;3850;1150;
2021-05-31 19:25:51;BB;PASEO SMARTY FACIAL TRAVEL PACK 50S GT;1;3000;0;3000;1980;1020;
2021-05-31 19:25:51;8999999558086;RINSO MOLTO FERFUME ESSENSE PWD 44G;5;1000;0;5000;4025;975;
2021-05-31 19:25:51;8993324850449;BABY LOVE COTTON BUDS;1;5000;0;5000;4500;500;
2021-05-31 19:25:51;8996001350423;ZUPER KEJU;1;9200;0;9200;8360;840;
2021-05-31 19:27:51;8997021870090;FRESH CARE LAVENDER 10ML;1;12000;0;12000;10000;2000;
2021-05-31 19:28:35;8996001600146;TEH PUCUK HARUM 350ML;1;3000;0;3000;2314;686;
2021-05-31 19:28:35;8992761145019;COCA COLA PET 250ML;1;3500;0;3500;2417;1083;
2021-05-31 19:30:43;8992761145019;COCA COLA PET 250ML;1;3500;0;3500;2417;1083;
2021-05-31 19:48:03;8998866610438;SOKLIN SOFTERGENT RED BAG 770G & PIRING;1;18000;0;18000;16680;1320;
2021-05-31 19:58:07;6291100212866;KURMA KHALAS;1;85000;0;85000;80000;5000;
2021-05-31 20:25:15;8992959509005;SWEETY SILVER PANTS XL26;1;61500;0;61500;55910;5590;
2021-05-31 20:25:48;HT;HOT-HOT;1;500;0;500;350;150;
2021-05-31 21:03:47;8992696422735;DNCO CKLT UHT 110ML;1;2500;0;2500;2041;459;
2021-05-31 21:03:47;089686010190;INDOMIE KARI AYAM;1;2800;0;2800;2522;278;
2021-05-31 21:03:47;8991102989428SCT;TANGO CKLT 24G SCT;1;1000;0;1000;609;391;
2021-05-31 21:03:47;8992957220087;COKLAT SINGA;1;2000;0;2000;1700;300;
2021-05-31 21:03:47;HT;HOT-HOT;2;500;0;1000;700;300;
2021-05-31 21:03:47;bb;BENG-BENG;1;1500;0;1500;1450;50;
2021-05-31 21:12:46;8997025914059;HATARI SEE HONG;1;6000;0;6000;4911;1089;
2021-05-31 21:13:23;089686611878;QTELA TEMPE;1;6000;0;6000;5370;630;
2021-05-31 21:13:23;8996001600221;KOPIKO 78;1;5000;0;5000;4283;717;
2021-05-31 21:13:23;PRG;PARAGO;2;500;0;1000;800;200;
2021-05-31 21:45:54;8998989300261;GUDANG GARAM SURYA 12 FILTER;1;18500;0;18500;17200;1300;
2021-05-31 22:10:08;8999909096004;SAMPOERNA 16 FILTER;1;24000;0;24000;23000;1000;
2021-05-31 22:10:08;8998989300261;GUDANG GARAM SURYA 12 FILTER;1;18500;0;18500;17200;1300;
2021-05-31 22:11:29;8999999552800;LUX YUZU BLOSSOM 75G;1;3500;0;3500;2800;700;
2021-05-31 22:11:29;8998866608718;DAIA SOFTENER PINK;1;5000;0;5000;4450;550;
2021-05-31 22:11:29;8998866202770;MIE SEDAAP SALERO PADANG;1;2500;0;2500;2362;138;
2021-05-31 22:12:44;8993072153595;LARISST COTTON 35G;1;5000;0;5000;3300;1700;
2021-05-31 22:22:59;8991111109107;JB POWDER BEDTIME 75+25g;1;6000;0;6000;5440;560;
2021-05-31 22:34:27;8998866201865;KRISBEE PILLOW CHOCOLAVA 120 GR;1;8000;0;8000;7250;750;
2021-05-31 22:34:27;8996001600146;TEH PUCUK HARUM 350ML;2;3000;0;6000;4628;1372;
2021-05-31 22:34:27;VCL;VITAMIN C500 LEMON;1;1000;0;1000;575;425;
2021-06-01 11:46:38;VCO;VITAMIN C500 ORANGE;1;1000;0;1000;575;425;
2021-06-01 12:49:38;8998989110167;SURYA GUDANG GARAM 16 FILTER;1;25000;0;25000;23200;1800;
2021-06-01 12:49:38;8992753100101;BKM FULL CREAM GOLD 370;1;15000;0;15000;14000;1000;
2021-06-01 13:48:05;8999999524722;SUNLIGHT LIME NEW PCH 435ML;1;10000;0;10000;9100;900;
2021-06-01 14:36:26;8991102213189;BLASTER UNGU;1;5000;0;5000;3106;1894;
2021-06-01 16:13:10;8994834006128;TICTIC PEDAS;1;2000;0;2000;1700;300;
2021-06-01 16:13:10;8997231980015;O'JELLY MINI APPLE;1;3000;0;3000;2250;750;
2021-06-01 16:13:10;PRG;PARAGO;1;500;0;500;400;100;
2021-06-01 16:13:10;JGR SHN;JOGER SHINY SACHET;1;500;0;500;437;63;
2021-06-01 16:14:04;8992957220087;COKLAT SINGA;2;2000;0;4000;3400;600;
2021-06-01 16:14:04;8992761166212;FRESTEA APPLE 350ML;1;4500;0;4500;3000;1500;
2021-06-01 16:14:04;JGR SHN;JOGER SHINY SACHET;1;500;0;500;437;63;
2021-06-01 16:14:04;8886013257400;TWISTKO;1;1000;0;1000;900;100;
2021-06-01 16:45:10;8991004011906;KOPI BORONG;1;10000;0;10000;8333;1667;
2021-06-01 18:18:37;8998866202619;MIE SEDAAP KOREAN SPICY SOUP;2;2500;0;5000;4546;454;
2021-06-01 18:31:22;8992775315057;GERY SALUT MALKIST COKLAT;1;6500;0;6500;5516;984;
2021-06-01 18:31:22;8992959304235;SFX COMFORT SLIM 29CM 8S;1;8000;0;8000;7387;613;
2021-06-01 18:36:04;8993007000680;INDOMILK 1L;1;16500;0;16500;14792;1708;
2021-06-01 18:36:04;8992761166205;FRESTEA GREEN HONEY 350ML;1;4500;0;4500;3000;1500;
2021-06-01 19:46:06;VCO;VITAMIN C500 ORANGE;2;1000;0;2000;1150;850;
2021-06-01 19:48:49;8992761164546;NUTRIBOOST STRAWBERRY 300ML;1;6500;0;6500;5300;1200;
2021-06-01 19:49:11;089686021127;INTER MIE KALDU;2;1000;0;2000;1626;374;
2021-06-01 20:06:34;8999909010567;234 16 FILTER;1;22000;0;22000;21500;500;
2021-06-01 20:07:19;8991001780065;TWISTER BLACK 140G;1;13000;0;13000;11700;1300;
2021-06-01 20:47:02;ARG;ARGUS 220ML;6;14500;0;87000;75000;12000;
2021-06-01 21:03:20;8997009510055;YOU C1000;1;10000;0;10000;9166;834;
2021-06-01 21:03:20;8992696404441;BEAR BRAND 189ML;1;9000;0;9000;7887;1113;
2021-06-01 21:05:10;8992959953082;SWEETY BRONZE L8;1;17000;0;17000;15380;1620;
2021-06-01 21:06:44;8997025915124;HATARI PEANUT 125G;1;7000;0;7000;6037;963;
2021-06-01 21:14:05;GL;GULA 1 LITER;1;11500;0;11500;10500;1000;
2021-06-01 21:34:23;8993176110081;MINYAK KAYU PUTIH 30ML;1;12000;0;12000;9091;2909;
2021-06-01 21:34:23;8999908042408;MY BABY POWDER BIRU;1;5000;0;5000;3275;1725;
2021-06-01 21:51:17;8996001600375;LE MINERAL 330ML;1;2000;0;2000;1417;583;
2021-06-01 21:51:17;8996001318980;BETTER 120G;1;6000;0;6000;5100;900;
2021-06-01 21:57:34;089686060027;POP MIE AYAM JUMBO;1;4500;0;4500;3833;667;
2021-06-01 21:57:34;8997231980022;O'JELLY MINI STRAWBERRY;2;3000;0;6000;4500;1500;
2021-06-01 22:05:21;8998989300261;GUDANG GARAM SURYA 12 FILTER;1;18500;0;18500;17200;1300;
2021-06-01 22:05:21;089686010107;INDOMIE KALDU AYAM;1;2500;0;2500;2150;350;
2021-06-01 22:05:21;089686010343;INDOMIE SOTO MIE;1;2600;0;2600;2367;233;
2021-06-01 22:05:21;089686011036;INDOMIE GORENG PEDAS;1;2700;0;2700;2452;248;
2021-06-01 22:25:51;8997025914059;HATARI SEE HONG;1;6000;0;6000;4911;1089;
2021-06-01 22:25:51;8998866202244;EKOMIE BUMBU KALDU AYAM;1;1000;0;1000;798;202;
2021-06-01 22:25:51;8997027300089;NOMOS;1;4000;0;4000;2963;1037;
2021-06-01 22:25:51;8998866105507;EMERON LOVELY NOURIST&BRIGHT 100ML;1;4300;0;4300;3800;500;
2021-06-01 22:25:51;8997009510055;YOU C1000;1;10000;0;10000;9166;834;
2021-06-01 22:25:51;8992696404441;BEAR BRAND 189ML;1;9000;0;9000;7887;1113;
2021-06-01 22:25:51;8998866202770;MIE SEDAAP SALERO PADANG;2;2500;0;5000;4724;276;
2021-06-01 22:25:51;8998866501033;MINYAK GORENG SEDAAP POUCH 2L;3;29000;0;87000;83238;3762;
2021-06-01 22:25:51;8995333060703;TERIGU KOMPAS 1KG;1;10500;0;10500;9816;684;
2021-06-01 22:25:51;8998989300261;GUDANG GARAM SURYA 12 FILTER;1;18500;0;18500;17200;1300;
2021-06-01 22:25:51;8997231980015;O'JELLY MINI APPLE;1;3000;0;3000;2250;750;
2021-06-01 22:25:51;8993007003063;ENAAK 500G;1;11000;0;11000;9625;1375;
2021-06-02 10:54:00;8991102714495;TANGO DRINK COKLAT;1;5000;0;5000;3818;1182;
2021-06-02 10:54:00;8992775211434;PILUS GARUDA SAPI PANGGANG;1;5000;0;5000;4810;190;
2021-06-02 11:03:17;8992761139018;ADES 600ML;1;3500;0;3500;2292;1208;
2021-06-02 11:17:50;8999909010567;234 16 FILTER;1;22000;0;22000;21500;500;
2021-06-02 11:17:50;8996001302316;MALKIST ABON SCT;1;1000;0;1000;840;160;
2021-06-02 11:32:37;8998866607315;SOKLIN SOFTERGENT SAKURA 770G & PIRING;1;18000;0;18000;16680;1320;
2021-06-02 11:34:56;711844150027;ABC NANAS;1;13000;0;13000;12241;759;
2021-06-02 11:39:37;8996001302323;MALKIST ABON;1;6500;0;6500;4800;1700;
2021-06-02 11:39:37;8997028590014;ARGUS 220ML;2;500;0;1000;604;396;
2021-06-02 12:06:11;8992761122331;FRESTEA APPEL 500ML;1;6500;0;6500;4708;1792;
2021-06-02 12:06:11;8992761166038;MMP ORANGE 300ML;1;5000;0;5000;3750;1250;
2021-06-02 12:06:11;8994834006128;TICTIC PEDAS;5;2000;0;10000;8500;1500;
2021-06-02 12:06:11;8994834003752;TICTIC;2;2000;0;4000;3400;600;
2021-06-02 12:10:22;8992761139018;ADES 600ML;2;3500;0;7000;4584;2416;
2021-06-02 12:10:22;8992761166212;FRESTEA APPLE 350ML;1;4500;0;4500;3000;1500;
2021-06-02 12:10:22;PRG;PARAGO;7;500;0;3500;2800;700;
2021-06-02 12:12:38;8997028590014;ARGUS 220ML;4;500;0;2000;1208;792;
2021-06-02 12:33:34;8994867000162;ROKOK PUNDIMAS KRETEK16;1;10000;0;10000;8600;1400;
2021-06-02 13:53:03;8998866501033;MINYAK GORENG SEDAAP POUCH 2L;2;29000;0;58000;55492;2508;
2021-06-02 14:36:21;VCO;VITAMIN C500 ORANGE;1;1000;0;1000;575;425;
2021-06-02 15:07:04;8992761111519;COCA COLA SLIM CAM 250ML;1;5000;0;5000;3750;1250;
2021-06-02 15:08:13;8999909010567;234 16 FILTER;1;22000;0;22000;21500;500;
2021-06-02 15:08:13;6907992823973;JD PINEAPPLE;1;5000;0;5000;4300;700;
2021-06-02 15:08:13;HT;HOT-HOT;2;500;0;1000;700;300;
2021-06-02 15:29:12;8998866608756;SOKLIN SOFTENER TWILIGHT BLUE 14SCH;1;5000;0;5000;4560;440;
2021-06-02 15:29:12;8999999042646;RINSO MOLTO ROSE FRESH LIQ 40ML;1;6000;0;6000;4817;1183;
2021-06-02 15:29:23;HT;HOT-HOT;2;500;0;1000;700;300;
2021-06-02 15:34:07;6907992823966;JD BLUEBERRY;1;3500;0;3500;3000;500;
2021-06-02 15:34:07;VCO;VITAMIN C500 ORANGE;2;1000;0;2000;1150;850;
2021-06-02 15:45:09;8998866202053;POTABEE AYAM BAKAR PEDAS 68GR;1;8000;0;8000;7200;800;
2021-06-02 15:45:09;089686611519;QTELA SINGKONG;1;5000;0;5000;4266;734;
2021-06-02 15:45:09;089686834055;FREISS JERUK;1;11000;0;11000;8750;2250;
2021-06-02 15:45:09;8997009510116;LEMON WATER;1;7000;0;7000;5694;1306;
2021-06-02 15:45:09;bb;BENG-BENG;2;1500;0;3000;2900;100;
2021-06-02 15:45:09;ARG;ARGUS 220ML;1;14500;0;14500;12500;2000;
2021-06-02 15:45:09;JGR SHN;JOGER SHINY SACHET;3;500;0;1500;1311;189;
2021-06-02 16:28:20;8998866108317;EMERON HJB ANTDNDF 10ML;1;5000;0;5000;4185;815;
2021-06-02 16:41:20;8998866202732;MILKU STROBERI 200ML;1;3000;0;3000;2375;625;
2021-06-02 16:41:20;8991102387286SCT;TANGO LONG CKLT 47G;1;2000;0;2000;1551;449;
2021-06-02 16:46:47;8995333060772;TERIGU GATOT KACA 500GR;1;4500;0;4500;4065;435;
2021-06-02 16:46:47;HT;HOT-HOT;1;500;0;500;350;150;
2021-06-02 17:23:38;VCO;VITAMIN C500 ORANGE;1;1000;0;1000;575;425;
2021-06-02 17:23:38;8994867007161;ROKOK PENA GOLD 20;1;17000;0;17000;15000;2000;
2021-06-02 17:32:20;8993989311279;CLAS MILD 12;1;17000;0;17000;15700;1300;
2021-06-02 17:51:35;8998989300261;GUDANG GARAM SURYA 12 FILTER;2;18500;0;37000;34400;2600;
2021-06-02 17:53:35;089686021127;INTER MIE KALDU;2;1000;0;2000;1626;374;
2021-06-02 17:53:35;RB;RED BOLD;1;19000;0;19000;17900;1100;
2021-06-02 17:53:35;8997009510055;YOU C1000;1;10000;0;10000;9166;834;
2021-06-02 17:53:35;8993470671752;JOGER STICK DUO KACANG;1;1000;0;1000;850;150;
2021-06-02 17:53:35;8996001305041;ROMA SANDWICH CKLT;1;7000;0;7000;5000;2000;
2021-06-02 17:53:35;8998866200882;SUKSESMIE GORENG AYAM KRMS 133GR;1;3500;0;3500;3047;453;
2021-06-02 17:53:35;8998866202732;MILKU STROBERI 200ML;1;3000;0;3000;2375;625;
2021-06-02 17:53:35;VCO;VITAMIN C500 ORANGE;1;1000;0;1000;575;425;
2021-06-02 17:55:04;8998009020186;BUAVITA GUAVA 250ML;1;7000;0;7000;6083;917;
2021-06-02 17:55:04;6907992823850;JD CHOCO CIRLE;1;5500;0;5500;4700;800;
2021-06-02 17:55:04;8991102987875;WFR TANGO POUCH CKL 115G;1;8000;0;8000;6786;1214;
2021-06-02 17:55:04;8992761139018;ADES 600ML;1;3500;0;3500;2292;1208;
2021-06-02 17:55:04;8998866202930;SEDAAP AYAM JERIT CUP;1;4500;0;4500;3738;762;
2021-06-02 17:55:21;YP;YUPI;6;250;0;1500;1248;252;
2021-06-02 18:29:31;089686043617;INDOMIE MIEGHETTI;2;2700;0;5400;4904;496;
2021-06-02 18:29:31;8997013790108;BIMURA KACANG TELUR 25G;1;1000;0;1000;875;125;
2021-06-02 18:29:31;8991102989428SCT;TANGO CKLT 24G SCT;1;1000;0;1000;609;391;
2021-06-02 18:29:31;8994834005923;SPIX 1000;1;1000;0;1000;850;150;
2021-06-02 18:29:31;JGR SHN;JOGER SHINY SACHET;1;500;0;500;437;63;
2021-06-02 18:29:31;8998866202930;SEDAAP AYAM JERIT CUP;1;4500;0;4500;3738;762;
2021-06-02 18:59:48;8998866202930;SEDAAP AYAM JERIT CUP;2;4500;0;9000;7476;1524;
2021-06-02 19:31:00;7118441101378;KECAP ABC 520 ML;1;19000;0;19000;17800;1200;
2021-06-02 19:39:02;YP;YUPI;12;250;0;3000;2496;504;
2021-06-02 20:27:53;BRS5;BERAS BUMN 5KG;2;64000;0;128000;101000;27000;
2021-06-02 20:27:53;BMO;BERAS MERAH ORGANIK;2;25000;0;50000;47000;3000;
2021-06-02 20:28:18;8997021870595;HOT IN CREAM AROMA THERAPY 60G;1;12500;0;12500;11360;1140;
2021-06-02 20:29:51;8992696405424;DNCO INST FORTIGO 200G;1;21000;0;21000;19297;1703;
2021-06-02 20:29:51;8996001600375;LE MINERAL 330ML;1;2000;0;2000;1417;583;
2021-06-02 20:29:51;8996001600399;LE MINERAL 1500ML;2;5000;0;10000;8084;1916;
2021-06-02 20:49:19;6907992823874;JD CRUNCHY CHOCO BLUEBERRY;1;5500;0;5500;4700;800;
2021-06-02 21:02:41;8994834005923;SPIX 1000;2;1000;0;2000;1700;300;
2021-06-02 21:02:41;089686041705;INDOMIE GORENG JUMBO;1;3500;0;3500;3143;357;
2021-06-02 21:02:41;YP;YUPI;2;250;0;500;416;84;
2021-06-02 22:28:37;8991002304413;RELAXA GRAPE MINT;1;5000;0;5000;4500;500;
2021-06-02 22:28:37;001;PASEO SMART FACIAL SF 250S GT;1;10000;0;10000;9500;500;
2021-06-02 22:28:37;VCO;VITAMIN C500 ORANGE;1;1000;0;1000;575;425;
2021-06-09 09:49:58;8999999516208;ROYCO FDS CHICKEN NEW 230G;1;10000;0;10000;9000;1000;
2021-06-09 10:29:57;8999999540159;VASELINE REPAIRING JELLY ALOE 50ML;1;23000;0;23000;21333;1667;
2021-06-09 10:41:39;ARG;ARGUS 220ML;3;14500;0;43500;37500;6000;
2021-06-09 12:56:05;8999909002821;MARLBORO BLACK 16;1;22000;0;22000;20850;1150;
2021-06-09 14:32:22;8999999049492;REXONA WMN RO POWDER DRY 45 ML;1;15000;0;15000;13500;1500;
2021-06-09 14:32:22;8992959509005;SWEETY SILVER PANTS XL26;1;61500;0;61500;55910;5590;
2021-06-09 14:32:48;HT;HOT-HOT;1;500;0;500;350;150;
2021-06-09 14:34:23;8996001600269;LE MINERAL 600ML;1;3000;0;3000;1688;1312;
2021-06-09 14:34:23;8991102213189;BLASTER UNGU;1;5000;0;5000;3106;1894;
2021-06-09 15:09:05;8992775001691;GARUDA ROSTA WAGYU BEEF;1;8000;0;8000;7322;678;
2021-06-09 15:09:05;8991102994422;TANGO WALUT CHOCOBNN 18G;1;9000;0;9000;8661;339;
2021-06-09 15:09:05;8992761136161;COCACOLA 1L;1;10000;0;10000;9000;1000;
2021-06-09 15:09:54;8993470279651;JOGER CHOCKY BAR;1;1000;0;1000;867;133;
2021-06-09 15:56:05;6907992825076;JD WATERMELON APPLE;1;2000;0;2000;1700;300;
2021-06-09 16:13:23;8992959850046;CONFI PANTS M10;1;80000;0;80000;75120;4880;
2021-06-09 16:13:23;8992761002022;SPRITE PET 390ML;1;5500;0;5500;4300;1200;
2021-06-09 16:13:23;089686611519;QTELA SINGKONG;1;5000;0;5000;4266;734;
2021-06-09 16:38:34;8995333060703;TERIGU KOMPAS 1KG;1;10500;0;10500;9816;684;
2021-06-09 16:39:04;8999999007768;FAIR&LOVELY MULTIVITAMIN  CREAM 9 ML;2;4500;0;9000;6400;2600;
2021-06-09 17:26:42;8998866202930;SEDAAP AYAM JERIT CUP;1;4500;0;4500;3738;762;
2021-06-09 17:27:54;ARG;ARGUS 220ML;1;14500;0;14500;12500;2000;
2021-06-09 17:28:12;HT;HOT-HOT;1;500;0;500;350;150;
2021-06-09 17:39:45;8998866201711;KRISBEE KRUNCHY JAGUNG BAKAR MENTEGA 75 GR;1;5500;0;5500;4400;1100;
2021-06-09 17:39:45;8993470672827;SAKU-SAKU SAPI PANGGANG;1;2000;0;2000;1530;470;
2021-06-09 17:39:45;8996001305003;SARI GANDUM SANDWICH;1;6000;0;6000;5100;900;
2021-06-09 17:39:45;8993470672858;SAKU-SAKU RASA BALADO;1;2000;0;2000;1530;470;
2021-06-09 17:39:45;8998866202343;MIE SEDAAP KOREAN SPICY;2;2500;0;5000;4046;954;
2021-06-09 17:39:45;HT;HOT-HOT;1;500;0;500;350;150;
2021-06-09 18:16:38;8999999529703;CLEAR MEN COOL SPORT MTHL 80ML;1;11000;0;11000;10000;1000;
2021-06-09 18:50:04;8998989500166;GUDANG GARAM MERAH BESAR 16KS;2;18000;0;36000;34000;2000;
2021-06-09 18:59:04;089686021219;INTER MIE GORENG;3;1000;0;3000;2655;345;
2021-06-09 19:37:30;8998866610278;DAIA VIOLET GUSSET 565G;1;10000;0;10000;8700;1300;
2021-06-09 19:59:38;8992761164546;NUTRIBOOST STRAWBERRY 300ML;1;6500;0;6500;5300;1200;
2021-06-09 19:59:38;8998666001306GT;TB CREAMY LATTE;1;13000;0;13000;9900;3100;
2021-06-09 19:59:38;HT;HOT-HOT;1;500;0;500;350;150;
2021-06-09 20:01:22;8993007003063;ENAAK 500G;1;11000;0;11000;9625;1375;
2021-06-09 20:01:22;8850507000094;POLICE BONCHA;2;2000;0;4000;1600;2400;
2021-06-09 20:01:22;KJ;KINDER JOY;2;2000;0;4000;3166;834;
2021-06-09 20:04:57;089686021127;INTER MIE KALDU;2;1000;0;2000;1626;374;
2021-06-09 20:04:57;RB;RED BOLD;1;19000;0;19000;17900;1100;
2021-06-09 20:04:57;8997009510055;YOU C1000;1;10000;0;10000;9166;834;
2021-06-09 20:04:57;8993470671752;JOGER STICK DUO KACANG;1;1000;0;1000;850;150;
2021-06-09 20:04:57;8998989300261;GUDANG GARAM SURYA 12 FILTER;1;18500;0;18500;17200;1300;
2021-06-09 20:04:57;8996001305041;ROMA SANDWICH CKLT;1;7000;0;7000;5000;2000;
2021-06-09 20:04:57;VCO;VITAMIN C500 ORANGE;1;1000;0;1000;575;425;
2021-06-09 20:04:57;8998866200882;SUKSESMIE GORENG AYAM KRMS 133GR;1;3500;0;3500;3047;453;
2021-06-09 20:04:57;8998866202732;MILKU STROBERI 200ML;1;3000;0;3000;2375;625;
2021-06-09 20:04:57;GL;GULA 1 LITER;3;11500;0;34500;31500;3000;
2021-06-09 20:04:57;8996001302323;MALKIST ABON;1;6500;0;6500;4800;1700;
2021-06-09 20:04:57;8998866201964;MINYAK GORENG SABRINA 2L POUCH;1;27500;0;27500;26753;747;
2021-06-09 20:04:57;8996001312278;MALKIST KEJU MANIS;2;6500;0;13000;10800;2200;
2021-06-09 20:04:57;8999999059781;SUNLIGHT LIME NEW POUCH 210ML;1;5000;0;5000;4300;700;
2021-06-09 20:04:57;089686021219;INTER MIE GORENG;2;1000;0;2000;1770;230;
2021-06-09 20:09:59;8991102300421;WFR TANGO COKLAT 176GR;1;10000;0;10000;8694;1306;
2021-06-09 20:09:59;8999909096004;SAMPOERNA 16 FILTER;1;24000;0;24000;23000;1000;
2021-06-09 20:09:59;8996001600221;KOPIKO 78;1;5000;0;5000;4283;717;
2021-06-09 20:40:24;089686043204;INDOMIE MIE ACEH;1;2700;0;2700;2452;248;
2021-06-09 20:40:24;YP;YUPI;1;250;0;250;208;42;
2021-06-09 21:08:58;8999909002821;MARLBORO BLACK 16;1;22000;0;22000;20850;1150;
2021-06-09 21:27:31;8999909000377;SAMPOERNA AVOLUTION;1;30000;0;30000;28450;1550;
2021-06-09 21:27:31;8991001005694;SELAMAT 20X15G;1;18000;0;18000;16000;2000;
2021-06-09 21:27:31;BRS5;BERAS BUMN 5KG;1;64000;0;64000;50500;13500;
2021-06-09 21:27:31;8998866611718;EKONOMI PENCUCI PIRING  LIQ 780ML;1;12000;0;12000;10900;1100;
2021-06-09 21:27:31;8998866102605;KODOMO TB REG 2IN1;1;7500;0;7500;6600;900;
2021-06-09 21:27:31;8998866200882;SUKSESMIE GORENG AYAM KRMS 133GR;1;3500;0;3500;3047;453;
2021-06-09 21:27:31;089686010107;INDOMIE KALDU AYAM;1;2500;0;2500;2150;350;
2021-06-09 21:27:31;8999908284907;MY BABY MINYAK TELON 90ML;1;25000;0;25000;22700;2300;
2021-06-09 21:27:31;8998989300261;GUDANG GARAM SURYA 12 FILTER;1;18500;0;18500;17200;1300;
2021-06-09 21:41:18;8997013790108;BIMURA KACANG TELUR 25G;3;1000;0;3000;2625;375;
2021-06-09 21:41:18;8994834005923;SPIX 1000;2;1000;0;2000;1700;300;
2021-06-09 21:41:18;8998866202619;MIE SEDAAP KOREAN SPICY SOUP;1;2500;0;2500;2273;227;
2021-06-09 21:41:18;JGR SHN;JOGER SHINY SACHET;1;500;0;500;437;63;
2021-06-09 21:58:11;8992959953129;SWEETY BRONZE M20;1;35000;0;35000;33020;1980;
2021-06-09 21:58:11;089686010343;INDOMIE SOTO MIE;2;2600;0;5200;4734;466;
2021-06-09 21:58:11;089686010824;INDOMIE GORENG SPESIAL;1;2700;0;2700;2452;248;
2021-06-09 21:58:11;089686043204;INDOMIE MIE ACEH;1;2700;0;2700;2452;248;
2021-06-09 21:58:11;089686011036;INDOMIE GORENG PEDAS;1;2700;0;2700;2452;248;
2021-06-09 21:59:10;8992761139018;ADES 600ML;1;3500;0;3500;2292;1208;
2021-06-09 22:17:02;8998898336405;TOLAK ANGIN FREE SUGAR;3;3500;0;10500;8598;1902;
2021-06-10 10:46:56;8996001600375;LE MINERAL 330ML;1;2000;0;2000;1417;583;
2021-06-10 10:46:56;8996001600146;TEH PUCUK HARUM 350ML;1;3000;0;3000;2314;686;
2021-06-10 11:10:22;8998866202466;JAPOTA HAPPY HONEY BUTTER;2;5000;0;10000;8300;1700;
2021-06-10 11:10:22;089686041705;INDOMIE GORENG JUMBO;3;3500;0;10500;9429;1071;
2021-06-10 11:10:22;089686043204;INDOMIE MIE ACEH;3;2700;0;8100;7356;744;
2021-06-10 11:10:44;HT;HOT-HOT;3;500;0;1500;1050;450;
2021-06-10 12:33:19;8998866501033;MINYAK GORENG SEDAAP POUCH 2L;3;29000;0;87000;83238;3762;
2021-06-10 13:31:21;8998866602563;NUVO FAMILY HIJAU 76G;3;2000;0;6000;5460;540;
2021-06-10 13:31:21;8998866602570;NUVO FAMILY KUNING 76G;1;2000;0;2000;1820;180;
2021-06-10 13:31:21;8999999059781;SUNLIGHT LIME NEW POUCH 210ML;1;5000;0;5000;4300;700;
2021-06-10 13:31:21;8999999033149;LIFEBUOY SHP PERAWATAN RMBT RONTOK 340ML;1;29500;0;29500;26850;2650;
2021-06-10 14:33:25;8999909096004;SAMPOERNA 16 FILTER;1;24000;0;24000;23000;1000;
2021-06-10 14:34:19;8996001600269;LE MINERAL 600ML;2;3000;0;6000;3376;2624;
2021-06-10 14:40:01;123124;KOREK BIASA;1;2000;0;2000;1800;200;
2021-06-10 15:29:53;8992696422735;DNCO CKLT UHT 110ML;1;2500;0;2500;2041;459;
2021-06-10 15:29:53;8996001600146;TEH PUCUK HARUM 350ML;1;3000;0;3000;2314;686;
2021-06-10 15:29:53;HT;HOT-HOT;1;500;0;500;350;150;
2021-06-10 17:11:37;SMC;BIMURA MAKARONI CINCIN 250G;1;10000;0;10000;9300;700;
2021-06-10 17:11:37;8997231980022;O'JELLY MINI STRAWBERRY;2;3000;0;6000;4500;1500;
2021-06-10 17:11:37;8997013790108;BIMURA KACANG TELUR 25G;1;1000;0;1000;875;125;
2021-06-10 17:18:28;6907992825076;JD WATERMELON APPLE;1;2000;0;2000;1700;300;
2021-06-10 17:22:07;8998989300261;GUDANG GARAM SURYA 12 FILTER;1;18500;0;18500;17200;1300;
2021-06-10 17:22:07;089686043051;INDOMIE COTO MAKASSAR;2;2800;0;5600;5050;550;
2021-06-10 18:13:51;8991001780065;TWISTER BLACK 140G;2;13000;0;26000;23400;2600;
2021-06-10 18:13:51;34678;SENDAL JEPIT;1;15000;0;15000;13500;1500;
2021-06-10 18:15:14;8996001600269;LE MINERAL 600ML;2;3000;0;6000;3376;2624;
2021-06-10 18:52:22;ARG;ARGUS 220ML;3;14500;0;43500;37500;6000;
2021-06-10 19:02:54;AMPLOP;AMPLOP;4;250;0;1000;560;440;
2021-06-10 19:21:51;8993989311279;CLAS MILD 12;1;17000;0;17000;15700;1300;
2021-06-10 19:40:06;8991102989428GT;TANGO CKLT 24G GT;2;7500;0;15000;12184;2816;
2021-06-10 19:40:06;8996001355985;BENG-BENG SHARE IT;1;27000;0;27000;25000;2000;
2021-06-10 19:43:05;8992696404441;BEAR BRAND 189ML;1;9000;0;9000;7887;1113;
2021-06-10 19:43:05;8998989110167;SURYA GUDANG GARAM 16 FILTER;1;25000;0;25000;23200;1800;
2021-06-10 19:45:00;8994834006128;TICTIC PEDAS;1;2000;0;2000;1700;300;
2021-06-10 19:45:00;8997231980022;O'JELLY MINI STRAWBERRY;1;3000;0;3000;2250;750;
2021-06-10 19:45:00;PRG;PARAGO;1;500;0;500;400;100;
2021-06-10 19:45:00;JGR SHN;JOGER SHINY SACHET;1;500;0;500;437;63;
2021-06-10 19:56:14;1223456;LEM CASTOL;1;10000;0;10000;8750;1250;
2021-06-10 19:58:37;8999999528843;CITRA PEARLY WHITE  60ML;1;6200;0;6200;5625;575;
2021-06-10 19:58:37;8999999706173;PEPSODENT WHITE 120G;1;6700;0;6700;5940;760;
2021-06-10 19:58:37;8998866602570;NUVO FAMILY KUNING 76G;1;2000;0;2000;1820;180;
2021-06-10 19:58:37;8991102385060;TANGO WAFFLE CHOX;1;9000;0;9000;8498;502;
2021-06-10 20:14:43;711844330108;ABC SARDEN CABAI;1;10000;0;10000;8000;2000;
2021-06-10 20:14:43;711844330009;ABC SARDEN TOMAT;1;10000;0;10000;8000;2000;
2021-06-10 20:34:05;GL;GULA 1 LITER;1;11500;0;11500;10500;1000;
2021-06-10 20:34:05;089686010824;INDOMIE GORENG SPESIAL;2;2700;0;5400;4904;496;
2021-06-10 20:39:00;8992775211434;PILUS GARUDA SAPI PANGGANG;1;5000;0;5000;4810;190;
2021-06-10 20:39:00;8997013790108;BIMURA KACANG TELUR 25G;1;1000;0;1000;875;125;
2021-06-10 20:39:00;8994834005923;SPIX 1000;1;1000;0;1000;850;150;
2021-06-10 20:39:00;JGR SHN;JOGER SHINY SACHET;6;500;0;3000;2622;378;
2021-06-10 20:52:17;8995333032113;TERIGU GATOT KACA 1 KG;1;8500;0;8500;8012;488;
2021-06-10 20:52:17;8995333060772;TERIGU GATOT KACA 500GR;1;4500;0;4500;4065;435;
2021-06-10 20:52:17;8997025915124;HATARI PEANUT 125G;1;7000;0;7000;6037;963;
2021-06-10 20:55:40;GL;GULA 1 LITER;1;11500;0;11500;10500;1000;
2021-06-10 21:46:50;8991002105409;KOPI KAPAL API;1;20000;0;20000;18888;1112;
2021-06-10 21:46:50;8994867000162;ROKOK PUNDIMAS KRETEK16;1;10000;0;10000;8600;1400;
2021-06-10 21:46:50;8998989110167;SURYA GUDANG GARAM 16 FILTER;1;25000;0;25000;23200;1800;
2021-06-10 22:10:18;8999099920486;SGM 0-6 1000G;1;87000;0;87000;83707;3293;
2021-06-10 22:10:18;711844330146;ABC SARDEN EXTRA PEDAS;1;10000;0;10000;8000;2000;
2021-06-10 22:10:18;YP;YUPI;4;250;0;1000;832;168;
2021-06-10 22:32:23;8993379152017;SABUN CUCI SURYA 200G;1;3000;0;3000;2281;719;
2021-06-10 22:32:23;8999999549565;PONDS ROSE MICELLAR WTR 100ML;1;25000;0;25000;22800;2200;
2021-06-10 22:32:23;8998866608312;GIV PAPAYA KOTAK 76GR;3;2000;0;6000;5460;540;
2021-06-10 22:32:23;8992696404441;BEAR BRAND 189ML;2;9000;0;18000;15774;2226;
2021-06-10 22:32:23;8992761139018;ADES 600ML;1;3500;0;3500;2292;1208;
2021-06-11 10:12:53;8998866501033;MINYAK GORENG SEDAAP POUCH 2L;3;29000;0;87000;83238;3762;
2021-06-11 11:10:01;089686010343;INDOMIE SOTO MIE;1;2600;0;2600;2367;233;
2021-06-11 11:10:01;8998866202619;MIE SEDAAP KOREAN SPICY SOUP;1;2500;0;2500;2273;227;
2021-06-11 11:10:01;8886013213208;FRENCH FREIS 2000;1;5000;0;5000;3750;1250;
2021-06-11 11:10:01;089686611878;QTELA TEMPE;1;6000;0;6000;5370;630;
2021-06-11 11:10:29;8997231980022;O'JELLY MINI STRAWBERRY;1;3000;0;3000;2250;750;
2021-06-11 11:54:47;8992761122331;FRESTEA APPEL 500ML;1;6500;0;6500;4708;1792;
2021-06-11 11:55:58;6907992823959;JD HAWTHORN BERRY;1;2000;0;2000;1700;300;
2021-06-11 12:57:38;SLAIM;SLAIM WARNA;1;2000;0;2000;1743;257;
2021-06-11 12:57:58;8998866202732;MILKU STROBERI 200ML;1;3000;0;3000;2375;625;
2021-06-11 13:41:37;8996001600399;LE MINERAL 1500ML;1;5000;0;5000;4042;958;
2021-06-11 13:41:37;8992761136161;COCACOLA 1L;1;10000;0;10000;9000;1000;
2021-06-11 13:41:37;8992759120264;LARISST 220;1;10000;0;10000;9200;800;
2021-06-11 13:41:37;8991102989534;TANGO VANILA 24G;1;1000;0;1000;609;391;
2021-06-11 13:41:37;8999999192150;ROYCO FDS CHICKEN 100GR;1;5000;0;5000;4300;700;
2021-06-11 14:05:42;WC;WAFER COKELAT MADE;2;1000;0;2000;1600;400;
2021-06-11 14:48:11;8998866200301;MIE SEDAAP GORENG;1;2500;0;2500;2023;477;
2021-06-11 14:48:11;COKLAT;COKLAT COIN;3;500;0;1500;1275;225;
2021-06-11 15:01:25;8998866202770;MIE SEDAAP SALERO PADANG;2;2500;0;5000;4724;276;
2021-06-11 16:22:49;GL;GULA 1 LITER;1;11500;0;11500;10500;1000;
2021-06-11 16:23:45;089686611519;QTELA SINGKONG;1;5000;0;5000;4266;734;
2021-06-11 16:24:28;8993072254056;MELROSE COTTON BUDS KCL;1;3000;0;3000;2450;550;
2021-06-11 16:24:28;8998866202770;MIE SEDAAP SALERO PADANG;4;2500;0;10000;9448;552;
2021-06-11 16:58:36;6907992823966;JD BLUEBERRY;1;3500;0;3500;3000;500;
2021-06-11 16:58:36;6907992823959;JD HAWTHORN BERRY;1;2000;0;2000;1700;300;
2021-06-11 16:58:36;8998866202732;MILKU STROBERI 200ML;1;3000;0;3000;2375;625;
2021-06-11 16:58:36;bb;BENG-BENG;1;1500;0;1500;1450;50;
2021-06-11 16:59:24;6907992823935;JD SWEETCORN;1;3500;0;3500;3000;500;
2021-06-11 17:19:49;8999999516208;ROYCO FDS CHICKEN NEW 230G;5;10000;0;50000;45000;5000;
2021-06-11 17:21:50;8934868015024;REXONA DEO LOTION FREE SPIRIT 9G;2;4500;0;9000;7800;1200;
2021-06-11 17:29:39;8999999030186;PEPSODENT ACTION 123 COMPLETE 190G;1;14000;0;14000;13200;800;
2021-06-11 17:29:39;8991102381024;FULLO VNL PCK;2;10000;0;20000;18000;2000;
2021-06-11 17:49:49;8996001600146;TEH PUCUK HARUM 350ML;1;3000;0;3000;2314;686;
2021-06-11 17:49:49;MARS;MARSHMELLOW;2;500;0;1000;866;134;
2021-06-11 17:53:26;8996001318980;BETTER 120G;1;6000;0;6000;5100;900;
2021-06-11 17:53:26;8996001600221;KOPIKO 78;1;5000;0;5000;4283;717;
2021-06-11 17:54:53;8997007780689;JIZZY MINERAL;3;3000;0;9000;3561;5439;
2021-06-11 17:54:53;6907992823850;JD CHOCO CIRLE;1;5500;0;5500;4700;800;
2021-06-11 17:54:53;8998866202244;EKOMIE BUMBU KALDU AYAM;1;1000;0;1000;798;202;
2021-06-11 17:54:53;WC;WAFER COKELAT MADE;1;1000;0;1000;800;200;
2021-06-11 17:54:53;YP;YUPI;2;250;0;500;416;84;
2021-06-11 18:23:39;8996001600399;LE MINERAL 1500ML;1;5000;0;5000;4042;958;
2021-06-11 18:24:01;8996001600399;LE MINERAL 1500ML;1;5000;0;5000;4042;958;
2021-06-11 19:08:06;8998989500166;GUDANG GARAM MERAH BESAR 16KS;1;18000;0;18000;17000;1000;
2021-06-11 19:08:06;123124;KOREK BIASA;1;2000;0;2000;1800;200;
2021-06-11 19:53:31;8998009020186;BUAVITA GUAVA 250ML;2;7000;0;14000;12166;1834;
2021-06-11 20:06:32;8993989311279;CLAS MILD 12;1;17000;0;17000;15700;1300;
2021-06-11 20:07:22;8992775913000SCT;CHOCOLATOS CKLT DRINK SCT;3;2000;0;6000;4758;1242;
2021-06-11 20:13:15;8999999528843;CITRA PEARLY WHITE  60ML;1;6200;0;6200;5625;575;
2021-06-11 20:13:15;8993335523363;TOTAL ALMEERA 250G;1;5000;0;5000;4100;900;
2021-06-11 20:13:15;8996001600399;LE MINERAL 1500ML;1;5000;0;5000;4042;958;
2021-06-11 20:13:15;8991102989428SCT;TANGO CKLT 24G SCT;2;1000;0;2000;1218;782;
2021-06-11 20:13:15;8998866202923;FLORIDINA COCO;1;3000;0;3000;2500;500;
2021-06-11 20:13:15;8992959117613;SFX DAUN SIRIH WING 1;2;5000;0;10000;8260;1740;
2021-06-11 20:16:45;SFX;SOFTEX DAUN SIRIH 1;2;500;0;1000;826;174;
2021-06-11 21:43:53;8998009020186;BUAVITA GUAVA 250ML;1;7000;0;7000;6083;917;
2021-06-11 21:43:53;8998866201827;JAVANA GULA BATU 350ML;1;3000;0;3000;2150;850;
2021-06-11 21:44:38;ARG;ARGUS 220ML;3;14500;0;43500;37500;6000;
2021-06-11 21:53:41;GL;GULA 1 LITER;1;11500;0;11500;10500;1000;
2021-06-11 21:53:41;bb;BENG-BENG;1;1500;0;1500;1450;50;
2021-06-12 10:41:17;8850507001152;MOTU ATV;1;10000;0;10000;8000;2000;
2021-06-12 10:41:17;SMC;BIMURA MAKARONI CINCIN 250G;1;10000;0;10000;9300;700;
2021-06-12 10:46:28;8998989500128;GUDANG GARAM MERAH KECIL 12KS;1;14000;0;14000;13000;1000;
2021-06-12 10:46:28;8992696404441;BEAR BRAND 189ML;1;9000;0;9000;7887;1113;
2021-06-12 11:44:17;8991001121615;SILVERQUEEN NUT;1;15000;0;15000;13200;1800;
2021-06-12 11:44:17;8999999528928;CITRA NOURISH WHT 230ML;1;20000;0;20000;18040;1960;
2021-06-12 11:44:17;8999999030179;PEPSODENT ACTION 123 COMPLETE 75G;1;6700;0;6700;5170;1530;
2021-06-12 11:44:17;8991002105409;KOPI KAPAL API;1;20000;0;20000;18888;1112;
2021-06-12 11:44:17;8992775913000SCT;CHOCOLATOS CKLT DRINK SCT;7;2000;0;14000;11102;2898;
2021-06-12 12:14:31;8992628605151;AMANDA MARGARINE;1;5000;0;5000;3806;1194;
2021-06-12 12:14:31;SS;SUPER SNAPS;1;1500;0;1500;1333;167;
2021-06-12 12:29:25;8997231980022;O'JELLY MINI STRAWBERRY;1;3000;0;3000;2250;750;
2021-06-12 12:29:25;8998866501033;MINYAK GORENG SEDAAP POUCH 2L;2;29000;0;58000;55492;2508;
2021-06-12 12:29:25;GL;GULA 1 LITER;1;11500;0;11500;10500;1000;
2021-06-12 12:48:27;8998989500166;GUDANG GARAM MERAH BESAR 16KS;2;18000;0;36000;34000;2000;
2021-06-12 12:48:27;8998866106979;CIPTADENT TB CHARCOAL PROTEC;1;6000;0;6000;5250;750;
2021-06-12 12:53:58;BTS;BIMURA TARO SEAWEED 250G;1;10000;0;10000;9300;700;
2021-06-12 12:53:58;8998866608756;SOKLIN SOFTENER TWILIGHT BLUE 14SCH;1;5000;0;5000;4560;440;
2021-06-12 13:25:20;8991001111883;SILVERQUEEN CHUNKYBAR 33G;1;8000;0;8000;7150;850;
2021-06-12 13:36:49;8998009020186;BUAVITA GUAVA 250ML;2;7000;0;14000;12166;1834;
2021-06-12 13:53:31;8996001302620;MALKIST COKLAT SCT;2;1000;0;2000;1680;320;
2021-06-12 14:24:20;8992222052979;GATSBY WATER GLOSS MERAH;1;5000;0;5000;3700;1300;
2021-06-12 14:24:20;8997210107877;VORTEX SMART 3;1;10000;0;10000;9500;500;
2021-06-12 14:36:32;8996001302620;MALKIST COKLAT SCT;1;1000;0;1000;840;160;
2021-06-12 14:55:13;8992628020152;BIMOLI POUCH 2L;1;31000;0;31000;29800;1200;
2021-06-12 14:55:13;8999999036355;SUNLIGHT LIME BTL 750ML;1;25000;0;25000;23050;1950;
2021-06-12 15:38:44;8998866501026;MINYAK GORENG SEDAAP POUCH 1 L;1;15000;0;15000;14110;890;
2021-06-12 15:38:44;8999999519735;PEPSODENT TB BAMBOO SALT;1;13200;0;13200;11990;1210;
2021-06-12 15:38:44;8996001600375;LE MINERAL 330ML;1;2000;0;2000;1417;583;
2021-06-12 15:38:44;8996001600269;LE MINERAL 600ML;1;3000;0;3000;1688;1312;
2021-06-12 15:38:44;8998866611718;EKONOMI PENCUCI PIRING  LIQ 780ML;1;12000;0;12000;10900;1100;
2021-06-12 15:45:16;8992759120264;LARISST 220;1;10000;0;10000;9200;800;
2021-06-12 15:45:16;8997226852006;TEH CAP KAMPUNG MANIS;1;12000;0;12000;10000;2000;
2021-06-12 16:49:46;8998866501033;MINYAK GORENG SEDAAP POUCH 2L;1;29000;0;29000;27746;1254;
2021-06-12 17:28:23;8998866200561;EKOMIE SUPER 600GR;2;10000;0;20000;17230;2770;
2021-06-12 17:53:10;8992761111533;SPRITE SLIM CAM250ML;1;5000;0;5000;3750;1250;
2021-06-12 18:44:46;8997002060168;KRP SINGKOG PDS PANDA DUO;1;8000;0;8000;7300;700;
2021-06-12 18:47:47;ARG;ARGUS 220ML;1;14500;0;14500;12500;2000;
2021-06-12 18:47:47;8998866200325;MIE SEDAAP SOTO;4;2500;0;10000;7808;2192;
2021-06-12 18:47:47;8994867007161;ROKOK PENA GOLD 20;1;17000;0;17000;15500;1500;
2021-06-12 18:52:14;089686043273;INDOMIE SAMBAL RICA;2;2700;0;5400;4904;496;
2021-06-12 18:53:48;8998866202244;EKOMIE BUMBU KALDU AYAM;1;1000;0;1000;798;202;
2021-06-12 19:11:21;8993379254469;SABUN LERVIA 90G;2;5000;0;10000;6154;3846;
2021-06-12 19:11:21;8999999558079;RINSO MOLTO ROSE FRESH PWD 44G;1;1000;0;1000;805;195;
2021-06-12 19:11:21;8886013213208;FRENCH FREIS 2000;2;5000;0;10000;7500;2500;
2021-06-12 19:11:21;8992959117514;SFX NON WING 20;1;10000;0;10000;9091;909;
2021-06-12 19:11:21;8992957220025;GOLDEN CITY MINI;1;3000;0;3000;2500;500;
2021-06-12 19:16:21;8994834005923;SPIX 1000;1;1000;0;1000;850;150;
2021-06-12 19:16:21;8991102989534;TANGO VANILA 24G;2;1000;0;2000;1218;782;
2021-06-12 19:16:21;JGR SHN;JOGER SHINY SACHET;1;500;0;500;437;63;
2021-06-12 19:46:21;8997025914059;HATARI SEE HONG;1;6000;0;6000;4911;1089;
2021-06-12 19:52:38;8998866501026;MINYAK GORENG SEDAAP POUCH 1 L;1;15000;0;15000;14110;890;
2021-06-12 19:52:38;089686044249;SUPERMI NUTRIMI STEAK AYAM;1;3500;0;3500;2800;700;
2021-06-12 19:52:38;VTM;VITAMIN;3;500;0;1500;1275;225;
2021-06-12 20:06:55;8996001355985;BENG-BENG SHARE IT;1;27000;0;27000;25000;2000;
2021-06-12 20:06:55;8991102989428GT;TANGO CKLT 24G GT;2;7500;0;15000;12184;2816;
2021-06-12 20:22:21;8992761139018;ADES 600ML;1;3500;0;3500;2292;1208;
2021-06-12 20:22:21;8996001600269;LE MINERAL 600ML;3;3000;0;9000;5064;3936;
2021-06-12 20:22:21;8996001600597;KOPIKO LUCKY DAY;1;5000;0;5000;4283;717;
2021-06-12 20:22:21;8991102989428GT;TANGO CKLT 24G GT;2;7500;0;15000;12184;2816;
2021-06-12 20:22:21;8996001318980;BETTER 120G;1;6000;0;6000;5100;900;
2021-06-12 20:22:21;6907992823904;JD CRUNCHY CHOCOLATE VAN;1;8000;0;8000;6800;1200;
2021-06-12 22:00:43;8992959953044;SWEETY BRONZE XL1;2;2500;0;5000;4500;500;
2021-06-12 22:00:44;WC;WAFER COKELAT MADE;1;1000;0;1000;800;200;
2021-06-12 22:00:44;SLAIM;SLAIM WARNA;2;2000;0;4000;3486;514;
2021-06-12 22:12:39;8993058304201;BEJO JAHE MERAH;1;3000;0;3000;1893;1107;
2021-06-13 10:36:12;8998866501033;MINYAK GORENG SEDAAP POUCH 2L;2;29000;0;58000;55492;2508;
2021-06-13 10:52:33;8999908284907;MY BABY MINYAK TELON 90ML;1;25000;0;25000;22700;2300;
2021-06-13 10:52:33;8998989300261;GUDANG GARAM SURYA 12 FILTER;1;18500;0;18500;17200;1300;
2021-06-13 11:04:53;8992775913000GT;CHOCOLATOS CKLT DRINK;2;18000;0;36000;31724;4276;
2021-06-13 11:04:53;8997009510017;YOU C1000 LEMON;1;10000;0;10000;9166;834;
2021-06-13 11:04:53;8999999042608;RINSO MOLTO PARFUME ESSENCE 750ML;1;15000;0;15000;12507;2493;
2021-06-13 11:04:53;8992775110157;GARUDA KACANG KULIT;1;5000;0;5000;3925;1075;
2021-06-13 11:04:53;8996001600610;TORA MILKY LATTE 180ML;1;3500;0;3500;2750;750;
2021-06-13 11:04:53;8991002103764;GOOD DAY CAPPUCINO 10X25G;1;1500;0;1500;1395;105;
2021-06-13 11:04:53;8997007780689;JIZZY MINERAL;1;3000;0;3000;1187;1813;
2021-06-13 11:13:02;MOLTO PINK;MOLTO ALL IN ONE 11 ML;2;500;0;1000;800;200;
2021-06-13 11:13:02;8993335523363;TOTAL ALMEERA 250G;1;5000;0;5000;4100;900;
2021-06-13 11:58:44;9999;ISOLASI LAKBAN;1;8000;0;8000;6500;1500;
2021-06-13 12:09:52;8886020033431;KAPUR AJAIB ANTI KECOA DAN NYAMUK;1;3000;0;3000;2700;300;
2021-06-13 13:07:57;8997021870076;FRESH CARE SANDAL WOOD 10ML;1;12000;0;12000;10000;2000;
2021-06-13 13:47:46;6907992825076;JD WATERMELON APPLE;1;2000;0;2000;1700;300;
2021-06-13 13:47:46;6907992823959;JD HAWTHORN BERRY;1;2000;0;2000;1700;300;
2021-06-13 13:47:46;HT;HOT-HOT;1;500;0;500;350;150;
2021-06-13 14:06:11;8998989500128;GUDANG GARAM MERAH KECIL 12KS;2;14000;0;28000;26000;2000;
2021-06-13 14:06:11;8999909096004;SAMPOERNA 16 FILTER;1;24000;0;24000;23000;1000;
2021-06-13 14:57:28;SLAIM;SLAIM WARNA;1;2000;0;2000;1743;257;
2021-06-13 14:57:28;COKLAT;COKLAT COIN;2;500;0;1000;850;150;
2021-06-13 14:57:28;PRG;PARAGO;2;500;0;1000;800;200;
2021-06-13 14:57:28;MARS;MARSHMELLOW;2;500;0;1000;866;134;
2021-06-13 15:57:26;8993053641042;PASEO BABY WIPES GAZETTE 50S;1;17000;0;17000;15400;1600;
2021-06-13 15:57:26;8992775311325;GERY SNACK&SEREAL 100G;2;7000;0;14000;12024;1976;
2021-06-13 15:57:26;8992959508312;SWEETY SILVER PANTS XL RTG;1;15500;0;15500;13944;1556;
2021-06-13 16:50:32;TBR;TEPUNG BERAS;1;8000;0;8000;8000;0;
2021-06-13 16:50:32;8992628020152;BIMOLI POUCH 2L;1;31000;0;31000;29800;1200;
2021-06-13 17:30:00;8996001600375;LE MINERAL 330ML;4;2000;0;8000;5668;2332;
2021-06-13 18:13:21;8996001600269;LE MINERAL 600ML;2;3000;0;6000;3376;2624;
2021-06-13 18:18:05;8992761166038;MMP ORANGE 300ML;1;5000;0;5000;3750;1250;
2021-06-13 18:21:20;8996001305041;ROMA SANDWICH CKLT;2;7000;0;14000;10000;4000;
2021-06-13 18:21:20;8992761002039;FANTA STRAWBERRY PET 390 ML;1;5500;0;5500;4300;1200;
2021-06-13 18:55:01;8998866501033;MINYAK GORENG SEDAAP POUCH 2L;1;29000;0;29000;27746;1254;
2021-06-13 18:55:01;8991188943062;SASA 250G;1;10000;0;10000;8500;1500;
2021-06-13 19:05:16;8998989500166;GUDANG GARAM MERAH BESAR 16KS;1;18000;0;18000;17000;1000;
2021-06-13 19:42:58;8997027300089;NOMOS;2;4000;0;8000;5926;2074;
2021-06-13 19:42:58;8991102989428SCT;TANGO CKLT 24G SCT;4;1000;0;4000;2436;1564;
2021-06-13 20:13:48;8992959953136;SWEETY BRONZE L20;1;40000;0;40000;36770;3230;
2021-06-13 20:13:48;8998898337440;TOLAK ANGIN CARE 10ML;1;10000;0;10000;7893;2107;
2021-06-13 20:33:39;8998866202930;SEDAAP AYAM JERIT CUP;1;4500;0;4500;3738;762;
2021-06-13 20:44:44;8994867000162;ROKOK PUNDIMAS KRETEK16;1;10000;0;10000;8600;1400;
2021-06-13 20:44:44;8998866202930;SEDAAP AYAM JERIT CUP;1;4500;0;4500;3738;762;
2021-06-13 21:03:30;8992761002039;FANTA STRAWBERRY PET 390 ML;2;5500;0;11000;8600;2400;
2021-06-13 21:04:16;8992761166212;FRESTEA APPLE 350ML;1;4500;0;4500;3000;1500;
2021-06-13 21:04:16;JGR SHN;JOGER SHINY SACHET;1;500;0;500;437;63;
2021-06-13 21:07:05;PRG;PARAGO;2;500;0;1000;800;200;
2021-06-13 21:07:05;bb;BENG-BENG;2;1500;0;3000;2900;100;
2021-06-13 21:07:05;8996001318430;BETTER 1000;1;1000;0;1000;820;180;
2021-06-13 21:07:05;8992959953044;SWEETY BRONZE XL1;2;2500;0;5000;4500;500;
2021-06-13 21:14:49;8991002105409;KOPI KAPAL API;1;20000;0;20000;18888;1112;
2021-06-13 21:25:08;8994867007161;ROKOK PENA GOLD 20;1;17000;0;17000;15500;1500;
2021-06-13 22:15:52;8998866200325;MIE SEDAAP SOTO;2;2500;0;5000;3904;1096;
2021-06-13 22:15:52;8992959953099;SWEETY BRONZE XL7;1;16000;0;16000;15190;810;
2021-06-13 22:15:52;089686021127;INTER MIE KALDU;1;1000;0;1000;813;187;
2021-06-13 22:51:04;8998866201827;JAVANA GULA BATU 350ML;1;3000;0;3000;2150;850;
2021-06-13 22:51:04;8998989300261;GUDANG GARAM SURYA 12 FILTER;1;18500;0;18500;17200;1300;
2021-06-13 22:54:57;8992775002155;CHOCOLATOS DRINK;1;4000;0;4000;3520;480;
2021-06-13 22:54:57;8992761164539;NUTRIBOOST ORANGE 300ML;1;6500;0;6500;5300;1200;
2021-06-13 22:54:57;YP;YUPI;2;250;0;500;416;84;
2021-06-13 22:54:57;COKLAT;COKLAT COIN;2;500;0;1000;850;150;
2021-06-13 22:54:57;8993470279651;JOGER CHOCKY BAR;1;1000;0;1000;867;133;
2021-06-13 22:54:57;8998866202619;MIE SEDAAP KOREAN SPICY SOUP;1;2500;0;2500;2273;227;
2021-06-13 22:54:57;8997007780689;JIZZY MINERAL;1;3000;0;3000;1187;1813;
2021-06-13 22:54:57;8992730002992;HAI CANDY;1;7000;0;7000;6000;1000;
2021-06-13 22:54:57;8991002103764;GOOD DAY CAPPUCINO 10X25G;1;1500;0;1500;1395;105;
2021-06-13 22:54:57;8996001600221;KOPIKO 78;1;5000;0;5000;4283;717;
2021-06-14 10:55:00;SLAIM;SLAIM WARNA;2;2000;0;4000;3486;514;
2021-06-14 11:09:58;8992761002022;SPRITE PET 390ML;1;5500;0;5500;4300;1200;
2021-06-14 11:33:48;8992761002022;SPRITE PET 390ML;1;5500;0;5500;4300;1200;
2021-06-14 11:33:48;8993274532105;BOLU;4;1000;0;4000;3332;668;
2021-06-14 11:33:56;JGR SHN;JOGER SHINY SACHET;1;500;0;500;437;63;
2021-06-14 11:51:59;6907992823973;JD PINEAPPLE;1;5000;0;5000;4300;700;
2021-06-14 11:51:59;6907992824963;JD MILKY CHOCOLATE;1;3000;0;3000;2600;400;
2021-06-14 12:57:41;6907992825076;JD WATERMELON APPLE;1;2000;0;2000;1700;300;
2021-06-14 12:57:41;8996001600269;LE MINERAL 600ML;1;3000;0;3000;1688;1312;
2021-06-14 13:10:33;SLAIM;SLAIM WARNA;1;2000;0;2000;1743;257;
2021-06-14 13:14:09;8999909000711;MAGNUM MILD 16;1;21000;0;21000;19350;1650;
2021-06-14 15:16:04;8992775211434;PILUS GARUDA SAPI PANGGANG;1;5000;0;5000;4810;190;
2021-06-14 15:16:04;8992775001042;PILUS GARUDA MI GORENG;1;5000;0;5000;4810;190;
2021-06-14 15:16:15;8996001600269;LE MINERAL 600ML;1;3000;0;3000;1688;1312;
2021-06-14 15:16:25;SWAL;SENDAL SWALLOW;1;18000;0;18000;16500;1500;
2021-06-14 16:48:56;8994834005923;SPIX 1000;1;1000;0;1000;850;150;
2021-06-14 16:48:56;SLAIM;SLAIM WARNA;1;2000;0;2000;1743;257;
2021-06-14 16:48:56;089686021127;INTER MIE KALDU;4;1000;0;4000;3252;748;
2021-06-14 16:48:56;089686021141;INTER MIE SOTO;3;1000;0;3000;2562;438;
2021-06-14 16:48:56;089686021219;INTER MIE GORENG;3;1000;0;3000;2655;345;
2021-06-14 16:50:43;8994867000179;ROKOK PENA MILD 16;1;14500;0;14500;13500;1000;
2021-06-14 17:07:52;8998989300261;GUDANG GARAM SURYA 12 FILTER;1;18500;0;18500;17200;1300;
2021-06-14 17:15:44;MARS;MARSHMELLOW;2;500;0;1000;866;134;
2021-06-14 17:17:19;8997231980015;O'JELLY MINI APPLE;1;3000;0;3000;2250;750;
2021-06-14 17:25:36;6907992823935;JD SWEETCORN;1;3500;0;3500;3000;500;
2021-06-14 17:25:36;MARS;MARSHMELLOW;1;500;0;500;433;67;
2021-06-14 17:29:13;8993083929806;BISKITOP COKLAT;1;30000;0;30000;27000;3000;
2021-06-14 17:31:00;8992696521797GT;MILO ACT GO SCT 22G;1;17500;0;17500;15536;1964;
2021-06-14 17:31:00;8996001305249;ROMA KELAPA CREAM;1;6800;0;6800;5514;1286;
2021-06-14 17:54:17;8993989311699;CLAS MILD 16 FILTER;1;23000;0;23000;21700;1300;
2021-06-14 17:54:17;8991102384841;WFR TANGO LONG CKLT 130G;1;5000;0;5000;4345;655;
2021-06-14 17:59:52;711844110021;KECAP ABC 600 ML;1;22000;0;22000;20700;1300;
2021-06-14 17:59:52;711844120037;SAMBAL ABC 135 ML;1;7000;0;7000;5600;1400;
2021-06-14 18:21:36;ARG;ARGUS 220ML;3;14500;0;43500;37500;6000;
2021-06-14 19:35:35;8992694247255;ZWITSAL BATH NAT HAIR&BODY 200ML;1;20500;0;20500;18810;1690;
2021-06-14 19:35:35;8999999005580;DOVE DEO WMN RONOURISH & SMOOTH 40 ML;1;17800;0;17800;16050;1750;
2021-06-14 19:35:35;8999999557355;ZWITSAL BABY BOTTLE CLEANER 135 ML;1;5000;0;5000;4000;1000;
2021-06-14 19:35:35;089686010107;INDOMIE KALDU AYAM;1;2500;0;2500;2150;350;
2021-06-14 19:46:21;76239878;MARLBORO GOLD;1;30000;0;30000;27700;2300;
2021-06-14 19:46:21;8998989300261;GUDANG GARAM SURYA 12 FILTER;1;18500;0;18500;17200;1300;
2021-06-14 19:52:56;8998866200301;MIE SEDAAP GORENG;2;2500;0;5000;4046;954;
2021-06-14 19:52:56;8994834005923;SPIX 1000;2;1000;0;2000;1700;300;
2021-06-14 19:52:56;8997013790108;BIMURA KACANG TELUR 25G;1;1000;0;1000;875;125;
2021-06-14 19:56:02;089686010107;INDOMIE KALDU AYAM;1;2500;0;2500;2150;350;
2021-06-14 19:56:02;089686010824;INDOMIE GORENG SPESIAL;1;2700;0;2700;2452;248;
2021-06-14 19:56:02;089686010343;INDOMIE SOTO MIE;1;2600;0;2600;2367;233;
2021-06-14 19:57:07;8999909982000;SAMPOERNA 12 FILTER;1;18000;0;18000;16000;2000;
2021-06-14 19:57:07;8998989300261;GUDANG GARAM SURYA 12 FILTER;1;18500;0;18500;17200;1300;
2021-06-14 20:00:48;8996001302316;MALKIST ABON SCT;5;1000;0;5000;4200;800;
2021-06-14 20:00:48;8997028590014;ARGUS 220ML;10;500;0;5000;3020;1980;
2021-06-14 20:19:31;8999909010567;234 DJI SAM SOE 16;1;22000;0;22000;21500;500;
2021-06-14 20:38:39;8999999031930;PEPSODENT TB TRIPLE CLEAN;2;3500;0;7000;5700;1300;
2021-06-14 20:43:54;8998866202770;MIE SEDAAP SALERO PADANG;1;2500;0;2500;2362;138;
2021-06-14 20:43:54;089686010107;INDOMIE KALDU AYAM;1;2500;0;2500;2150;350;
2021-06-14 20:43:54;8998866200301;MIE SEDAAP GORENG;1;2500;0;2500;2023;477;
2021-06-14 20:43:54;089686043204;INDOMIE MIE ACEH;1;2700;0;2700;2452;248;
2021-06-14 21:12:30;8998866200882;SUKSESMIE GORENG AYAM KRMS 133GR;1;3500;0;3500;3047;453;
2021-06-14 21:12:30;JGR SHN;JOGER SHINY SACHET;3;500;0;1500;1311;189;
2021-06-14 21:17:17;089686010107;INDOMIE KALDU AYAM;2;2500;0;5000;4300;700;
2021-06-14 21:17:17;089686010343;INDOMIE SOTO MIE;2;2600;0;5200;4734;466;
2021-06-14 21:17:17;089686043051;INDOMIE COTO MAKASSAR;2;2800;0;5600;5050;550;
2021-06-14 21:17:17;8996001301142;ROMA KELAPA;1;8000;0;8000;6628;1372;
2021-06-14 21:29:54;JGR SH;JOGER SHINY CHOCO;1;17500;0;17500;16235;1265;
2021-06-14 21:29:54;8992957220025;GOLDEN CITY MINI;1;3000;0;3000;2500;500;
2021-06-14 21:29:54;BALON;BALON CABUT;1;1000;0;1000;900;100;
2021-06-14 21:29:54;6907992823959;JD HAWTHORN BERRY;1;2000;0;2000;1700;300;
2021-06-14 21:29:54;VTM;VITAMIN;1;500;0;500;425;75;
2021-06-14 21:32:25;8998866105507;EMERON LOVELY NOURIST&BRIGHT 100ML;1;4300;0;4300;3800;500;
2021-06-14 21:32:25;6907992823935;JD SWEETCORN;1;3500;0;3500;3000;500;
2021-06-14 21:32:25;8996001600269;LE MINERAL 600ML;1;3000;0;3000;1688;1312;
2021-06-14 21:32:25;8991102384841;WFR TANGO LONG CKLT 130G;1;5000;0;5000;4345;655;
2021-06-14 21:56:51;BALON;BALON CABUT;2;1000;0;2000;1800;200;
2021-06-14 21:56:51;8886020033431;KAPUR AJAIB ANTI KECOA DAN NYAMUK;1;3000;0;3000;2700;300;
2021-06-15 10:20:06;6907992823843;JD MOCHA CRISPY;1;5000;0;5000;4400;600;
2021-06-15 10:21:23;8992959508848;SWEETY SILVER PANTS L 18;1;41500;0;41500;37728;3772;
2021-06-15 10:25:43;8999909002821;MARLBORO BLACK 16;1;22000;0;22000;20850;1150;
2021-06-15 10:47:14;8994834006128;TICTIC PEDAS;1;2000;0;2000;1700;300;
2021-06-15 12:55:47;BALON;BALON CABUT;7;1000;0;7000;6300;700;
2021-06-15 13:15:03;8998866201452;POTABEE REGULER BBQ BEEF 35GR;1;5000;0;5000;4150;850;
2021-06-15 13:15:03;8997231980022;O'JELLY MINI STRAWBERRY;1;3000;0;3000;2250;750;
2021-06-15 13:15:03;8996001600375;LE MINERAL 330ML;1;2000;0;2000;1417;583;
2021-06-15 13:15:41;8992759120264;LARISST 220;2;10000;0;20000;18400;1600;
2021-06-15 13:15:51;SLAIM;SLAIM WARNA;1;2000;0;2000;1743;257;
2021-06-15 13:16:22;8996001600269;LE MINERAL 600ML;1;3000;0;3000;1688;1312;
2021-06-15 14:17:28;bb;BENG-BENG;1;1500;0;1500;1450;50;
2021-06-15 14:17:28;8998866501033;MINYAK GORENG SEDAAP POUCH 2L;1;29000;0;29000;27746;1254;
2021-06-15 15:03:40;8996001600375;LE MINERAL 330ML;1;2000;0;2000;1417;583;
2021-06-15 15:34:58;8999999524722;SUNLIGHT LIME NEW PCH 435ML;1;10000;0;10000;9100;900;
2021-06-15 15:37:24;8992696521797SCT;MILO UHT ACT GO 22G;1;2000;0;2000;1412;588;
2021-06-15 15:37:24;8999999502003;SARIMURNI RL RB 1,8G;1;1500;0;1500;1207;293;
2021-06-15 15:37:24;BALON;BALON CABUT;6;1000;0;6000;5400;600;
2021-06-15 17:07:53;8999909028234;234 DJI SAM SOE 12;1;17000;0;17000;15850;1150;
2021-06-15 17:13:50;SLAIM;SLAIM WARNA;1;2000;0;2000;1743;257;
2021-06-15 17:29:57;8995333032113;TERIGU GATOT KACA 1 KG;2;8500;0;17000;16024;976;
2021-06-15 18:07:10;BALON;BALON CABUT;1;1000;0;1000;900;100;
2021-06-15 18:32:48;GL;GULA 1 LITER;1;11500;0;11500;10500;1000;
2021-06-15 18:32:48;8998989500166;GUDANG GARAM MERAH BESAR 16KS;2;18000;0;36000;34000;2000;
2021-06-15 18:47:48;089686043273;INDOMIE SAMBAL RICA;1;2700;0;2700;2452;248;
2021-06-15 19:08:13;8998866609043;DAIA SOFTENER GUSSET 565G;1;10000;0;10000;8700;1300;
2021-06-15 19:08:13;711844120037;SAMBAL ABC 135 ML;1;7000;0;7000;5600;1400;
2021-06-15 19:08:13;8998866200325;MIE SEDAAP SOTO;3;2500;0;7500;5856;1644;
2021-06-15 19:08:13;8999999525088;MOLTO AIO BLUE SPK 250ML;1;9800;0;9800;8910;890;
2021-06-15 19:10:42;8998866202930;SEDAAP AYAM JERIT CUP;1;4500;0;4500;3738;762;
2021-06-15 20:29:00;8998866201964;MINYAK GORENG SABRINA 2L POUCH;1;28000;0;28000;26753;1247;
2021-06-15 21:11:27;8999909010567;234 DJI SAM SOE 16;1;22000;0;22000;21500;500;
2021-06-15 21:11:27;8993989311699;CLAS MILD 16 FILTER;1;23000;0;23000;21700;1300;
2021-06-15 21:34:00;8992959953129;SWEETY BRONZE M20;1;35000;0;35000;33020;1980;
2021-06-15 21:34:00;8996001600399;LE MINERAL 1500ML;1;5000;0;5000;4042;958;
2021-06-15 21:40:11;8992775000014;CHOCOLATOS HAZELNUT;1;18000;0;18000;15483;2517;
2021-06-15 21:40:11;8999999195649;SARI WANGI 25X1.86G;1;6000;0;6000;5050;950;
2021-06-15 21:40:11;8992736025162;SASA TEPUNG PISANG GORENG;1;5000;0;5000;4455;545;
2021-06-15 21:40:11;711844120419;SAMBAL ABC 275 ML;1;12000;0;12000;10800;1200;
2021-06-15 21:40:11;9556040040038;SUSU F&N;1;33000;0;33000;30000;3000;
2021-06-15 21:40:11;4801010531234;JB BATH BLUE 200 (REFILL);1;14000;0;14000;13530;470;
2021-06-15 21:40:11;8992745320326;STELLA ORG 200ML;1;15000;0;15000;13300;1700;
2021-06-15 21:40:11;8999999059323;LIFEBUOY TS LEMONFRESH 75G;1;3000;0;3000;2640;360;
2021-06-15 21:40:11;8998866603683;FRES&NATURAL SOAP MERAH 65G;3;1800;0;5400;4275;1125;
2021-06-15 21:40:11;8999999520885;WIPOL 500 ML;1;10000;0;10000;8600;1400;
2021-06-15 22:04:48;8998866106504;EMERON LOVELY NAT PINK;1;3500;0;3500;2900;600;
2021-06-15 22:04:48;8999999706111;PEPSODENT WHITE 25G;1;2000;0;2000;1450;550;
2021-06-16 10:38:02;8997231980015;O'JELLY MINI APPLE;1;3000;0;3000;2250;750;
2021-06-16 10:38:02;089686044249;SUPERMI NUTRIMI STEAK AYAM;2;3500;0;7000;5600;1400;
2021-06-16 10:47:29;8992222091961;PUCELLE MIST COL SPRAY 75ML;1;13000;0;13000;11650;1350;
2021-06-16 10:47:29;8992759120264;LARISST 220;1;10000;0;10000;9200;800;
2021-06-16 11:05:10;8998866610261;DAIA VIOLET GUSSET BAG 290 GR;1;5000;0;5000;4450;550;
2021-06-16 11:05:10;8992959953143;SWEEETY BRONZE XL20;1;45000;0;45000;42620;2380;
2021-06-16 11:05:10;8998866201483;POTABEE REGULER GRILLED SEAWEED 35GR;3;5000;0;15000;12450;2550;
2021-06-16 11:05:10;8998866201452;POTABEE REGULER BBQ BEEF 35GR;1;5000;0;5000;4150;850;
2021-06-16 11:05:10;8992696422735;DNCO CKLT UHT 110ML;3;2500;0;7500;6123;1377;
2021-06-16 11:07:54;8994867007161;ROKOK PENA GOLD 20;1;17000;0;17000;15500;1500;
2021-06-16 12:05:02;BALON;BALON CABUT;2;1000;0;2000;1800;200;
2021-06-16 12:05:02;YP;YUPI;2;250;0;500;416;84;
2021-06-16 12:05:02;MARS;MARSHMELLOW;1;500;0;500;433;67;
2021-06-16 13:37:52;8998866200646;KOPI TOP MURNI;1;11000;0;11000;9600;1400;
2021-06-16 13:37:52;GL;GULA 1 LITER;2;11500;0;23000;21000;2000;
2021-06-16 13:37:52;8992979120013;TOTAL BUNGA SOFTENER;1;13000;0;13000;11532;1468;
2021-06-16 13:40:55;YP;YUPI;2;250;0;500;416;84;
2021-06-16 13:40:55;MARS;MARSHMELLOW;3;500;0;1500;1299;201;
2021-06-16 13:40:55;COKLAT;COKLAT COIN;2;500;0;1000;850;150;
2021-06-16 13:42:18;8998866501033;MINYAK GORENG SEDAAP POUCH 2L;3;29000;0;87000;83238;3762;
2021-06-16 13:42:32;HT;HOT-HOT;2;500;0;1000;700;300;
2021-06-16 14:16:21;ARG;ARGUS 220ML;6;14500;0;87000;75000;12000;
2021-06-16 15:02:39;089686010343;INDOMIE SOTO MIE;5;2600;0;13000;11835;1165;
2021-06-16 15:02:39;089686010824;INDOMIE GORENG SPESIAL;5;2700;0;13500;12260;1240;
2021-06-16 15:02:39;8999999195649;SARI WANGI 25X1.86G;1;6000;0;6000;5050;950;
2021-06-16 15:02:39;8995333060703;TERIGU KOMPAS 1KG;1;10500;0;10500;9816;684;
2021-06-16 15:02:39;711844150027;ABC NANAS;1;13000;0;13000;12241;759;
2021-06-16 15:49:00;8991102989428GT;TANGO CKLT 24G GT;1;7500;0;7500;6092;1408;
2021-06-16 16:26:40;RB;RED BOLD;1;19000;0;19000;17900;1100;
2021-06-16 17:22:03;8998009010569;ULTRA CHO 200;1;5000;0;5000;3830;1170;
2021-06-16 18:26:40;8995333060772;TERIGU GATOT KACA 500GR;2;4500;0;9000;8130;870;
2021-06-16 18:26:40;8995333032113;TERIGU GATOT KACA 1 KG;1;8500;0;8500;8012;488;
2021-06-16 19:45:40;8998866202619;MIE SEDAAP KOREAN SPICY SOUP;1;2500;0;2500;2273;227;
2021-06-16 19:45:40;8998866202930;SEDAAP AYAM JERIT CUP;1;4500;0;4500;3738;762;
2021-06-16 19:46:22;8998989300261;GUDANG GARAM SURYA 12 FILTER;1;18500;0;18500;17200;1300;
2021-06-16 19:46:22;8993176110081;MINYAK KAYU PUTIH 30ML;1;12000;0;12000;9091;2909;
2021-06-16 19:52:14;8992222050418;GATSBY NORMAL 38GR;1;5000;0;5000;3850;1150;
2021-06-16 19:52:14;8998866105507;EMERON LOVELY NOURIST&BRIGHT 100ML;1;4300;0;4300;3800;500;
2021-06-16 19:57:39;8999999033170;LIFEBUOY SHP  KUAT&BERKILAU 170ML;1;16500;0;16500;14950;1550;
2021-06-16 19:57:39;9556040040038;SUSU F&N;1;33000;0;33000;30000;3000;
2021-06-16 19:57:39;8991002307209;COFFE CANDY;1;5000;0;5000;4500;500;
2021-06-16 19:57:39;8992759120264;LARISST 220;1;10000;0;10000;9200;800;
2021-06-16 19:57:39;JGR SHN;JOGER SHINY SACHET;1;500;0;500;437;63;
2021-06-16 19:57:39;8998866202923;FLORIDINA COCO;1;3000;0;3000;2500;500;
2021-06-16 20:03:54;8994867007161;ROKOK PENA GOLD 20;1;17000;0;17000;15500;1500;
2021-06-16 20:30:00;COKLAT;COKLAT COIN;1;500;0;500;425;75;
2021-06-16 20:30:00;MARS;MARSHMELLOW;1;500;0;500;433;67;
2021-06-16 20:30:00;VTM;VITAMIN;2;500;0;1000;850;150;
2021-06-16 20:38:29;8998866200325;MIE SEDAAP SOTO;2;2500;0;5000;3904;1096;
2021-06-16 20:38:29;089686043051;INDOMIE COTO MAKASSAR;2;2800;0;5600;5050;550;
2021-06-16 20:40:15;8992775211434;PILUS GARUDA SAPI PANGGANG;1;5000;0;5000;4810;190;
2021-06-16 20:40:15;8993176110081;MINYAK KAYU PUTIH 30ML;1;12000;0;12000;9091;2909;
2021-06-16 20:40:15;bb;BENG-BENG;2;1500;0;3000;2900;100;
2021-06-16 20:40:15;8996001600269;LE MINERAL 600ML;1;3000;0;3000;1688;1312;
2021-06-16 20:41:54;8996001600269;LE MINERAL 600ML;1;3000;0;3000;1688;1312;
2021-06-16 20:41:54;MARS;MARSHMELLOW;4;500;0;2000;1732;268;
2021-06-16 20:41:54;8993470279651;JOGER CHOCKY BAR;2;1000;0;2000;1734;266;
2021-06-16 20:41:54;8850507002197;TOK TAK FRUIT CANDY;1;7500;0;7500;6250;1250;
2021-06-16 20:42:59;6907992823935;JD SWEETCORN;1;3500;0;3500;3000;500;
2021-06-16 20:42:59;8996001600269;LE MINERAL 600ML;1;3000;0;3000;1688;1312;
2021-06-16 20:42:59;bb;BENG-BENG;1;1500;0;1500;1450;50;
2021-06-16 20:43:21;BALON;BALON CABUT;1;1000;0;1000;900;100;
2021-06-16 20:43:21;COKLAT;COKLAT COIN;1;500;0;500;425;75;
2021-06-16 20:44:51;COKLAT;COKLAT COIN;3;500;0;1500;1275;225;
2021-06-16 20:51:42;8999909010567;234 DJI SAM SOE 16;1;22000;0;22000;21500;500;
2021-06-16 21:03:25;6907992823966;JD BLUEBERRY;1;3500;0;3500;3000;500;
2021-06-16 21:03:25;8990800016757;BB TUTI FRUITTY COSMO;1;8500;0;8500;7600;900;
2021-06-16 21:03:25;8996001440087;ENERGEN KACANG HIJAU;2;1500;0;3000;2300;700;
2021-06-16 21:03:25;8996001440049;ENERGEN;2;1500;0;3000;2400;600;
2021-06-16 21:03:25;8999999558086;RINSO MOLTO FERFUME ESSENSE PWD 44G;3;1000;0;3000;2415;585;
2021-06-16 21:03:25;8992770034175;MASAKO;5;500;0;2500;2500;0;
2021-06-16 21:56:28;8996001600399;LE MINERAL 1500ML;1;5000;0;5000;4042;958;
2021-06-16 21:56:28;8996001600269;LE MINERAL 600ML;1;3000;0;3000;1688;1312;
2021-06-16 21:58:25;8998866202770;MIE SEDAAP SALERO PADANG;3;2500;0;7500;7086;414;
2021-06-16 21:58:25;8998866200301;MIE SEDAAP GORENG;4;2500;0;10000;8092;1908;
2021-06-16 21:58:25;089686043051;INDOMIE COTO MAKASSAR;1;2800;0;2800;2525;275;
2021-06-16 22:09:41;PRG;PARAGO;7;500;0;3500;2800;700;
2021-06-16 22:09:41;bb;BENG-BENG;1;1500;0;1500;1450;50;
2021-06-16 22:09:41;8996001318911;BETTER ISI 4;1;2000;0;2000;1700;300;
2021-06-17 10:40:36;8997007780689;JIZZY MINERAL;2;3000;0;6000;2374;3626;
2021-06-17 10:40:36;8996001600221;KOPIKO 78;1;5000;0;5000;4283;717;
2021-06-17 10:40:36;9556001025272;NESCAFE LATTE 240ML;1;8500;0;8500;7834;666;
2021-06-17 10:40:36;8996001301579;MALKIST CKLT KELAPA PACK;1;6500;0;6500;5400;1100;
2021-06-17 10:40:36;089686060027;POP MIE AYAM JUMBO;1;4500;0;4500;3833;667;
2021-06-17 10:43:42;MOLTO PINK;MOLTO ALL IN ONE 11 ML;2;500;0;1000;800;200;
2021-06-17 10:43:42;8998866608718;DAIA SOFTENER PINK;1;5000;0;5000;4450;550;
2021-06-17 11:01:31;8997009510017;YOU C1000 LEMON;1;10000;0;10000;9166;834;
2021-06-17 11:01:31;8998989500128;GUDANG GARAM MERAH KECIL 12KS;1;14000;0;14000;13000;1000;
2021-06-17 11:01:31;8998989500166;GUDANG GARAM MERAH BESAR 16KS;1;18000;0;18000;17000;1000;
2021-06-17 11:42:55;BALON;BALON CABUT;1;1000;0;1000;900;100;
2021-06-17 12:03:26;8998866200301;MIE SEDAAP GORENG;2;2500;0;5000;4046;954;
2021-06-17 12:03:26;8998866202770;MIE SEDAAP SALERO PADANG;2;2500;0;5000;4724;276;
2021-06-17 12:03:26;8998866200578;MIE SEDAAP KARI KENTAL;4;2500;0;10000;9052;948;
2021-06-17 12:03:26;8998866202343;MIE SEDAAP KOREAN SPICY;4;2500;0;10000;8092;1908;
2021-06-17 12:03:26;089686043617;INDOMIE MIEGHETTI;4;2700;0;10800;9808;992;
2021-06-17 12:03:26;089686400816;SAMBAL EXTRA PEDAS 135ML;1;5500;0;5500;4950;550;
2021-06-17 12:03:26;711844140059;ABC SAUS TIRAM 135 ML;1;8500;0;8500;7750;750;
2021-06-17 12:04:07;8998866202923;FLORIDINA COCO;1;3000;0;3000;2500;500;
2021-06-17 14:39:02;8998866501033;MINYAK GORENG SEDAAP POUCH 2L;3;29000;0;87000;83238;3762;
2021-06-17 15:32:09;8994834006128;TICTIC PEDAS;1;2000;0;2000;1700;300;
2021-06-17 15:32:09;8993470672827;SAKU-SAKU SAPI PANGGANG;1;2000;0;2000;1530;470;
2021-06-17 15:32:09;8996001318911;BETTER ISI 4;1;2000;0;2000;1700;300;
2021-06-17 15:32:09;8992696422735;DNCO CKLT UHT 110ML;1;2500;0;2500;2041;459;
2021-06-17 15:32:09;8998866201452;POTABEE REGULER BBQ BEEF 35GR;1;5000;0;5000;4150;850;
2021-06-17 15:32:09;8991102714631;TANGO TETRA CKLT;1;5000;0;5000;4545;455;
2021-06-17 15:32:09;SST;SUPERSTAR;2;1000;0;2000;1832;168;
2021-06-17 15:32:09;8991102989428SCT;TANGO CKLT 24G SCT;2;1000;0;2000;1218;782;
2021-06-17 15:32:09;8994834003752;TICTIC;1;2000;0;2000;1700;300;
2021-06-17 15:35:46;TG APEL;TEH GELAS APEL;1;2000;0;2000;1178;822;
2021-06-17 15:41:49;BALON;BALON CABUT;1;1000;0;1000;900;100;
2021-06-17 15:41:49;8998989300261;GUDANG GARAM SURYA 12 FILTER;1;18500;0;18500;17200;1300;
2021-06-17 16:45:14;8998989300261;GUDANG GARAM SURYA 12 FILTER;1;18500;0;18500;17200;1300;
2021-06-17 16:45:14;8998866611718;EKONOMI PENCUCI PIRING  LIQ 780ML;1;12000;0;12000;10900;1100;
2021-06-17 16:52:49;8991002105409;KOPI KAPAL API;1;20000;0;20000;18888;1112;
2021-06-17 16:52:49;8997021870595;HOT IN CREAM AROMA THERAPY 60G;1;12500;0;12500;11360;1140;
2021-06-17 17:35:23;8999999037765;PEPSODENT WHITE 225G;1;12000;0;12000;10750;1250;
2021-06-17 17:35:23;8992959117583;SFX DS REG FLOW WING 20;1;5000;0;5000;4288;712;
2021-06-17 17:35:23;8991102230308;BLASTER PINK;1;5000;0;5000;3106;1894;
2021-06-17 17:35:23;8998866105644;EMERON LOVELY SMOTH&BRIGHT 200ML;1;7500;0;7500;6475;1025;
2021-06-17 17:35:23;8991111109107;JB POWDER BEDTIME 75+25g;1;6000;0;6000;5440;560;
2021-06-17 18:21:19;8998989300261;GUDANG GARAM SURYA 12 FILTER;1;18500;0;18500;17200;1300;
2021-06-17 18:23:12;8997213203095;INLITE 7W;1;34000;0;34000;31000;3000;
2021-06-17 18:25:07;8994834005923;SPIX 1000;1;1000;0;1000;850;150;
2021-06-17 18:25:07;8997013790108;BIMURA KACANG TELUR 25G;1;1000;0;1000;875;125;
2021-06-17 18:25:07;8991102989428SCT;TANGO CKLT 24G SCT;1;1000;0;1000;609;391;
2021-06-17 18:25:07;089686021219;INTER MIE GORENG;3;1000;0;3000;2655;345;
2021-06-17 18:47:12;8998866202930;SEDAAP AYAM JERIT CUP;1;4500;0;4500;3738;762;
2021-06-17 19:01:18;8993989311699;CLAS MILD 16 FILTER;1;23000;0;23000;21700;1300;
2021-06-17 19:08:32;8998866201469;POTABEE REGULER BBQ BEEF 68 GR;1;8000;0;8000;7200;800;
2021-06-17 19:08:32;8998866201377;KRISBEE FRIES KENTANG GORENG 68 GR;1;5500;0;5500;4620;880;
2021-06-17 19:08:32;8998866202435;JAPOTA UMAMI JAPANESE SEAWEED 35GR;1;5000;0;5000;4150;850;
2021-06-17 19:32:18;8992761139018;ADES 600ML;2;3500;0;7000;4584;2416;
2021-06-17 21:23:17;8998989300261;GUDANG GARAM SURYA 12 FILTER;1;18500;0;18500;17200;1300;
2021-06-17 21:25:22;8999999571924;MOLTO PURE 1OML;1;5000;0;5000;4800;200;
2021-06-17 22:01:30;8999909002821;MARLBORO BLACK 16;1;22000;0;22000;20850;1150;
2021-06-18 11:06:10;8991002330504;RELAXA MANGO MINT;1;5000;0;5000;4500;500;
2021-06-18 11:06:10;8992696404441;BEAR BRAND 189ML;1;9000;0;9000;7887;1113;
2021-06-18 11:06:10;8994834006128;TICTIC PEDAS;1;2000;0;2000;1700;300;
2021-06-18 11:06:10;BKM;BKM COKLAT SACHET;1;1500;0;1500;1150;350;
2021-06-18 11:06:10;8996001414002SCT;TB CAPPUCINO SCT;1;1500;0;1500;1350;150;
2021-06-18 11:08:55;SLAIM;SLAIM WARNA;1;2000;0;2000;1743;257;
2021-06-18 11:08:55;8991909101016;URBAN MILD 16;1;17000;0;17000;15800;1200;
2021-06-18 11:13:31;8996001600375;LE MINERAL 330ML;2;2000;0;4000;2834;1166;
2021-06-18 11:13:31;8998989110167;SURYA GUDANG GARAM 16 FILTER;1;25000;0;25000;23200;1800;
2021-06-18 11:13:31;GL;GULA 1 LITER;1;11500;0;11500;10500;1000;
2021-06-18 11:13:31;PRG;PARAGO;1;500;0;500;400;100;
2021-06-18 11:13:31;8996001600399;LE MINERAL 1500ML;2;5000;0;10000;8084;1916;
2021-06-18 11:13:31;8998866200325;MIE SEDAAP SOTO;1;2500;0;2500;1952;548;
2021-06-18 11:13:31;8998866200578;MIE SEDAAP KARI KENTAL;1;2500;0;2500;2263;237;
2021-06-18 11:13:31;8991002105409;KOPI KAPAL API;1;20000;0;20000;18888;1112;
2021-06-18 11:13:31;089686011036;INDOMIE GORENG PEDAS;1;2700;0;2700;2452;248;
2021-06-18 11:13:31;089686010343;INDOMIE SOTO MIE;1;2600;0;2600;2367;233;
2021-06-18 11:13:31;089686010107;INDOMIE KALDU AYAM;1;2500;0;2500;2150;350;
2021-06-18 11:13:31;MARS;MARSHMELLOW;4;500;0;2000;1732;268;
2021-06-18 11:13:31;COKLAT;COKLAT COIN;3;500;0;1500;1275;225;
2021-06-18 11:13:31;YP;YUPI;3;250;0;750;624;126;
2021-06-18 11:13:31;8998866202619;MIE SEDAAP KOREAN SPICY SOUP;1;2500;0;2500;2273;227;
2021-06-18 11:40:30;TG;TEH GELAS;1;1000;0;1000;729;271;
2021-06-18 12:12:28;8993226365522;GARAM MEJA GYURI 200GR;2;2000;0;4000;3400;600;
2021-06-18 12:12:28;8995333060703;TERIGU KOMPAS 1KG;1;10500;0;10500;9816;684;
2021-06-18 12:23:00;8998866607315;SOKLIN SOFTERGENT SAKURA 770G & PIRING;1;18000;0;18000;16680;1320;
2021-06-18 12:23:00;8992702000063;INDOMILK COKLAT 370G;1;10000;0;10000;9020;980;
2021-06-18 12:23:00;TBR;TEPUNG BERAS ROSE BRAND;1;8000;0;8000;5800;2200;
2021-06-18 12:25:00;8998866200561;EKOMIE SUPER 600GR;1;10000;0;10000;8615;1385;
2021-06-18 12:47:05;8994935000070;MINYAK DUNIA 450 ML;1;7500;0;7500;6779;721;
2021-06-18 12:48:25;VCO;VITAMIN C500 ORANGE;3;1000;0;3000;1725;1275;
2021-06-18 13:17:39;8997011700123;BIHUN JAGUNG 300GR;2;6000;0;12000;9958;2042;
2021-06-18 13:17:39;8993058105013;EXTRA JOSS;1;12000;0;12000;9773;2227;
2021-06-18 13:25:03;8997002060168;KRP SINGKOG PDS PANDA DUO;1;8000;0;8000;7300;700;
2021-06-18 13:25:03;8997025914059;HATARI SEE HONG;1;6000;0;6000;4911;1089;
2021-06-18 13:25:03;8992761136178;SPRITE 1L;1;10000;0;10000;9000;1000;
2021-06-18 13:25:03;8995333060703;TERIGU KOMPAS 1KG;2;10500;0;21000;19632;1368;
2021-06-18 13:25:03;8999999049478;REXONA WMN RO NATURALS BIO 45 ML;1;16500;0;16500;14900;1600;
2021-06-18 13:25:03;8999999528966;CITRA FRESH WHITE 120ML;1;13200;0;13200;11875;1325;
2021-06-18 13:48:34;TG;TEH GELAS;2;1000;0;2000;1458;542;
2021-06-18 13:48:34;8997028590014;ARGUS 220ML;3;500;0;1500;906;594;
2021-06-18 13:48:34;8998866200882;SUKSESMIE GORENG AYAM KRMS 133GR;1;3500;0;3500;3047;453;
2021-06-18 14:04:04;8992761139018;ADES 600ML;1;3500;0;3500;2292;1208;
2021-06-18 14:10:34;8997028590014;ARGUS 220ML;4;500;0;2000;1208;792;
2021-06-18 14:10:34;JGR SHN;JOGER SHINY SACHET;6;500;0;3000;2622;378;
2021-06-18 14:21:48;8993083929837;BISKITOP BLACK COOKIES;1;27000;0;27000;23700;3300;
2021-06-18 14:21:48;8996001318911;BETTER ISI 4;1;2000;0;2000;1700;300;
2021-06-18 14:21:48;8996001302316;MALKIST ABON SCT;1;1000;0;1000;840;160;
2021-06-18 15:05:33;089686611519;QTELA SINGKONG;1;5000;0;5000;4266;734;
2021-06-18 15:05:33;8886013213208;FRENCH FREIS 2000;2;5000;0;10000;7500;2500;
2021-06-18 15:05:33;8998866201865;KRISBEE PILLOW CHOCOLAVA 120 GR;1;8000;0;8000;7250;750;
2021-06-18 15:28:08;8996001600146;TEH PUCUK HARUM 350ML;1;3000;0;3000;2314;686;
2021-06-18 15:28:08;8886013213208;FRENCH FREIS 2000;2;5000;0;10000;7500;2500;
2021-06-18 15:28:08;6907992823874;JD CRUNCHY CHOCO BLUEBERRY;1;5500;0;5500;4700;800;
2021-06-18 15:28:08;YP;YUPI;6;250;0;1500;1248;252;
2021-06-18 16:01:04;SFX;SOFTEX DAUN SIRIH 1;10;500;0;5000;4130;870;
2021-06-18 16:01:04;8997021300092;LARISSA BAWANG 250GR;1;5500;0;5500;5125;375;
2021-06-18 16:01:04;8997028900837;SABUN PAPAYA;1;10000;0;10000;9375;625;
2021-06-18 16:01:04;8998866603683;FRES&NATURAL SOAP MERAH 65G;1;1800;0;1800;1425;375;
2021-06-18 16:01:04;8998866610742;NOVO FAMILY PINK 76G;1;2000;0;2000;1820;180;
2021-06-18 16:01:04;8998866604512;FRES&NATURAL SOAP VIOLET 65G;1;1800;0;1800;1425;375;
2021-06-18 16:03:13;8999999031602;SARI MURNI 20X1.6G;1;6000;0;6000;5400;600;
2021-06-18 16:03:13;SMC;BIMURA MAKARONI CINCIN 250G;1;10000;0;10000;9300;700;
2021-06-18 16:15:18;8998866608312;GIV PAPAYA KOTAK 76GR;1;2000;0;2000;1820;180;
2021-06-18 16:15:33;8999999516208;ROYCO FDS CHICKEN NEW 230G;3;10000;0;30000;27000;3000;
2021-06-18 16:22:53;BALON;BALON CABUT;6;1000;0;6000;5400;600;
2021-06-18 16:22:53;8991102989428SCT;TANGO CKLT 24G SCT;1;1000;0;1000;609;391;
2021-06-18 16:34:36;089686021219;INTER MIE GORENG;1;1000;0;1000;885;115;
2021-06-18 16:34:36;8998866501033;MINYAK GORENG SEDAAP POUCH 2L;1;29000;0;29000;27746;1254;
2021-06-18 17:44:02;BRS;BERAS BUMN 10KG;1;128000;0;128000;100000;28000;
2021-06-18 17:44:02;BRS5;BERAS BUMN 5KG;1;64000;0;64000;50500;13500;
2021-06-18 17:44:02;8998866201964;MINYAK GORENG SABRINA 2L POUCH;1;28000;0;28000;26753;1247;
2021-06-18 17:44:02;8992736925134;SASA TEPUNG BUMBU SERBAGUNA;1;5500;0;5500;4700;800;
2021-06-18 17:44:02;8997025911058;HATARI SHP KELAPA;1;6000;0;6000;4911;1089;
2021-06-18 17:59:36;8999999195656;SARI WANGI 50X1.85;1;10000;0;10000;9500;500;
2021-06-18 17:59:36;8999999502003;SARIMURNI RL RB 1,8G;2;1500;0;3000;2414;586;
2021-06-18 17:59:36;8997025911058;HATARI SHP KELAPA;1;6000;0;6000;4911;1089;
2021-06-18 18:00:44;6907992823874;JD CRUNCHY CHOCO BLUEBERRY;1;5500;0;5500;4700;800;
2021-06-18 18:00:44;8992959117583;SFX DS REG FLOW WING 20;1;5000;0;5000;4288;712;
2021-06-18 18:00:44;8997218380074;ICHITAN MILK TEA;1;8000;0;8000;6583;1417;
2021-06-18 18:00:44;8996001600269;LE MINERAL 600ML;3;3000;0;9000;5064;3936;
2021-06-18 18:36:22;8992761164539;NUTRIBOOST ORANGE 300ML;1;6500;0;6500;5300;1200;
2021-06-18 18:36:22;8992761164546;NUTRIBOOST STRAWBERRY 300ML;1;6500;0;6500;5300;1200;
2021-06-18 19:41:37;8999999524722;SUNLIGHT LIME NEW PCH 435ML;2;10000;0;20000;18200;1800;
2021-06-18 19:43:28;8999908389008;HEMAVITON C1000;1;8000;0;8000;6000;2000;
2021-06-18 19:43:28;8992696404441;BEAR BRAND 189ML;1;9000;0;9000;7887;1113;
2021-06-18 19:44:29;8999909096004;SAMPOERNA 16 FILTER;1;24000;0;24000;23000;1000;
2021-06-18 20:06:17;8999909002821;MARLBORO BLACK 16;1;22000;0;22000;20850;1150;
2021-06-18 20:23:01;8992761166229;FRESTEA MARKISA 350ML;1;4500;0;4500;3000;1500;
2021-06-18 20:49:12;ARG;ARGUS 220ML;3;14500;0;43500;37500;6000;
2021-06-18 21:02:25;8992775211434;PILUS GARUDA SAPI PANGGANG;1;5000;0;5000;4810;190;
2021-06-18 21:07:00;711844120433;SAMBAL ABC 600 ML;1;22000;0;22000;20300;1700;
2021-06-18 21:48:07;123;BETREI JAM;1;5500;0;5500;5000;500;
2021-06-18 21:48:07;BALON;BALON CABUT;1;1000;0;1000;900;100;
2021-06-18 21:52:13;8998989300261;GUDANG GARAM SURYA 12 FILTER;1;18500;0;18500;17200;1300;
2021-06-18 21:52:13;8998989500166;GUDANG GARAM MERAH BESAR 16KS;1;18000;0;18000;17000;1000;
2021-06-18 21:52:49;YP;YUPI;2;250;0;500;416;84;
2021-06-18 22:11:08;8993989311279;CLAS MILD 12;1;17000;0;17000;15700;1300;
2021-06-18 22:22:19;8999999549138;CLEAR HIJAB AD SHP HF TMT 160ML;1;25000;0;25000;23870;1130;
2021-06-18 22:22:19;TK;TEPUNG KETAN;1;13000;0;13000;13000;0;
2021-06-19 10:48:50;8999999031930;PEPSODENT TB TRIPLE CLEAN;1;3500;0;3500;2850;650;
2021-06-19 10:48:50;BB;PASEO SMARTY FACIAL TRAVEL PACK 50S GT;1;3000;0;3000;1980;1020;
2021-06-19 10:48:50;8998866500135;HERSPROTEX SOFTCARE WINGS;1;5500;0;5500;4820;680;
2021-06-19 10:48:50;8993560026103;DETTOL SKINCARE;1;20000;0;20000;18524;1476;
2021-06-19 10:48:50;8996001440049;ENERGEN;3;1500;0;4500;3600;900;
2021-06-19 11:03:34;ff;FULLO BLASTO;1;1000;0;1000;995;5;
2021-06-19 11:03:34;BALON;BALON CABUT;4;1000;0;4000;3600;400;
2021-06-19 11:19:15;8992628022156;BIMOLI KLASIK TOUCH 1 LT;1;16000;0;16000;14350;1650;
2021-06-19 11:19:15;8999999559045;SUNLIGHT LIME CREAM 110G;1;2000;0;2000;1800;200;
2021-06-19 11:19:15;8994834003752;TICTIC;1;2000;0;2000;1700;300;
2021-06-19 12:10:27;8998866201377;KRISBEE FRIES KENTANG GORENG 68 GR;1;5500;0;5500;4620;880;
2021-06-19 12:10:27;8994834005923;SPIX 1000;1;1000;0;1000;850;150;
2021-06-19 12:10:27;8991001503114;CHACHA MILK CHOCOLATE 35G;3;5500;0;16500;14700;1800;
2021-06-19 12:10:27;8992696422735;DNCO CKLT UHT 110ML;1;2500;0;2500;2041;459;
2021-06-19 12:10:27;8991001780065;TWISTER BLACK 140G;1;13000;0;13000;11700;1300;
2021-06-19 12:10:27;8992696523067;MILO ACTVGO UHT 180ML;1;4500;0;4500;3515;985;
2021-06-19 12:10:27;8992753184200;FF MILKY STRY 180ML;1;4500;0;4500;3250;1250;
2021-06-19 12:59:36;8998866501033;MINYAK GORENG SEDAAP POUCH 2L;2;29000;0;58000;55492;2508;
2021-06-19 12:59:36;8998866200882;SUKSESMIE GORENG AYAM KRMS 133GR;1;3500;0;3500;3047;453;
2021-06-19 13:00:20;8992696425316;NESCAFE BLACK;1;5000;0;5000;4099;901;
2021-06-19 13:00:20;8998989300261;GUDANG GARAM SURYA 12 FILTER;1;18500;0;18500;17200;1300;
2021-06-19 13:39:54;VTM;VITAMIN;1;500;0;500;425;75;
2021-06-19 13:41:13;089686043617;INDOMIE MIEGHETTI;2;2700;0;5400;4904;496;
2021-06-19 14:01:59;8999999195649;SARI WANGI 25X1.86G;1;6000;0;6000;5050;950;
2021-06-19 14:01:59;8992753102204;BKM COKLAT 370G;1;11300;0;11300;9500;1800;
2021-06-19 14:01:59;SFX;SOFTEX DAUN SIRIH 1;10;500;0;5000;4130;870;
2021-06-19 14:03:28;8996001302620;MALKIST COKLAT SCT;2;1000;0;2000;1680;320;
2021-06-19 14:16:04;8993176110135;MINYAK TELON LANG 30ML;1;10000;0;10000;8167;1833;
2021-06-19 14:16:04;8992946512223;SHINZUI;1;4000;0;4000;2500;1500;
2021-06-19 14:16:04;8993335523363;TOTAL ALMEERA 250G;1;5000;0;5000;4100;900;
2021-06-19 14:48:24;8999909010567;234 DJI SAM SOE 16;1;22000;0;22000;21500;500;
2021-06-19 15:16:04;8999909002821;MARLBORO BLACK 16;1;22000;0;22000;20850;1150;
2021-06-19 15:31:24;RB;RED BOLD;1;19000;0;19000;17900;1100;
2021-06-19 15:31:24;PRG;PARAGO;2;500;0;1000;800;200;
2021-06-19 15:58:09;089686010107;INDOMIE KALDU AYAM;2;2500;0;5000;4300;700;
2021-06-19 15:58:09;089686010824;INDOMIE GORENG SPESIAL;4;2700;0;10800;9808;992;
2021-06-19 15:58:09;8992753100101;BKM FULL CREAM GOLD 370;2;15000;0;30000;28000;2000;
2021-06-19 16:39:30;8996001305058;ROMA SANDWICH KACANG;1;7000;0;7000;5000;2000;
2021-06-19 16:39:30;8996001600146;TEH PUCUK HARUM 350ML;1;3000;0;3000;2314;686;
2021-06-19 16:39:30;8997231980022;O'JELLY MINI STRAWBERRY;1;3000;0;3000;2250;750;
2021-06-19 16:39:30;ff;FULLO BLASTO;2;1000;0;2000;1990;10;
2021-06-19 16:39:30;COKLAT;COKLAT COIN;4;500;0;2000;1700;300;
2021-06-19 16:39:30;HT;HOT-HOT;2;500;0;1000;700;300;
2021-06-19 16:40:47;8999999053000;PONDS OIL CONTROL FACIAL FOAM 50G;1;18400;0;18400;16300;2100;
2021-06-19 16:40:47;8996001600221;KOPIKO 78;1;5000;0;5000;4283;717;
2021-06-19 16:40:47;8991001111883;SILVERQUEEN CHUNKYBAR 33G;1;8000;0;8000;7150;850;
2021-06-19 17:16:59;089686611519;QTELA SINGKONG;2;5000;0;10000;8532;1468;
2021-06-19 17:16:59;8999999036607;LUX TS SOFT ROSE 75G;1;3500;0;3500;2800;700;
2021-06-19 17:16:59;SFX;SOFTEX DAUN SIRIH 1;2;500;0;1000;826;174;
2021-06-19 17:16:59;MOLTO PINK;MOLTO ALL IN ONE 11 ML;7;500;0;3500;2800;700;
2021-06-19 17:17:54;8998666001306SCT;TB CREAMY LATTE SCT;2;1500;0;3000;1980;1020;
2021-06-19 17:23:08;8996001414002SCT;TB CAPPUCINO SCT;2;1500;0;3000;2700;300;
2021-06-19 17:34:44;SLAIM;SLAIM WARNA;1;2000;0;2000;1743;257;
2021-06-19 17:34:44;8991001503114;CHACHA MILK CHOCOLATE 35G;1;5500;0;5500;4900;600;
2021-06-19 17:34:44;8999999528850;CITRA NAT GLOW WHITE 60ML;1;6200;0;6200;5625;575;
2021-06-19 17:34:44;8996001414002SCT;TB CAPPUCINO SCT;2;1500;0;3000;2700;300;
2021-06-19 17:34:44;6907992823850;JD CHOCO CIRLE;1;5500;0;5500;4700;800;
2021-06-19 17:35:51;SLAIM;SLAIM WARNA;1;2000;0;2000;1743;257;
2021-06-19 17:58:25;089686010107;INDOMIE KALDU AYAM;1;2500;0;2500;2150;350;
2021-06-19 17:58:25;089686010343;INDOMIE SOTO MIE;1;2600;0;2600;2367;233;
2021-06-19 17:58:25;089686043617;INDOMIE MIEGHETTI;1;2700;0;2700;2452;248;
2021-06-19 17:58:25;BALON;BALON CABUT;6;1000;0;6000;5400;600;
2021-06-19 18:06:44;8992730002992;HAI CANDY;1;7000;0;7000;6000;1000;
2021-06-19 18:09:28;8994867000179;ROKOK PENA MILD 16;1;14500;0;14500;13500;1000;
2021-06-19 18:09:28;8999999559861;AXE DARK POCKET FRAG 17ML;1;10000;0;10000;8000;2000;
2021-06-19 18:09:28;VTM;VITAMIN;1;500;0;500;425;75;
2021-06-19 18:47:28;8992696404441;BEAR BRAND 189ML;2;9000;0;18000;15774;2226;
2021-06-19 18:47:28;8991001780492;SELAMAT COKLAT;1;13000;0;13000;11800;1200;
2021-06-19 19:04:42;8994867000162;ROKOK PUNDIMAS KRETEK16;1;10000;0;10000;8600;1400;
2021-06-19 19:04:42;8993083929806;BISKITOP COKLAT;1;30000;0;30000;27000;3000;
2021-06-19 19:04:42;GL;GULA 1 LITER;4;11500;0;46000;42000;4000;
2021-06-19 19:04:42;8999999195656;SARI WANGI 50X1.85;1;10000;0;10000;9500;500;
2021-06-19 19:09:02;8998009020186;BUAVITA GUAVA 250ML;1;7000;0;7000;6083;917;
2021-06-19 19:09:02;6907992823829;JD MILKY MILK;1;3000;0;3000;2600;400;
2021-06-19 19:27:16;8994867007161;ROKOK PENA GOLD 20;1;17000;0;17000;15500;1500;
2021-06-19 19:35:39;8998866200301;MIE SEDAAP GORENG;1;2500;0;2500;2023;477;
2021-06-19 19:35:39;MARS;MARSHMELLOW;1;500;0;500;433;67;
2021-06-19 19:38:01;MARS;MARSHMELLOW;2;500;0;1000;866;134;
2021-06-19 19:45:35;8998989110167;SURYA GUDANG GARAM 16 FILTER;1;25000;0;25000;23200;1800;
2021-06-19 19:45:35;6921101219235;YAKUAT JELLY;1;2000;0;2000;1750;250;
2021-06-19 19:54:01;8996001302620;MALKIST COKLAT SCT;1;1000;0;1000;840;160;
2021-06-19 19:54:01;MARS;MARSHMELLOW;1;500;0;500;433;67;
2021-06-19 19:56:10;089686021141;INTER MIE SOTO;5;1000;0;5000;4270;730;
2021-06-19 19:57:26;8992759120264;LARISST 220;1;10000;0;10000;9200;800;
2021-06-19 19:57:26;8992222054973;GATSBY STYLING POMADE 30GR;1;15000;0;15000;13000;2000;
2021-06-19 19:57:26;8999999048488;SUNSILK SHP REFRESH ANTI DDRF 70+21ML;1;10000;0;10000;9075;925;
2021-06-19 20:23:27;6907992823904;JD CRUNCHY CHOCOLATE VAN;2;8000;0;16000;13600;2400;
2021-06-19 20:25:45;8998866200325;MIE SEDAAP SOTO;4;2500;0;10000;7808;2192;
2021-06-19 20:25:45;089686041705;INDOMIE GORENG JUMBO;1;3500;0;3500;3143;357;
2021-06-19 20:25:45;089686010824;INDOMIE GORENG SPESIAL;1;2700;0;2700;2452;248;
2021-06-19 20:25:45;8991004011906;KOPI BORONG;1;10000;0;10000;8333;1667;
2021-06-19 21:05:40;8998989500166;GUDANG GARAM MERAH BESAR 16KS;1;18000;0;18000;17000;1000;
2021-06-19 21:58:41;8999099920714;SGM 1+ VANILA 1000G;1;85000;0;85000;78510;6490;
2021-06-19 21:58:41;8999999048303;SUNSILK HJV RFR HF SOL 170ML;1;22000;0;22000;20020;1980;
2021-06-19 22:01:35;8994867000179;ROKOK PENA MILD 16;1;14500;0;14500;13500;1000;
2021-06-19 22:02:05;8992775211434;PILUS GARUDA SAPI PANGGANG;1;5000;0;5000;4810;190;
2021-06-19 22:11:40;089686010824;INDOMIE GORENG SPESIAL;2;2700;0;5400;4904;496;
2021-06-19 22:11:40;089686010343;INDOMIE SOTO MIE;2;2600;0;5200;4734;466;
2021-06-19 22:11:40;8992388112401;MIE ABC SELERA PEDAS- GORENG AYAM PEDAS LIMAU;1;2600;0;2600;2368;232;
2021-06-19 22:11:40;8998866202435;JAPOTA UMAMI JAPANESE SEAWEED 35GR;1;5000;0;5000;4150;850;
2021-06-19 22:11:40;8992696521797G;MILO 22G GT;1;20000;0;20000;17090;2910;
2021-06-19 22:11:40;711844110113;KECAP ABC 135 ML;1;7000;0;7000;6400;600;
2021-06-19 22:11:40;8999801700030;SUSU FOYU;1;11500;0;11500;10450;1050;
2021-06-19 22:11:40;8998866500135;HERSPROTEX SOFTCARE WINGS;1;5500;0;5500;4820;680;
2021-06-19 22:11:40;8992959107539;SFX WING 23CM;1;5000;0;5000;4091;909;
2021-06-19 22:11:40;8999999024468;CITRA FRESH EHITE 400ML;1;20800;0;20800;18950;1850;
2021-06-19 22:11:40;8998866618298;DAIA CLEAN&FRESH HJB 320GR;1;5000;0;5000;4450;550;
2021-06-19 22:11:40;8999999059781;SUNLIGHT LIME NEW POUCH 210ML;1;5000;0;5000;4300;700;
2021-06-19 22:11:40;8992806145417;SCOTCH BRITE;1;3500;0;3500;2407;1093;
2021-06-19 22:11:40;8999999007768;FAIR&LOVELY MULTIVITAMIN  CREAM 9 ML;1;4500;0;4500;3200;1300;
2021-06-19 22:11:58;6907992823904;JD CRUNCHY CHOCOLATE VAN;1;8000;0;8000;6800;1200;
2021-06-19 22:12:59;8992775315057;GERY SALUT MALKIST COKLAT;1;6500;0;6500;5516;984;
2021-06-19 22:28:48;ARG;ARGUS 220ML;3;14500;0;43500;37500;6000;
2021-06-20 10:58:35;8999909096004;SAMPOERNA 16 FILTER;1;24000;0;24000;23000;1000;
2021-06-20 10:58:35;8996001305041;ROMA SANDWICH CKLT;1;7000;0;7000;5000;2000;
2021-06-20 10:58:35;8999999516208;ROYCO FDS CHICKEN NEW 230G;1;10000;0;10000;9000;1000;
2021-06-20 10:58:35;8999909010567;234 DJI SAM SOE 16;1;22000;0;22000;21500;500;
2021-06-20 10:58:35;8998866202053;POTABEE AYAM BAKAR PEDAS 68GR;1;8000;0;8000;7200;800;
2021-06-20 10:58:35;8998866500708;FLORIDINA ORANGE;1;3000;0;3000;2500;500;
2021-06-20 10:58:35;8997231980015;O'JELLY MINI APPLE;1;3000;0;3000;2250;750;
2021-06-20 10:58:35;6907992825069;JD FRUITY;1;5000;0;5000;4400;600;
2021-06-20 10:58:35;8994867007161;ROKOK PENA GOLD 20;1;17000;0;17000;15500;1500;
2021-06-20 11:07:20;8991002105409;KOPI KAPAL API;1;20000;0;20000;18888;1112;
2021-06-20 11:07:20;GL;GULA 1 LITER;2;11500;0;23000;21000;2000;
2021-06-20 11:07:20;KP;KERIPIK PISANG;2;5000;0;10000;10000;0;
2021-06-20 11:07:20;8992725910424;LISTERINE FRESH BURST 250ML;1;19000;0;19000;17550;1450;
2021-06-20 11:07:20;8999999030179;PEPSODENT ACTION 123 COMPLETE 75G;1;6700;0;6700;5170;1530;
2021-06-20 11:07:20;BTS;BIMURA TARO SEAWEED 250G;1;10000;0;10000;9300;700;
2021-06-20 11:07:20;8998866105491;EMERON LOVELY SMOTH&BRIGHT 100ML;1;4300;0;4300;3800;500;
2021-06-20 11:07:20;8998866610261;DAIA VIOLET GUSSET BAG 290 GR;1;5000;0;5000;4450;550;
2021-06-20 11:07:20;8997011700123;BIHUN JAGUNG 300GR;1;6000;0;6000;4979;1021;
2021-06-20 11:07:20;8998866200882;SUKSESMIE GORENG AYAM KRMS 133GR;2;3500;0;7000;6094;906;
2021-06-20 11:07:20;8997231980022;O'JELLY MINI STRAWBERRY;1;3000;0;3000;2250;750;
2021-06-20 11:07:20;8991102228053;TEH GELAS BOTOL;1;3000;0;3000;1695;1305;
2021-06-20 11:09:02;KRTS;KERTAS NASI;1;10000;0;10000;7200;2800;
2021-06-20 11:26:17;8998866201827;JAVANA GULA BATU 350ML;1;3000;0;3000;2150;850;
2021-06-20 12:40:51;GL;GULA 1 LITER;4;11500;0;46000;42000;4000;
2021-06-20 12:41:27;8991102022347;SIKAT GIGI FORMULA RIPPLE;1;5000;0;5000;4583;417;
2021-06-20 12:49:57;8998866202343;MIE SEDAAP KOREAN SPICY;5;2500;0;12500;10115;2385;
2021-06-20 12:50:29;8994834006128;TICTIC PEDAS;2;2000;0;4000;3400;600;
2021-06-20 13:11:16;8996001318911;BETTER ISI 4;1;2000;0;2000;1700;300;
2021-06-20 13:11:16;8994834006128;TICTIC PEDAS;1;2000;0;2000;1700;300;
2021-06-20 13:11:16;8991102989534;TANGO VANILA 24G;1;1000;0;1000;609;391;
2021-06-20 13:14:52;8998898830125;KKB ENER-G ANGGUR;1;5500;0;5500;4824;676;
2021-06-20 13:14:52;YP;YUPI;2;250;0;500;416;84;
2021-06-20 13:32:20;8997231980022;O'JELLY MINI STRAWBERRY;2;3000;0;6000;4500;1500;
2021-06-20 13:32:20;JGR SHN;JOGER SHINY SACHET;2;500;0;1000;874;126;
2021-06-20 13:32:20;MARS;MARSHMELLOW;6;500;0;3000;2598;402;
2021-06-20 16:55:30;8998898830125;KKB ENER-G ANGGUR;2;5500;0;11000;9648;1352;
2021-06-20 16:58:02;8992959002032;SWEETY SILVER PANTS L 36;1;72000;0;72000;68182;3818;
2021-06-20 16:59:31;8999999559854;AXE BLACK POCKET FRAG 17ML;1;10000;0;10000;8000;2000;
2021-06-20 17:00:25;GL;GULA 1 LITER;2;11500;0;23000;21000;2000;
2021-06-20 17:07:35;8991102387286SCT;TANGO LONG CKLT 47G;1;2000;0;2000;1551;449;
2021-06-20 17:07:35;8994834005923;SPIX 1000;1;1000;0;1000;850;150;
2021-06-20 17:07:35;8999999059316;LIFEBUOY TS MILDCARE 75G;1;3000;0;3000;2640;360;
2021-06-20 17:16:17;8996001302620;MALKIST COKLAT SCT;2;1000;0;2000;1680;320;
2021-06-20 17:17:04;JD VM;JD VANILLA MILKSHAKE;1;5000;0;5000;4300;700;
2021-06-20 17:35:49;8992761166229;FRESTEA MARKISA 350ML;1;4500;0;4500;3000;1500;
2021-06-20 17:35:56;YP;YUPI;2;250;0;500;416;84;
2021-06-20 18:33:40;8998989110129;SURYA KECIL MERAH 12KS;1;18000;0;18000;16450;1550;
2021-06-20 18:33:40;8998989110167;SURYA GUDANG GARAM 16 FILTER;1;25000;0;25000;23200;1800;
2021-06-20 18:34:22;089686043273;INDOMIE SAMBAL RICA;2;2700;0;5400;4904;496;
2021-06-20 19:46:46;8993176110081;MINYAK KAYU PUTIH 30ML;1;12000;0;12000;9091;2909;
2021-06-20 19:46:46;8993470671752;JOGER STICK DUO KACANG;1;1000;0;1000;850;150;
2021-06-20 20:01:53;8991102987639;WFR TANGO LONG VNL 130G;1;5000;0;5000;3773;1227;
2021-06-20 20:01:53;8992959953044;SWEETY BRONZE XL1;1;2500;0;2500;2250;250;
2021-06-20 20:05:23;ff;FULLO BLASTO;2;1000;0;2000;1990;10;
2021-06-20 20:38:33;8991102384841;WFR TANGO LONG CKLT 130G;1;5000;0;5000;4345;655;
2021-06-20 21:13:30;GL;GULA 1 LITER;1;11500;0;11500;10500;1000;
2021-06-20 21:13:30;8998989300261;GUDANG GARAM SURYA 12 FILTER;1;18500;0;18500;17200;1300;
2021-06-20 21:13:30;8995333060772;TERIGU GATOT KACA 500GR;1;4500;0;4500;4065;435;
2021-06-20 21:30:34;8998898337440;TOLAK ANGIN CARE 10ML;1;10000;0;10000;7893;2107;
2021-06-20 22:07:37;8999909000377;SAMPOERNA AVOLUTION;1;30000;0;30000;28450;1550;
2021-06-21 10:49:34;SMC;BIMURA MAKARONI CINCIN 250G;1;10000;0;10000;9300;700;
2021-06-21 10:49:34;MARS;MARSHMELLOW;7;500;0;3500;3031;469;
2021-06-21 10:49:34;8998866108126;POSH HIJAB WINTER MAGIC 150ML;1;19500;0;19500;17500;2000;
2021-06-21 11:13:53;8999909028234;234 DJI SAM SOE 12;1;17000;0;17000;15850;1150;
2021-06-21 11:16:12;8992775312414;GERY CHOCO HEZELNUT;1;11000;0;11000;9983;1017;
2021-06-21 11:16:12;8992222091961;PUCELLE MIST COL SPRAY 75ML;1;13000;0;13000;11650;1350;
2021-06-21 12:13:22;8992761002039;FANTA STRAWBERRY PET 390 ML;1;5500;0;5500;4300;1200;
2021-06-21 12:26:21;8992761002039;FANTA STRAWBERRY PET 390 ML;1;5500;0;5500;4300;1200;
2021-06-21 12:54:28;8999909010567;234 DJI SAM SOE 16;1;22000;0;22000;21500;500;
2021-06-21 13:21:13;8999909096004;SAMPOERNA 16 FILTER;1;24000;0;24000;23000;1000;
2021-06-21 13:33:03;8998989300261;GUDANG GARAM SURYA 12 FILTER;1;18500;0;18500;17200;1300;
2021-06-21 13:33:03;YP;YUPI;2;250;0;500;416;84;
2021-06-21 13:47:21;9556040040038;SUSU F&N;1;33000;0;33000;30000;3000;
2021-06-21 13:50:20;TG;TEH GELAS;1;1000;0;1000;729;271;
2021-06-21 14:22:54;8999801700030;SUSU FOYU;1;11500;0;11500;10450;1050;
2021-06-21 14:22:54;COKLAT;COKLAT COIN;1;500;0;500;425;75;
2021-06-21 14:29:26;8999999192150;ROYCO FDS CHICKEN 100GR;4;5000;0;20000;17200;2800;
2021-06-21 14:29:26;8999999516208;ROYCO FDS CHICKEN NEW 230G;1;10000;0;10000;9000;1000;
2021-06-21 15:43:08;8991102300421;WFR TANGO COKLAT 176GR;1;10000;0;10000;8694;1306;
2021-06-21 15:43:08;8998866202060;POTABEE AYAM BAKAR PEDAS 35 GR;1;5000;0;5000;4150;850;
2021-06-21 15:43:08;8992696422735;DNCO CKLT UHT 110ML;1;2500;0;2500;2041;459;
2021-06-21 15:43:08;COKLAT;COKLAT COIN;5;500;0;2500;2125;375;
2021-06-21 15:47:18;8993989311699;CLAS MILD 16 FILTER;1;23000;0;23000;21700;1300;
2021-06-21 16:20:05;8998866201964;MINYAK GORENG SABRINA 2L POUCH;1;28000;0;28000;26753;1247;
2021-06-21 16:20:05;COKLAT;COKLAT COIN;4;500;0;2000;1700;300;
2021-06-21 16:45:07;8996001600221;KOPIKO 78;1;5000;0;5000;4283;717;
2021-06-21 16:45:07;8998866618298;DAIA CLEAN&FRESH HJB 320GR;1;5000;0;5000;4450;550;
2021-06-21 16:45:07;KP;KERIPIK PISANG;1;5000;0;5000;5000;0;
2021-06-21 16:45:07;8992759120264;LARISST 220;1;10000;0;10000;9200;800;
2021-06-21 16:45:07;8992388111206;MIE ABC SELERA PEDAS-GULAI AYAM PEDAS;1;2500;0;2500;2022;478;
2021-06-21 16:45:07;8992388112401;MIE ABC SELERA PEDAS- GORENG AYAM PEDAS LIMAU;1;2600;0;2600;2368;232;
2021-06-21 16:55:58;8994867000179;ROKOK PENA MILD 16;1;14500;0;14500;13500;1000;
2021-06-21 16:59:23;8996001440520;ENERGEN JAGUNG;1;1500;0;1500;1150;350;
2021-06-21 17:04:32;8997218380135;ICHITAN GREEN TEA;1;8000;0;8000;6583;1417;
2021-06-21 17:04:32;8991001121400;SILVERQUEEN ALMOND 65G;1;15000;0;15000;13200;1800;
2021-06-21 17:15:36;8999999710880;PEPSODENT ACTION123 HERBAL 75G;1;7500;0;7500;6650;850;
2021-06-21 17:54:15;8992628020152;BIMOLI POUCH 2L;1;31000;0;31000;29800;1200;
2021-06-21 17:54:15;6907992823591;JD STRAW MILKSHAKE;2;5000;0;10000;8600;1400;
2021-06-21 17:54:15;6907992823904;JD CRUNCHY CHOCOLATE VAN;4;8000;0;32000;27200;4800;
2021-06-21 17:54:15;JD VM;JD VANILLA MILKSHAKE;1;5000;0;5000;4300;700;
2021-06-21 17:54:15;6907992824963;JD MILKY CHOCOLATE;1;3000;0;3000;2600;400;
2021-06-21 18:02:50;8996001600375;LE MINERAL 330ML;1;42000;0;42000;34008;7992;
2021-06-21 18:10:50;6907992825076;JD WATERMELON APPLE;1;2000;0;2000;1700;300;
2021-06-21 18:10:50;8997028590014;ARGUS 220ML;2;500;0;1000;604;396;
2021-06-21 18:47:42;8994867000162;ROKOK PUNDIMAS KRETEK16;1;10000;0;10000;8600;1400;
2021-06-21 20:32:44;MARS;MARSHMELLOW;6;500;0;3000;2598;402;
2021-06-21 20:48:11;8999999042646;RINSO MOLTO ROSE FRESH LIQ 40ML;1;6000;0;6000;4817;1183;
2021-06-21 20:52:32;8997231980022;O'JELLY MINI STRAWBERRY;1;3000;0;3000;2250;750;
2021-06-21 21:30:51;8992775913000GT;CHOCOLATOS CKLT DRINK;1;18000;0;18000;15862;2138;
2021-06-21 21:30:51;8992753100101;BKM FULL CREAM GOLD 370;1;15000;0;15000;14000;1000;
2021-06-21 21:31:27;8996001600221;KOPIKO 78;2;5000;0;10000;8566;1434;
2021-06-21 21:31:27;8996001600146;TEH PUCUK HARUM 350ML;1;3000;0;3000;2314;686;
2021-06-21 21:31:27;SMC;BIMURA MAKARONI CINCIN 250G;1;10000;0;10000;9300;700;
2021-06-21 22:11:34;MARS;MARSHMELLOW;2;500;0;1000;866;134;
2021-06-22 14:15:55;8992959953327;SWEETY BRONZE L52;1;85000;0;85000;80304;4696;
2021-06-22 14:42:51;8997025914059;HATARI SEE HONG;1;6000;0;6000;4911;1089;
2021-06-22 14:42:51;8999999195649;SARI WANGI 25X1.86G;1;6000;0;6000;5050;950;
2021-06-22 16:18:24;089686010343;INDOMIE SOTO MIE;5;2600;0;13000;11835;1165;
2021-06-22 16:18:24;089686010190;INDOMIE KARI AYAM;5;2800;0;14000;12610;1390;
2021-06-22 16:19:35;8999909096004;SAMPOERNA 16 FILTER;1;24000;0;24000;23000;1000;
2021-06-22 16:28:04;8998866108003;EMERON HJB CLEANFRESH 10ML;1;5000;0;5000;4185;815;
2021-06-22 18:05:18;8998866200578;MIE SEDAAP KARI KENTAL;2;2500;0;5000;4526;474;
2021-06-22 18:05:29;8997012321174;CHILLI-QU;1;1000;0;1000;800;200;
2021-06-22 19:02:08;8994834006128;TICTIC PEDAS;1;2000;0;2000;1700;300;
2021-06-22 19:38:51;089686021127;INTER MIE KALDU;1;1000;0;1000;813;187;
2021-06-22 19:38:51;8998866202343;MIE SEDAAP KOREAN SPICY;2;2500;0;5000;4046;954;
2021-06-22 19:44:31;8992959610114;HN PANTS XL 44;1;78000;0;78000;72273;5727;
2021-06-22 19:44:31;8999908389008;HEMAVITON C1000;1;8000;0;8000;6000;2000;
2021-06-22 19:44:31;8992696523081;MILO UHT 110ML;1;2500;0;2500;1962;538;
2021-06-22 19:44:31;8997210107877;VORTEX SMART 3;1;5000;0;5000;4750;250;
2021-06-22 19:52:21;8994867000179;ROKOK PENA MILD 16;1;14500;0;14500;13500;1000;
2021-06-22 21:47:31;LT;LIPSTIK HANASUI;1;27000;0;27000;27000;0;
2021-06-22 21:47:31;8999999007768;FAIR&LOVELY MULTIVITAMIN  CREAM 9 ML;1;4500;0;4500;3200;1300;
2021-06-22 21:47:31;MOBIL;GULA GULA HP;1;2000;0;2000;1700;300;
2021-06-22 21:47:31;8991001503114;CHACHA MILK CHOCOLATE 35G;1;5500;0;5500;4900;600;
2021-06-22 21:47:31;VTM;VITAMIN;2;500;0;1000;850;150;
2021-06-22 21:47:31;8996001600399;LE MINERAL 1500ML;1;5000;0;5000;4042;958;
2021-06-22 21:47:31;8992775211410;PILUS GARUDA PEDAS;1;5000;0;5000;4886;114;
2021-06-22 21:51:38;GL;GULA 1 LITER;4;11500;0;46000;42000;4000;
2021-06-22 22:31:38;8998989300261;GUDANG GARAM SURYA 12 FILTER;1;18500;0;18500;17200;1300;
2021-06-22 22:31:38;089686011036;INDOMIE GORENG PEDAS;1;2700;0;2700;2452;248;
2021-06-22 22:43:43;8996001440124;ENERGEN VANILA;2;1500;0;3000;2300;700;
2021-06-22 22:43:43;8998866202060;POTABEE AYAM BAKAR PEDAS 35 GR;1;5000;0;5000;4150;850;
2021-06-22 22:43:43;8996001600375;LE MINERAL 330ML;2;2000;0;4000;2834;1166;
2021-06-22 22:43:43;8994834003752;TICTIC;1;2000;0;2000;1700;300;
2021-06-22 22:43:43;8996001305041;ROMA SANDWICH CKLT;1;7000;0;7000;5000;2000;
2021-06-22 22:43:43;089686010824;INDOMIE GORENG SPESIAL;1;2700;0;2700;2452;248;
2021-06-22 22:43:43;8999999059781;SUNLIGHT LIME NEW POUCH 210ML;1;5000;0;5000;4300;700;
2021-06-22 22:43:43;8998866200882;SUKSESMIE GORENG AYAM KRMS 133GR;1;3500;0;3500;3047;453;
2021-06-22 22:43:43;8998866613262;SUKSESMIE SOTO 111 GR;1;3500;0;3500;2770;730;
2021-06-23 11:43:23;GL;GULA 1 LITER;1;11500;0;11500;10500;1000;
2021-06-23 12:27:47;8992628022156;BIMOLI KLASIK TOUCH 1 LT;1;16000;0;16000;14350;1650;
2021-06-23 12:43:41;089686043617;INDOMIE MIEGHETTI;1;2700;0;2700;2452;248;
2021-06-23 12:43:41;8998866200561;EKOMIE SUPER 600GR;1;10000;0;10000;8615;1385;
2021-06-23 12:43:41;8998866608305;GIV BENGKOANG KOTAK 76G;2;2000;0;4000;3640;360;
2021-06-23 12:43:41;8999999534097;PEPSODENT PGB FCM 75G;1;5000;0;5000;3850;1150;
2021-06-23 12:49:20;ASTOR;ASTOR SCT;13;1000;0;13000;10725;2275;
2021-06-23 12:50:26;9556001025272;NESCAFE LATTE 240ML;1;8500;0;8500;7834;666;
2021-06-23 12:50:26;ASTOR;ASTOR SCT;3;1000;0;3000;2475;525;
2021-06-23 12:50:26;YP;YUPI;2;250;0;500;416;84;
2021-06-23 13:55:38;8992775002155;CHOCOLATOS DRINK;1;4000;0;4000;3520;480;
2021-06-23 14:05:52;8993989311699;CLAS MILD 16 FILTER;1;23000;0;23000;21700;1300;
2021-06-23 14:27:10;8999999502003;SARIMURNI RL RB 1,8G;12;1500;0;18000;14484;3516;
2021-06-23 15:35:08;8999999502003;SARIMURNI RL RB 1,8G;2;1500;0;3000;2414;586;
2021-06-23 16:41:19;6907992825045;JD CRUNCHY MATCHA CHEESE;1;8000;0;8000;7000;1000;
2021-06-23 17:51:00;8991004011906;KOPI BORONG;1;10000;0;10000;8333;1667;
2021-06-23 17:51:00;8998898847109;KOPI JAHE;2;1500;0;3000;2360;640;
2021-06-23 17:51:00;711844110083;KECAP ABC 275 ML;1;14500;0;14500;13400;1100;
2021-06-23 17:51:00;8992979120013;TOTAL BUNGA SOFTENER;1;13000;0;13000;11532;1468;
2021-06-23 18:00:13;8998866202619;MIE SEDAAP KOREAN SPICY SOUP;1;2500;0;2500;2273;227;
2021-06-23 18:29:28;8994834005923;SPIX 1000;2;1000;0;2000;1700;300;
2021-06-23 18:33:22;8992696404441;BEAR BRAND 189ML;1;9000;0;9000;7887;1113;
2021-06-23 18:33:22;6907992824963;JD MILKY CHOCOLATE;2;3000;0;6000;5200;800;
2021-06-23 18:36:07;8998989500166;GUDANG GARAM MERAH BESAR 16KS;2;18000;0;36000;34000;2000;
2021-06-23 18:50:56;8997018460150;MARLBORO ICE BURST 20;1;30000;0;30000;27750;2250;
2021-06-23 18:55:12;8992775211434;PILUS GARUDA SAPI PANGGANG;1;5000;0;5000;4810;190;
2021-06-23 19:11:03;MARS;MARSHMELLOW;2;500;0;1000;866;134;
2021-06-23 19:15:39;8999909002821;MARLBORO BLACK 16;1;22000;0;22000;20850;1150;
2021-06-23 19:36:11;8992959508879;SWEETY SILVER PANTS L 7;1;16800;0;16800;15228;1572;
2021-06-23 19:59:57;8998989300261;GUDANG GARAM SURYA 12 FILTER;1;18500;0;18500;17200;1300;
2021-06-23 20:01:58;8991111109121;JB POWDER BLOSSOM 75+25G;1;6000;0;6000;5430;570;
2021-06-23 21:29:21;8994867000162;ROKOK PUNDIMAS KRETEK16;1;10000;0;10000;8600;1400;
2021-06-23 21:34:48;6907992824963;JD MILKY CHOCOLATE;1;3000;0;3000;2600;400;
2021-06-23 21:46:35;8998866200646;KOPI TOP MURNI;1;11000;0;11000;9600;1400;
2021-06-23 21:48:48;8998866200646;KOPI TOP MURNI;1;11000;0;11000;9600;1400;
2021-06-23 21:48:48;8998866619288;SOKLIN ANTISEP;1;5000;0;5000;4159;841;
2021-06-23 21:48:48;8999999037765;PEPSODENT WHITE 225G;1;12000;0;12000;10750;1250;
2021-06-23 22:14:31;8992761002039;FANTA STRAWBERRY PET 390 ML;1;5500;0;5500;4300;1200;
2021-06-23 22:14:31;8992696523067;MILO ACTVGO UHT 180ML;1;4500;0;4500;3515;985;
2021-06-23 22:16:09;8998989300261;GUDANG GARAM SURYA 12 FILTER;1;18500;0;18500;17200;1300;
2021-06-23 22:34:18;089686010343;INDOMIE SOTO MIE;1;2600;0;2600;2367;233;
2021-06-23 22:34:18;089686010824;INDOMIE GORENG SPESIAL;1;2700;0;2700;2452;248;
2021-06-23 22:34:18;089686010107;INDOMIE KALDU AYAM;1;2500;0;2500;2150;350;
2021-06-23 22:34:18;089686043204;INDOMIE MIE ACEH;1;2700;0;2700;2452;248;
2021-06-23 22:34:18;ASTOR;ASTOR SCT;1;1000;0;1000;825;175;
2021-06-23 22:36:19;ASTOR;ASTOR SCT;1;1000;0;1000;825;175;
2021-06-23 22:36:19;MARS;MARSHMELLOW;1;500;0;500;433;67;
2021-06-23 22:36:19;VTM;VITAMIN;1;500;0;500;425;75;
2021-06-24 11:26:13;8996001600269;LE MINERAL 600ML;1;3000;0;3000;1688;1312;
2021-06-24 11:26:13;8993989311699;CLAS MILD 16 FILTER;1;23000;0;23000;21700;1300;
2021-06-24 11:26:13;8997012321204;MAXX BUMBU BALADO;1;5000;0;5000;4100;900;
2021-06-24 11:30:01;8996001355978;BENG-BENG SHARE IT 9.5G;1;10000;0;10000;8700;1300;
2021-06-24 11:30:01;8992761164478;FRESTEA MILK TEA;1;8000;0;8000;6575;1425;
2021-06-24 11:30:01;6907992825076;JD WATERMELON APPLE;1;2000;0;2000;1700;300;
2021-06-24 11:36:58;9556001004673;MILO NESTLE MALAYSIA ACTIVE GO;1;85000;0;85000;80000;5000;
2021-06-24 11:36:58;711844130128;ABC SAUS TOMAT 275 ML;1;10000;0;10000;8800;1200;
2021-06-24 11:36:58;089686010343;INDOMIE SOTO MIE;4;2600;0;10400;9468;932;
2021-06-24 11:36:58;8999999049454;REXONA WMN RO FREE SPIRIT 45 ML;1;15000;0;15000;13550;1450;
2021-06-24 11:37:59;8998866200325;MIE SEDAAP SOTO;2;2500;0;5000;3904;1096;
2021-06-24 11:46:51;GL;GULA 1 LITER;2;11500;0;23000;21000;2000;
2021-06-24 11:49:56;8992984820410;BAKING POWDER;1;6500;0;6500;5500;1000;
2021-06-24 11:49:56;8998866501026;MINYAK GORENG SEDAAP POUCH 1 L;1;15000;0;15000;14110;890;
2021-06-24 12:18:07;COKLAT;COKLAT COIN;2;500;0;1000;850;150;
2021-06-24 12:18:07;VTM;VITAMIN;2;500;0;1000;850;150;
2021-06-24 12:21:39;BAYFLAST;BAYPLAST;4;500;0;2000;1400;600;
2021-06-24 14:02:00;8998666003089SCT;TB GILUX MIX SCT;1;1000;0;1000;800;200;
2021-06-24 14:02:00;9311931024036;COFFEEMIX SCT;1;1500;0;1500;1200;300;
2021-06-24 14:02:29;8992959971093;SFX COMFORT SLIME 6;1;8500;0;8500;7798;702;
2021-06-24 14:02:29;8998866202770;MIE SEDAAP SALERO PADANG;2;2500;0;5000;4724;276;
2021-06-24 14:02:29;8998866200325;MIE SEDAAP SOTO;2;2500;0;5000;3904;1096;
2021-06-24 14:03:45;8998866106535;EMERON LOVELY NAT GREEN 200ML;1;6000;0;6000;5075;925;
2021-06-24 14:05:37;8998866501033;MINYAK GORENG SEDAAP POUCH 2L;1;29000;0;29000;27746;1254;
2021-06-24 14:16:15;8997028590014;ARGUS 220ML;2;500;0;1000;604;396;
2021-06-24 14:34:08;8997011700123;BIHUN JAGUNG 300GR;1;6000;0;6000;4979;1021;
2021-06-24 14:34:08;ff;FULLO BLASTO;1;1000;0;1000;995;5;
2021-06-24 15:01:45;8998989110167;SURYA GUDANG GARAM 16 FILTER;1;25000;0;25000;23200;1800;
2021-06-24 15:11:17;GL;GULA 1 LITER;3;11500;0;34500;31500;3000;
2021-06-24 15:11:17;8998866201964;MINYAK GORENG SABRINA 2L POUCH;1;28000;0;28000;26753;1247;
2021-06-24 15:11:17;8992759120264;LARISST 220;1;10000;0;10000;9200;800;
2021-06-24 15:11:17;089686043204;INDOMIE MIE ACEH;3;2700;0;8100;7356;744;
2021-06-24 15:11:17;8992775310212;GERY PASTA COKELAT;1;18000;0;18000;16029;1971;
2021-06-24 16:58:26;8999999706173;PEPSODENT WHITE 120G;1;6700;0;6700;5940;760;
2021-06-24 16:58:26;6907992823591;JD STRAW MILKSHAKE;1;5000;0;5000;4300;700;
2021-06-24 16:59:15;8994867000179;ROKOK PENA MILD 16;2;14500;0;29000;27000;2000;
2021-06-24 17:22:11;8999999195656;SARI WANGI 50X1.85;1;10000;0;10000;9500;500;
2021-06-24 17:22:11;8999999046989;LIFEBUOY MILD CARE 60G;1;10000;0;10000;7645;2355;
2021-06-24 17:25:11;8996001600269;LE MINERAL 600ML;1;3000;0;3000;1688;1312;
2021-06-24 17:25:11;8992761164546;NUTRIBOOST STRAWBERRY 300ML;1;6500;0;6500;5300;1200;
2021-06-24 17:25:11;8992761164539;NUTRIBOOST ORANGE 300ML;1;6500;0;6500;5300;1200;
2021-06-24 17:25:11;089686834307;FREISS LECI;5;11000;0;55000;43750;11250;
2021-06-24 17:25:11;711844150027;ABC NANAS;1;13000;0;13000;12241;759;
2021-06-24 17:25:11;089686834055;FREISS JERUK;4;11000;0;44000;35000;9000;
2021-06-24 17:26:31;8991102303309;WFR TANGO SBJ 176G;1;10000;0;10000;8694;1306;
2021-06-24 17:42:51;8992959954058;SWEETY BRONZE NB 44;1;48000;0;48000;45682;2318;
2021-06-24 17:42:51;8996001600375;LE MINERAL 330ML;1;2000;0;2000;1417;583;
2021-06-24 18:06:03;LT;LIPSTIK HANASUI;1;27000;0;27000;27000;0;
2021-06-24 18:06:03;8998866107464;POSH FRESH SPIRIT 150ML;1;19500;0;19500;17500;2000;
2021-06-24 20:07:26;8992761139018;ADES 600ML;1;3500;0;3500;2292;1208;
2021-06-24 20:07:26;8886013213208;FRENCH FREIS 2000;2;5000;0;10000;7500;2500;
2021-06-24 20:07:26;8998009010569;ULTRA CHO 200;2;5000;0;10000;7660;2340;
2021-06-24 20:07:26;COKLAT;COKLAT COIN;10;500;0;5000;4250;750;
2021-06-24 20:07:26;JGR SHN;JOGER SHINY SACHET;3;500;0;1500;1311;189;
2021-06-24 21:08:20;8999999706111;PEPSODENT WHITE 25G;1;2000;0;2000;1450;550;
2021-06-24 21:08:20;8992959117583;SFX DS REG FLOW WING 20;1;5000;0;5000;4288;712;
2021-06-24 21:41:46;8996001440049;ENERGEN;2;1500;0;3000;2400;600;
2021-06-24 21:42:35;8998866202244;EKOMIE BUMBU KALDU AYAM;3;1000;0;3000;2394;606;
2021-06-24 21:42:35;8992696520103SCT;DNCO CKLT 39G SCT;2;3500;0;7000;5914;1086;
2021-06-24 21:43:17;8994867000179;ROKOK PENA MILD 16;1;14500;0;14500;13500;1000;
2021-06-24 21:43:17;8998989300261;GUDANG GARAM SURYA 12 FILTER;1;18500;0;18500;17200;1300;
2021-06-24 21:43:17;8993989311279;CLAS MILD 12;1;17000;0;17000;15700;1300;
2021-06-24 21:43:17;8992696521797SCT;MILO ACT GO 22G SCT;1;2000;0;2000;1553;447;
2021-06-24 22:01:40;PRG;PARAGO;6;500;0;3000;2400;600;
2021-06-25 10:57:43;8998866618298;DAIA CLEAN&FRESH HJB 320GR;1;5000;0;5000;4450;550;
2021-06-25 10:57:43;8998666001924SCT;TB TORA CAFE CHOCO LATTE SCT;1;1000;0;1000;780;220;
2021-06-25 11:05:10;MOLTO PINK;MOLTO ALL IN ONE 11 ML;4;500;0;2000;1600;400;
2021-06-25 11:05:10;MARS;MARSHMELLOW;13;500;0;6500;5629;871;
2021-06-25 11:05:10;8992761145026;SPRITE PET 250ML;3;3500;0;10500;7251;3249;
2021-06-25 11:05:10;ASTOR;ASTOR SCT;1;1000;0;1000;825;175;
2021-06-25 11:05:10;bb;BENG-BENG;1;1500;0;1500;1450;50;
2021-06-25 11:05:10;8998989300261;GUDANG GARAM SURYA 12 FILTER;1;18500;0;18500;17200;1300;
2021-06-25 11:05:10;8992702000018;INDOMILK 370G;1;10000;0;10000;9020;980;
2021-06-25 11:05:10;8998866202244;EKOMIE BUMBU KALDU AYAM;5;1000;0;5000;3990;1010;
2021-06-25 11:34:10;ROTI;ROTI 2000;2;2000;0;4000;3600;400;
2021-06-25 12:55:34;8999909010567;234 DJI SAM SOE 16;1;22000;0;22000;21500;500;
2021-06-25 14:22:18;8994935000070;MINYAK DUNIA 450 ML;1;7500;0;7500;6779;721;
2021-06-25 14:22:18;ROTI;ROTI 2000;1;2000;0;2000;1800;200;
2021-06-25 14:23:16;8993989311699;CLAS MILD 16 FILTER;1;23000;0;23000;21700;1300;
2021-06-25 14:23:16;8996001600269;LE MINERAL 600ML;1;3000;0;3000;1688;1312;
2021-06-25 14:23:16;VTM;VITAMIN;2;500;0;1000;850;150;
2021-06-25 14:42:18;8999999719760;PONDS CLEAR SOL SHAKE&CLEAN 100ML;1;20000;0;20000;18000;2000;
2021-06-25 14:42:56;8998989500166;GUDANG GARAM MERAH BESAR 16KS;2;18000;0;36000;34000;2000;
2021-06-25 15:42:53;GL;GULA 1 LITER;1;11500;0;11500;10500;1000;
2021-06-25 16:18:08;8886013213208;FRENCH FREIS 2000;7;5000;0;35000;26250;8750;
2021-06-25 16:18:08;8994834003752;TICTIC;1;2000;0;2000;1700;300;
2021-06-25 16:18:57;8994834003752;TICTIC;1;2000;0;2000;1700;300;
2021-06-25 16:55:41;MARS;MARSHMELLOW;4;500;0;2000;1732;268;
2021-06-25 17:46:17;711844610095;LARISSA UDANG 500 GR;2;11000;0;22000;19580;2420;
2021-06-25 18:07:40;8998866610438;SOKLIN SOFTERGENT RED BAG 770G & PIRING;1;18000;0;18000;16680;1320;
2021-06-25 18:07:40;8994834005923;SPIX 1000;3;1000;0;3000;2550;450;
2021-06-25 18:07:40;ROTI;ROTI 2000;2;2000;0;4000;3600;400;
2021-06-25 18:17:43;8992959117583;SFX DS REG FLOW WING 20;1;5000;0;5000;4288;712;
2021-06-25 18:17:43;8999999035495;VASELINE INSTA FAIR 190ML;1;33100;0;33100;30855;2245;
2021-06-25 18:17:43;8999999549305;VASELINE SUPERFOOD CRANBERRY 200ML;1;26000;0;26000;23940;2060;
2021-06-26 21:16:43;8991102989381;TANGO LONG BUBBLEGUM 130G;1;5000;0;5000;4345;655;
2021-06-26 21:36:50;8991102989381;TANGO LONG BUBBLEGUM 130G;1;5000;0;5000;4345;655;
2021-06-26 21:36:50;8998866202343;MIE SEDAAP KOREAN SPICY;1;2500;0;2500;2023;477;
2021-06-26 21:45:21;8998989110167;SURYA GUDANG GARAM 16 FILTER;1;25000;0;25000;23200;1800;
2021-06-26 21:59:41;8998009040023;TEH KOTAK;1;5000;0;5000;2827;2173;
2021-06-26 22:02:16;8991102989381;TANGO LONG BUBBLEGUM 130G;1;5000;0;5000;4345;655;
2021-06-26 22:02:16;8996001355978;BENG-BENG SHARE IT 9.5G;2;10000;0;20000;17400;2600;
2021-06-27 20:38:40;gula;GULA;1;11500;0;11500;10000;1500;
2021-06-27 20:44:01;8998989110167;SURYA GUDANG GARAM 16 FILTER;1;25000;0;25000;23200;1800;
2021-06-27 20:59:17;8992959974018;SFX SIRIH 36CM 12+1;1;17000;0;17000;15958;1042;
2021-06-27 20:59:17;8992959508954;SWEETY SILVER PANTS S 66;1;92000;0;92000;88788;3212;
2021-06-27 20:59:17;8991909101016;URBAN MILD 16;1;17000;0;17000;15800;1200;
2021-06-27 21:25:28;8998989300261;GUDANG GARAM SURYA 12 FILTER;1;18500;0;18500;17200;1300;
2021-06-27 21:30:48;8998989300261;GUDANG GARAM SURYA 12 FILTER;1;18500;0;18500;17200;1300;
2021-06-27 21:42:03;8998989300261;GUDANG GARAM SURYA 12 FILTER;1;18500;0;18500;17200;1300;
2021-06-27 21:50:15;8998989110167;SURYA GUDANG GARAM 16 FILTER;1;25000;0;25000;23200;1800;
2021-06-27 22:01:37;8998866618298;DAIA CLEAN&FRESH HJB 320GR;1;5000;0;5000;4450;550;
2021-06-27 22:24:31;8998989500166;GUDANG GARAM MERAH BESAR 16KS;2;18000;0;36000;34000;2000;
2021-06-27 22:37:51;8999099922985;SGM 0-6 600G;2;55000;0;110000;103902;6098;
2021-06-28 20:06:28;8998989110167;SURYA GUDANG GARAM 16 FILTER;2;25000;0;50000;46400;3600;
2021-06-28 20:07:42;8994867007161;ROKOK PENA GOLD 20;1;17000;0;17000;15500;1500;
2021-06-28 20:10:57;8992696404441;BEAR BRAND 189ML;1;9000;0;9000;7887;1113;
2021-06-28 20:14:03;8999909096004;SAMPOERNA 16 FILTER;1;24000;0;24000;23000;1000;
2021-06-28 20:19:56;8992696523081;MILO UHT 110ML;2;2500;0;5000;3924;1076;
2021-06-28 20:22:30;8992775000076;GERY SNACK RING CKLT;1;2000;0;2000;1712;288;
2021-06-28 20:30:53;8999999059309;LIFEBUOY TS TOTAL 10 DG 75G;1;3000;0;3000;2640;360;
2021-06-28 20:35:11;8996001355237;SUPER STAR;1;11000;0;11000;9900;1100;
2021-06-28 20:36:00;8996001355237;SUPER STAR;3;11000;0;33000;29700;3300;
2021-06-28 20:41:18;089686011494;INDOMIE SOTO PADANG;1;2600;0;2600;2317;283;
2021-06-28 20:53:55;8999999707835;CLOSEUP GREEN 65G;2;7000;0;14000;12000;2000;
2021-06-28 20:54:42;8999999031930;PEPSODENT TB TRIPLE CLEAN;2;3500;0;7000;5700;1300;
2021-06-28 21:16:36;8992696404441;BEAR BRAND 189ML;2;9000;0;18000;15774;2226;
2021-06-28 21:28:39;8996001600399;LE MINERAL 1500ML;1;5000;0;5000;4042;958;
2021-06-28 22:29:36;089686010824;INDOMIE GORENG SPESIAL;2;2700;0;5400;4904;496;
2021-06-28 22:32:19;8998989110167;SURYA GUDANG GARAM 16 FILTER;1;25000;0;25000;23200;1800;
2021-06-28 22:37:02;8999999001209;LIFEBUOY BW MILDCARE LD REFF 450 ML;2;25000;0;50000;44220;5780;
2021-06-29 20:11:16;8998989110167;SURYA GUDANG GARAM 16 FILTER;1;25000;0;25000;23200;1800;
2021-06-29 20:12:28;8993989311279;CLAS MILD 12;1;17000;0;17000;15700;1300;
2021-06-29 20:15:23;8999999706180;PEPSODENT WHITE 190GR;1;10000;0;10000;9350;650;
2021-06-29 20:18:24;8992696404441;BEAR BRAND 189ML;1;9000;0;9000;7887;1113;
2021-06-29 20:21:38;089686010190;INDOMIE KARI AYAM;2;2800;0;5600;5044;556;
2021-06-29 20:24:36;8998989500128;GUDANG GARAM MERAH KECIL 12KS;1;14000;0;14000;13000;1000;
2021-06-29 20:29:44;8999999031602;SARI MURNI 20X1.6G;1;6000;0;6000;5400;600;
2021-06-29 21:28:34;8998989500128;GUDANG GARAM MERAH KECIL 12KS;1;14000;0;14000;13000;1000;
2021-06-29 21:30:03;8999999001179;LIFEBUOY BW COOLFRESH LD REFF 450 ML;1;25000;0;25000;22110;2890;
2021-06-29 21:30:03;8999999048181;SUNSILK BLK SHINE 170ML;1;20000;0;20000;18150;1850;
2021-06-29 21:30:03;8992694247255;ZWITSAL BATH NAT HAIR&BODY 200ML;1;20500;0;20500;18810;1690;
2021-06-29 21:37:25;8999999059309;LIFEBUOY TS TOTAL 10 DG 75G;1;3000;0;3000;2640;360;
2021-06-29 22:11:28;8999999004248;CITRA NATURAL WHITE SCRUB 200ML;1;16200;0;16200;14550;1650;
2021-06-29 22:11:28;8999999528942;CITRA HBL PEARLY WHITE UV 120ML;1;12000;0;12000;10082;1918;
2021-06-29 22:11:28;089686010824;INDOMIE GORENG SPESIAL;1;2700;0;2700;2452;248;
2021-06-29 22:11:28;711844110113;KECAP ABC 135 ML;1;7000;0;7000;6400;600;
2021-06-29 22:11:28;8994834003752;TICTIC;1;2000;0;2000;1700;300;
2021-06-29 22:11:28;8991111101316;JB OIL 50ML;1;9500;0;9500;8700;800;
2021-06-29 22:14:52;8998989500128;GUDANG GARAM MERAH KECIL 12KS;2;14000;0;28000;26000;2000;
2021-06-29 22:19:31;8991102022347;SIKAT GIGI FORMULA RIPPLE;1;5000;0;5000;4583;417;
2021-06-29 22:19:31;8999999559861;AXE DARK POCKET FRAG 17ML;1;10000;0;10000;8000;2000;
2021-06-29 22:19:31;8993072254056;MELROSE COTTON BUDS KCL;1;3000;0;3000;2450;550;
2021-06-30 11:56:09;8992753102204;BKM COKLAT 370G;1;11300;0;11300;9500;1800;
2021-06-30 12:07:04;8994867007161;ROKOK PENA GOLD 20;1;17000;0;17000;15500;1500;
2021-06-30 12:07:04;8999909002821;MARLBORO BLACK 16;1;22000;0;22000;20850;1150;
2021-06-30 12:40:25;8997028590014;ARGUS 220ML;1;500;0;500;302;198;
2021-06-30 14:38:13;6907992823591;JD STRAW MILKSHAKE;1;5000;0;5000;4300;700;
2021-06-30 16:04:24;8999999571924;MOLTO PURE 1OML;1;5000;0;5000;4800;200;
2021-06-30 16:04:24;8999999195656;SARI WANGI 50X1.85;1;10000;0;10000;9500;500;
2021-06-30 16:04:24;COKLAT;COKLAT COIN;2;500;0;1000;850;150;
2021-06-30 16:22:29;8997009510017;YOU C1000 LEMON;2;10000;0;20000;18332;1668;
2021-06-30 16:28:04;8993989311279;CLAS MILD 12;1;17000;0;17000;15700;1300;
2021-06-30 16:30:19;8998866501033;MINYAK GORENG SEDAAP POUCH 2L;1;29000;0;29000;27746;1254;
2021-06-30 16:35:16;8999909010567;234 DJI SAM SOE 16;1;22000;0;22000;21500;500;
2021-06-30 16:48:59;8991102281430;PERMEN MINTZ DUOMINT;1;4500;0;4500;4000;500;
2021-06-30 16:51:55;6907992823843;JD MOCHA CRISPY;2;5000;0;10000;8800;1200;
2021-06-30 16:51:55;8992775318201;GERY SNACK BANTAL COKLAT;2;2000;0;4000;3424;576;
2021-06-30 16:51:55;8996001305003;SARI GANDUM SANDWICH;1;6000;0;6000;5100;900;
2021-06-30 17:01:47;8994867000094;ROKOK PUNDIMAS FIL16;1;15000;0;15000;13500;1500;
2021-06-30 17:47:06;8992696521797SCT;MILO ACT GO 22G SCT;2;2000;0;4000;3106;894;
2021-06-30 18:04:10;8850007090267;JB BATH MILK 400ML (REFILL);1;24500;0;24500;23390;1110;
2021-06-30 18:34:36;8998866607315;SOKLIN SOFTERGENT SAKURA 770G & PIRING;1;18000;0;18000;16680;1320;
2021-06-30 19:12:40;GL;GULA 1 LITER;4;11500;0;46000;42000;4000;
2021-06-30 19:15:37;8998989110167;SURYA GUDANG GARAM 16 FILTER;1;25000;0;25000;23200;1800;
2021-06-30 19:16:41;8992696404441;BEAR BRAND 189ML;1;9000;0;9000;7887;1113;
2021-06-30 19:41:58;8992959953181;SWEETY BRONZE L30+2;1;55000;0;55000;53410;1590;
2021-06-30 21:06:22;8998866202466;JAPOTA HAPPY HONEY BUTTER;1;5000;0;5000;4150;850;
2021-06-30 21:06:22;8998866202435;JAPOTA UMAMI JAPANESE SEAWEED 35GR;1;5000;0;5000;4150;850;
2021-06-30 21:06:22;8991909101016;URBAN MILD 16;1;17000;0;17000;15800;1200;
2021-06-30 21:50:38;8999909010567;234 DJI SAM SOE 16;1;22000;0;22000;21500;500;
2021-06-30 22:09:44;8996001600375;LE MINERAL 330ML;1;43200;0;43200;34008;9192;
2021-06-30 22:44:28;8998866202244;EKOMIE BUMBU KALDU AYAM;1;1000;0;1000;798;202;
2021-06-30 22:44:28;8997007780689;JIZZY MINERAL;1;3000;0;3000;1187;1813;
2021-06-30 22:44:28;6907992825076;JD WATERMELON APPLE;1;2000;0;2000;1700;300;
2021-06-30 22:44:28;SS;SUPER SNAPS;1;1500;0;1500;1333;167;
2021-06-30 22:44:28;8992761145033;FANTA STRAW PET 250ML;1;3500;0;3500;2417;1083;
2021-06-30 22:44:28;8992775318201;GERY SNACK BANTAL COKLAT;1;2000;0;2000;1712;288;
2021-07-01 11:19:21;8997231980015;O'JELLY MINI APPLE;1;3000;0;3000;2250;750;
2021-07-01 11:34:21;8998866501033;MINYAK GORENG SEDAAP POUCH 2L;2;29000;0;58000;55492;2508;
2021-07-01 11:34:21;bb;BENG-BENG;2;1500;0;3000;2900;100;
2021-07-01 12:32:03;9556001004673;MILO NESTLE MALAYSIA ACTIVE GO;1;85000;0;85000;80000;5000;
2021-07-01 12:32:03;KP;KERIPIK PISANG;2;5000;0;10000;10000;0;
2021-07-01 12:32:03;089686611519;QTELA SINGKONG;1;5000;0;5000;4266;734;
2021-07-01 12:32:03;8996001600269;LE MINERAL 600ML;2;3000;0;6000;3376;2624;
2021-07-01 13:25:45;8999999195649;SARI WANGI 25X1.86G;1;6000;0;6000;5050;950;
2021-07-01 13:50:33;8999908284907;MY BABY MINYAK TELON 90ML;1;25000;0;25000;22700;2300;
2021-07-01 13:50:33;8998989300261;GUDANG GARAM SURYA 12 FILTER;1;18500;0;18500;17200;1300;
2021-07-01 13:50:33;SF TAWAR ORI;SAFFANAH TAWAR ORI;1;9000;0;9000;8000;1000;
2021-07-01 14:33:04;8996001600269;LE MINERAL 600ML;3;3000;0;9000;5064;3936;
2021-07-01 14:52:19;089686010824;INDOMIE GORENG SPESIAL;2;2700;0;5400;4904;496;
2021-07-01 15:23:30;8991002103764GT;GOOD DAY CAPPUCINO;1;13000;0;13000;11000;2000;
2021-07-01 15:23:30;8992957220025;GOLDEN CITY MINI;1;3000;0;3000;2500;500;
2021-07-01 15:23:30;8993072254056;MELROSE COTTON BUDS KCL;1;3000;0;3000;2450;550;
2021-07-01 15:23:30;8991102213189;BLASTER UNGU;1;5000;0;5000;3106;1894;
2021-07-01 15:23:30;8999999195649;SARI WANGI 25X1.86G;1;6000;0;6000;5050;950;
2021-07-01 15:23:30;kp;KALPA;2;2000;0;4000;3332;668;
2021-07-01 15:23:30;8995333032113;TERIGU GATOT KACA 1 KG;1;8500;0;8500;8012;488;
2021-07-01 15:23:30;8992730002992;HAI CANDY;1;7000;0;7000;6000;1000;
2021-07-01 15:23:30;COKLAT;COKLAT COIN;1;500;0;500;425;75;
2021-07-01 16:16:30;8998989500128;GUDANG GARAM MERAH KECIL 12KS;1;14000;0;14000;13000;1000;
2021-07-01 16:16:30;8998989500166;GUDANG GARAM MERAH BESAR 16KS;2;18000;0;36000;34000;2000;
2021-07-01 16:47:59;6907992823843;JD MOCHA CRISPY;1;5000;0;5000;4400;600;
2021-07-01 16:47:59;8992761166038;MMP ORANGE 300ML;1;5000;0;5000;3750;1250;
2021-07-01 16:47:59;8999999195656;SARI WANGI 50X1.85;1;10000;0;10000;9500;500;
2021-07-01 16:47:59;8992628022156;BIMOLI KLASIK TOUCH 1 LT;1;16000;0;16000;14350;1650;
2021-07-01 16:47:59;8992761166052;FRESTEA MELATI 350ML;1;4500;0;4500;3000;1500;
2021-07-01 18:10:27;8998866202060;POTABEE AYAM BAKAR PEDAS 35 GR;1;5000;0;5000;4150;850;
2021-07-01 18:10:27;8998866501026;MINYAK GORENG SEDAAP POUCH 1 L;1;15000;0;15000;14110;890;
2021-07-01 18:10:27;8997011700123;BIHUN JAGUNG 300GR;1;6000;0;6000;4979;1021;
2021-07-01 18:29:32;8991002105409;KOPI KAPAL API;1;20000;0;20000;18888;1112;
2021-07-01 18:29:32;8991909101016;URBAN MILD 16;1;17000;0;17000;15800;1200;
2021-07-01 18:29:32;123124;KOREK BIASA;1;2000;0;2000;1800;200;
2021-07-01 19:15:43;8998866200325;MIE SEDAAP SOTO;2;2500;0;5000;3904;1096;
2021-07-01 19:21:46;8999909010567;234 DJI SAM SOE 16;1;22000;0;22000;21500;500;
2021-07-01 19:45:18;8993058304201;BEJO JAHE MERAH;1;3000;0;3000;1893;1107;
2021-07-01 19:45:18;8996001301142;ROMA KELAPA;1;8000;0;8000;6628;1372;
2021-07-01 20:33:11;8992959953037;SWEETY BRONZE L1;1;3000;0;3000;2671;329;
2021-07-01 20:33:11;8992870311091;SALONPAS;1;6000;0;6000;4806;1194;
2021-07-01 20:42:07;8992959953181;SWEETY BRONZE L30+2;1;55000;0;55000;53410;1590;
2021-07-01 20:47:40;8992959953044;SWEETY BRONZE XL1;1;2500;0;2500;2250;250;
2021-07-01 20:47:40;8992775001653;GERY SALUT CHOCOLATE COCONUT;1;2000;0;2000;1476;524;
2021-07-01 20:47:49;HT;HOT-HOT;1;500;0;500;350;150;
2021-07-01 20:51:48;8999909002821;MARLBORO BLACK 16;1;22000;0;22000;20850;1150;
2021-07-01 20:57:39;8993989311279;CLAS MILD 12;1;17000;0;17000;15700;1300;
2021-07-01 20:57:39;VTM;VITAMIN;2;500;0;1000;850;150;
2021-07-01 21:16:40;8993176110074;MINYAK KAYU PUTIH 60ML;1;20000;0;20000;17333;2667;
2021-07-01 21:21:13;8998009010569;ULTRA CHO 200;1;5000;0;5000;3830;1170;
2021-07-01 21:32:22;8998866200301;MIE SEDAAP GORENG;2;2500;0;5000;4046;954;
2021-07-01 21:32:22;8999999531508;MOLTO HYGIENE SC 10ML;10;500;0;5000;4800;200;
2021-07-01 21:32:22;6907992823911;JD CRUNCHY HONEYDEW MELON;1;8000;0;8000;6800;1200;
2021-07-01 21:32:22;6907992823621;JD CREAMY YOGURT;1;3000;0;3000;2600;400;
2021-07-01 21:32:22;8992957220087;COKLAT SINGA;2;2000;0;4000;3400;600;
2021-07-01 21:40:13;8997013790108;BIMURA KACANG TELUR 25G;2;1000;0;2000;1750;250;
2021-07-01 21:40:13;6907992823911;JD CRUNCHY HONEYDEW MELON;1;8000;0;8000;6800;1200;
2021-07-01 21:40:13;COKLAT;COKLAT COIN;2;500;0;1000;850;150;
2021-07-01 22:36:39;089686017748;SARIMIE GORENG ISI 2;2;3500;0;7000;6240;760;
2021-07-01 22:36:39;8999999031602;SARI MURNI 20X1.6G;1;6000;0;6000;5400;600;
2021-07-01 22:36:39;8996001440087;ENERGEN KACANG HIJAU;7;1500;0;10500;8050;2450;
2021-07-01 22:36:39;8993083929806;BISKITOP COKLAT;1;30000;0;30000;27000;3000;
2021-07-01 22:37:38;8993470671752;JOGER STICK DUO KACANG;1;1000;0;1000;850;150;
2021-07-01 22:37:38;HT;HOT-HOT;1;500;0;500;350;150;
2021-07-01 22:56:03;8998866200325;MIE SEDAAP SOTO;1;2500;0;2500;1952;548;
2021-07-01 22:56:03;CC;NICE FACIAL KILOAN 900 GR DUO;1;34500;0;34500;31325;3175;
2021-07-01 22:56:03;8997007780689;JIZZY MINERAL;2;3000;0;6000;2374;3626;
2021-07-01 22:56:03;8886013213208;FRENCH FREIS 2000;1;5000;0;5000;3750;1250;
2021-07-01 22:56:03;8992775000663;GERY SNACK KEJU;1;2000;0;2000;1712;288;
2021-07-02 11:18:41;123;BETREI JAM;1;5500;0;5500;5000;500;
2021-07-02 11:28:40;GL;GULA 1 LITER;1;11500;0;11500;10500;1000;
2021-07-02 11:28:40;8998866501033;MINYAK GORENG SEDAAP POUCH 2L;1;29000;0;29000;27746;1254;
2021-07-02 11:28:40;8999999516208;ROYCO FDS CHICKEN NEW 230G;1;10000;0;10000;9000;1000;
2021-07-02 11:28:40;8998008151065;MIWON 100 GR;1;3300;0;3300;2996;304;
2021-07-02 11:33:33;8999909004221;SAMPOERNA ULTRAMILD 16;1;22000;0;22000;20350;1650;
2021-07-02 11:42:59;SF TAWAR ORI;SAFFANAH TAWAR ORI;1;9000;0;9000;8000;1000;
2021-07-02 11:42:59;8998898830125;KKB ENER-G ANGGUR;1;5500;0;5500;4824;676;
2021-07-02 11:42:59;8992761139018;ADES 600ML;1;3500;0;3500;2292;1208;
2021-07-02 11:42:59;8998866501033;MINYAK GORENG SEDAAP POUCH 2L;1;29000;0;29000;27746;1254;
2021-07-02 11:42:59;ff;FULLO BLASTO;1;1000;0;1000;995;5;
2021-07-02 11:42:59;bb;BENG-BENG;6;1500;0;9000;8700;300;
2021-07-02 11:42:59;8992775210215;GARUDA ATOM PEDAS;1;17000;0;17000;15363;1637;
2021-07-02 11:42:59;8992775610008;TING-TING GARUDA 2.5G;1;7500;0;7500;6296;1204;
2021-07-02 11:42:59;8997025914059;HATARI SEE HONG;1;6000;0;6000;4911;1089;
2021-07-02 11:42:59;8991102230308;BLASTER PINK;1;5000;0;5000;3106;1894;
2021-07-02 11:42:59;VTM;VITAMIN;4;500;0;2000;1700;300;
2021-07-02 11:42:59;ROTI;ROTI 2000;2;2000;0;4000;3600;400;
2021-07-02 11:42:59;8998666001306SCT;TB CREAMY LATTE SCT;2;1500;0;3000;1980;1020;
2021-07-02 11:42:59;8996001414002SCT;TB CAPPUCINO SCT;2;1500;0;3000;2700;300;
2021-07-02 11:53:12;HT;HOT-HOT;1;500;0;500;350;150;
2021-07-02 11:53:12;TUSTEL;TUSUK TELINGA;1;1000;0;1000;833;167;
2021-07-02 11:53:12;8998866501033;MINYAK GORENG SEDAAP POUCH 2L;2;29000;0;58000;55492;2508;
2021-07-02 11:53:12;bb;BENG-BENG;1;1500;0;1500;1450;50;
2021-07-02 11:53:12;COKLAT;COKLAT COIN;1;500;0;500;425;75;
2021-07-02 11:53:12;ROTI;ROTI 2000;2;2000;0;4000;3600;400;
2021-07-02 12:21:03;8990800016757;BB TUTI FRUITTY COSMO;1;8500;0;8500;7600;900;
2021-07-02 12:21:03;COKLAT;COKLAT COIN;1;500;0;500;425;75;
2021-07-02 12:21:03;8997231980022;O'JELLY MINI STRAWBERRY;3;3000;0;9000;6750;2250;
2021-07-02 12:21:03;8996001304549;SLAI OLAI 1000;2;1000;0;2000;1650;350;
2021-07-02 12:21:03;ASTOR;ASTOR SCT;5;1000;0;5000;4125;875;
2021-07-02 12:21:03;YP;YUPI;4;250;0;1000;832;168;
2021-07-02 12:21:03;8992761145033;FANTA STRAW PET 250ML;1;3500;0;3500;2417;1083;
2021-07-02 12:21:03;MARS;MARSHMELLOW;14;500;0;7000;6062;938;
2021-07-02 12:21:03;8993154790021;DELLA CHA;1;2000;0;2000;1714;286;
2021-07-02 12:21:03;8998866610261;DAIA VIOLET GUSSET BAG 290 GR;1;5000;0;5000;4450;550;
2021-07-02 12:21:03;JD VM;JD VANILLA MILKSHAKE;1;5000;0;5000;4300;700;
2021-07-02 12:21:03;8999909002821;MARLBORO BLACK 16;1;22000;0;22000;20850;1150;
2021-07-02 12:21:03;8992752112013;MIZONE;1;5000;0;5000;3800;1200;
2021-07-02 12:21:03;8991102384841;WFR TANGO LONG CKLT 130G;1;5000;0;5000;4345;655;
2021-07-02 12:21:03;8996001414002SCT;TB CAPPUCINO SCT;2;1500;0;3000;2700;300;
2021-07-02 12:21:03;8998866202343;MIE SEDAAP KOREAN SPICY;1;2500;0;2500;2023;477;
2021-07-02 12:21:03;ARG;ARGUS 220ML;1;14500;0;14500;12500;2000;
2021-07-02 12:21:03;8992696404441;BEAR BRAND 189ML;1;9000;0;9000;7887;1113;
2021-07-02 12:21:03;8997009510017;YOU C1000 LEMON;1;10000;0;10000;9166;834;
2021-07-02 12:21:03;8999909085114;SAMPOERNA KRETEK HIJAU 12;1;13000;0;13000;11650;1350;
2021-07-02 12:21:03;8998009010590;ULTRA CHO 125;1;3000;0;3000;2428;572;
2021-07-02 12:21:03;MOBIL;GULA GULA HP;1;2000;0;2000;1700;300;
2021-07-02 12:21:03;6907992823843;JD MOCHA CRISPY;1;5000;0;5000;4400;600;
2021-07-02 12:21:03;711844610095;LARISSA UDANG 500 GR;1;11000;0;11000;9790;1210;
2021-07-02 12:21:03;8998866202244;EKOMIE BUMBU KALDU AYAM;5;1000;0;5000;3990;1010;
2021-07-02 12:21:03;8993335523363;TOTAL ALMEERA 250G;1;5000;0;5000;4100;900;
2021-07-02 12:21:03;8999999059781;SUNLIGHT LIME NEW POUCH 210ML;1;5000;0;5000;4300;700;
2021-07-02 12:21:03;MOLTO PINK;MOLTO ALL IN ONE 11 ML;4;500;0;2000;1600;400;
2021-07-02 12:21:03;8993989311699;CLAS MILD 16 FILTER;2;23000;0;46000;43400;2600;
2021-07-02 12:21:03;8998866202619;MIE SEDAAP KOREAN SPICY SOUP;2;2500;0;5000;4546;454;
2021-07-02 12:21:03;8999999707781;PEPSODENT ACTION 123 PLUS WHITENING 190G;1;17200;0;17200;15785;1415;
2021-07-02 12:21:03;8991102994422;TANGO WALUT CHOCOBNN 18G;1;9000;0;9000;8661;339;
2021-07-02 12:21:03;8994834003752;TICTIC;4;2000;0;8000;6800;1200;
2021-07-02 12:21:03;8994834006128;TICTIC PEDAS;2;2000;0;4000;3400;600;
2021-07-02 12:21:03;8998866500708;FLORIDINA ORANGE;1;3000;0;3000;2500;500;
2021-07-02 12:21:03;8995333032113;TERIGU GATOT KACA 1 KG;3;8500;0;25500;24036;1464;
2021-07-02 12:21:03;8992761111533;SPRITE SLIM CAM250ML;1;5000;0;5000;3750;1250;
2021-07-02 12:21:03;8996001600269;LE MINERAL 600ML;2;3000;0;6000;3376;2624;
2021-07-02 12:21:03;8992759120264;LARISST 220;2;10000;0;20000;18400;1600;
2021-07-02 12:21:03;8992628020152;BIMOLI POUCH 2L;2;31000;0;62000;59600;2400;
2021-07-02 12:21:03;8998009020186;BUAVITA GUAVA 250ML;1;7000;0;7000;6083;917;
2021-07-02 12:21:03;8997002060168;KRP SINGKOG PDS PANDA DUO;1;8000;0;8000;7300;700;
2021-07-02 12:21:03;8997011700123;BIHUN JAGUNG 300GR;2;6000;0;12000;9958;2042;
2021-07-02 12:21:03;8999999524807;SUNLIGHT HABBATUSSAUDA POUCH 755ML;1;17000;0;17000;15400;1600;
2021-07-02 12:21:03;8996001440049;ENERGEN;9;1500;0;13500;10800;2700;
2021-07-02 12:21:03;8999999707859;CLOSEUP GREEN 160G;1;15000;0;15000;13600;1400;
2021-07-02 12:21:03;8999999548698;LUXTS VALVET JASMINE 4X60G;1;8500;0;8500;7650;850;
2021-07-02 12:21:03;8992702000063;INDOMILK COKLAT 370G;1;10000;0;10000;9020;980;
2021-07-02 12:21:03;8992979190986;TOTAL PUTIH SOFTENER;1;13000;0;13000;11532;1468;
2021-07-02 12:21:03;8992979130012;TOTAL LEMON SOFTENER;1;13000;0;13000;11532;1468;
2021-07-02 12:38:10;8996001301142;ROMA KELAPA;1;8000;0;8000;6628;1372;
2021-07-02 12:38:10;8999999531478;MOLTO BLACK PURPLE;1;5500;0;5500;4800;700;
2021-07-02 12:38:10;8999999048167;SUNSILK SHP BLACK SHINE 9ML;1;10500;0;10500;9300;1200;
2021-07-02 12:38:10;8998989300261;GUDANG GARAM SURYA 12 FILTER;2;18500;0;37000;34400;2600;
2021-07-02 12:38:10;8994834005923;SPIX 1000;1;1000;0;1000;850;150;
2021-07-02 12:38:10;8992775002735;CHOCOLATOS SUSU COKELAT;1;4000;0;4000;3520;480;
2021-07-02 12:38:10;YP;YUPI;3;250;0;750;624;126;
2021-07-02 12:38:10;8996001600399;LE MINERAL 1500ML;1;5000;0;5000;4042;958;
2021-07-02 12:38:10;8992694247255;ZWITSAL BATH NAT HAIR&BODY 200ML;1;20500;0;20500;18810;1690;
2021-07-02 12:38:10;8992959610114;HN PANTS XL 44;1;78000;0;78000;72273;5727;
2021-07-02 12:38:10;8997231980015;O'JELLY MINI APPLE;2;3000;0;6000;4500;1500;
2021-07-02 12:38:10;6907992823973;JD PINEAPPLE;2;5000;0;10000;8600;1400;
2021-07-02 12:38:10;8998009020186;BUAVITA GUAVA 250ML;1;7000;0;7000;6083;917;
2021-07-02 12:38:10;711844120419;SAMBAL ABC 275 ML;1;12000;0;12000;10800;1200;
2021-07-02 12:38:10;8999909010567;234 DJI SAM SOE 16;1;22000;0;22000;21500;500;
2021-07-02 12:38:10;8996001600269;LE MINERAL 600ML;1;3000;0;3000;1688;1312;
2021-07-02 12:38:10;8998866500708;FLORIDINA ORANGE;1;3000;0;3000;2500;500;
2021-07-02 12:38:10;MARS;MARSHMELLOW;22;500;0;11000;9526;1474;
2021-07-02 12:38:10;8991102989534;TANGO VANILA 24G;2;1000;0;2000;1218;782;
2021-07-02 12:38:10;8998666002525GT;TB TORA CAFE CAPPUCINO;1;9000;0;9000;7800;1200;
2021-07-02 12:38:10;8998866200578;MIE SEDAAP KARI KENTAL;2;2500;0;5000;4526;474;
2021-07-02 12:38:10;8998989500166;GUDANG GARAM MERAH BESAR 16KS;1;18000;0;18000;17000;1000;
2021-07-02 12:38:10;123124;KOREK BIASA;1;2000;0;2000;1800;200;
2021-07-02 12:38:10;089686010343;INDOMIE SOTO MIE;1;2600;0;2600;2367;233;
2021-07-02 12:38:10;089686010824;INDOMIE GORENG SPESIAL;1;2700;0;2700;2452;248;
2021-07-02 12:38:10;8991001503114;CHACHA MILK CHOCOLATE 35G;1;5500;0;5500;4900;600;
2021-07-02 12:38:10;8993176110074;MINYAK KAYU PUTIH 60ML;1;20000;0;20000;17333;2667;
2021-07-02 12:38:10;8992761166038;MMP ORANGE 300ML;2;5000;0;10000;7500;2500;
2021-07-02 12:38:10;8998866202619;MIE SEDAAP KOREAN SPICY SOUP;1;2500;0;2500;2273;227;
2021-07-02 12:38:10;8992959117514;SFX NON WING 20;1;10000;0;10000;9091;909;
2021-07-02 12:38:10;8992775001783;GERY SALUT MALKIST;1;6500;0;6500;5516;984;
2021-07-02 12:38:10;8999909001909;MAGNUM REVAMP BLACK 12;1;18000;0;18000;16300;1700;
2021-07-02 12:38:10;6907992823669;JD MILKY STRAW;4;3000;0;12000;10400;1600;
2021-07-02 12:38:10;089686043204;INDOMIE MIE ACEH;1;2700;0;2700;2452;248;
2021-07-02 12:38:10;8992775000250SCT;CHOCOLATOS MATCHA DRINK SCT;1;2000;0;2000;1586;414;
2021-07-02 12:38:10;ff;FULLO BLASTO;1;1000;0;1000;995;5;
2021-07-02 12:38:10;8992696404441;BEAR BRAND 189ML;1;9000;0;9000;7887;1113;
2021-07-02 12:38:10;8997009510017;YOU C1000 LEMON;1;10000;0;10000;9166;834;
2021-07-02 12:38:10;8992759120264;LARISST 220;1;10000;0;10000;9200;800;
2021-07-02 12:38:10;8992696405417SCT;DNCO INSTANT 27G SCT;3;3500;0;10500;8871;1629;
2021-07-02 12:38:10;8992696521797SCT;MILO ACT GO 22G SCT;1;2000;0;2000;1553;447;
2021-07-02 12:39:03;8999099923005;SGM 6-12 600G;1;53000;0;53000;51951;1049;
2021-07-02 12:50:31;8999999008475;SUNLIGHT LIME NEW REF 1600ML;1;33000;0;33000;29800;3200;
2021-07-02 12:50:31;8998866610070;SOKLIN SOFTERGEN 280G PURPLE;1;5000;0;5000;4425;575;
2021-07-02 12:50:31;8999999046989;LIFEBUOY MILD CARE 60G;1;10000;0;10000;7645;2355;
2021-07-02 12:50:31;8999999030186;PEPSODENT ACTION 123 COMPLETE 190G;1;14000;0;14000;13200;800;
2021-07-02 12:50:31;8992759218046;JOLLY KLNR FCL CR LUNAK EMBOSS 10 ROLL;1;9000;0;9000;8075;925;
2021-07-02 12:50:31;8998009020186;BUAVITA GUAVA 250ML;1;7000;0;7000;6083;917;
2021-07-02 12:50:31;SF SOSIS;SAFFANAH ROTI SOSIS;2;6000;0;12000;11000;1000;
2021-07-02 12:50:31;8996001600399;LE MINERAL 1500ML;1;5000;0;5000;4042;958;
2021-07-02 12:50:31;8992761122331;FRESTEA APPEL 500ML;1;6500;0;6500;4708;1792;
2021-07-02 12:50:31;089686011036;INDOMIE GORENG PEDAS;1;2700;0;2700;2452;248;
2021-07-02 12:50:31;089686043273;INDOMIE SAMBAL RICA;1;2700;0;2700;2452;248;
2021-07-02 12:50:31;8998866200882;SUKSESMIE GORENG AYAM KRMS 133GR;1;3500;0;3500;3047;453;
2021-07-02 12:50:31;089686011494;INDOMIE SOTO PADANG;1;2600;0;2600;2317;283;
2021-07-02 12:50:31;8992959974018;SFX SIRIH 36CM 12+1;1;17000;0;17000;15958;1042;
2021-07-02 12:50:31;JGR;JOGER CHOCKY PASTA;1;20000;0;20000;18190;1810;
2021-07-02 12:50:31;SF TAWAR ORI;SAFFANAH TAWAR ORI;1;9000;0;9000;8000;1000;
2021-07-02 12:50:31;8886013213208;FRENCH FREIS 2000;1;5000;0;5000;3750;1250;
2021-07-02 12:50:31;089686041705;INDOMIE GORENG JUMBO;1;3500;0;3500;3143;357;
2021-07-02 12:50:31;089686010190;INDOMIE KARI AYAM;2;2800;0;5600;5044;556;
2021-07-02 12:50:31;8999999555191;SAHAJA PENCUCI PRG JRUK NIPIS  BTL 650ML;1;19000;0;19000;17250;1750;
2021-07-02 12:50:31;ARG;ARGUS 220ML;1;14500;0;14500;12500;2000;
2021-07-02 12:50:31;8992753102204;BKM COKLAT 370G;1;11300;0;11300;9500;1800;
2021-07-02 12:50:31;8991909101016;URBAN MILD 16;1;17000;0;17000;15800;1200;
2021-07-02 12:50:31;8997231980022;O'JELLY MINI STRAWBERRY;1;3000;0;3000;2250;750;
2021-07-02 12:50:31;8996001414002SCT;TB CAPPUCINO SCT;1;1500;0;1500;1350;150;
2021-07-02 12:50:31;8992775001653;GERY SALUT CHOCOLATE COCONUT;1;2000;0;2000;1476;524;
2021-07-02 12:50:31;GL;GULA 1 LITER;1;11500;0;11500;10500;1000;
2021-07-02 12:50:31;8994935000070;MINYAK DUNIA 450 ML;2;7500;0;15000;13558;1442;
2021-07-02 12:50:31;8995333032113;TERIGU GATOT KACA 1 KG;1;8500;0;8500;8012;488;
2021-07-02 12:50:31;8998898830125;KKB ENER-G ANGGUR;1;5500;0;5500;4824;676;
2021-07-02 12:50:31;8991102300421;WFR TANGO COKLAT 176GR;1;10000;0;10000;8694;1306;
2021-07-02 12:50:31;8997027490018;LADAMAS MERICA BUBUK;1;9500;0;9500;8898;602;
2021-07-02 12:50:31;8992770034175;MASAKO;6;500;0;3000;3000;0;
2021-07-02 13:00:52;8992959953327;SWEETY BRONZE L52;1;85000;0;85000;80304;4696;
2021-07-02 13:00:52;8993176110074;MINYAK KAYU PUTIH 60ML;2;20000;0;40000;34666;5334;
2021-07-02 13:00:52;8992761145033;FANTA STRAW PET 250ML;2;3500;0;7000;4834;2166;
2021-07-02 13:00:52;8997011700123;BIHUN JAGUNG 300GR;1;6000;0;6000;4979;1021;
2021-07-02 13:00:52;ROTI;ROTI 2000;3;2000;0;6000;5400;600;
2021-07-02 13:00:52;ff;FULLO BLASTO;1;1000;0;1000;995;5;
2021-07-02 13:00:52;VCO;VITAMIN C500 ORANGE;1;1000;0;1000;575;425;
2021-07-02 13:00:52;8992696422735;DNCO CKLT UHT 110ML;1;2500;0;2500;2041;459;
2021-07-02 13:00:52;8992959107539;SFX WING 23CM;1;5000;0;5000;4091;909;
2021-07-02 13:00:52;8992736424293;SASA BUMBU NASI GORENG 20G;1;2000;0;2000;1136;864;
2021-07-02 13:00:52;8994834005923;SPIX 1000;1;1000;0;1000;850;150;
2021-07-02 13:00:52;8996001305041;ROMA SANDWICH CKLT;1;7000;0;7000;5000;2000;
2021-07-02 13:00:52;089686010824;INDOMIE GORENG SPESIAL;1;2700;0;2700;2452;248;
2021-07-02 13:00:52;8998866202343;MIE SEDAAP KOREAN SPICY;3;2500;0;7500;6069;1431;
2021-07-02 13:00:52;8992761139018;ADES 600ML;2;3500;0;7000;4584;2416;
2021-07-02 13:00:52;8997009510116;LEMON WATER;1;7000;0;7000;5694;1306;
2021-07-02 13:00:52;089686021127;INTER MIE KALDU;1;1000;0;1000;813;187;
2021-07-02 13:00:52;8998989300261;GUDANG GARAM SURYA 12 FILTER;1;18500;0;18500;17200;1300;
2021-07-02 13:00:52;8999801700030;SUSU FOYU;2;11500;0;23000;20900;2100;
2021-07-02 13:00:52;6907992824963;JD MILKY CHOCOLATE;1;3000;0;3000;2600;400;
2021-07-02 13:00:52;8999999027056;LIFEBUOY ANTI KETOMBE 9ML;1;5000;0;5000;4500;500;
2021-07-02 13:00:52;8998009020186;BUAVITA GUAVA 250ML;1;7000;0;7000;6083;917;
2021-07-02 13:00:52;8998899002132;BAY FRESH LEMON 320ML;1;18500;0;18500;16700;1800;
2021-07-02 13:00:52;COKLAT;COKLAT COIN;2;500;0;1000;850;150;
2021-07-02 13:00:52;8992696521797SCT;MILO ACT GO 22G SCT;1;2000;0;2000;1553;447;
2021-07-02 13:00:52;8992752112013;MIZONE;1;5000;0;5000;3800;1200;
2021-07-02 13:00:52;6907992825076;JD WATERMELON APPLE;1;2000;0;2000;1700;300;
2021-07-02 13:00:52;8993379241858;SABUN HARMONY LEMON 70G;2;2000;0;4000;3304;696;
2021-07-02 13:00:52;8998866202244;EKOMIE BUMBU KALDU AYAM;1;1000;0;1000;798;202;
2021-07-02 13:11:21;8997009510017;YOU C1000 LEMON;2;10000;0;20000;18332;1668;
2021-07-02 13:11:21;8992761145033;FANTA STRAW PET 250ML;2;3500;0;7000;4834;2166;
2021-07-02 13:11:21;COKLAT;COKLAT COIN;3;500;0;1500;1275;225;
2021-07-02 13:11:21;8999999516208;ROYCO FDS CHICKEN NEW 230G;2;10000;0;20000;18000;2000;
2021-07-02 13:11:21;8998866202404;NOODLE SEDAAP MIE KOREAN SPICY CHICKEN CUP;1;5000;0;5000;4002;998;
2021-07-02 13:11:21;089686010190;INDOMIE KARI AYAM;1;2800;0;2800;2522;278;
2021-07-02 13:11:21;HT;HOT-HOT;1;500;0;500;350;150;
2021-07-02 13:11:21;YP;YUPI;2;250;0;500;416;84;
2021-07-02 13:11:21;8997028590014;ARGUS 220ML;3;500;0;1500;906;594;
2021-07-02 13:11:21;089686048704;SARIMIE GORENG AYAM KCP ISI 2;1;3500;0;3500;3120;380;
2021-07-02 13:11:21;8998009020186;BUAVITA GUAVA 250ML;2;7000;0;14000;12166;1834;
2021-07-02 13:11:21;8998989500166;GUDANG GARAM MERAH BESAR 16KS;1;18000;0;18000;17000;1000;
2021-07-02 13:11:21;GL;GULA 1 LITER;1;11500;0;11500;10500;1000;
2021-07-02 13:11:21;8995333060772;TERIGU GATOT KACA 500GR;1;4500;0;4500;4065;435;
2021-07-02 13:11:21;8996001440001GT;TB SUSU JAHE;1;13000;0;13000;8700;4300;
2021-07-02 13:11:21;8998866501026;MINYAK GORENG SEDAAP POUCH 1 L;1;15000;0;15000;14110;890;
2021-07-02 13:11:21;8996001301142;ROMA KELAPA;2;8000;0;16000;13256;2744;
2021-07-02 13:11:21;8996001414002SCT;TB CAPPUCINO SCT;1;1500;0;1500;1350;150;
2021-07-02 13:11:21;8992761145026;SPRITE PET 250ML;1;3500;0;3500;2417;1083;
2021-07-02 13:11:21;8993379260026;SABUN MEDICARE BLACK;1;2500;0;2500;2237;263;
2021-07-02 13:11:21;ROTI;ROTI 2000;5;2000;0;10000;9000;1000;
2021-07-02 13:11:21;bb;BENG-BENG;4;1500;0;6000;5800;200;
2021-07-02 13:11:21;SF SOSIS;SAFFANAH ROTI SOSIS;1;6000;0;6000;5500;500;
2021-07-02 13:11:21;8999999036690;LUX TS MAGICAL ORCHID;3;3500;0;10500;8400;2100;
2021-07-02 13:11:21;8993379152017;SABUN CUCI SURYA 200G;1;3000;0;3000;2281;719;
2021-07-02 13:11:21;8991102384841;WFR TANGO LONG CKLT 130G;1;5000;0;5000;4345;655;
2021-07-02 13:11:21;TBR;TEPUNG BERAS ROSE BRAND;1;8000;0;8000;5800;2200;
2021-07-02 13:11:21;8994907000428;KECAP SACHET ABC;2;500;0;1000;708;292;
2021-07-02 13:11:21;8993989311279;CLAS MILD 12;1;17000;0;17000;15700;1300;
2021-07-02 13:11:21;8996001318980;BETTER 120G;1;6000;0;6000;5100;900;
2021-07-02 13:11:21;JGR SHN;JOGER SHINY SACHET;1;500;0;500;437;63;
2021-07-02 13:25:13;ARG;ARGUS 220ML;1;14500;0;14500;12500;2000;
2021-07-02 13:26:01;8992775318201;GERY SNACK BANTAL COKLAT;1;2000;0;2000;1712;288;
2021-07-02 13:26:01;8993083929837;BISKITOP BLACK COOKIES;1;27000;0;27000;23700;3300;
2021-07-02 13:45:14;8998009020186;BUAVITA GUAVA 250ML;2;7000;0;14000;12166;1834;
2021-07-02 13:45:14;6921101219235;YAKUAT JELLY;2;2000;0;4000;3500;500;
2021-07-02 14:10:19;8992761166052;FRESTEA MELATI 350ML;2;4500;0;9000;6000;3000;
2021-07-02 14:10:19;8992761002022;SPRITE PET 390ML;1;5500;0;5500;4300;1200;
2021-07-02 14:10:19;8992761002015;COCA COLA PET 390ML;1;5500;0;5500;4333;1167;
2021-07-02 14:10:19;BTS;BIMURA TARO SEAWEED 250G;1;10000;0;10000;9300;700;
2021-07-02 14:22:30;8992761145033;FANTA STRAW PET 250ML;1;3500;0;3500;2417;1083;
2021-07-02 14:22:30;JGR SHN;JOGER SHINY SACHET;1;500;0;500;437;63;
2021-07-02 14:23:56;8992979120013;TOTAL BUNGA SOFTENER;1;13000;0;13000;11532;1468;
2021-07-02 15:40:43;8991909101016;URBAN MILD 16;2;17000;0;34000;31600;2400;
2021-07-02 15:40:43;8992761166205;FRESTEA GREEN HONEY 350ML;3;4500;0;13500;9000;4500;
2021-07-02 15:41:31;KOPIKO;KOPIKO;2;250;0;500;350;150;
2021-07-02 16:29:17;ROTI;ROTI 2000;3;2000;0;6000;5400;600;
2021-07-02 16:29:17;8998989300261;GUDANG GARAM SURYA 12 FILTER;1;18500;0;18500;17200;1300;
2021-07-02 16:29:17;KOPIKO;KOPIKO;2;250;0;500;350;150;
2021-07-02 16:59:35;SF BOX;SAFFANAH ROTI BOX;1;12000;0;12000;10500;1500;
2021-07-02 16:59:35;ROTI;ROTI 2000;4;2000;0;8000;7200;800;
2021-07-02 18:48:20;089686043273;INDOMIE SAMBAL RICA;2;2700;0;5400;4904;496;
2021-07-02 19:21:27;ROTI;ROTI 2000;2;2000;0;4000;3600;400;
2021-07-02 19:21:27;MILKITA;MILKITA;4;250;0;1000;800;200;
2021-07-02 19:44:04;8991909101016;URBAN MILD 16;1;17000;0;17000;15800;1200;
2021-07-02 20:24:36;8992775211410;PILUS GARUDA PEDAS;1;5000;0;5000;4886;114;
2021-07-02 20:24:36;8991102281430;PERMEN MINTZ DUOMINT;1;4500;0;4500;4000;500;
2021-07-02 20:24:36;8998866200301;MIE SEDAAP GORENG;1;2500;0;2500;2023;477;
2021-07-02 20:24:36;8998866202343;MIE SEDAAP KOREAN SPICY;1;2500;0;2500;2023;477;
2021-07-02 20:24:36;8994834006128;TICTIC PEDAS;2;2000;0;4000;3400;600;
2021-07-02 20:24:36;8998866202244;EKOMIE BUMBU KALDU AYAM;2;1000;0;2000;1596;404;
2021-07-02 20:24:36;089686021219;INTER MIE GORENG;2;1000;0;2000;1770;230;
2021-07-02 20:33:52;8999909010567;234 DJI SAM SOE 16;2;22000;0;44000;43000;1000;
2021-07-02 20:50:21;8998009010569;ULTRA CHO 200;1;5000;0;5000;3830;1170;
2021-07-02 21:20:27;8998866201377;KRISBEE FRIES KENTANG GORENG 68 GR;2;5500;0;11000;9240;1760;
2021-07-02 21:20:27;8996001600399;LE MINERAL 1500ML;1;5000;0;5000;4042;958;
2021-07-02 21:20:27;VCO;VITAMIN C500 ORANGE;4;1000;0;4000;2300;1700;
2021-07-02 22:08:33;8992696521797SCT;MILO ACT GO 22G SCT;1;2000;0;2000;1553;447;
2021-07-02 22:08:33;6907992823645;JD COCONUT BLISS;1;4000;0;4000;3500;500;
2021-07-02 22:08:33;COKLAT;COKLAT COIN;2;500;0;1000;850;150;
2021-07-02 22:15:37;8997007780689;JIZZY MINERAL;1;3000;0;3000;1187;1813;
2021-07-02 22:15:37;8992775318201;GERY SNACK BANTAL COKLAT;1;2000;0;2000;1712;288;
2021-07-02 22:15:37;8998898830125;KKB ENER-G ANGGUR;1;5500;0;5500;4824;676;
2021-07-03 10:46:05;8998866501033;MINYAK GORENG SEDAAP POUCH 2L;3;29000;0;87000;83238;3762;
2021-07-03 10:46:05;8995333060703;TERIGU KOMPAS 1KG;1;10500;0;10500;9816;684;
2021-07-03 10:46:05;bb;BENG-BENG;1;1500;0;1500;1450;50;
2021-07-03 11:11:38;8999999571887;MOLTO EDP PURPLE 10ML;1;5000;0;5000;4800;200;
2021-07-03 11:11:38;8998866609036;DAIA BUNGA GUSSET 565G;1;10000;0;10000;8700;1300;
2021-07-03 11:11:38;8998866610261;DAIA VIOLET GUSSET BAG 290 GR;1;5000;0;5000;4450;550;
2021-07-03 11:11:38;8997009510055;YOU C1000;1;10000;0;10000;9166;834;
2021-07-03 11:11:38;8998866202299;KECAP MANIS SEDAAP SPC REFILL 220ML;1;9500;0;9500;8500;1000;
2021-07-03 11:11:38;8999909096004;SAMPOERNA 16 FILTER;1;24000;0;24000;23000;1000;
2021-07-03 11:11:38;ROTI;ROTI 2000;4;2000;0;8000;7200;800;
2021-07-03 11:11:38;8992775203422;GARUDA ROSTA OVEN 100G;1;8000;0;8000;7322;678;
2021-07-03 11:11:38;8994834003752;TICTIC;2;2000;0;4000;3400;600;
2021-07-03 11:11:38;089686611878;QTELA TEMPE;2;6000;0;12000;10740;1260;
2021-07-03 11:11:38;8991102281430;PERMEN MINTZ DUOMINT;1;4500;0;4500;4000;500;
2021-07-03 11:11:38;8991001770301;SELAMAT CLACK VANILA;1;13000;0;13000;11800;1200;
2021-07-03 11:11:38;8998989500166;GUDANG GARAM MERAH BESAR 16KS;1;18000;0;18000;17000;1000;
2021-07-03 11:11:38;8998989500128;GUDANG GARAM MERAH KECIL 12KS;1;14000;0;14000;13000;1000;
2021-07-03 11:11:38;8999999706081;PEPSODENT WHITE 75G;2;5000;0;10000;7700;2300;
2021-07-03 11:26:32;8994935000070;MINYAK DUNIA 450 ML;1;7500;0;7500;6779;721;
2021-07-03 12:01:29;8992696404441;BEAR BRAND 189ML;1;9000;0;9000;7887;1113;
2021-07-03 12:01:29;8999999710880;PEPSODENT ACTION123 HERBAL 75G;1;7500;0;7500;6650;850;
2021-07-03 12:01:29;8999999559861;AXE DARK POCKET FRAG 17ML;1;10000;0;10000;8000;2000;
2021-07-03 12:01:29;8997025914042;ATB MARIE SUSU 185G;1;7000;0;7000;4554;2446;
2021-07-03 12:01:29;BKM;BKM COKLAT SACHET;3;1500;0;4500;3450;1050;
2021-07-03 12:22:22;ff;FULLO BLASTO;4;1000;0;4000;3980;20;
2021-07-03 12:22:22;VTM;VITAMIN;2;500;0;1000;850;150;
2021-07-03 12:40:29;8998989110167;SURYA GUDANG GARAM 16 FILTER;1;25000;0;25000;23200;1800;
2021-07-03 12:40:29;8998989300261;GUDANG GARAM SURYA 12 FILTER;1;18500;0;18500;17200;1300;
2021-07-03 13:34:17;8999999059316;LIFEBUOY TS MILDCARE 75G;1;3000;0;3000;2640;360;
2021-07-03 13:34:17;8999999707835;CLOSEUP GREEN 65G;1;7000;0;7000;6000;1000;
2021-07-03 13:34:44;8998866679572;SOKLIN LANTAI MERAH 780ML;1;12000;0;12000;10020;1980;
2021-07-03 13:34:44;GL;GULA 1 LITER;1;11500;0;11500;10500;1000;
2021-07-03 14:24:19;089686060362;POP MIE SOTO AYAM JUMBO;1;4500;0;4500;3833;667;
2021-07-03 14:24:19;MENTOS;MENTOS;2;250;0;500;350;150;
2021-07-03 14:27:34;9556040040038;SUSU F&N;2;33000;0;66000;60000;6000;
2021-07-03 14:27:34;8992761166038;MMP ORANGE 300ML;1;5000;0;5000;3750;1250;
2021-07-03 14:35:42;8996001305041;ROMA SANDWICH CKLT;1;7000;0;7000;5000;2000;
2021-07-03 14:35:42;8998866201711;KRISBEE KRUNCHY JAGUNG BAKAR MENTEGA 75 GR;1;5500;0;5500;4400;1100;
2021-07-03 14:35:42;089686010824;INDOMIE GORENG SPESIAL;3;2700;0;8100;7356;744;
2021-07-03 14:35:43;089686011036;INDOMIE GORENG PEDAS;3;2700;0;8100;7356;744;
2021-07-03 14:35:43;8998866201377;KRISBEE FRIES KENTANG GORENG 68 GR;1;5500;0;5500;4620;880;
2021-07-03 14:35:43;8998866201865;KRISBEE PILLOW CHOCOLAVA 120 GR;1;8000;0;8000;7250;750;
2021-07-03 14:35:43;8998866202343;MIE SEDAAP KOREAN SPICY;2;2500;0;5000;4046;954;
2021-07-03 16:15:14;MENTOS;MENTOS;2;250;0;500;350;150;
2021-07-03 16:15:14;8998989110167;SURYA GUDANG GARAM 16 FILTER;1;25000;0;25000;23200;1800;
2021-07-03 16:51:27;8992761002015;COCA COLA PET 390ML;1;5500;0;5500;4333;1167;
2021-07-03 16:51:27;8992761002039;FANTA STRAWBERRY PET 390 ML;1;5500;0;5500;4300;1200;
2021-07-03 16:51:27;8992761122331;FRESTEA APPEL 500ML;2;6500;0;13000;9416;3584;
2021-07-03 17:23:31;8995333060703;TERIGU KOMPAS 1KG;2;10500;0;21000;19632;1368;
2021-07-03 17:23:31;8991188943062;SASA 250G;1;10000;0;10000;8500;1500;
2021-07-03 17:23:31;8993335523363;TOTAL ALMEERA 250G;2;5000;0;10000;8200;1800;
2021-07-03 17:23:31;8998866613002;CREAM EKONOMI PINK 455G;2;5500;0;11000;9500;1500;
2021-07-03 17:23:31;8999999710866;PEPSODENT 123 HERBAL 190G;1;18000;0;18000;17500;500;
2021-07-03 17:23:31;8999999390198;SUNLIGHT LIME NEW POUCH 755ML;1;17000;0;17000;15400;1600;
2021-07-03 17:23:31;8999999016128;RINSO MOLTO ROSE FRESH 750ML;1;15000;0;15000;12507;2493;
2021-07-03 17:23:31;8998866200561;EKOMIE SUPER 600GR;1;10000;0;10000;8615;1385;
2021-07-03 17:49:46;8998866604963;POWDET DAIA LEMON 290GR;1;5000;0;5000;4450;550;
2021-07-03 18:11:11;GL;GULA 1 LITER;1;11500;0;11500;10500;1000;
2021-07-03 18:12:08;GL;GULA 1 LITER;1;11500;0;11500;10500;1000;
2021-07-03 18:17:39;8992775000663;GERY SNACK KEJU;1;2000;0;2000;1712;288;
2021-07-03 18:17:39;8991102387286SCT;TANGO LONG CKLT 47G;1;2000;0;2000;1551;449;
2021-07-03 18:17:39;8996001318430;BETTER 1000;1;1000;0;1000;820;180;
2021-07-03 18:50:28;JGR SHN;JOGER SHINY SACHET;4;500;0;2000;1748;252;
2021-07-03 18:51:21;8997027300089;NOMOS;1;4000;0;4000;2963;1037;
2021-07-03 18:51:21;8998989110167;SURYA GUDANG GARAM 16 FILTER;1;25000;0;25000;23200;1800;
2021-07-03 19:02:56;GL;GULA 1 LITER;1;11500;0;11500;10500;1000;
2021-07-03 19:15:06;8998009010231;ULTRA CHO 250;5;6000;0;30000;23920;6080;
2021-07-03 22:01:47;JGR SHN;JOGER SHINY SACHET;1;500;0;500;437;63;
2021-07-03 22:01:47;8992761145026;SPRITE PET 250ML;1;3500;0;3500;2417;1083;
2021-07-03 22:01:47;8992775211410;PILUS GARUDA PEDAS;1;5000;0;5000;4886;114;
2021-07-03 22:36:47;8998866501033;MINYAK GORENG SEDAAP POUCH 2L;1;29000;0;29000;27746;1254;
2021-07-03 22:36:47;8991188943062;SASA 250G;1;10000;0;10000;8500;1500;
2021-07-03 22:36:47;8997011700123;BIHUN JAGUNG 300GR;1;6000;0;6000;4979;1021;
2021-07-03 22:36:47;GL;GULA 1 LITER;1;11500;0;11500;10500;1000;
2021-07-03 22:36:47;8994935000049;MINYAK GORENG DAMAI 5L;1;75000;0;75000;73780;1220;
2021-07-03 22:36:47;8998866610438;SOKLIN SOFTERGENT RED BAG 770G & PIRING;1;18000;0;18000;16680;1320;
2021-07-03 22:36:47;bb;BENG-BENG;1;1500;0;1500;1450;50;
2021-07-03 22:36:47;8993571002196;CAP 19 OBAT KURAP AIR 10ML;1;5000;0;5000;3637;1363;
2021-07-03 22:37:39;8998866803694;SOKLIN SOFTERGENT PURPLE BAG 770 & PIRING;1;18000;0;18000;16680;1320;
2021-07-03 22:38:09;8998866200301;MIE SEDAAP GORENG;2;2500;0;5000;4046;954;
2021-07-04 11:45:07;8998989300261;GUDANG GARAM SURYA 12 FILTER;1;18500;0;18500;17200;1300;
2021-07-04 11:45:07;KOPIKO;KOPIKO;2;250;0;500;350;150;
2021-07-04 14:28:38;089686834055;FREISS JERUK;1;11000;0;11000;8750;2250;
2021-07-04 14:33:20;8991102989381;TANGO LONG BUBBLEGUM 130G;1;5000;0;5000;4345;655;
2021-07-04 15:37:45;8993226365522;GARAM MEJA GYURI 200GR;2;2000;0;4000;3400;600;
2021-07-04 15:37:45;TS;TISSUE TESSY;1;5000;0;5000;4200;800;
2021-07-04 15:50:15;8994867000179;ROKOK PENA MILD 16;1;14500;0;14500;13500;1000;
2021-07-04 15:50:15;KOPIKO;KOPIKO;2;250;0;500;350;150;
2021-07-04 15:55:30;6907992823874;JD CRUNCHY CHOCO BLUEBERRY;1;5500;0;5500;4700;800;
2021-07-04 16:31:20;8998989500166;GUDANG GARAM MERAH BESAR 16KS;2;18000;0;36000;34000;2000;
2021-07-04 16:31:20;GL;GULA 1 LITER;1;11500;0;11500;10500;1000;
2021-07-04 16:32:13;MILKITA;MILKITA;6;250;0;1500;1200;300;
2021-07-04 16:54:56;8994834006128;TICTIC PEDAS;2;2000;0;4000;3400;600;
2021-07-04 16:54:56;8999999529833;CLEAR SHP ICM UNISEX 9 ML;1;10500;0;10500;9300;1200;
2021-07-04 16:54:56;KOPIKO;KOPIKO;2;250;0;500;350;150;
2021-07-04 16:56:05;8998866202770;MIE SEDAAP SALERO PADANG;4;2500;0;10000;9448;552;
2021-07-04 16:56:05;8998866203104;MIE SEDAAP SINGAPORE;4;2500;0;10000;9064;936;
2021-07-04 17:11:35;6907992823904;JD CRUNCHY CHOCOLATE VAN;2;8000;0;16000;13600;2400;
2021-07-04 17:53:55;8999999571924;MOLTO PURE 1OML;1;5000;0;5000;4800;200;
2021-07-04 17:53:55;8999999007768;FAIR&LOVELY MULTIVITAMIN  CREAM 9 ML;2;4500;0;9000;6400;2600;
2021-07-04 17:53:55;8993560026028;DETTOL SENSITIVE;1;20000;0;20000;18524;1476;
2021-07-04 17:53:55;8998866618298;DAIA CLEAN&FRESH HJB 320GR;1;5000;0;5000;4450;550;
2021-07-04 17:57:22;8998866679572;SOKLIN LANTAI MERAH 780ML;1;12000;0;12000;10020;1980;
2021-07-04 18:48:15;8996001600269;LE MINERAL 600ML;1;3000;0;3000;1688;1312;
2021-07-04 18:48:15;8996001600399;LE MINERAL 1500ML;1;5000;0;5000;4042;958;
2021-07-04 20:03:26;8999099920691;SGM 1+ MADU 1000G;1;85000;0;85000;78510;6490;
2021-07-04 20:03:26;8992959508992;SWEETY SILVER PANTS L 28;1;56800;0;56800;51819;4981;
2021-07-04 20:03:26;8992696404441;BEAR BRAND 189ML;1;9000;0;9000;7887;1113;
2021-07-04 20:03:26;8999909096004;SAMPOERNA 16 FILTER;1;24000;0;24000;23000;1000;
2021-07-04 21:26:41;8998866200325;MIE SEDAAP SOTO;1;2500;0;2500;1952;548;
2021-07-04 21:26:41;089686011036;INDOMIE GORENG PEDAS;1;2700;0;2700;2452;248;
2021-07-04 21:26:41;MILKITA;MILKITA;4;250;0;1000;800;200;
2021-07-04 21:26:41;KOPIKO;KOPIKO;4;250;0;1000;700;300;
2021-07-04 21:26:41;MENTOS;MENTOS;4;250;0;1000;700;300;
2021-07-04 21:33:33;8999999037765;PEPSODENT WHITE 225G;1;12000;0;12000;10750;1250;
2021-07-04 21:33:33;8999999529734;CLEAR IC MTHL 160ML;1;23700;0;23700;21400;2300;
2021-07-04 22:08:52;MILKITA;MILKITA;2;250;0;500;400;100;
2021-07-04 22:08:52;VTM;VITAMIN;2;500;0;1000;850;150;
2021-07-04 22:08:52;8998989300261;GUDANG GARAM SURYA 12 FILTER;1;18500;0;18500;17200;1300;
2021-07-04 22:10:26;ROTI;ROTI 2000;2;2000;0;4000;3600;400;
2021-07-04 22:10:26;8997007780689;JIZZY MINERAL;2;3000;0;6000;2374;3626;
2021-07-05 11:20:00;8992761164539;NUTRIBOOST ORANGE 300ML;1;6500;0;6500;5300;1200;
2021-07-05 11:20:00;8991002304413;RELAXA GRAPE MINT;1;5000;0;5000;4500;500;
2021-07-05 11:20:00;JGR SHN;JOGER SHINY SACHET;1;500;0;500;437;63;
2021-07-05 11:52:54;ROTI;ROTI 2000;2;2000;0;4000;3600;400;
2021-07-05 11:52:54;PRG;PARAGO;6;500;0;3000;2400;600;
2021-07-05 12:42:20;8992959117514;SFX NON WING 20;1;10000;0;10000;9091;909;
2021-07-05 12:42:20;8993989311699;CLAS MILD 16 FILTER;1;23000;0;23000;21700;1300;
2021-07-05 13:08:11;6907992823942;JD JUJUBE;1;4500;0;4500;3800;700;
2021-07-05 13:08:11;8999909010567;234 DJI SAM SOE 16;2;22000;0;44000;43000;1000;
2021-07-05 13:09:05;8998866501033;MINYAK GORENG SEDAAP POUCH 2L;1;29000;0;29000;27746;1254;
2021-07-05 13:09:05;089686611519;QTELA SINGKONG;1;5000;0;5000;4266;734;
2021-07-05 13:09:05;8999999516208;ROYCO FDS CHICKEN NEW 230G;1;10000;0;10000;9000;1000;
2021-07-05 13:55:38;8992957220186;COKLAT RUSA;1;2000;0;2000;1700;300;
2021-07-05 13:55:38;8997231980015;O'JELLY MINI APPLE;1;3000;0;3000;2250;750;
2021-07-05 13:55:38;8997231980022;O'JELLY MINI STRAWBERRY;1;3000;0;3000;2250;750;
2021-07-05 15:20:19;8999999524722;SUNLIGHT LIME NEW PCH 435ML;1;10000;0;10000;9100;900;
2021-07-05 15:24:27;8993989311279;CLAS MILD 12;1;17000;0;17000;15700;1300;
2021-07-05 16:55:24;8998989110167;SURYA GUDANG GARAM 16 FILTER;1;25000;0;25000;23200;1800;
2021-07-05 17:04:38;8999999525088;MOLTO AIO BLUE SPK 250ML;1;9800;0;9800;8910;890;
2021-07-05 17:04:38;8996001600269;LE MINERAL 600ML;1;3000;0;3000;1688;1312;
2021-07-05 17:04:38;8998009010569;ULTRA CHO 200;1;5000;0;5000;3830;1170;
2021-07-05 17:20:42;8992959930748;CONFI PANTS L10;2;5000;0;10000;8516;1484;
2021-07-05 17:29:55;8993989311699;CLAS MILD 16 FILTER;1;23000;0;23000;21700;1300;
2021-07-05 17:29:55;CHYK;CAHAYA MINYAK TERAPI;1;60000;0;60000;50000;10000;
2021-07-05 17:38:39;8991001502933;CHACHA TUBE;2;7500;0;15000;12800;2200;
2021-07-05 17:38:39;8998866202060;POTABEE AYAM BAKAR PEDAS 35 GR;1;5000;0;5000;4150;850;
2021-07-05 17:42:08;CC;NICE FACIAL KILOAN 900 GR DUO;1;34500;0;34500;31325;3175;
2021-07-05 17:42:08;8996001414002GT;TB CAPPUCINO;1;15000;0;15000;13500;1500;
2021-07-05 17:42:08;8998866679572;SOKLIN LANTAI MERAH 780ML;1;12000;0;12000;10020;1980;
2021-07-05 17:42:08;8998866605137;CLING BIRU POUCH 425ML;1;4000;0;4000;3250;750;
2021-07-05 17:42:08;8999999524838;SUNLIGHT MINT POUCH 755ML;1;17000;0;17000;15400;1600;
2021-07-05 17:43:17;8997218380074;ICHITAN MILK TEA;1;8000;0;8000;6583;1417;
2021-07-05 17:43:48;8992959073209;HN PANTS XL 20;1;40000;0;40000;37425;2575;
2021-07-05 17:43:48;8998866201452;POTABEE REGULER BBQ BEEF 35GR;1;5000;0;5000;4150;850;
2021-07-05 17:46:00;8998866202619;MIE SEDAAP KOREAN SPICY SOUP;2;2500;0;5000;4546;454;
2021-07-05 17:46:00;8996001414002SCT;TB CAPPUCINO SCT;1;1500;0;1500;1350;150;
2021-07-05 18:53:02;8998866107457;POSH SUMMER LOVE 150ML;1;19500;0;19500;17500;2000;
2021-07-05 19:29:13;8992628022156;BIMOLI KLASIK TOUCH 1 LT;1;16000;0;16000;14350;1650;
2021-07-05 19:46:26;8998866202053;POTABEE AYAM BAKAR PEDAS 68GR;1;8000;0;8000;7200;800;
2021-07-05 19:46:26;8992775001691;GARUDA ROSTA WAGYU BEEF;1;8000;0;8000;7322;678;
2021-07-05 19:46:26;8992775001783;GERY SALUT MALKIST;1;6500;0;6500;5516;984;
2021-07-05 19:46:26;8992775311325;GERY SNACK&SEREAL 100G;1;7000;0;7000;6012;988;
2021-07-05 19:46:26;8992775311998;GERY CHOCOLATOS;1;17000;0;17000;15483;1517;
2021-07-05 20:33:50;8998866202435;JAPOTA UMAMI JAPANESE SEAWEED 35GR;1;5000;0;5000;4150;850;
2021-07-05 20:33:50;COKLAT;COKLAT COIN;10;500;0;5000;4250;750;
2021-07-05 20:45:04;8996001600375;LE MINERAL 330ML;1;43200;0;43200;34080;9120;
2021-07-05 21:18:24;8998866108126;POSH HIJAB WINTER MAGIC 150ML;1;19500;0;19500;17500;2000;
2021-07-05 21:18:24;8999999533731;CITRA TS NATURE WHITE 70G;1;2200;0;2200;1900;300;
2021-07-05 21:19:10;8996001600375;LE MINERAL 330ML;1;2000;0;2000;1417;583;
2021-07-05 21:19:10;8996001600269;LE MINERAL 600ML;1;3000;0;3000;1688;1312;
2021-07-05 21:19:48;8886013213208;FRENCH FREIS 2000;1;5000;0;5000;3750;1250;
2021-07-05 21:19:48;8992696523081;MILO UHT 110ML;1;2500;0;2500;1962;538;
2021-07-05 21:51:54;6926546662141;GUNTING EMIGO;1;15000;0;15000;12000;3000;
2021-07-05 21:54:47;8992959508312;SWEETY SILVER PANTS XL RTG;1;15500;0;15500;13944;1556;
2021-07-05 22:30:49;8999909085114;SAMPOERNA KRETEK HIJAU 12;1;13000;0;13000;11650;1350;
2021-07-06 10:06:49;8998866501033;MINYAK GORENG SEDAAP POUCH 2L;3;29000;0;87000;83238;3762;
2021-07-06 10:18:40;8992753102204;BKM COKLAT 370G;1;11300;0;11300;9500;1800;
2021-07-06 10:20:32;8998989300261;GUDANG GARAM SURYA 12 FILTER;1;18500;0;18500;17200;1300;
2021-07-06 10:26:21;8992628020152;BIMOLI POUCH 2L;1;31000;0;31000;29800;1200;
2021-07-06 10:26:21;711844120433;SAMBAL ABC 600 ML;1;22000;0;22000;20300;1700;
2021-07-06 10:26:21;8995333060703;TERIGU KOMPAS 1KG;2;10500;0;21000;19632;1368;
2021-07-06 10:26:21;GL;GULA 1 LITER;2;11500;0;23000;21000;2000;
2021-07-06 11:37:53;GL;GULA 1 LITER;4;11500;0;46000;42000;4000;
2021-07-06 11:52:24;8993989311699;CLAS MILD 16 FILTER;1;23000;0;23000;21700;1300;
2021-07-06 12:09:09;PRG;PARAGO;8;500;0;4000;3200;800;
2021-07-06 12:34:04;8886013213208;FRENCH FREIS 2000;1;5000;0;5000;3750;1250;
2021-07-06 12:34:04;8998866201483;POTABEE REGULER GRILLED SEAWEED 35GR;1;5000;0;5000;4150;850;
2021-07-06 12:34:04;8992696523081;MILO UHT 110ML;2;2500;0;5000;3924;1076;
2021-07-06 12:34:04;RT 1000;ROTI 1000;4;1000;0;4000;3200;800;
2021-07-06 12:34:04;8998866601429;POWDET DAIA BUNGA BAG 290GR;1;5000;0;5000;4450;550;
2021-07-06 12:34:04;HT;HOT-HOT;2;500;0;1000;700;300;
2021-07-06 12:35:20;BALON;BALON CABUT;2;1000;0;2000;1800;200;
2021-07-06 13:04:40;8999909000377;SAMPOERNA AVOLUTION;1;30000;0;30000;28450;1550;
2021-07-06 15:24:34;8996001600146;TEH PUCUK HARUM 350ML;1;3000;0;3000;2314;686;
2021-07-06 15:24:34;8992775318201;GERY SNACK BANTAL COKLAT;1;2000;0;2000;1712;288;
2021-07-06 15:24:34;PD;PENDEKAR;1;500;0;500;350;150;
2021-07-06 15:34:24;8997007780689;JIZZY MINERAL;2;3000;0;6000;2374;3626;
2021-07-06 15:34:24;ROTI;ROTI 2000;1;2000;0;2000;1800;200;
2021-07-06 15:34:24;SS;SUPER SNAPS;1;1500;0;1500;1333;167;
2021-07-06 15:34:24;PRG;PARAGO;1;500;0;500;400;100;
2021-07-06 15:34:24;8993007000024;INDOMILK UHT VANILA;1;5000;0;5000;3470;1530;
2021-07-06 15:34:24;089686060126;POP MIE BASO JUMBO;1;4500;0;4500;3833;667;
2021-07-06 15:34:24;PD;PENDEKAR;4;500;0;2000;1400;600;
2021-07-06 17:19:03;kp;KALPA;1;2000;0;2000;1666;334;
2021-07-06 17:19:03;8992775001653;GERY SALUT CHOCOLATE COCONUT;1;2000;0;2000;1476;524;
2021-07-06 18:40:56;8996001600399;LE MINERAL 1500ML;1;5000;0;5000;4042;958;
2021-07-06 20:09:03;6907992823645;JD COCONUT BLISS;1;4000;0;4000;3500;500;
2021-07-06 20:09:03;8998866200301;MIE SEDAAP GORENG;1;2500;0;2500;2023;477;
2021-07-06 20:09:03;8997009510017;YOU C1000 LEMON;2;10000;0;20000;18332;1668;
2021-07-06 20:09:03;8992696404441;BEAR BRAND 189ML;1;9000;0;9000;7887;1113;
2021-07-06 20:14:06;RB;RED BOLD;1;19000;0;19000;17900;1100;
2021-07-06 20:14:06;8994867007161;ROKOK PENA GOLD 20;1;17000;0;17000;15500;1500;
2021-07-06 20:22:41;8999999538422;CLEAR SHP ICM UNISEX 55 ML;1;5000;0;5000;3750;1250;
2021-07-06 20:22:41;8998989300261;GUDANG GARAM SURYA 12 FILTER;1;18500;0;18500;17200;1300;
2021-07-06 20:46:34;BM;BENG-BENG MAXX;2;2500;0;5000;4082;918;
2021-07-06 20:46:34;089686021127;INTER MIE KALDU;5;1000;0;5000;4065;935;
2021-07-06 20:46:34;8993379260804;SABUN MEDICARE BLUE;1;2500;0;2500;2237;263;
2021-07-06 20:46:34;8998866888622;GIV MERAH KOTAK 76G;2;2000;0;4000;3640;360;
2021-07-06 20:46:34;8997210107877;VORTEX SMART 3;1;5000;0;5000;4750;250;
2021-07-06 20:46:34;8999999559854;AXE BLACK POCKET FRAG 17ML;1;10000;0;10000;8000;2000;
2021-07-06 20:46:34;8992222050401;GATSBY WATER GLOSS KUNING 30GR;1;5000;0;5000;3700;1300;
2021-07-06 20:46:34;KT;KUNING TELUR;1;2500;0;2500;2000;500;
2021-07-06 20:46:34;8992959971109;SFX COMFORT SLIM 36CM 12+1;1;17000;0;17000;15152;1848;
2021-07-06 20:46:34;ARG;ARGUS 220ML;1;14500;0;14500;12500;2000;
2021-07-06 20:46:34;8999999195656;SARI WANGI 50X1.85;1;10000;0;10000;9500;500;
2021-07-06 20:46:34;8999999524722;SUNLIGHT LIME NEW PCH 435ML;1;10000;0;10000;9100;900;
2021-07-06 20:46:34;8998009020186;BUAVITA GUAVA 250ML;1;7000;0;7000;6083;917;
2021-07-06 20:46:34;8992696521797SCT;MILO ACT GO 22G SCT;1;2000;0;2000;1553;447;
2021-07-06 20:46:34;8995333060703;TERIGU KOMPAS 1KG;4;10500;0;42000;39264;2736;
2021-07-06 20:46:34;RT MENARA;ROTI TAWAR MENARA;1;8000;0;8000;7200;800;
2021-07-06 20:46:34;RT KJ;ROTI KASUR JUMBO;1;8000;0;8000;7200;800;
2021-07-06 20:46:34;8992761139018;ADES 600ML;1;3500;0;3500;2292;1208;
2021-07-06 20:46:34;RT BAKPIA;ROTI BAKPIA;2;1000;0;2000;1500;500;
2021-07-06 20:46:34;8992775000076;GERY SNACK RING CKLT;1;2000;0;2000;1712;288;
2021-07-06 20:46:34;KOPIKO;KOPIKO;4;250;0;1000;700;300;
2021-07-06 20:46:34;089686021219;INTER MIE GORENG;4;1000;0;4000;3540;460;
2021-07-06 20:46:34;8996001305003;SARI GANDUM SANDWICH;1;6000;0;6000;5100;900;
2021-07-06 20:46:34;8996001600665;COOL TIME;1;3500;0;3500;2750;750;
2021-07-06 20:46:34;8991188943536;SASA SANTAN KELAPA 65ML;1;3000;0;3000;2437;563;
2021-07-06 20:46:34;MILKITA;MILKITA;6;250;0;1500;1200;300;
2021-07-06 21:34:09;8993007000024;INDOMILK UHT VANILA;1;5000;0;5000;3470;1530;
2021-07-07 10:52:48;8992761139018;ADES 600ML;1;3500;0;3500;2292;1208;
2021-07-07 10:52:48;8991909101016;URBAN MILD 16;1;17000;0;17000;15800;1200;
2021-07-07 10:52:48;123124;KOREK BIASA;1;2000;0;2000;1800;200;
2021-07-07 10:52:48;bb;BENG-BENG;1;1500;0;1500;1450;50;
2021-07-07 10:52:48;8991102022347;SIKAT GIGI FORMULA RIPPLE;1;5000;0;5000;4583;417;
2021-07-07 10:53:37;8992696405417SCT;DNCO INSTANT 27G SCT;2;3500;0;7000;5914;1086;
2021-07-07 10:53:37;8992696521797SCT;MILO ACT GO 22G SCT;1;2000;0;2000;1553;447;
2021-07-07 10:58:43;8998866501033;MINYAK GORENG SEDAAP POUCH 2L;2;29000;0;58000;55492;2508;
2021-07-07 10:58:43;8998866501026;MINYAK GORENG SEDAAP POUCH 1 L;1;15000;0;15000;14110;890;
2021-07-07 10:58:43;8992959953044;SWEETY BRONZE XL1;1;2500;0;2500;2250;250;
2021-07-07 10:58:43;8994834003752;TICTIC;1;2000;0;2000;1700;300;
2021-07-07 10:58:43;RT BAKPIA;ROTI BAKPIA;1;1000;0;1000;750;250;
2021-07-07 10:58:43;8998866804516;GIV LEMON KOTAK 76G;2;2000;0;4000;3640;360;
2021-07-07 10:58:43;8998866609142;GIV MULBERRY SILK KOTAK 76G;2;2000;0;4000;3640;360;
2021-07-07 10:58:43;8999999706081;PEPSODENT WHITE 75G;1;5000;0;5000;3850;1150;
2021-07-07 12:31:54;PRG;PARAGO;6;500;0;3000;2400;600;
2021-07-07 12:47:25;8992770034151;MASAKO 250GR;1;10000;0;10000;8000;2000;
2021-07-07 13:13:39;8992770034175;MASAKO;1;5000;0;5000;4000;1000;
2021-07-07 13:13:39;8993226112508;GARAM REFINA;1;3000;0;3000;2461;539;
2021-07-07 13:20:09;8991002105409;KOPI KAPAL API;1;20000;0;20000;18888;1112;
2021-07-07 13:39:26;8991102989381;TANGO LONG BUBBLEGUM 130G;1;5000;0;5000;4345;655;
2021-07-07 13:39:26;8992775002735;CHOCOLATOS SUSU COKELAT;1;4000;0;4000;3520;480;
2021-07-07 13:39:26;8997028590014;ARGUS 220ML;1;500;0;500;302;198;
2021-07-07 13:39:26;8998866202619;MIE SEDAAP KOREAN SPICY SOUP;2;2500;0;5000;4546;454;
2021-07-07 13:39:26;PRG;PARAGO;1;500;0;500;400;100;
2021-07-07 13:39:26;8998989300261;GUDANG GARAM SURYA 12 FILTER;1;18500;0;18500;17200;1300;
2021-07-07 13:39:26;8994907000428;KECAP SACHET ABC;1;500;0;500;354;146;
2021-07-07 13:55:53;8999909096004;SAMPOERNA 16 FILTER;1;24000;0;24000;23000;1000;
2021-07-07 14:45:08;8999999524722;SUNLIGHT LIME NEW PCH 435ML;1;10000;0;10000;9100;900;
2021-07-07 14:45:08;8999999524807;SUNLIGHT HABBATUSSAUDA POUCH 755ML;1;17000;0;17000;15400;1600;
2021-07-07 14:45:08;8995333032113;TERIGU GATOT KACA 1 KG;1;8500;0;8500;8012;488;
2021-07-07 14:45:08;GL;GULA 1 LITER;2;11500;0;23000;21000;2000;
2021-07-07 14:45:09;8998866501033;MINYAK GORENG SEDAAP POUCH 2L;1;29000;0;29000;27746;1254;
2021-07-07 14:45:09;8991002105409;KOPI KAPAL API;1;20000;0;20000;18888;1112;
2021-07-07 14:45:09;8993007002967;KRIMER KENTAL MANIS;2;10500;0;21000;18958;2042;
2021-07-07 14:45:09;8996001351888;WFR WAFELLO;1;17000;0;17000;15500;1500;
2021-07-07 14:45:09;RT BAKPIA;ROTI BAKPIA;1;1000;0;1000;750;250;
2021-07-07 14:52:03;ARG;ARGUS 220ML;3;14500;0;43500;37500;6000;
2021-07-07 15:24:40;8993324850449;BABY LOVE COTTON BUDS;1;5000;0;5000;4500;500;
2021-07-07 15:24:40;8991111102603;JB SHAMPOO GOLD 100ML;1;9200;0;9200;8250;950;
2021-07-07 15:24:40;4801010531234;JB BATH BLUE 200 (REFILL);1;14000;0;14000;13530;470;
2021-07-07 15:24:40;8999999719395;VASELINE HW UV LIGHTENING 100ML;1;12900;0;12900;11805;1095;
2021-07-07 15:24:40;8999999043674;LUX BW CAMELLIA WHITE LD REFF 450 ML;1;25000;0;25000;22330;2670;
2021-07-07 15:24:40;8999999041229;DOVE SHP DNDRUFF CARE 160ML;1;24300;0;24300;22000;2300;
2021-07-07 16:27:40;8998989110167;SURYA GUDANG GARAM 16 FILTER;1;25000;0;25000;23200;1800;
2021-07-07 17:40:54;8992959953167;SWEETY BRONZE S36+2;1;48000;0;48000;45682;2318;
2021-07-07 17:40:54;ROTI;ROTI 2000;1;2000;0;2000;1800;200;
2021-07-07 17:56:20;8996001600399;LE MINERAL 1500ML;1;5000;0;5000;4042;958;
2021-07-07 17:56:20;8992759120264;LARISST 220;1;10000;0;10000;9200;800;
2021-07-07 17:56:20;8992696405417SCT;DNCO INSTANT 27G SCT;3;3500;0;10500;8871;1629;
2021-07-07 18:05:39;8992759120264;LARISST 220;1;10000;0;10000;9200;800;
2021-07-07 18:52:15;KT;KUNING TELUR;1;2500;0;2500;2000;500;
2021-07-07 19:00:07;8992628022156;BIMOLI KLASIK TOUCH 1 LT;1;16000;0;16000;14350;1650;
2021-07-07 19:00:07;8992957220087;COKLAT SINGA;1;2000;0;2000;1700;300;
2021-07-07 19:04:36;8999909010567;234 DJI SAM SOE 16;2;22000;0;44000;43000;1000;
2021-07-07 19:10:48;ARG;ARGUS 220ML;1;14500;0;14500;12500;2000;
2021-07-07 19:10:48;GL;GULA 1 LITER;1;11500;0;11500;10500;1000;
2021-07-07 19:11:48;8992957220087;COKLAT SINGA;2;2000;0;4000;3400;600;
2021-07-07 20:39:31;8998866202343;MIE SEDAAP KOREAN SPICY;1;2500;0;2500;2023;477;
2021-07-07 22:28:15;PD;PENDEKAR;1;500;0;500;350;150;
2021-07-07 22:28:15;8992761145033;FANTA STRAW PET 250ML;1;3500;0;3500;2417;1083;
2021-07-08 08:57:25;711844110083;KECAP ABC 275 ML;1;14500;0;14500;13400;1100;
2021-07-08 08:57:25;GL;GULA 1 LITER;4;11500;0;46000;42000;4000;
2021-07-08 08:57:26;8997025914059;HATARI SEE HONG;1;6000;0;6000;4911;1089;
2021-07-08 09:01:09;8998989300261;GUDANG GARAM SURYA 12 FILTER;1;18500;0;18500;17200;1300;
2021-07-08 09:01:09;RT MENARA;ROTI TAWAR MENARA;1;8000;0;8000;7200;800;
2021-07-08 09:01:09;8998866203104;MIE SEDAAP SINGAPORE;1;2500;0;2500;2266;234;
2021-07-08 09:01:09;KOPIKO;KOPIKO;2;250;0;500;350;150;
2021-07-08 09:01:09;8991002105409;KOPI KAPAL API;1;20000;0;20000;18888;1112;
2021-07-08 09:01:09;RT BAKPIA;ROTI BAKPIA;5;1000;0;5000;3750;1250;
2021-07-08 09:01:09;8998989110167;SURYA GUDANG GARAM 16 FILTER;1;25000;0;25000;23200;1800;
2021-07-08 09:01:09;8992730002992;HAI CANDY;1;7000;0;7000;6000;1000;
2021-07-08 09:01:09;8997025914059;HATARI SEE HONG;1;6000;0;6000;4911;1089;
2021-07-08 09:01:09;8998009020186;BUAVITA GUAVA 250ML;1;7000;0;7000;6083;917;
2021-07-08 09:37:59;8998866200325;MIE SEDAAP SOTO;4;2500;0;10000;7808;2192;
2021-07-08 09:37:59;089686011494;INDOMIE SOTO PADANG;2;2600;0;5200;4634;566;
2021-07-08 09:37:59;089686041705;INDOMIE GORENG JUMBO;3;3500;0;10500;9429;1071;
2021-07-08 09:37:59;8996001301142;ROMA KELAPA;1;8000;0;8000;6628;1372;
2021-07-08 09:37:59;8993007002967;KRIMER KENTAL MANIS;1;10500;0;10500;9479;1021;
2021-07-08 12:01:16;8998866501033;MINYAK GORENG SEDAAP POUCH 2L;2;29000;0;58000;55492;2508;
2021-07-08 12:14:20;8998989110167;SURYA GUDANG GARAM 16 FILTER;1;25000;0;25000;23200;1800;
2021-07-08 12:14:20;8994935000070;MINYAK DUNIA 450 ML;1;7500;0;7500;6779;721;
2021-07-08 12:14:20;8993989311699;CLAS MILD 16 FILTER;1;23000;0;23000;21700;1300;
2021-07-08 12:14:20;8998866200844;NOODLE SEDAAP MIE KARI SPESIAL CUP 81 GR;1;4500;0;4500;3650;850;
2021-07-08 12:38:46;8999999537180;CLEAR SHP LEMON FRESH 9 ML;1;10500;0;10500;9300;1200;
2021-07-08 12:38:46;8992979130012;TOTAL LEMON SOFTENER;1;13000;0;13000;11532;1468;
2021-07-08 12:38:46;8934868015024;REXONA DEO LOTION FREE SPIRIT 9G;12;4500;0;54000;46800;7200;
2021-07-08 14:10:26;089686834055;FREISS JERUK;1;11000;0;11000;8750;2250;
2021-07-08 14:40:47;8998866202619;MIE SEDAAP KOREAN SPICY SOUP;2;2500;0;5000;4546;454;
2021-07-08 14:40:47;8991909101016;URBAN MILD 16;1;17000;0;17000;15800;1200;
2021-07-08 14:40:47;8998866200837;NOODLE SEDAAPMIE SOTO CUP 81 GR;1;4500;0;4500;3650;850;
2021-07-08 14:40:47;8997013790108;BIMURA KACANG TELUR 25G;1;1000;0;1000;875;125;
2021-07-08 14:40:47;HT;HOT-HOT;1;500;0;500;350;150;
2021-07-08 14:42:24;BALON;BALON CABUT;5;1000;0;5000;4500;500;
2021-07-08 14:42:24;8999999195649;SARI WANGI 25X1.86G;1;6000;0;6000;5050;950;
2021-07-08 14:42:24;8991102384841;WFR TANGO LONG CKLT 130G;1;5000;0;5000;4345;655;
2021-07-08 14:42:24;8992775001691;GARUDA ROSTA WAGYU BEEF;1;8000;0;8000;7322;678;
2021-07-08 14:42:24;kp;KALPA;2;2000;0;4000;3332;668;
2021-07-08 14:42:24;8992957220117;COKLAT BERUANG;1;2000;0;2000;1700;300;
2021-07-08 14:42:24;8992957220063;COKLAT BANGO;1;2000;0;2000;1700;300;
2021-07-08 14:42:24;8992957220087;COKLAT SINGA;1;2000;0;2000;1700;300;
2021-07-08 14:51:49;123124;KOREK BIASA;1;2000;0;2000;1800;200;
2021-07-08 14:51:49;8998989300261;GUDANG GARAM SURYA 12 FILTER;1;18500;0;18500;17200;1300;
2021-07-08 15:05:30;711844110144;KECAP ABC 225 ML;1;9000;0;9000;8200;800;
2021-07-08 15:05:30;8995333060703;TERIGU KOMPAS 1KG;1;10500;0;10500;9816;684;
2021-07-08 15:05:30;HT;HOT-HOT;1;500;0;500;350;150;
2021-07-08 15:08:43;8991102213189;BLASTER UNGU;1;5000;0;5000;3106;1894;
2021-07-08 16:51:01;8998866808699;ROYALE PURPLE DAWN 13ML;1;5000;0;5000;4500;500;
2021-07-08 17:53:08;8992959954034;SWEETY BRONZE NB 24;1;29000;0;29000;26762;2238;
2021-07-08 17:56:16;8998866200882;SUKSESMIE GORENG AYAM KRMS 133GR;1;3500;0;3500;3047;453;
2021-07-08 17:56:16;089686021219;INTER MIE GORENG;1;1000;0;1000;885;115;
2021-07-08 17:56:16;HT;HOT-HOT;1;500;0;500;350;150;
2021-07-08 17:56:16;8999999401023;MOLTO PEWANGI PINK 820ML;1;12500;0;12500;11275;1225;
2021-07-08 17:56:16;8991102387286SCT;TANGO LONG CKLT 47G;3;2000;0;6000;4653;1347;
2021-07-08 17:56:16;8994867000179;ROKOK PENA MILD 16;1;14500;0;14500;13500;1000;
2021-07-08 17:56:16;PRG;PARAGO;4;500;0;2000;1600;400;
2021-07-08 18:25:59;RT KN;ROTI KASUR NANAS;1;8000;0;8000;7200;800;
2021-07-08 18:25:59;RSK;ROTI SUSU KOTAK;1;7500;0;7500;6500;1000;
2021-07-08 18:25:59;CSM;ROTI COKLAT MATAHARI;1;6000;0;6000;5000;1000;
2021-07-08 18:26:53;8992775203422;GARUDA ROSTA OVEN 100G;1;8000;0;8000;7322;678;
2021-07-08 18:26:53;089686611519;QTELA SINGKONG;1;5000;0;5000;4266;734;
2021-07-08 18:26:53;8994834003752;TICTIC;1;2000;0;2000;1700;300;
2021-07-08 18:32:41;GL;GULA 1 LITER;1;11500;0;11500;10500;1000;
2021-07-08 18:32:41;8999999195656;SARI WANGI 50X1.85;1;10000;0;10000;9500;500;
2021-07-08 18:46:53;8991909101016;URBAN MILD 16;1;17000;0;17000;15800;1200;
2021-07-08 18:46:53;089686021219;INTER MIE GORENG;2;1000;0;2000;1770;230;
2021-07-08 19:34:28;8999909028234;234 DJI SAM SOE 12;1;17000;0;17000;15850;1150;
2021-07-08 19:39:26;8992761145026;SPRITE PET 250ML;2;3500;0;7000;4834;2166;
2021-07-08 19:39:26;8992761164539;NUTRIBOOST ORANGE 300ML;1;6500;0;6500;5300;1200;
2021-07-08 19:39:57;8992775318201;GERY SNACK BANTAL COKLAT;1;2000;0;2000;1712;288;
2021-07-08 20:11:03;8996001600269;LE MINERAL 600ML;1;3000;0;3000;1688;1312;
2021-07-08 20:11:03;8992775001783;GERY SALUT MALKIST;1;6500;0;6500;5516;984;
2021-07-08 20:20:24;8992761111519;COCA COLA SLIM CAM 250ML;1;5000;0;5000;3750;1250;
2021-07-08 20:20:24;8998009010569;ULTRA CHO 200;1;5000;0;5000;3830;1170;
2021-07-08 20:20:24;8992775002735;CHOCOLATOS SUSU COKELAT;1;4000;0;4000;3520;480;
2021-07-08 20:20:24;8992761164546;NUTRIBOOST STRAWBERRY 300ML;1;6500;0;6500;5300;1200;
2021-07-08 20:20:24;8992775001691;GARUDA ROSTA WAGYU BEEF;1;8000;0;8000;7322;678;
2021-07-08 20:25:01;8996001600399;LE MINERAL 1500ML;2;5000;0;10000;8084;1916;
2021-07-08 20:27:03;8994834003752;TICTIC;2;2000;0;4000;3400;600;
2021-07-08 20:48:39;8999999555191;SAHAJA PENCUCI PRG JRUK NIPIS  BTL 650ML;1;19000;0;19000;17250;1750;
2021-07-08 20:48:39;8993072254056;MELROSE COTTON BUDS KCL;1;3000;0;3000;2450;550;
2021-07-08 21:46:31;8993989311279;CLAS MILD 12;1;17000;0;17000;15700;1300;
2021-07-08 22:15:58;9556001004673;MILO NESTLE MALAYSIA ACTIVE GO;1;85000;0;85000;80000;5000;
2021-07-08 22:15:58;GL;GULA 1 LITER;3;11500;0;34500;31500;3000;
2021-07-08 22:15:58;8998666002525GT;TB TORA CAFE CAPPUCINO;1;9000;0;9000;7800;1200;
2021-07-08 22:15:58;RT BAKPIA;ROTI BAKPIA;1;1000;0;1000;750;250;
2021-07-08 22:15:58;8850507001152;MOTU ATV;1;10000;0;10000;8000;2000;
2021-07-08 22:17:52;8993001003908;INDOMILK KENTAL MANIS 545G;1;15000;0;15000;13333;1667;
2021-07-09 12:01:06;6907992823867;JD CRUNCHY CHOCOLATE MALT;1;5500;0;5500;4700;800;
2021-07-09 12:12:58;8993989311699;CLAS MILD 16 FILTER;1;23000;0;23000;21700;1300;
2021-07-09 12:12:58;089686044249;SUPERMI NUTRIMI STEAK AYAM;2;3500;0;7000;5600;1400;
2021-07-09 12:12:58;089686043204;INDOMIE MIE ACEH;1;2700;0;2700;2452;248;
2021-07-09 12:12:58;RT BAKPIA;ROTI BAKPIA;3;1000;0;3000;2250;750;
2021-07-09 12:12:58;8998866200561;EKOMIE SUPER 600GR;1;10000;0;10000;8615;1385;
2021-07-09 12:12:58;8996001312445;MALKIST CAPPUCINO;1;6500;0;6500;5400;1100;
2021-07-09 12:12:58;8998866202619;MIE SEDAAP KOREAN SPICY SOUP;2;2500;0;5000;4546;454;
2021-07-09 12:12:58;8998866202343;MIE SEDAAP KOREAN SPICY;2;2500;0;5000;4046;954;
2021-07-09 12:12:58;8999909096004;SAMPOERNA 16 FILTER;1;24000;0;24000;23000;1000;
2021-07-09 12:12:58;8997012321204;MAXX BUMBU BALADO;1;5000;0;5000;4100;900;
2021-07-09 12:12:58;8991002105409;KOPI KAPAL API;1;20000;0;20000;18888;1112;
2021-07-09 12:12:58;8996001338056;TAMARIN;1;6000;0;6000;5100;900;
2021-07-09 12:12:58;ROTI;ROTI 2000;2;2000;0;4000;3600;400;
2021-07-09 12:12:58;BALON;BALON CABUT;2;1000;0;2000;1800;200;
2021-07-09 12:12:58;HT;HOT-HOT;3;500;0;1500;1050;450;
2021-07-09 12:12:58;JGR SHN;JOGER SHINY SACHET;1;500;0;500;437;63;
2021-07-09 12:12:58;8996001600269;LE MINERAL 600ML;1;3000;0;3000;1688;1312;
2021-07-09 12:12:58;8998866201520;KOPI TOP TORAJA MURNI;1;11000;0;11000;9600;1400;
2021-07-09 12:12:58;8999999534752;PEPSODENT ACTION123 CHARCOAL 65G;1;7400;0;7400;6710;690;
2021-07-09 12:12:58;8992696521797SCT;MILO ACT GO 22G SCT;1;2000;0;2000;1553;447;
2021-07-09 12:12:58;8996001312353;MALKIST KELAPA KOPYOR;2;6700;0;13400;10800;2600;
2021-07-09 12:12:58;RT CD;ROTI COKLAT DURIAN;1;8000;0;8000;7200;800;
2021-07-09 12:12:58;8998866200301;MIE SEDAAP GORENG;1;2500;0;2500;2023;477;
2021-07-09 12:12:58;8998866200882;SUKSESMIE GORENG AYAM KRMS 133GR;1;3500;0;3500;3047;453;
2021-07-09 12:12:58;8997231980022;O'JELLY MINI STRAWBERRY;1;3000;0;3000;2250;750;
2021-07-09 12:12:58;MILKITA;MILKITA;2;250;0;500;400;100;
2021-07-09 12:14:24;8998866201964;MINYAK GORENG SABRINA 2L POUCH;1;28000;0;28000;26753;1247;
2021-07-09 13:01:12;8998866501033;MINYAK GORENG SEDAAP POUCH 2L;3;29000;0;87000;83238;3762;
2021-07-09 14:45:33;8998866501033;MINYAK GORENG SEDAAP POUCH 2L;1;29000;0;29000;27746;1254;
2021-07-09 14:45:33;TBR;TEPUNG BERAS ROSE BRAND;1;8000;0;8000;5800;2200;
2021-07-09 15:14:35;GL;GULA 1 LITER;1;11500;0;11500;10500;1000;
2021-07-09 17:19:19;SWAL;SENDAL SWALLOW;1;18000;0;18000;16500;1500;
2021-07-09 17:23:54;6907992823966;JD BLUEBERRY;1;3500;0;3500;3000;500;
2021-07-09 17:23:54;6907992824963;JD MILKY CHOCOLATE;1;3000;0;3000;2600;400;
2021-07-09 17:23:54;8999909010567;234 DJI SAM SOE 16;1;22000;0;22000;21500;500;
2021-07-09 17:25:17;8999909002821;MARLBORO BLACK 16;1;22000;0;22000;20850;1150;
2021-07-09 18:10:29;ARG;ARGUS 220ML;3;14500;0;43500;37500;6000;
2021-07-09 18:20:55;TG;TEH GELAS;5;1000;0;5000;3645;1355;
2021-07-09 18:20:55;8998866202664;POTABEE WAGYU BEEF STEAK 68 GR;1;8000;0;8000;7200;800;
2021-07-09 18:20:55;089686611519;QTELA SINGKONG;1;5000;0;5000;4266;734;
2021-07-09 18:20:55;RT BAKPIA;ROTI BAKPIA;10;1000;0;10000;7500;2500;
2021-07-09 18:56:34;PD;PENDEKAR;1;500;0;500;350;150;
2021-07-09 18:56:34;8992761145026;SPRITE PET 250ML;1;3500;0;3500;2417;1083;
2021-07-09 19:20:51;TG MARKISA;TEH GELAS MARKISA;3;2000;0;6000;3534;2466;
2021-07-09 19:26:57;8998866501026;MINYAK GORENG SEDAAP POUCH 1 L;1;15000;0;15000;14110;890;
2021-07-09 19:51:01;8997011700123;BIHUN JAGUNG 300GR;1;6000;0;6000;4979;1021;
2021-07-09 20:07:52;8996001318980;BETTER 120G;1;6000;0;6000;5100;900;
2021-07-09 20:07:52;8992696422735;DNCO CKLT UHT 110ML;1;2500;0;2500;2041;459;
2021-07-09 20:07:52;8998866201483;POTABEE REGULER GRILLED SEAWEED 35GR;1;5000;0;5000;4150;850;
2021-07-09 20:07:52;8992730002992;HAI CANDY;1;7000;0;7000;6000;1000;
2021-07-09 20:07:52;8997009510017;YOU C1000 LEMON;1;10000;0;10000;9166;834;
2021-07-09 20:35:59;8996001600375;LE MINERAL 330ML;1;2000;0;2000;1417;583;
2021-07-09 20:35:59;8996001600269;LE MINERAL 600ML;1;3000;0;3000;1688;1312;
2021-07-09 20:35:59;6907992823843;JD MOCHA CRISPY;1;5000;0;5000;4400;600;
2021-07-09 21:13:05;8999999195649;SARI WANGI 25X1.86G;1;6000;0;6000;5050;950;
2021-07-09 21:37:24;8998009020520;BUAVITA MINI GUAVA 125ML;1;6000;0;6000;5250;750;
2021-07-09 21:37:24;8993007000024;INDOMILK UHT VANILA;1;5000;0;5000;3470;1530;
2021-07-09 21:46:46;GL;GULA 1 LITER;2;11500;0;23000;21000;2000;
2021-07-09 21:59:02;8992696404441;BEAR BRAND 189ML;2;9000;0;18000;15774;2226;
2021-07-10 10:48:08;8998866202244;EKOMIE BUMBU KALDU AYAM;5;1000;0;5000;3990;1010;
2021-07-10 10:48:56;8997009510017;YOU C1000 LEMON;1;10000;0;10000;9166;834;
2021-07-10 10:48:56;8992696404441;BEAR BRAND 189ML;1;9000;0;9000;7887;1113;
2021-07-10 10:51:08;TBR;TEPUNG BERAS ROSE BRAND;1;8000;0;8000;5800;2200;
2021-07-10 10:51:08;8997012321204;MAXX BUMBU BALADO;1;5000;0;5000;4100;900;
2021-07-10 10:51:08;8996001301142;ROMA KELAPA;1;8000;0;8000;6628;1372;
2021-07-10 10:51:08;8992775913000SCT;CHOCOLATOS CKLT DRINK SCT;4;2000;0;8000;6344;1656;
2021-07-10 10:51:08;8998866501033;MINYAK GORENG SEDAAP POUCH 2L;3;29000;0;87000;83238;3762;
2021-07-10 10:51:08;711844340008;ABC TERASI;1;7000;0;7000;5800;1200;
2021-07-10 10:51:08;HT;HOT-HOT;1;500;0;500;350;150;
2021-07-10 10:51:08;BALON;BALON CABUT;2;1000;0;2000;1800;200;
2021-07-10 11:16:33;8992957220025;GOLDEN CITY MINI;1;3000;0;3000;2500;500;
2021-07-10 11:16:33;6907992825076;JD WATERMELON APPLE;2;2000;0;4000;3400;600;
2021-07-10 11:16:33;8992957220087;COKLAT SINGA;1;2000;0;2000;1700;300;
2021-07-10 11:16:33;8992957220063;COKLAT BANGO;2;2000;0;4000;3400;600;
2021-07-10 11:48:22;8994867007161;ROKOK PENA GOLD 20;1;17000;0;17000;15500;1500;
2021-07-10 11:56:44;8994867007161;ROKOK PENA GOLD 20;1;17000;0;17000;15500;1500;
2021-07-10 11:56:44;8999909002821;MARLBORO BLACK 16;1;22000;0;22000;20850;1150;
2021-07-10 12:27:08;8998866200325;MIE SEDAAP SOTO;6;2500;0;15000;11712;3288;
2021-07-10 13:02:17;RB;RED BOLD;1;19000;0;19000;17900;1100;
2021-07-10 13:09:12;BALON;BALON CABUT;2;1000;0;2000;1800;200;
2021-07-10 14:24:01;8998866202619;MIE SEDAAP KOREAN SPICY SOUP;1;2500;0;2500;2273;227;
2021-07-10 14:24:01;8993470672827;SAKU-SAKU SAPI PANGGANG;1;2000;0;2000;1530;470;
2021-07-10 14:24:01;HT;HOT-HOT;1;500;0;500;350;150;
2021-07-10 14:24:12;8998899002132;BAY FRESH LEMON 320ML;1;18500;0;18500;16700;1800;
2021-07-10 15:04:04;BRS5;BERAS BUMN 5KG;1;64000;0;64000;50500;13500;
2021-07-10 15:08:55;BG;BERAS GURIH PASAR RAME;1;60000;0;60000;56000;4000;
2021-07-10 16:25:31;8999999706449;CLOSEUP ICY WHITE 65G;1;9000;0;9000;7865;1135;
2021-07-10 16:30:44;8992696523067;MILO ACTVGO UHT 180ML;1;4500;0;4500;3515;985;
2021-07-10 16:30:44;PD;PENDEKAR;1;500;0;500;350;150;
2021-07-10 16:42:45;6907992823973;JD PINEAPPLE;1;5000;0;5000;4300;700;
2021-07-10 16:42:45;8999999538453;SUNSILK SHP SOFT AND  SMOOTH 55 ML;1;5000;0;5000;3750;1250;
2021-07-10 16:48:41;8998866693608;SOKLIN FLOORCLENER HIJAU 900ML;1;14000;0;14000;12436;1564;
2021-07-10 16:48:41;8999999042608;RINSO MOLTO PARFUME ESSENCE 750ML;1;15000;0;15000;12507;2493;
2021-07-10 16:48:41;8999999706081;PEPSODENT WHITE 75G;1;5000;0;5000;3850;1150;
2021-07-10 16:48:41;8999999048501;SUNSILK RFR ANTI DDRF 170ML;1;22200;0;22200;20020;2180;
2021-07-10 16:48:41;089686440133;BUMBU KARE;1;5000;0;5000;4500;500;
2021-07-10 16:48:41;8991002105409;KOPI KAPAL API;1;20000;0;20000;18888;1112;
2021-07-10 16:48:41;8992759120264;LARISST 220;1;10000;0;10000;9200;800;
2021-07-10 16:48:41;8999999524722;SUNLIGHT LIME NEW PCH 435ML;1;10000;0;10000;9100;900;
2021-07-10 16:48:41;VCL;VITAMIN C500 LEMON;10;1000;0;10000;5750;4250;
2021-07-10 17:54:07;9556001004673;MILO NESTLE MALAYSIA ACTIVE GO;1;85000;0;85000;80000;5000;
2021-07-10 18:00:18;8992759120264;LARISST 220;1;10000;0;10000;9200;800;
2021-07-10 18:00:18;8996001351888;WFR WAFELLO;1;17000;0;17000;15500;1500;
2021-07-10 18:40:30;8998989500166;GUDANG GARAM MERAH BESAR 16KS;2;18000;0;36000;34000;2000;
2021-07-10 18:55:52;GL;GULA 1 LITER;1;11500;0;11500;10500;1000;
2021-07-10 19:24:43;ARG;ARGUS 220ML;6;14500;0;87000;75000;12000;
2021-07-10 20:05:20;RT MENARA;ROTI TAWAR MENARA;1;8000;0;8000;7200;800;
2021-07-10 20:05:20;8998989110167;SURYA GUDANG GARAM 16 FILTER;1;25000;0;25000;23200;1800;
2021-07-10 20:05:20;BALON;BALON CABUT;2;1000;0;2000;1800;200;
2021-07-10 21:27:45;089686041705;INDOMIE GORENG JUMBO;2;3500;0;7000;6286;714;
2021-07-10 21:27:45;8998866203104;MIE SEDAAP SINGAPORE;2;2500;0;5000;4532;468;
2021-07-10 21:33:53;8992761166038;MMP ORANGE 300ML;2;5000;0;10000;7500;2500;
2021-07-10 21:50:36;8999909010567;234 DJI SAM SOE 16;1;22000;0;22000;21500;500;
2021-07-10 21:57:22;8998866501026;MINYAK GORENG SEDAAP POUCH 1 L;1;15000;0;15000;14110;890;
2021-07-10 21:57:22;8996001318980;BETTER 120G;1;6000;0;6000;5100;900;
2021-07-10 21:57:22;8998866202060;POTABEE AYAM BAKAR PEDAS 35 GR;1;5000;0;5000;4150;850;
2021-07-10 21:57:22;711844330009;ABC SARDEN TOMAT;1;10000;0;10000;8000;2000;
2021-07-10 21:57:22;8998866203104;MIE SEDAAP SINGAPORE;1;2500;0;2500;2266;234;
2021-07-10 21:57:22;8992388111206;MIE ABC SELERA PEDAS-GULAI AYAM PEDAS;1;2500;0;2500;2022;478;
2021-07-10 21:57:22;089686010190;INDOMIE KARI AYAM;1;2800;0;2800;2522;278;
2021-07-10 21:57:22;POTO;KERUPUK PANJANG;1;5000;0;5000;4000;1000;
2021-07-10 21:57:22;8992696404441;BEAR BRAND 189ML;1;9000;0;9000;7887;1113;
2021-07-10 21:57:22;8999801700030;SUSU FOYU;1;11500;0;11500;10450;1050;
2021-07-10 21:57:22;8992759120264;LARISST 220;1;10000;0;10000;9200;800;
2021-07-10 21:57:22;8999999024468;CITRA FRESH EHITE 400ML;1;20800;0;20800;18950;1850;
2021-07-10 21:57:22;8999999059781;SUNLIGHT LIME NEW POUCH 210ML;1;5000;0;5000;4300;700;
2021-07-10 21:57:22;8999999030186;PEPSODENT ACTION 123 COMPLETE 190G;1;14000;0;14000;13200;800;
2021-07-10 21:57:22;8998866618298;DAIA CLEAN&FRESH HJB 320GR;1;5000;0;5000;4450;550;
2021-07-10 21:57:22;8994037800608;WENIS UNGU;1;8000;0;8000;6500;1500;
2021-07-10 21:57:22;8999999528829;CITRA SAKURA FAIR UV 120ML;1;11200;0;11200;10082;1118;
2021-07-10 21:57:22;8998866610742;NOVO FAMILY PINK 76G;1;2000;0;2000;1820;180;
2021-07-10 21:57:22;8994907000428;KECAP SACHET ABC;4;500;0;2000;1416;584;
2021-07-11 11:22:59;8999999514495;RINSO MOLTO ROSE FRESH 215ML;1;5000;0;5000;4250;750;
2021-07-11 11:22:59;MOLTO PINK;MOLTO ALL IN ONE 11 ML;2;500;0;1000;800;200;
2021-07-11 11:22:59;JGR SHN;JOGER SHINY SACHET;1;500;0;500;437;63;
2021-07-11 11:22:59;BALON;BALON CABUT;1;1000;0;1000;900;100;
2021-07-11 11:22:59;GL;GULA 1 LITER;1;11500;0;11500;10500;1000;
2021-07-11 11:22:59;8998866202770;MIE SEDAAP SALERO PADANG;2;2500;0;5000;4724;276;
2021-07-11 11:22:59;8998666002525SCT;TB TORA CAFE CAPPUCINO SCT;5;1000;0;5000;3900;1100;
2021-07-11 11:49:29;8996001312438;MALKIST CAPPUCINO SCT;2;1000;0;2000;1640;360;
2021-07-11 11:49:29;8996001312582;MALKIST KELAPA KOPYOR SCT;1;1000;0;1000;820;180;
2021-07-11 11:49:29;BALON;BALON CABUT;2;1000;0;2000;1800;200;
2021-07-11 11:53:10;8992775913000SCT;CHOCOLATOS CKLT DRINK SCT;4;2000;0;8000;6344;1656;
2021-07-11 11:53:10;8991102987639;WFR TANGO LONG VNL 130G;1;5000;0;5000;3773;1227;
2021-07-11 12:07:46;8998866500708;FLORIDINA ORANGE;1;3000;0;3000;2500;500;
2021-07-11 12:34:39;8999999530266;LIFEBUOY MATCHA GREENTEA 100ML;2;10500;0;21000;18810;2190;
2021-07-11 12:34:39;9556001025272;NESCAFE LATTE 240ML;1;8500;0;8500;7834;666;
2021-07-11 12:34:39;8993560026028;DETTOL SENSITIVE;1;20000;0;20000;18524;1476;
2021-07-11 12:39:01;8992759120264;LARISST 220;1;10000;0;10000;9200;800;
2021-07-11 12:39:01;8999908082800;MARINA HEALTHY AND GLOW;1;10000;0;10000;8500;1500;
2021-07-11 12:39:01;8886013213208;FRENCH FREIS 2000;1;5000;0;5000;3750;1250;
2021-07-11 12:39:01;8998866202466;JAPOTA HAPPY HONEY BUTTER;1;5000;0;5000;4150;850;
2021-07-11 12:40:01;8998866201964;MINYAK GORENG SABRINA 2L POUCH;1;28000;0;28000;26753;1247;
2021-07-11 12:40:01;8998866201377;KRISBEE FRIES KENTANG GORENG 68 GR;1;5500;0;5500;4620;880;
2021-07-11 17:35:10;8996001600375;LE MINERAL 330ML;2;2000;0;4000;2834;1166;
2021-07-11 17:35:50;76239878;MARLBORO GOLD;1;30000;0;30000;27700;2300;
2021-07-11 17:35:50;8998009040023;TEH KOTAK;1;5000;0;5000;2827;2173;
2021-07-11 17:35:50;8998009010569;ULTRA CHO 200;1;5000;0;5000;3830;1170;
2021-07-11 17:36:44;089686021219;INTER MIE GORENG;5;1000;0;5000;4425;575;
2021-07-11 17:36:44;089686021127;INTER MIE KALDU;1;1000;0;1000;813;187;
2021-07-11 17:37:01;8992752112013;MIZONE;1;5000;0;5000;3800;1200;
2021-07-11 17:37:01;8992761145026;SPRITE PET 250ML;2;3500;0;7000;4834;2166;
2021-07-11 18:32:22;8999909010567;234 DJI SAM SOE 16;1;22000;0;22000;21500;500;
2021-07-11 18:54:07;8998989110167;SURYA GUDANG GARAM 16 FILTER;1;25000;0;25000;23200;1800;
2021-07-11 18:54:07;123124;KOREK BIASA;1;2000;0;2000;1800;200;
2021-07-11 18:59:28;8998989300261;GUDANG GARAM SURYA 12 FILTER;1;18500;0;18500;17200;1300;
2021-07-11 18:59:28;MILKITA;MILKITA;2;250;0;500;400;100;
2021-07-11 18:59:28;BALON;BALON CABUT;1;1000;0;1000;900;100;
2021-07-11 19:03:11;8998989110167;SURYA GUDANG GARAM 16 FILTER;1;25000;0;25000;23200;1800;
2021-07-11 19:06:17;8999999557355;ZWITSAL BABY BOTTLE CLEANER 135 ML;1;5000;0;5000;4000;1000;
2021-07-11 19:44:09;8999999042646;RINSO MOLTO ROSE FRESH LIQ 40ML;2;6000;0;12000;9634;2366;
2021-07-11 20:05:17;089686043273;INDOMIE SAMBAL RICA;2;2700;0;5400;4904;496;
2021-07-11 20:33:35;8998989500166;GUDANG GARAM MERAH BESAR 16KS;1;18000;0;18000;17000;1000;
2021-07-11 20:37:40;VCL;VITAMIN C500 LEMON;16;1000;0;16000;9200;6800;
2021-07-11 21:12:51;8992775913000GT;CHOCOLATOS CKLT DRINK;1;18000;0;18000;15862;2138;
2021-07-11 21:12:51;ROTI;ROTI 2000;2;2000;0;4000;3600;400;
2021-07-11 21:12:51;RT BAKPIA;ROTI BAKPIA;13;1000;0;13000;9750;3250;
2021-07-11 21:12:51;8992761164478;FRESTEA MILK TEA;1;8000;0;8000;6575;1425;
2021-07-11 21:12:51;8997009510123;ORANGE WATER;1;7000;0;7000;6089;911;
2021-07-11 21:13:17;6907992825076;JD WATERMELON APPLE;2;2000;0;4000;3400;600;
2021-07-11 21:13:18;PD;PENDEKAR;1;500;0;500;350;150;
2021-07-11 21:13:18;HT;HOT-HOT;1;500;0;500;350;150;
2021-07-11 22:12:06;8992730002992;HAI CANDY;1;7000;0;7000;6000;1000;
2021-07-11 22:12:06;8850507001152;MOTU ATV;1;10000;0;10000;8000;2000;
2021-07-11 22:12:06;123;BETREI JAM;1;5500;0;5500;5000;500;
2021-07-11 22:32:30;089686611519;QTELA SINGKONG;1;5000;0;5000;4266;734;
2021-07-12 10:49:26;8992761166205;FRESTEA GREEN HONEY 350ML;3;4500;0;13500;9000;4500;
2021-07-12 10:49:26;8993176110135;MINYAK TELON LANG 30ML;1;10000;0;10000;8167;1833;
2021-07-12 10:49:26;8999999502003;SARIMURNI RL RB 1,8G;1;1500;0;1500;1207;293;
2021-07-12 10:49:26;8996001305041;ROMA SANDWICH CKLT;1;7000;0;7000;5000;2000;
2021-07-12 10:49:26;8996001355237;SUPER STAR;1;11000;0;11000;9900;1100;
2021-07-12 10:50:31;8992761139018;ADES 600ML;3;3500;0;10500;6876;3624;
2021-07-12 11:07:17;8999999059316;LIFEBUOY TS MILDCARE 75G;1;3000;0;3000;2640;360;
2021-07-12 11:07:17;BALON;BALON CABUT;4;1000;0;4000;3600;400;
2021-07-12 11:40:33;8998989121163;SURYA PRO MERAH;1;20000;0;20000;18600;1400;
2021-07-12 11:40:33;8992761002015;COCA COLA PET 390ML;1;5500;0;5500;4333;1167;
2021-07-12 12:23:54;8992959974018;SFX SIRIH 36CM 12+1;1;17000;0;17000;15958;1042;
2021-07-12 12:23:54;8999909002876;SAMPOERNA ULTRAMILD 12;1;16000;0;16000;14600;1400;
2021-07-12 12:57:02;8998866501033;MINYAK GORENG SEDAAP POUCH 2L;1;29000;0;29000;27746;1254;
2021-07-12 12:57:02;BM;BENG-BENG MAXX;1;2500;0;2500;2041;459;
2021-07-12 12:57:02;VTM;VITAMIN;1;500;0;500;425;75;
2021-07-12 12:57:36;089686048704;SARIMIE GORENG AYAM KCP ISI 2;2;3500;0;7000;6240;760;
2021-07-12 13:20:34;GL;GULA 1 LITER;2;11500;0;23000;21000;2000;
2021-07-12 13:20:34;8998866200646;KOPI TOP MURNI;1;11000;0;11000;9600;1400;
2021-07-12 13:23:33;8999999401245;RINSO ANTI NODA NCLASSIC 1.4KG;1;36500;0;36500;33147;3353;
2021-07-12 13:23:33;8998989300261;GUDANG GARAM SURYA 12 FILTER;1;18500;0;18500;17200;1300;
2021-07-12 13:23:33;BALON;BALON CABUT;2;1000;0;2000;1800;200;
2021-07-12 13:23:33;MILKITA;MILKITA;2;250;0;500;400;100;
2021-07-12 13:35:23;6907992824963;JD MILKY CHOCOLATE;1;3000;0;3000;2600;400;
2021-07-12 13:35:23;6907992823669;JD MILKY STRAW;1;3000;0;3000;2600;400;
2021-07-12 13:35:23;6907992823829;JD MILKY MILK;1;3000;0;3000;2600;400;
2021-07-12 13:35:23;8997231980039;O`JELLY KONYAKU (MAXI APPLE STRAWBERRY);1;5000;0;5000;4620;380;
2021-07-12 13:35:23;BALON;BALON CABUT;10;1000;0;10000;9000;1000;
2021-07-12 14:15:08;RT KJ;ROTI KASUR JUMBO;2;8000;0;16000;14400;1600;
2021-07-12 14:15:08;8999999526863;MOLTO ALL IN ONE PINK 11ML;3;5500;0;16500;14400;2100;
2021-07-12 14:15:08;8996001402023GT;TB TORA SUSU;1;13000;0;13000;9333;3667;
2021-07-12 14:15:08;8998866201490;POTABEE REGULER GRILLED SEAWED 68 GR;1;8000;0;8000;7200;800;
2021-07-12 14:15:08;8998866201483;POTABEE REGULER GRILLED SEAWEED 35GR;2;5000;0;10000;8300;1700;
2021-07-12 14:15:08;8998866201452;POTABEE REGULER BBQ BEEF 35GR;1;5000;0;5000;4150;850;
2021-07-12 14:15:08;711844110144;KECAP ABC 225 ML;1;9000;0;9000;8200;800;
2021-07-12 14:48:37;GL;GULA 1 LITER;2;11500;0;23000;21000;2000;
2021-07-12 14:50:33;8999999534097;PEPSODENT PGB FCM 75G;1;5000;0;5000;3850;1150;
2021-07-12 14:50:33;8999908082800;MARINA HEALTHY AND GLOW;1;10000;0;10000;8500;1500;
2021-07-12 14:50:33;8993379121204;SABUN MEDICARE RED;1;2500;0;2500;2237;263;
2021-07-12 14:50:33;8993379260804;SABUN MEDICARE BLUE;1;2500;0;2500;2237;263;
2021-07-12 14:50:33;8999908059802;MY BABY POWDER KUNING;1;5000;0;5000;3276;1724;
2021-07-12 14:50:33;8999999031930;PEPSODENT TB TRIPLE CLEAN;1;3500;0;3500;2850;650;
2021-07-12 14:50:33;HT;HOT-HOT;1;500;0;500;350;150;
2021-07-12 15:15:14;8998866501026;MINYAK GORENG SEDAAP POUCH 1 L;1;15000;0;15000;14110;890;
2021-07-12 15:15:14;8992696404441;BEAR BRAND 189ML;1;9000;0;9000;7887;1113;
2021-07-12 16:03:04;8996001355978;BENG-BENG SHARE IT 9.5G;1;10000;0;10000;8700;1300;
2021-07-12 16:03:04;8996001600375;LE MINERAL 330ML;2;2000;0;4000;2834;1166;
2021-07-12 16:03:04;8991001111883;SILVERQUEEN CHUNKYBAR 33G;1;8000;0;8000;7150;850;
2021-07-12 16:16:45;SLAIM;SLAIM WARNA;2;2000;0;4000;3486;514;
2021-07-12 16:35:04;8992761145026;SPRITE PET 250ML;1;3500;0;3500;2417;1083;
2021-07-12 16:35:04;8999909002876;SAMPOERNA ULTRAMILD 12;1;16000;0;16000;14600;1400;
2021-07-12 16:35:34;8992957220087;COKLAT SINGA;1;2000;0;2000;1700;300;
2021-07-12 16:39:44;8998989300261;GUDANG GARAM SURYA 12 FILTER;1;18500;0;18500;17200;1300;
2021-07-12 16:39:44;8992730002992;HAI CANDY;1;7000;0;7000;6000;1000;
2021-07-12 17:02:44;8996001600375;LE MINERAL 330ML;1;2000;0;2000;1417;583;
2021-07-12 17:02:44;PD;PENDEKAR;1;500;0;500;350;150;
2021-07-12 17:02:44;8997028590014;ARGUS 220ML;1;500;0;500;302;198;
2021-07-12 17:15:47;8998866202930;SEDAAP AYAM JERIT CUP;1;4500;0;4500;3738;762;
2021-07-12 17:15:47;089686049053;SARIMI PUAS;1;3000;0;3000;2400;600;
2021-07-12 17:15:47;KP;KERIPIK PISANG;1;5000;0;5000;5000;0;
2021-07-12 17:34:25;COKLAT;COKLAT COIN;2;500;0;1000;850;150;
2021-07-12 17:34:25;8998866501033;MINYAK GORENG SEDAAP POUCH 2L;1;29000;0;29000;27746;1254;
2021-07-12 17:35:19;8998989110167;SURYA GUDANG GARAM 16 FILTER;1;25000;0;25000;23200;1800;
2021-07-12 17:53:29;8991102714846;MILKIDO CKLT;1;3000;0;3000;2153;847;
2021-07-12 17:53:29;8998866203104;MIE SEDAAP SINGAPORE;1;2500;0;2500;2266;234;
2021-07-12 17:53:29;RSK;ROTI SUSU KOTAK;1;7500;0;7500;6500;1000;
2021-07-12 18:07:40;8992761145033;FANTA STRAW PET 250ML;1;3500;0;3500;2417;1083;
2021-07-12 18:19:12;8998866203104;MIE SEDAAP SINGAPORE;1;2500;0;2500;2266;234;
2021-07-12 18:19:12;8998866202923;FLORIDINA COCO;1;3000;0;3000;2500;500;
2021-07-12 18:19:12;8996001312438;MALKIST CAPPUCINO SCT;1;1000;0;1000;820;180;
2021-07-12 18:19:12;089686021127;INTER MIE KALDU;1;1000;0;1000;813;187;
2021-07-12 18:19:12;JGR SHN;JOGER SHINY SACHET;1;500;0;500;437;63;
2021-07-12 18:22:19;8997009510017;YOU C1000 LEMON;1;10000;0;10000;9166;834;
2021-07-12 18:22:19;089686043204;INDOMIE MIE ACEH;2;2700;0;5400;4904;496;
2021-07-12 18:22:19;8996001301142;ROMA KELAPA;1;8000;0;8000;6628;1372;
2021-07-12 19:19:29;8999909010567;234 DJI SAM SOE 16;1;22000;0;22000;21500;500;
2021-07-12 19:36:14;ARG;ARGUS 220ML;1;14500;0;14500;12500;2000;
2021-07-12 19:56:17;8993001003908;INDOMILK KENTAL MANIS 545G;1;15000;0;15000;13333;1667;
2021-07-12 19:57:24;8992761145033;FANTA STRAW PET 250ML;3;3500;0;10500;7251;3249;
2021-07-12 19:57:24;8992761145026;SPRITE PET 250ML;3;3500;0;10500;7251;3249;
2021-07-12 19:57:24;8992957220063;COKLAT BANGO;1;2000;0;2000;1700;300;
2021-07-12 20:02:06;8998866613729;EMERON LOVELY NTRL 100ML;1;3500;0;3500;2900;600;
2021-07-12 20:02:06;8994935000070;MINYAK DUNIA 450 ML;1;7500;0;7500;6779;721;
2021-07-12 20:55:26;8999999555450;VIXAL PEMB PORS BIRU 190ML;1;5000;0;5000;4200;800;
2021-07-12 20:55:26;8999999524722;SUNLIGHT LIME NEW PCH 435ML;1;10000;0;10000;9100;900;
2021-07-12 20:55:26;8934868015024;REXONA DEO LOTION FREE SPIRIT 9G;3;2500;0;7500;6000;1500;
2021-07-12 20:55:26;kp;KALPA;3;2000;0;6000;4998;1002;
2021-07-12 20:55:26;8992957220087;COKLAT SINGA;1;2000;0;2000;1700;300;
2021-07-12 20:55:26;8992957220186;COKLAT RUSA;1;2000;0;2000;1700;300;
2021-07-12 20:55:26;8998866609036;DAIA BUNGA GUSSET 565G;1;10000;0;10000;8700;1300;
2021-07-12 20:55:26;GL;GULA 1 LITER;1;11500;0;11500;10500;1000;
2021-07-12 20:55:26;8998866808699;ROYALE PURPLE DAWN 13ML;1;5000;0;5000;4500;500;
2021-07-12 20:55:26;8998866201377;KRISBEE FRIES KENTANG GORENG 68 GR;1;5500;0;5500;4620;880;
2021-07-12 21:06:45;8992696521797SCT;MILO ACT GO 22G SCT;1;2000;0;2000;1553;447;
2021-07-12 21:06:45;MENTOS;MENTOS;4;250;0;1000;700;300;
2021-07-12 22:09:24;8998989300261;GUDANG GARAM SURYA 12 FILTER;1;18500;0;18500;17200;1300;
2021-07-12 22:09:24;8992761139018;ADES 600ML;1;3500;0;3500;2292;1208;
2021-07-12 22:23:45;8992761002022;SPRITE PET 390ML;1;5500;0;5500;4300;1200;
2021-07-12 22:24:18;8997218380074;ICHITAN MILK TEA;1;8000;0;8000;6583;1417;
2021-07-12 22:24:18;8999999528812;CITRA  GOLDEN WHITE 120ML;1;11100;0;11100;10082;1018;
2021-07-12 22:38:46;8993571002196;CAP 19 OBAT KURAP AIR 10ML;1;5000;0;5000;3637;1363;
2021-07-12 22:38:46;8886001038011;BENG-BENG SCT;1;1500;0;1500;1450;50;
2021-07-12 22:38:55;8998989110167;SURYA GUDANG GARAM 16 FILTER;1;25000;0;25000;23200;1800;
2021-07-13 11:48:01;GL;GULA 1 LITER;4;11500;0;46000;42000;4000;
2021-07-13 11:48:01;8992696523067;MILO ACTVGO UHT 180ML;1;4500;0;4500;3515;985;
2021-07-13 11:48:01;8996001600375;LE MINERAL 330ML;1;2000;0;2000;1417;583;
2021-07-13 11:48:01;8998866201452;POTABEE REGULER BBQ BEEF 35GR;1;5000;0;5000;4150;850;
2021-07-13 11:48:01;9556001174659;MILO ACT GO 240ML;1;8500;0;8500;7437;1063;
2021-07-13 11:48:01;8850507002197;TOK TAK FRUIT CANDY;1;7500;0;7500;6250;1250;
2021-07-13 11:48:01;BALON;BALON CABUT;2;1000;0;2000;1800;200;
2021-07-13 11:48:01;HT;HOT-HOT;1;500;0;500;350;150;
2021-07-13 11:48:01;CLUB;AIR CLUB;1;3000;0;3000;1452;1548;
2021-07-13 11:48:01;ROTI;ROTI 2000;2;2000;0;4000;3600;400;
2021-07-13 11:48:01;8998866202602;KRISBEE FRENCH FRIES 18GR;1;2000;0;2000;1500;500;
2021-07-13 11:48:01;RT BAKPIA;ROTI BAKPIA;2;1000;0;2000;1500;500;
2021-07-13 11:48:01;8996001302620;MALKIST COKLAT SCT;2;1000;0;2000;1680;320;
2021-07-13 11:48:01;8997231980039;O`JELLY KONYAKU (MAXI APPLE STRAWBERRY);1;5000;0;5000;4620;380;
2021-07-13 11:48:01;8996001440049;ENERGEN;2;1500;0;3000;2400;600;
2021-07-13 11:48:01;CSM;ROTI COKLAT MATAHARI;1;6000;0;6000;5000;1000;
2021-07-13 11:48:02;8993989311699;CLAS MILD 16 FILTER;1;23000;0;23000;21700;1300;
2021-07-13 11:48:02;8991102714846;MILKIDO CKLT;1;3000;0;3000;2153;847;
2021-07-13 11:48:02;8991102281430;PERMEN MINTZ DUOMINT;1;4500;0;4500;4000;500;
2021-07-13 11:48:02;8996001305041;ROMA SANDWICH CKLT;1;7000;0;7000;5000;2000;
2021-07-13 11:48:02;8998009020186;BUAVITA GUAVA 250ML;2;7000;0;14000;12166;1834;
2021-07-13 11:48:02;8996001600597;KOPIKO LUCKY DAY;1;5000;0;5000;4283;717;
2021-07-13 11:48:02;8994834003752;TICTIC;1;2000;0;2000;1700;300;
2021-07-13 11:48:02;8992761145033;FANTA STRAW PET 250ML;1;3500;0;3500;2417;1083;
2021-07-13 11:48:02;MENTOS;MENTOS;6;250;0;1500;1050;450;
2021-07-13 12:39:07;8851019210193;POCKY CHOCO BANANA 47G;1;7300;0;7300;5671;1629;
2021-07-13 12:46:38;8850507000094;POLICE BONCHA;1;2000;0;2000;800;1200;
2021-07-13 12:58:35;8998989500166;GUDANG GARAM MERAH BESAR 16KS;1;18000;0;18000;17000;1000;
2021-07-13 12:58:35;GL;GULA 1 LITER;1;11500;0;11500;10500;1000;
2021-07-13 12:58:35;8999909004221;SAMPOERNA ULTRAMILD 16;1;22000;0;22000;20350;1650;
2021-07-13 13:20:48;8998866501033;MINYAK GORENG SEDAAP POUCH 2L;3;29000;0;87000;83238;3762;
2021-07-13 13:23:31;8992775318201;GERY SNACK BANTAL COKLAT;1;2000;0;2000;1712;288;
2021-07-13 13:23:31;8886001038011;BENG-BENG SCT;2;1500;0;3000;2900;100;
2021-07-13 13:23:31;8996001355756;BENG-BENG MAXX SCT;1;2500;0;2500;2041;459;
2021-07-13 14:01:25;6907992823867;JD CRUNCHY CHOCOLATE MALT;1;5500;0;5500;4700;800;
2021-07-13 14:01:25;6907992823621;JD CREAMY YOGURT;1;3000;0;3000;2600;400;
2021-07-13 14:01:25;JGR SHN;JOGER SHINY SACHET;1;500;0;500;437;63;
2021-07-13 14:03:30;6907992823966;JD BLUEBERRY;1;3500;0;3500;3000;500;
2021-07-13 14:03:30;6907992823669;JD MILKY STRAW;1;3000;0;3000;2600;400;
2021-07-13 14:42:48;8991001780492;SELAMAT COKLAT;1;13000;0;13000;11800;1200;
2021-07-13 14:42:48;8992761122430;FRESTEA GREEN HONEY 500ML;1;6500;0;6500;4708;1792;
2021-07-13 14:42:48;8992761002039;FANTA STRAWBERRY PET 390 ML;1;5500;0;5500;4300;1200;
2021-07-13 14:48:02;8992696404441;BEAR BRAND 189ML;1;9000;0;9000;7887;1113;
2021-07-13 14:48:02;8997009510017;YOU C1000 LEMON;1;10000;0;10000;9166;834;
2021-07-13 15:05:52;8995333060703;TERIGU KOMPAS 1KG;2;10500;0;21000;19632;1368;
2021-07-13 15:05:52;8992628020152;BIMOLI POUCH 2L;1;31000;0;31000;29800;1200;
2021-07-13 15:05:52;GL;GULA 1 LITER;2;11500;0;23000;21000;2000;
2021-07-13 15:05:52;8999999049447;REXONA WMN RO ADVANCED WHITE 45 ML;1;16500;0;16500;14900;1600;
2021-07-13 15:05:52;8996001318911;BETTER ISI 4;2;2000;0;4000;3400;600;
2021-07-13 15:05:52;8992628510158;SIMAS PALMIA;1;6000;0;6000;4832;1168;
2021-07-13 15:05:52;ROTI;ROTI 2000;2;2000;0;4000;3600;400;
2021-07-13 15:05:52;JGR SHN;JOGER SHINY SACHET;3;500;0;1500;1311;189;
2021-07-13 16:57:23;8998989110167;SURYA GUDANG GARAM 16 FILTER;1;25000;0;25000;23200;1800;
2021-07-13 16:57:23;8998989300261;GUDANG GARAM SURYA 12 FILTER;1;18500;0;18500;17200;1300;
2021-07-13 17:26:37;8992959953310;SWEETY BRONZE M58;1;85000;0;85000;80304;4696;
2021-07-13 17:26:37;8996001318430;BETTER 1000;1;1000;0;1000;820;180;
2021-07-13 17:33:55;089686060362;POP MIE SOTO AYAM JUMBO;2;4500;0;9000;7666;1334;
2021-07-13 17:33:55;8995333060703;TERIGU KOMPAS 1KG;1;10500;0;10500;9816;684;
2021-07-13 17:33:55;089686041705;INDOMIE GORENG JUMBO;2;3500;0;7000;6286;714;
2021-07-13 17:33:55;089686043273;INDOMIE SAMBAL RICA;2;2700;0;5400;4904;496;
2021-07-13 17:33:55;8998866200325;MIE SEDAAP SOTO;2;2500;0;5000;3904;1096;
2021-07-13 17:38:58;8992694247163;ZWITSAL SOAP RICH N HON 70G;1;4000;0;4000;3410;590;
2021-07-13 17:38:58;8999999537180;CLEAR SHP LEMON FRESH 9 ML;1;10500;0;10500;9300;1200;
2021-07-13 17:38:58;COBRA;LEM TIKUS COBRA;1;20000;0;20000;15000;5000;
2021-07-13 17:38:58;8998866500708;FLORIDINA ORANGE;1;3000;0;3000;2500;500;
2021-07-13 17:38:58;8992696404441;BEAR BRAND 189ML;1;9000;0;9000;7887;1113;
2021-07-13 17:38:58;8992959953143;SWEEETY BRONZE XL20;1;45000;0;45000;42620;2380;
2021-07-13 17:38:58;8991102385060;TANGO WAFFLE CHOX;1;9000;0;9000;8498;502;
2021-07-13 17:38:58;089686043617;INDOMIE MIEGHETTI;1;2700;0;2700;2452;248;
2021-07-13 17:38:58;8998866200301;MIE SEDAAP GORENG;1;2500;0;2500;2023;477;
2021-07-13 17:38:58;8991102714846;MILKIDO CKLT;1;3000;0;3000;2153;847;
2021-07-13 17:53:12;8992959954058;SWEETY BRONZE NB 44;1;48000;0;48000;45682;2318;
2021-07-13 18:02:26;8994867007161;ROKOK PENA GOLD 20;1;17000;0;17000;15500;1500;
2021-07-13 18:32:50;8991111101330;JB OIL 200ML;1;28000;0;28000;26080;1920;
2021-07-13 18:39:35;BALON;BALON CABUT;1;1000;0;1000;900;100;
2021-07-13 18:58:15;8998866203104;MIE SEDAAP SINGAPORE;2;2500;0;5000;4532;468;
2021-07-13 18:58:15;089686043617;INDOMIE MIEGHETTI;1;2700;0;2700;2452;248;
2021-07-13 18:58:15;8998866106979;CIPTADENT TB CHARCOAL PROTEC;1;6000;0;6000;5250;750;
2021-07-13 18:58:15;089686041705;INDOMIE GORENG JUMBO;2;3500;0;7000;6286;714;
2021-07-13 18:58:15;089686049053;SARIMI PUAS;1;3000;0;3000;2400;600;
2021-07-13 18:59:31;KOPIKO;KOPIKO;5;250;0;1250;875;375;
2021-07-13 20:16:07;BRS5;BERAS BUMN 5KG;1;64000;0;64000;50500;13500;
2021-07-13 20:16:07;8994867000162;ROKOK PUNDIMAS KRETEK16;1;10000;0;10000;8600;1400;
2021-07-13 20:16:49;8996001600146;TEH PUCUK HARUM 350ML;2;3000;0;6000;4628;1372;
2021-07-13 20:16:49;8997011700123;BIHUN JAGUNG 300GR;1;6000;0;6000;4979;1021;
2021-07-13 20:16:49;8998866608459;POWDET DAIA PUTIH BAG 290GR;1;5000;0;5000;4450;550;
2021-07-13 20:51:19;8999909002821;MARLBORO BLACK 16;1;22000;0;22000;20850;1150;
2021-07-13 21:10:42;8998866202244;EKOMIE BUMBU KALDU AYAM;3;1000;0;3000;2394;606;
2021-07-13 21:10:42;8997013790108;BIMURA KACANG TELUR 25G;1;1000;0;1000;875;125;
2021-07-13 21:11:05;8999999516208;ROYCO FDS CHICKEN NEW 230G;1;10000;0;10000;9000;1000;
2021-07-13 21:11:05;8991188943062;SASA 250G;1;10000;0;10000;8500;1500;
2021-07-13 21:21:24;8991102228053;TEH GELAS BOTOL;1;3000;0;3000;1695;1305;
2021-07-13 21:21:24;8992775002582;DILAN CHOCO;1;2000;0;2000;1503;497;
2021-07-13 21:28:09;8997025914059;HATARI SEE HONG;1;6000;0;6000;4911;1089;
2021-07-13 21:28:09;8997025911058;HATARI SHP KELAPA;1;6000;0;6000;4911;1089;
2021-07-13 21:58:57;8999999706081;PEPSODENT WHITE 75G;1;5000;0;5000;3850;1150;
2021-07-13 21:58:57;8999999519711;PEPSODENT TB HIMALAYAN ROCK SALT;1;13300;0;13300;12045;1255;
2021-07-13 21:58:57;8998989300261;GUDANG GARAM SURYA 12 FILTER;1;18500;0;18500;17200;1300;
2021-07-13 21:59:58;MENTOS;MENTOS;13;250;0;3250;2275;975;
2021-07-13 22:04:24;RB;RED BOLD;1;19000;0;19000;17900;1100;
2021-07-13 22:24:21;9556001025272;NESCAFE LATTE 240ML;1;8500;0;8500;7834;666;
2021-07-13 22:24:21;8992761139018;ADES 600ML;1;3500;0;3500;2292;1208;
2021-07-13 22:24:21;8992775002582;DILAN CHOCO;1;2000;0;2000;1503;497;
2021-07-13 22:25:42;8998866201865;KRISBEE PILLOW CHOCOLAVA 120 GR;1;8000;0;8000;7250;750;
2021-07-13 22:30:21;8998866610087;JAVANA ORIGINAL 350ML;1;3000;0;3000;2150;850;
2021-07-13 22:30:21;MENTOS;MENTOS;4;250;0;1000;700;300;
2021-07-13 22:30:21;MILKITA;MILKITA;4;250;0;1000;800;200;
2021-07-14 12:06:47;8992761139018;ADES 600ML;1;3500;0;3500;2292;1208;
2021-07-14 12:28:35;8999999529918;CLEAR SPR FRESH APPLE 80ML;1;11300;0;11300;10120;1180;
2021-07-14 12:30:20;8998866500708;FLORIDINA ORANGE;1;3000;0;3000;2500;500;
2021-07-14 12:30:20;8998866501033;MINYAK GORENG SEDAAP POUCH 2L;1;29000;0;29000;27746;1254;
2021-07-14 13:20:46;8998866501033;MINYAK GORENG SEDAAP POUCH 2L;2;29000;0;58000;55492;2508;
2021-07-14 13:20:46;8998989300261;GUDANG GARAM SURYA 12 FILTER;1;18500;0;18500;17200;1300;
2021-07-14 13:35:20;8998866602273;HERSPROTEX SOFTCARE MAX;1;3500;0;3500;2950;550;
2021-07-14 14:38:33;8992959953167;SWEETY BRONZE S36+2;1;48000;0;48000;45682;2318;
2021-07-14 15:05:31;8996001305041;ROMA SANDWICH CKLT;1;7000;0;7000;5000;2000;
2021-07-14 15:05:31;8998866201964;MINYAK GORENG SABRINA 2L POUCH;1;28000;0;28000;26753;1247;
2021-07-14 15:05:31;RSK;ROTI SUSU KOTAK;1;7500;0;7500;6500;1000;
2021-07-14 15:10:07;8999999195649;SARI WANGI 25X1.86G;1;6000;0;6000;5050;950;
2021-07-14 15:33:26;8992753102204;BKM COKLAT 370G;2;11300;0;22600;19000;3600;
2021-07-14 15:33:26;8991102384841;WFR TANGO LONG CKLT 130G;2;5000;0;10000;8690;1310;
2021-07-14 15:33:26;8996001305058;ROMA SANDWICH KACANG;1;7000;0;7000;5000;2000;
2021-07-14 15:33:26;8996001305041;ROMA SANDWICH CKLT;1;7000;0;7000;5000;2000;
2021-07-14 15:33:26;RT MENARA;ROTI TAWAR MENARA;1;8000;0;8000;7200;800;
2021-07-14 18:48:24;8997009510123;ORANGE WATER;1;7000;0;7000;6089;911;
2021-07-14 18:48:24;8992957220087;COKLAT SINGA;1;2000;0;2000;1700;300;
2021-07-14 18:48:24;8992957220063;COKLAT BANGO;1;2000;0;2000;1700;300;
2021-07-14 18:48:24;COKLAT;COKLAT COIN;1;500;0;500;425;75;
2021-07-14 19:41:28;8991188943536;SASA SANTAN KELAPA 65ML;3;3000;0;9000;7311;1689;
2021-07-14 19:41:28;MILKITA;MILKITA;4;250;0;1000;800;200;
2021-07-14 20:10:15;8999909085114;SAMPOERNA KRETEK HIJAU 12;1;13000;0;13000;11650;1350;
2021-07-14 20:10:15;8999909096004;SAMPOERNA 16 FILTER;1;24000;0;24000;23000;1000;
2021-07-14 21:05:50;8998989500166;GUDANG GARAM MERAH BESAR 16KS;1;18000;0;18000;17000;1000;
2021-07-14 21:25:28;8994867007161;ROKOK PENA GOLD 20;1;17000;0;17000;15500;1500;
2021-07-14 21:25:28;8999909002821;MARLBORO BLACK 16;1;22000;0;22000;20850;1150;
2021-07-14 21:30:45;8992222091961;PUCELLE MIST COL SPRAY 75ML;1;13000;0;13000;11650;1350;
2021-07-14 22:32:55;8999909010567;234 DJI SAM SOE 16;2;22000;0;44000;43000;1000;
2021-07-14 22:35:23;8996001318430;BETTER 1000;1;1000;0;1000;820;180;
2021-07-14 22:35:23;8996001318980;BETTER 120G;1;6000;0;6000;5100;900;
2021-07-15 12:55:57;8998989500166;GUDANG GARAM MERAH BESAR 16KS;1;18000;0;18000;17000;1000;
2021-07-15 12:55:57;RB;RED BOLD;1;19000;0;19000;17900;1100;
2021-07-15 12:59:19;MILKITA;MILKITA;4;250;0;1000;800;200;
2021-07-15 13:00:14;8994907001272;KECAP ABC 700 ML;1;22500;0;22500;21000;1500;
2021-07-15 13:00:14;8994935000049;MINYAK GORENG DAMAI 5L;1;75000;0;75000;73780;1220;
2021-07-15 14:53:11;8999909096004;SAMPOERNA 16 FILTER;1;24000;0;24000;23000;1000;
2021-07-15 14:53:19;HT;HOT-HOT;2;500;0;1000;700;300;
2021-07-15 15:08:54;8999909002821;MARLBORO BLACK 16;1;22000;0;22000;20850;1150;
2021-07-15 15:26:42;8999999045920;LIFEBUOY TS TOTAL 10 110GR;1;15000;0;15000;14245;755;
2021-07-15 16:04:56;8992959953334;SWEETY BRONZE XL42;2;80000;0;160000;150910;9090;
2021-07-15 16:04:56;711844120419;SAMBAL ABC 275 ML;1;12000;0;12000;10800;1200;
2021-07-15 16:04:56;8998866612173;SOKLIN SOFTERGENT PINK 770G & PIRING;1;18000;0;18000;16055;1945;
2021-07-15 16:04:56;8999999524722;SUNLIGHT LIME NEW PCH 435ML;1;10000;0;10000;9100;900;
2021-07-15 16:04:56;8993226112508;GARAM REFINA;1;3000;0;3000;2461;539;
2021-07-15 16:04:56;8998866200301;MIE SEDAAP GORENG;2;2500;0;5000;4046;954;
2021-07-15 16:04:56;8992775000076;GERY SNACK RING CKLT;1;2000;0;2000;1712;288;
2021-07-15 16:35:40;8998989500166;GUDANG GARAM MERAH BESAR 16KS;1;18000;0;18000;17000;1000;
2021-07-15 16:36:31;8994935000049;MINYAK GORENG DAMAI 5L;1;75000;0;75000;73780;1220;
2021-07-15 16:38:23;8992959971109;SFX COMFORT SLIM 36CM 12+1;1;17000;0;17000;15152;1848;
2021-07-15 16:39:43;JD VM;JD VANILLA MILKSHAKE;1;5000;0;5000;4300;700;
2021-07-15 16:40:29;8999999059781;SUNLIGHT LIME NEW POUCH 210ML;1;5000;0;5000;4300;700;
2021-07-15 16:42:23;8999908204202;MY BABY MINYAK TELON 60ML;1;18000;0;18000;16900;1100;
2021-07-15 16:57:05;8994867000179;ROKOK PENA MILD 16;1;14500;0;14500;13500;1000;
2021-07-15 17:00:11;8998989300261;GUDANG GARAM SURYA 12 FILTER;1;18500;0;18500;17200;1300;
2021-07-15 17:00:11;HT;HOT-HOT;1;500;0;500;350;150;
2021-07-15 17:28:03;8992959304235;SFX COMFORT SLIM 29CM 8S;1;8000;0;8000;7387;613;
2021-07-15 17:28:03;8991001111883;SILVERQUEEN CHUNKYBAR 33G;1;8000;0;8000;7150;850;
2021-07-15 17:29:50;ff;FULLO BLASTO;1;1000;0;1000;995;5;
2021-07-15 17:46:09;8993989311699;CLAS MILD 16 FILTER;1;23000;0;23000;21700;1300;
2021-07-15 18:21:46;8998866602556;NUVO FAMILY MERAH 76G;1;2000;0;2000;1820;180;
2021-07-15 18:21:46;8991001111883;SILVERQUEEN CHUNKYBAR 33G;1;8000;0;8000;7150;850;
2021-07-15 18:24:48;8996001440124;ENERGEN VANILA;15;1500;0;22500;17250;5250;
2021-07-15 18:24:48;089686021141;INTER MIE SOTO;5;1000;0;5000;4270;730;
2021-07-15 18:24:48;089686021127;INTER MIE KALDU;5;1000;0;5000;4065;935;
2021-07-15 18:40:08;8998866202244;EKOMIE BUMBU KALDU AYAM;1;1000;0;1000;798;202;
2021-07-15 19:11:04;8996001600146;TEH PUCUK HARUM 350ML;1;3000;0;3000;2314;686;
2021-07-15 19:13:57;8998866200578;MIE SEDAAP KARI KENTAL;1;2500;0;2500;2263;237;
2021-07-15 19:13:57;8997218380135;ICHITAN GREEN TEA;1;8000;0;8000;6583;1417;
2021-07-15 19:19:27;8999909085114;SAMPOERNA KRETEK HIJAU 12;1;13000;0;13000;11650;1350;
2021-07-15 19:46:40;8997028900837;SABUN PAPAYA;1;10000;0;10000;9375;625;
2021-07-15 19:46:40;8998866201865;KRISBEE PILLOW CHOCOLAVA 120 GR;1;8000;0;8000;7250;750;
2021-07-15 19:46:40;8999999031930;PEPSODENT TB TRIPLE CLEAN;1;3500;0;3500;2850;650;
2021-07-15 19:46:40;8999999037765;PEPSODENT WHITE 225G;1;12000;0;12000;10750;1250;
2021-07-15 19:46:40;8996001355237;SUPER STAR;1;11000;0;11000;9900;1100;
2021-07-15 19:46:40;8992761145026;SPRITE PET 250ML;1;3500;0;3500;2417;1083;
2021-07-15 19:46:40;8999999531508;MOLTO HYGIENE SC 10ML;24;500;0;12000;11520;480;
2021-07-15 19:46:40;8998866107495;ZINC HAIRFALL TREATH SHT 10ML;1;5000;0;5000;4500;500;
2021-07-15 19:46:40;8998866612173;SOKLIN SOFTERGENT PINK 770G & PIRING;1;18000;0;18000;16055;1945;
2021-07-15 20:13:27;8991102281430;PERMEN MINTZ DUOMINT;1;5000;0;5000;4000;1000;
2021-07-15 20:40:23;8999999530495;AXE HIGH HOLD MATTE WAX 75G;1;23200;0;23200;20845;2355;
2021-07-15 20:44:18;8998989110167;SURYA GUDANG GARAM 16 FILTER;1;25000;0;25000;23200;1800;
2021-07-15 20:52:19;6907992823621;JD CREAMY YOGURT;1;3000;0;3000;2600;400;
2021-07-15 20:52:19;8994867007161;ROKOK PENA GOLD 20;1;17000;0;17000;15500;1500;
2021-07-15 21:04:39;8997009510017;YOU C1000 LEMON;1;10000;0;10000;9166;834;
2021-07-15 21:22:56;8992775315057;GERY SALUT MALKIST COKLAT;1;6500;0;6500;5516;984;
2021-07-15 21:22:56;8992705025124;AGAR-AGAR SATELIT MERAH;1;3500;0;3500;2604;896;
2021-07-15 21:22:56;8999999531478;MOLTO BLACK PURPLE;1;5500;0;5500;4800;700;
2021-07-15 21:22:56;RT BAKPIA;ROTI BAKPIA;5;1000;0;5000;3750;1250;
2021-07-15 21:22:56;8992959953327;SWEETY BRONZE L52;1;85000;0;85000;80304;4696;
2021-07-15 21:22:56;8998866612173;SOKLIN SOFTERGENT PINK 770G & PIRING;1;18000;0;18000;16055;1945;
2021-07-15 21:22:56;8993379200886;SABUN HARMONY ORANGE 70G;1;2000;0;2000;1652;348;
2021-07-15 21:22:56;8993379200855;SABUN HARMONY STRAWBERRY 70G;1;2000;0;2000;1652;348;
2021-07-15 21:22:56;8994834003752;TICTIC;1;2000;0;2000;1700;300;
2021-07-15 21:22:56;8993083140058;BISKITOP COCONUT;2;27000;0;54000;50400;3600;
2021-07-15 21:22:56;8850007014478;JB POWDER ACTIVE FRESH 100G;1;7000;0;7000;6030;970;
2021-07-15 21:22:56;8996001312438;MALKIST CAPPUCINO SCT;3;1000;0;3000;2460;540;
2021-07-15 21:22:56;8998989500166;GUDANG GARAM MERAH BESAR 16KS;1;18000;0;18000;17000;1000;
2021-07-15 21:22:56;8997028590014;ARGUS 220ML;2;500;0;1000;604;396;
2021-07-15 21:22:56;RT 1000;ROTI 1000;7;1000;0;7000;5600;1400;
2021-07-15 21:22:56;8999801700030;SUSU FOYU;1;11500;0;11500;10450;1050;
2021-07-15 21:22:56;089686834055;FREISS JERUK;1;11000;0;11000;8750;2250;
2021-07-15 21:22:56;8998866202602;KRISBEE FRENCH FRIES 18GR;1;2000;0;2000;1500;500;
2021-07-15 21:22:56;8992775001691;GARUDA ROSTA WAGYU BEEF;2;8000;0;16000;14644;1356;
2021-07-15 21:22:56;VCL;VITAMIN C500 LEMON;3;1000;0;3000;1725;1275;
2021-07-15 21:22:56;8993083929905;BISKITOP WAFER;1;30000;0;30000;27000;3000;
2021-07-15 21:22:56;8993072254056;MELROSE COTTON BUDS KCL;3;3000;0;9000;7350;1650;
2021-07-15 21:22:56;123124;KOREK BIASA;2;2000;0;4000;3600;400;
2021-07-15 21:22:56;8992628020152;BIMOLI POUCH 2L;1;31000;0;31000;29800;1200;
2021-07-15 21:22:56;BALON;BALON CABUT;1;1000;0;1000;900;100;
2021-07-15 21:22:56;8992775318201;GERY SNACK BANTAL COKLAT;4;2000;0;8000;6848;1152;
2021-07-15 21:22:56;8850507002968;A1 KING TRUCK;1;16500;0;16500;15500;1000;
2021-07-15 21:22:56;8996001312582;MALKIST KELAPA KOPYOR SCT;2;1000;0;2000;1640;360;
2021-07-15 21:22:56;ROTI;ROTI 2000;6;2000;0;12000;10800;1200;
2021-07-15 21:22:56;8994907001272;KECAP ABC 700 ML;1;22500;0;22500;21000;1500;
2021-07-15 21:22:56;089686386127;BUMBU RACIK NASI GORENG SOSIS;2;2000;0;4000;3240;760;
2021-07-15 21:22:56;8999999059323;LIFEBUOY TS LEMONFRESH 75G;3;3000;0;9000;7920;1080;
2021-07-15 21:22:56;6907992823959;JD HAWTHORN BERRY;2;2000;0;4000;3400;600;
2021-07-15 21:22:56;6907992823829;JD MILKY MILK;1;3000;0;3000;2600;400;
2021-07-15 21:22:56;8998866608718;DAIA SOFTENER PINK;1;5000;0;5000;4450;550;
2021-07-15 21:22:56;8998866200561;EKOMIE SUPER 600GR;1;10000;0;10000;8615;1385;
2021-07-15 21:22:56;8994907000428;KECAP SACHET ABC;5;500;0;2500;1770;730;
2021-07-15 21:22:56;8998989300261;GUDANG GARAM SURYA 12 FILTER;1;18500;0;18500;17200;1300;
2021-07-15 21:22:56;8992696523067;MILO ACTVGO UHT 180ML;1;4500;0;4500;3515;985;
2021-07-15 21:22:56;8992959953112;SWEETY BRONZE S20;1;30000;0;30000;26540;3460;
2021-07-15 21:22:56;8995150109418;M+SUSU RASA MANGGA;1;5000;0;5000;4000;1000;
2021-07-15 21:22:56;8998866501033;MINYAK GORENG SEDAAP POUCH 2L;3;29000;0;87000;83238;3762;
2021-07-15 21:22:56;8996001305041;ROMA SANDWICH CKLT;1;7000;0;7000;5000;2000;
2021-07-15 21:22:56;711844340008;ABC TERASI;1;7000;0;7000;5800;1200;
2021-07-15 21:22:56;8997231980039;O`JELLY KONYAKU (MAXI APPLE STRAWBERRY);1;5000;0;5000;4620;380;
2021-07-15 21:22:56;089686021127;INTER MIE KALDU;2;1000;0;2000;1626;374;
2021-07-15 21:24:06;8992959953020;SWEETY BRONZE M1;2;3000;0;6000;5342;658;
2021-07-15 21:26:52;8992775318201;GERY SNACK BANTAL COKLAT;1;2000;0;2000;1712;288;
2021-07-15 21:26:52;8999999059781;SUNLIGHT LIME NEW POUCH 210ML;1;5000;0;5000;4300;700;
2021-07-15 21:26:52;8851019210193;POCKY CHOCO BANANA 47G;1;7300;0;7300;5671;1629;
2021-07-15 21:26:52;8998866609036;DAIA BUNGA GUSSET 565G;1;10000;0;10000;8700;1300;
2021-07-15 21:26:52;8999999538439;CLEAR SHP CSC UNISEX 55ML;1;5000;0;5000;3750;1250;
2021-07-15 21:26:52;CS;CONE SNACK;2;500;0;1000;1000;0;
2021-07-15 21:26:52;8996001304549;SLAI OLAI 1000;1;1000;0;1000;825;175;
2021-07-15 21:26:52;8998866808699;ROYALE PURPLE DAWN 13ML;1;5000;0;5000;4500;500;
2021-07-16 11:25:17;RT 1000;ROTI 1000;2;1000;0;2000;1600;400;
2021-07-16 11:39:51;089686041705;INDOMIE GORENG JUMBO;2;3500;0;7000;6286;714;
2021-07-16 12:21:29;ff;FULLO BLASTO;1;1000;0;1000;995;5;
2021-07-16 12:21:29;8992775002582;DILAN CHOCO;1;2000;0;2000;1503;497;
2021-07-16 12:21:29;ROTI;ROTI 2000;1;2000;0;2000;1800;200;
2021-07-16 12:21:29;8992628022156;BIMOLI KLASIK TOUCH 1 LT;1;16000;0;16000;14350;1650;
2021-07-16 12:21:29;8992775311325;GERY SNACK&SEREAL 100G;1;7000;0;7000;6012;988;
2021-07-16 12:21:29;8998989300261;GUDANG GARAM SURYA 12 FILTER;1;18500;0;18500;17200;1300;
2021-07-16 12:21:29;8998898830125;KKB ENER-G ANGGUR;1;5500;0;5500;4824;676;
2021-07-16 12:21:29;8996001600641;TORA CAPPUCINO;1;3500;0;3500;2750;750;
2021-07-16 12:21:29;34678;SENDAL JEPIT;1;15000;0;15000;13500;1500;
2021-07-16 12:21:29;8998866501033;MINYAK GORENG SEDAAP POUCH 2L;2;29000;0;58000;55492;2508;
2021-07-16 12:21:29;8992694247163;ZWITSAL SOAP RICH N HON 70G;1;4000;0;4000;3410;590;
2021-07-16 12:21:29;8998866608718;DAIA SOFTENER PINK;1;5000;0;5000;4450;550;
2021-07-16 12:21:29;8994935000070;MINYAK DUNIA 450 ML;1;7500;0;7500;6779;721;
2021-07-16 12:21:29;MOLTO PINK;MOLTO ALL IN ONE 11 ML;4;500;0;2000;1600;400;
2021-07-16 12:21:29;YP;YUPI;2;250;0;500;416;84;
2021-07-16 12:38:16;GL;GULA 1 LITER;1;11500;0;11500;10500;1000;
2021-07-16 12:38:16;8992959974001;SFX SIRIH SLIM 36CM 6+1;1;10000;0;10000;8315;1685;
2021-07-16 13:11:36;8998989500166;GUDANG GARAM MERAH BESAR 16KS;2;18000;0;36000;34000;2000;
2021-07-16 13:39:23;PUL;PULPEN;2;1500;0;3000;1666;1334;
2021-07-16 13:39:23;8993072254018;MELROSE COTTON BUDS BSR;1;5000;0;5000;4050;950;
2021-07-16 14:38:33;RT 1000;ROTI 1000;2;1000;0;2000;1600;400;
2021-07-16 14:38:33;8991102714846;MILKIDO CKLT;1;3000;0;3000;2153;847;
2021-07-16 14:38:33;8998866200851;NOODLE SEDAAP MIE BAKSO SPESIAL CUP 77 GR;2;4500;0;9000;7300;1700;
2021-07-16 15:14:53;8999909002821;MARLBORO BLACK 16;1;22000;0;22000;20850;1150;
2021-07-16 17:16:43;VTM;VITAMIN;1;500;0;500;425;75;
2021-07-16 17:16:43;MENTOS;MENTOS;2;250;0;500;350;150;
2021-07-16 17:25:54;8992761166038;MMP ORANGE 300ML;1;5000;0;5000;3750;1250;
2021-07-16 17:43:54;8998866200325;MIE SEDAAP SOTO;4;2500;0;10000;7808;2192;
2021-07-16 17:43:54;ROTI;ROTI 2000;2;2000;0;4000;3600;400;
2021-07-16 18:55:39;BG;BERAS GURIH PASAR RAME;1;60000;0;60000;56000;4000;
2021-07-16 18:55:39;8998866501033;MINYAK GORENG SEDAAP POUCH 2L;1;29000;0;29000;27746;1254;
2021-07-16 18:55:39;8996001305058;ROMA SANDWICH KACANG;1;7000;0;7000;5000;2000;
2021-07-16 19:09:12;TBR;TEPUNG BERAS ROSE BRAND;2;8000;0;16000;11600;4400;
2021-07-16 19:12:54;ff;FULLO BLASTO;1;1000;0;1000;995;5;
2021-07-16 19:12:54;8996001312438;MALKIST CAPPUCINO SCT;1;1000;0;1000;820;180;
2021-07-16 19:14:26;8992696523081;MILO UHT 110ML;1;2500;0;2500;1962;538;
2021-07-16 19:14:26;8992696422735;DNCO CKLT UHT 110ML;1;2500;0;2500;2041;459;
2021-07-16 19:14:26;CS;CONE SNACK;4;500;0;2000;2000;0;
2021-07-16 20:01:37;8998866203104;MIE SEDAAP SINGAPORE;3;2500;0;7500;6798;702;
2021-07-16 20:01:37;8998989300261;GUDANG GARAM SURYA 12 FILTER;1;18500;0;18500;17200;1300;
2021-07-16 20:07:49;089686535143;SUN KACANG HIJAU;1;8500;0;8500;7410;1090;
2021-07-16 20:28:20;8993989311699;CLAS MILD 16 FILTER;1;23000;0;23000;21700;1300;
2021-07-16 20:46:57;8851019210193;POCKY CHOCO BANANA 47G;1;7300;0;7300;5671;1629;
2021-07-16 20:50:05;8998989110167;SURYA GUDANG GARAM 16 FILTER;1;25000;0;25000;23200;1800;
2021-07-16 20:54:51;8996001600146;TEH PUCUK HARUM 350ML;1;3000;0;3000;2314;686;
2021-07-16 20:59:17;8997009510017;YOU C1000 LEMON;1;10000;0;10000;9166;834;
2021-07-16 21:29:54;8999999059781;SUNLIGHT LIME NEW POUCH 210ML;1;5000;0;5000;4300;700;
2021-07-16 21:29:54;8999999538422;CLEAR SHP ICM UNISEX 55 ML;1;5000;0;5000;3750;1250;
2021-07-16 21:29:54;8992759120264;LARISST 220;1;10000;0;10000;9200;800;
2021-07-16 21:29:54;8992761164478;FRESTEA MILK TEA;1;8000;0;8000;6575;1425;
2021-07-16 21:29:54;8998866106979;CIPTADENT TB CHARCOAL PROTEC;1;6000;0;6000;5250;750;
2021-07-17 12:38:08;6907992823621;JD CREAMY YOGURT;1;3000;0;3000;2600;400;
2021-07-17 12:58:27;8995150101719;M+SUSU RASA SODA GEMBIRA;1;5000;0;5000;4000;1000;
2021-07-17 13:01:35;8994867000162;ROKOK PUNDIMAS KRETEK16;1;10000;0;10000;8600;1400;
2021-07-17 14:52:45;8997028590014;ARGUS 220ML;4;500;0;2000;1208;792;
2021-07-17 15:42:16;8998866202930;SEDAAP AYAM JERIT CUP;1;4500;0;4500;3738;762;
2021-07-17 15:42:16;8992761145026;SPRITE PET 250ML;1;3500;0;3500;2417;1083;
2021-07-17 16:37:34;8996001302316;MALKIST ABON SCT;1;1000;0;1000;840;160;
2021-07-17 16:40:45;8996001304020;SLAI OLAI NANAS;1;8500;0;8500;7700;800;
2021-07-17 16:40:45;8999999059309;LIFEBUOY TS TOTAL 10 DG 75G;1;3000;0;3000;2640;360;
2021-07-17 16:40:45;RT BAKPIA;ROTI BAKPIA;2;1000;0;2000;1500;500;
2021-07-17 16:42:39;8991001121400;SILVERQUEEN ALMOND 65G;1;15000;0;15000;13200;1800;
2021-07-17 17:42:40;ROTI;ROTI 2000;1;2000;0;2000;1800;200;
2021-07-17 17:42:40;8992775002582;DILAN CHOCO;1;2000;0;2000;1503;497;
2021-07-17 17:42:40;8999999502003;SARIMURNI RL RB 1,8G;2;1500;0;3000;2414;586;
2021-07-17 17:42:40;8992759120264;LARISST 220;1;10000;0;10000;9200;800;
2021-07-17 18:18:10;711844110144;KECAP ABC 225 ML;1;9000;0;9000;8200;800;
2021-07-17 18:18:10;8997210107877;VORTEX SMART 3;1;5000;0;5000;4750;250;
2021-07-17 18:18:10;8998989500166;GUDANG GARAM MERAH BESAR 16KS;1;18000;0;18000;17000;1000;
2021-07-17 19:06:53;8992959002032;SWEETY SILVER PANTS L 36;1;72000;0;72000;68182;3818;
2021-07-17 19:28:15;8998989110167;SURYA GUDANG GARAM 16 FILTER;1;25000;0;25000;23200;1800;
2021-07-17 19:35:25;711844110144;KECAP ABC 225 ML;1;9000;0;9000;8200;800;
2021-07-17 19:35:25;8998866501033;MINYAK GORENG SEDAAP POUCH 2L;1;29000;0;29000;27746;1254;
2021-07-17 19:35:25;8999999059781;SUNLIGHT LIME NEW POUCH 210ML;1;5000;0;5000;4300;700;
2021-07-17 19:35:25;8999999559045;SUNLIGHT LIME CREAM 110G;1;2000;0;2000;1800;200;
2021-07-17 19:35:25;GL;GULA 1 LITER;1;11500;0;11500;10500;1000;
2021-07-17 19:51:57;089686043204;INDOMIE MIE ACEH;2;2700;0;5400;4904;496;
2021-07-17 19:51:57;8998866200325;MIE SEDAAP SOTO;3;2500;0;7500;5856;1644;
2021-07-17 19:51:57;8992388111145;MIE ABC SELERA PEDAS- SUP TOMAT PEDAS;2;2500;0;5000;4046;954;
2021-07-17 19:51:57;089686041705;INDOMIE GORENG JUMBO;1;3500;0;3500;3143;357;
2021-07-17 19:51:57;089686044249;SUPERMI NUTRIMI STEAK AYAM;1;3500;0;3500;2800;700;
2021-07-17 19:51:57;8998866202770;MIE SEDAAP SALERO PADANG;2;2500;0;5000;4724;276;
2021-07-17 19:51:57;8998866200561;EKOMIE SUPER 600GR;1;10000;0;10000;8615;1385;
2021-07-17 19:51:57;8993007003063;ENAAK 500G;1;11000;0;11000;9625;1375;
2021-07-17 19:51:57;8992753100101;BKM FULL CREAM GOLD 370;1;15000;0;15000;14000;1000;
2021-07-17 19:51:57;SF TAWAR KUPAS;SAFFANAH ROTI TAWAR KUPAS;1;10000;0;10000;9000;1000;
2021-07-17 19:51:57;8999909004221;SAMPOERNA ULTRAMILD 16;1;22000;0;22000;20350;1650;
2021-07-17 20:03:46;GL;GULA 1 LITER;4;11500;0;46000;42000;4000;
2021-07-17 20:03:46;6907992825076;JD WATERMELON APPLE;1;2000;0;2000;1700;300;
2021-07-17 20:03:46;ROTI;ROTI 2000;2;2000;0;4000;3600;400;
2021-07-17 20:03:46;RT 1000;ROTI 1000;1;1000;0;1000;800;200;
2021-07-17 20:03:46;8993176110074;MINYAK KAYU PUTIH 60ML;1;20000;0;20000;17333;2667;
2021-07-17 20:03:46;8999999544126;FAIR&LOVELY BB CREAM 15 MG;1;20000;0;20000;17625;2375;
2021-07-17 20:03:46;8999999558086;RINSO MOLTO FERFUME ESSENSE PWD 44G;2;1000;0;2000;1610;390;
2021-07-17 20:03:46;8994867000162;ROKOK PUNDIMAS KRETEK16;1;10000;0;10000;8600;1400;
2021-07-17 20:03:46;8999999059323;LIFEBUOY TS LEMONFRESH 75G;1;3000;0;3000;2640;360;
2021-07-17 20:03:46;8999999059309;LIFEBUOY TS TOTAL 10 DG 75G;1;3000;0;3000;2640;360;
2021-07-17 20:03:46;MLTO PINK;MOLTO ALL IN ONE;6;1000;0;6000;4800;1200;
2021-07-17 20:03:46;8999999059781;SUNLIGHT LIME NEW POUCH 210ML;1;5000;0;5000;4300;700;
2021-07-17 20:03:46;TEMBAK;TEMBAK SNIPPER;1;3500;0;3500;2500;1000;
2021-07-17 20:03:46;8997012321174;CHILLI-QU;1;1000;0;1000;800;200;
2021-07-17 20:03:46;8998866601429;POWDET DAIA BUNGA BAG 290GR;1;5000;0;5000;4450;550;
2021-07-17 20:03:46;TBR;TEPUNG BERAS ROSE BRAND;1;8000;0;8000;5800;2200;
2021-07-17 20:03:46;8998866501026;MINYAK GORENG SEDAAP POUCH 1 L;1;15000;0;15000;14110;890;
2021-07-17 20:03:46;8999909002821;MARLBORO BLACK 16;1;22000;0;22000;20850;1150;
2021-07-17 20:03:46;SF SOSIS;SAFFANAH ROTI SOSIS;1;6000;0;6000;5500;500;
2021-07-17 20:03:46;8999909010567;234 DJI SAM SOE 16;1;22000;0;22000;21500;500;
2021-07-17 20:03:46;6907992823843;JD MOCHA CRISPY;1;5000;0;5000;4400;600;
2021-07-17 20:03:46;8992628020152;BIMOLI POUCH 2L;1;31000;0;31000;29800;1200;
2021-07-17 20:03:46;8992933213119;NUTRIJELL LECI;1;6000;0;6000;5041;959;
2021-07-17 20:03:46;8997013790108;BIMURA KACANG TELUR 25G;1;1000;0;1000;875;125;
2021-07-17 20:03:46;JGR SHN;JOGER SHINY SACHET;1;500;0;500;437;63;
2021-07-17 20:03:46;8992775318201;GERY SNACK BANTAL COKLAT;1;2000;0;2000;1712;288;
2021-07-17 20:03:46;8992933243116;NUTRIJELLL KELAPA;2;6000;0;12000;9666;2334;
2021-07-17 20:03:46;711844150027;ABC NANAS;1;13000;0;13000;12241;759;
2021-07-17 20:04:32;8992959073209;HN PANTS XL 20;1;40000;0;40000;37425;2575;
2021-07-17 20:08:10;8999908204202;MY BABY MINYAK TELON 60ML;1;18000;0;18000;16900;1100;
2021-07-17 20:09:07;8992725910417;LISTERINE FRESH BURST 100ML;1;7500;0;7500;6800;700;
2021-07-17 20:09:07;8991001111883;SILVERQUEEN CHUNKYBAR 33G;1;8000;0;8000;7150;850;
2021-07-17 20:09:07;SF SOSIS;SAFFANAH ROTI SOSIS;1;6000;0;6000;5500;500;
2021-07-17 20:09:07;SF GULUNG;SAFFANAH ROTI GULUNG;1;6000;0;6000;5500;500;
2021-07-17 20:45:01;8994867000162;ROKOK PUNDIMAS KRETEK16;1;10000;0;10000;8600;1400;
2021-07-17 21:15:22;8999908389008;HEMAVITON C1000;1;8000;0;8000;6000;2000;
2021-07-17 21:15:58;JGR SHN;JOGER SHINY SACHET;4;500;0;2000;1748;252;
2021-07-17 22:05:58;8998866202343;MIE SEDAAP KOREAN SPICY;2;2500;0;5000;4046;954;
2021-07-18 11:53:41;8998866501033;MINYAK GORENG SEDAAP POUCH 2L;1;29000;0;29000;27746;1254;
2021-07-18 11:53:41;8997011700123;BIHUN JAGUNG 300GR;1;6000;0;6000;4979;1021;
2021-07-18 11:56:58;8991102714846;MILKIDO CKLT;1;3000;0;3000;2153;847;
2021-07-18 12:14:21;8997012321174;CHILLI-QU;1;1000;0;1000;800;200;
2021-07-18 12:17:42;8997012321204;MAXX BUMBU BALADO;1;5000;0;5000;4100;900;
2021-07-18 12:17:42;SF SOSIS;SAFFANAH ROTI SOSIS;1;6000;0;6000;5500;500;
2021-07-18 12:17:42;TUSTEL;TUSUK TELINGA;1;1000;0;1000;833;167;
2021-07-18 12:17:42;8992696405417SCT;DNCO INSTANT 27G SCT;1;3500;0;3500;2957;543;
2021-07-18 12:17:42;8992775318201;GERY SNACK BANTAL COKLAT;1;2000;0;2000;1712;288;
2021-07-18 12:17:42;6907992823843;JD MOCHA CRISPY;1;5000;0;5000;4400;600;
2021-07-18 12:17:42;8996001414002SCT;TB CAPPUCINO SCT;3;1500;0;4500;4050;450;
2021-07-18 12:17:42;JGR SHN;JOGER SHINY SACHET;1;500;0;500;437;63;
2021-07-18 12:17:42;8997028590014;ARGUS 220ML;2;500;0;1000;604;396;
2021-07-18 12:17:42;MILKITA;MILKITA;4;250;0;1000;800;200;
2021-07-18 12:17:42;11222;LEM KOREA;1;10000;0;10000;8000;2000;
2021-07-18 12:17:42;8999909002821;MARLBORO BLACK 16;1;22000;0;22000;20850;1150;
2021-07-18 12:36:45;9556001004673;MILO NESTLE MALAYSIA ACTIVE GO;1;85000;0;85000;80000;5000;
2021-07-18 12:36:45;711844110021;KECAP ABC 600 ML;1;22000;0;22000;20700;1300;
2021-07-18 12:36:45;8997021300092;LARISSA BAWANG 250GR;1;5500;0;5500;5125;375;
2021-07-18 12:36:45;8998866607315;SOKLIN SOFTERGENT SAKURA 770G & PIRING;2;18000;0;36000;33360;2640;
2021-07-18 12:36:45;8850507002968;A1 KING TRUCK;1;16500;0;16500;15500;1000;
2021-07-18 12:36:45;TEMBAK;TEMBAK SNIPPER;1;3500;0;3500;2500;1000;
2021-07-18 14:21:58;8994867000162;ROKOK PUNDIMAS KRETEK16;1;10000;0;10000;8600;1400;
2021-07-18 14:29:33;6907992823621;JD CREAMY YOGURT;1;3000;0;3000;2600;400;
2021-07-18 14:29:33;BALON;BALON CABUT;1;1000;0;1000;900;100;
2021-07-18 14:29:33;6907992823829;JD MILKY MILK;1;3000;0;3000;2600;400;
2021-07-18 14:29:33;HT;HOT-HOT;1;500;0;500;350;150;
2021-07-18 14:29:33;6907992823867;JD CRUNCHY CHOCOLATE MALT;1;5500;0;5500;4700;800;
2021-07-18 14:51:49;8998866501026;MINYAK GORENG SEDAAP POUCH 1 L;12;15000;0;180000;169320;10680;
2021-07-18 14:51:49;8998866106979;CIPTADENT TB CHARCOAL PROTEC;1;6000;0;6000;5250;750;
2021-07-18 14:51:49;VCL;VITAMIN C500 LEMON;5;1000;0;5000;2875;2125;
2021-07-18 14:51:49;8999908389008;HEMAVITON C1000;1;8000;0;8000;6000;2000;
2021-07-18 14:52:54;8994037800042;WENIS MERAH;1;8000;0;8000;6500;1500;
2021-07-18 14:52:54;8992775211434;PILUS GARUDA SAPI PANGGANG;1;5000;0;5000;4810;190;
2021-07-18 14:53:55;6907992823867;JD CRUNCHY CHOCOLATE MALT;1;5500;0;5500;4700;800;
2021-07-18 14:53:55;089686060126;POP MIE BASO JUMBO;2;4500;0;9000;7666;1334;
2021-07-18 14:56:22;8992388111145;MIE ABC SELERA PEDAS- SUP TOMAT PEDAS;4;2500;0;10000;8092;1908;
2021-07-18 14:56:22;8991102022347;SIKAT GIGI FORMULA RIPPLE;1;5000;0;5000;4583;417;
2021-07-18 14:56:22;711844610064;LARISSA SINGKONG 250GR;1;5000;0;5000;4545;455;
2021-07-18 14:56:22;8999999034726;PONDS MEN WHITE BOOST 50G;1;18500;0;18500;17160;1340;
2021-07-18 14:56:22;8999999538422;CLEAR SHP ICM UNISEX 55 ML;1;5000;0;5000;3750;1250;
2021-07-18 14:56:22;8999999401023;MOLTO PEWANGI PINK 820ML;1;12500;0;12500;11275;1225;
2021-07-18 14:58:44;GL;GULA 1 LITER;2;11500;0;23000;21000;2000;
2021-07-18 14:58:44;8999999042592;RINSO MOLTO PERFUME ESSENSE LIQ 4OML;1;5500;0;5500;4817;683;
2021-07-18 14:58:44;8999999042646;RINSO MOLTO ROSE FRESH LIQ 40ML;1;6000;0;6000;4817;1183;
2021-07-18 14:58:44;8992761111533;SPRITE SLIM CAM250ML;1;5000;0;5000;3750;1250;
2021-07-18 14:58:44;8997028900837;SABUN PAPAYA;1;10000;0;10000;9375;625;
2021-07-18 15:40:59;CLUB;AIR CLUB;1;3000;0;3000;1452;1548;
2021-07-18 16:20:19;8998866609494;SOKLIN SOFTERGEN 280G BIRU;1;5000;0;5000;4425;575;
2021-07-18 16:20:19;8998866611725;EKONOMI PENCUCI PIRING  LIQ 290ML;1;5000;0;5000;4200;800;
2021-07-18 16:20:19;8998866501026;MINYAK GORENG SEDAAP POUCH 1 L;1;15000;0;15000;14110;890;
2021-07-18 16:20:19;WC;WAFER COKELAT MADE;1;1000;0;1000;800;200;
2021-07-18 16:20:19;JL;JELLY;2;500;0;1000;800;200;
2021-07-18 16:28:24;8999999030179;PEPSODENT ACTION 123 COMPLETE 75G;1;6700;0;6700;5170;1530;
2021-07-18 16:31:00;8999999037765;PEPSODENT WHITE 225G;1;12000;0;12000;10750;1250;
2021-07-18 16:31:00;8992775211434;PILUS GARUDA SAPI PANGGANG;1;5000;0;5000;4810;190;
2021-07-18 16:31:00;8998866501026;MINYAK GORENG SEDAAP POUCH 1 L;1;15000;0;15000;14110;890;
2021-07-18 17:05:29;8998009010569;ULTRA CHO 200;2;5000;0;10000;7660;2340;
2021-07-18 17:05:29;8992696523067;MILO ACTVGO UHT 180ML;1;4500;0;4500;3515;985;
2021-07-18 17:05:29;8992696422735;DNCO CKLT UHT 110ML;1;2500;0;2500;2041;459;
2021-07-18 17:05:29;6907992823669;JD MILKY STRAW;2;3000;0;6000;5200;800;
2021-07-18 17:05:29;6907992825076;JD WATERMELON APPLE;1;2000;0;2000;1700;300;
2021-07-18 17:05:29;6907992823829;JD MILKY MILK;1;3000;0;3000;2600;400;
2021-07-18 17:14:55;8999999195649;SARI WANGI 25X1.86G;2;6000;0;12000;10100;1900;
2021-07-18 17:14:55;6907992823935;JD SWEETCORN;1;3500;0;3500;3000;500;
2021-07-18 17:55:14;8993989311699;CLAS MILD 16 FILTER;1;23000;0;23000;21700;1300;
2021-07-18 18:34:18;089686043273;INDOMIE SAMBAL RICA;2;2700;0;5400;4904;496;
2021-07-18 18:36:28;8997009510017;YOU C1000 LEMON;1;10000;0;10000;9166;834;
2021-07-18 18:36:28;8992696404441;BEAR BRAND 189ML;1;9000;0;9000;7887;1113;
2021-07-18 18:36:28;SF KEMASAN;SAFFANAH ROTI KEMASAN;1;3500;0;3500;3000;500;
2021-07-18 18:38:33;PD;PENDEKAR;2;500;0;1000;700;300;
2021-07-18 18:38:33;MILKITA;MILKITA;2;250;0;500;400;100;
2021-07-18 18:38:33;VTM;VITAMIN;1;500;0;500;425;75;
2021-07-18 18:44:54;8998866202244;EKOMIE BUMBU KALDU AYAM;1;1000;0;1000;798;202;
2021-07-18 19:03:45;8991002105409;KOPI KAPAL API;1;20000;0;20000;18888;1112;
2021-07-18 19:03:45;8992761139018;ADES 600ML;1;3500;0;3500;2292;1208;
2021-07-18 19:03:45;8992761145033;FANTA STRAW PET 250ML;1;3500;0;3500;2417;1083;
2021-07-18 19:03:45;TBR;TEPUNG BERAS ROSE BRAND;2;8000;0;16000;11600;4400;
2021-07-18 19:03:45;8996001414002SCT;TB CAPPUCINO SCT;1;1500;0;1500;1350;150;
2021-07-18 20:02:59;8999999538453;SUNSILK SHP SOFT AND  SMOOTH 55 ML;1;5000;0;5000;3750;1250;
2021-07-18 20:02:59;8998866105651;EMERON LOVELY NOUR&BRIGHT 200ML;1;7500;0;7500;6475;1025;
2021-07-18 20:02:59;8999999004248;CITRA NATURAL WHITE SCRUB 200ML;1;16200;0;16200;14550;1650;
2021-07-18 20:02:59;8996001410042GT;TB TORA MOKA;1;13000;0;13000;8700;4300;
2021-07-18 20:04:39;8995333060772;TERIGU GATOT KACA 500GR;1;4500;0;4500;4065;435;
2021-07-18 20:04:39;8991111112084;C&C DAILY PORE CLEANSER 50G;1;14000;0;14000;12900;1100;
2021-07-18 20:04:39;VCL;VITAMIN C500 LEMON;2;1000;0;2000;1150;850;
2021-07-18 20:41:36;ARG;ARGUS 220ML;1;15000;0;15000;13300;1700;
2021-07-18 20:42:42;GL;GULA 1 LITER;1;11500;0;11500;10500;1000;
2021-07-18 20:42:42;ROTI;ROTI 2000;3;2000;0;6000;5400;600;
2021-07-18 20:54:38;8998866202343;MIE SEDAAP KOREAN SPICY;1;2500;0;2500;2023;477;
2021-07-18 20:54:38;8992775002735;CHOCOLATOS SUSU COKELAT;1;4000;0;4000;3520;480;
2021-07-18 21:40:03;8998989110167;SURYA GUDANG GARAM 16 FILTER;1;25000;0;25000;23200;1800;
2021-07-18 21:51:13;8998866200301;MIE SEDAAP GORENG;2;2500;0;5000;4046;954;
2021-07-18 21:51:13;089686010190;INDOMIE KARI AYAM;1;2800;0;2800;2522;278;
2021-07-18 22:11:12;8994867007161;ROKOK PENA GOLD 20;1;17000;0;17000;15500;1500;
2021-07-18 23:04:17;089686048704;SARIMIE GORENG AYAM KCP ISI 2;2;3500;0;7000;6240;760;
2021-07-18 23:04:17;089686044249;SUPERMI NUTRIMI STEAK AYAM;2;3500;0;7000;5600;1400;
2021-07-18 23:04:17;8998866200325;MIE SEDAAP SOTO;2;2500;0;5000;3904;1096;
2021-07-18 23:04:17;711844120433;SAMBAL ABC 600 ML;1;22000;0;22000;20300;1700;
2021-07-18 23:04:17;8992628020152;BIMOLI POUCH 2L;1;31000;0;31000;29800;1200;
2021-07-18 23:04:17;GL;GULA 1 LITER;2;11500;0;23000;21000;2000;
2021-07-18 23:04:17;8999999524722;SUNLIGHT LIME NEW PCH 435ML;1;10000;0;10000;9100;900;
2021-07-18 23:05:48;YP;YUPI;8;250;0;2000;1664;336;
2021-07-18 23:10:51;089686021219;INTER MIE GORENG;1;1000;0;1000;885;115;
2021-07-18 23:10:51;089686021127;INTER MIE KALDU;2;1000;0;2000;1626;374;
2021-07-19 15:18:34;AMPLOP;AMPLOP;1;250;0;250;140;110;
2021-07-19 15:18:34;8992959953334;SWEETY BRONZE XL42;1;80000;0;80000;75455;4545;
2021-07-19 15:18:34;8992761122331;FRESTEA APPEL 500ML;1;6500;0;6500;4708;1792;
2021-07-19 15:18:34;8991102384841;WFR TANGO LONG CKLT 130G;1;5000;0;5000;4345;655;
2021-07-19 15:18:34;8991102989381;TANGO LONG BUBBLEGUM 130G;1;5000;0;5000;4345;655;
2021-07-19 15:18:34;8992759120264;LARISST 220;1;10000;0;10000;9200;800;
2021-07-19 15:18:35;8998866202664;POTABEE WAGYU BEEF STEAK 68 GR;1;8000;0;8000;7200;800;
2021-07-19 15:18:35;8998866201469;POTABEE REGULER BBQ BEEF 68 GR;1;8000;0;8000;7200;800;
2021-07-19 15:18:35;8998866202619;MIE SEDAAP KOREAN SPICY SOUP;2;2500;0;5000;4546;454;
2021-07-19 15:18:35;8998866200301;MIE SEDAAP GORENG;7;2500;0;17500;14161;3339;
2021-07-19 15:18:35;8999999192150;ROYCO FDS CHICKEN 100GR;1;5000;0;5000;4300;700;
2021-07-19 15:18:35;711844110021;KECAP ABC 600 ML;1;22000;0;22000;20700;1300;
2021-07-19 15:18:35;8999999524838;SUNLIGHT MINT POUCH 755ML;1;17000;0;17000;15400;1600;
2021-07-19 15:18:35;8999999534769;PEPSODENT ACTION123 CHARCOAL 160G;1;16800;0;16800;15345;1455;
2021-07-19 15:18:35;8999999551223;RINSO ACTIVE FRESH LIQ 700ML;1;19500;0;19500;17900;1600;
2021-07-19 15:18:35;8996001355008;BENG-BENG SP20G;1;29000;0;29000;26500;2500;
2021-07-19 15:18:35;8994867007161;ROKOK PENA GOLD 20;1;17000;0;17000;15500;1500;
2021-07-19 15:48:18;8998866202435;JAPOTA UMAMI JAPANESE SEAWEED 35GR;1;5000;0;5000;4150;850;
2021-07-19 15:48:18;8998866201865;KRISBEE PILLOW CHOCOLAVA 120 GR;1;8000;0;8000;7250;750;
2021-07-19 15:48:18;8992761139018;ADES 600ML;1;3500;0;3500;2292;1208;
2021-07-19 15:48:18;MILKITA;MILKITA;8;250;0;2000;1600;400;
2021-07-19 16:42:30;ARG;ARGUS 220ML;2;15000;0;30000;26600;3400;
2021-07-19 17:06:50;8993989311699;CLAS MILD 16 FILTER;1;23000;0;23000;21700;1300;
2021-07-19 17:06:50;8999999534097;PEPSODENT PGB FCM 75G;1;5000;0;5000;3850;1150;
2021-07-19 17:48:02;123124;KOREK BIASA;1;2000;0;2000;1800;200;
2021-07-19 17:48:02;8999999538422;CLEAR SHP ICM UNISEX 55 ML;1;5000;0;5000;3750;1250;
2021-07-19 17:55:45;8992761145026;SPRITE PET 250ML;2;3500;0;7000;4834;2166;
2021-07-19 17:55:45;8992761145033;FANTA STRAW PET 250ML;2;3500;0;7000;4834;2166;
2021-07-19 18:01:33;8999999707859;CLOSEUP GREEN 160G;1;15000;0;15000;13600;1400;
2021-07-19 18:01:33;8999999055769;FAIR&LOVELY MVIT FC FOAM 50 G;1;12500;0;12500;11180;1320;
2021-07-19 18:01:33;8992856892507;VITALIS PINK 120ML;1;22000;0;22000;19900;2100;
2021-07-19 18:01:33;HT;HOT-HOT;1;500;0;500;350;150;
2021-07-19 18:15:23;8996001600399;LE MINERAL 1500ML;2;5000;0;10000;8084;1916;
2021-07-19 18:15:23;PD;PENDEKAR;1;500;0;500;350;150;
2021-07-19 18:15:23;MOBIL;GULA GULA HP;1;2000;0;2000;1700;300;
2021-07-19 18:15:50;ARG;ARGUS 220ML;1;14500;0;14500;13300;1200;
2021-07-19 18:24:16;123124;KOREK BIASA;1;2000;0;2000;1800;200;
2021-07-19 18:24:16;8998989300261;GUDANG GARAM SURYA 12 FILTER;1;18500;0;18500;17200;1300;
2021-07-19 18:24:16;8992761111533;SPRITE SLIM CAM250ML;2;5000;0;10000;7500;2500;
2021-07-19 18:24:16;ROTI;ROTI 2000;4;2000;0;8000;7200;800;
2021-07-19 18:39:00;8991102987639;WFR TANGO LONG VNL 130G;1;5000;0;5000;3773;1227;
2021-07-19 18:57:37;GL;GULA 1 LITER;2;11500;0;23000;21000;2000;
2021-07-19 18:57:37;8992979130012;TOTAL LEMON SOFTENER;1;13000;0;13000;11532;1468;
2021-07-19 19:08:22;ARG;ARGUS 220ML;1;14500;0;14500;13300;1200;
2021-07-19 19:08:22;711844110113;KECAP ABC 135 ML;1;7000;0;7000;6400;600;
2021-07-19 19:22:53;MENTOS;MENTOS;6;250;0;1500;1050;450;
2021-07-19 19:22:53;MILKITA;MILKITA;2;250;0;500;400;100;
2021-07-19 19:45:14;8992761111533;SPRITE SLIM CAM250ML;1;5000;0;5000;3750;1250;
2021-07-19 20:41:23;PD;PENDEKAR;2;500;0;1000;700;300;
2021-07-19 20:41:23;HT;HOT-HOT;2;500;0;1000;700;300;
2021-07-19 20:59:10;089686834055;FREISS JERUK;2;11000;0;22000;17500;4500;
2021-07-19 21:14:52;8998866200301;MIE SEDAAP GORENG;1;2500;0;2500;2023;477;
2021-07-19 21:27:37;8991102714846;MILKIDO CKLT;2;3000;0;6000;4306;1694;
2021-07-19 21:38:59;8992959953099;SWEETY BRONZE XL7;1;16000;0;16000;15190;810;
2021-07-19 21:45:02;8992761136178;SPRITE 1L;5;10000;0;50000;45000;5000;
2021-07-19 22:24:03;8992761136178;SPRITE 1L;2;10000;0;20000;18000;2000;
2021-07-19 22:24:03;ROTI;ROTI 2000;1;2000;0;2000;1800;200;
2021-07-19 22:24:03;8992775318201;GERY SNACK BANTAL COKLAT;1;2000;0;2000;1712;288;
2021-07-19 22:24:03;8992761139018;ADES 600ML;1;3500;0;3500;2292;1208;
2021-07-19 22:28:12;ARG;ARGUS 220ML;1;14500;0;14500;13300;1200;
2021-07-20 17:30:31;711844110083;KECAP ABC 275 ML;1;14500;0;14500;13400;1100;
2021-07-20 17:30:31;711844120419;SAMBAL ABC 275 ML;1;12000;0;12000;10800;1200;
2021-07-22 12:19:31;BALON;BALON CABUT;5;1000;0;5000;4500;500;
2021-07-22 12:47:54;8991102714846;MILKIDO CKLT;1;3000;0;3000;2153;847;
2021-07-22 12:47:54;8992761145026;SPRITE PET 250ML;1;3500;0;3500;2417;1083;
2021-07-22 12:47:54;8992761145033;FANTA STRAW PET 250ML;1;3500;0;3500;2417;1083;
2021-07-22 12:47:54;8998866200813;NOODLE SEDAAP MIE GORENG CUP 85 GR;1;5000;0;5000;3917;1083;
2021-07-22 12:47:54;089686043204;INDOMIE MIE ACEH;2;2700;0;5400;4904;496;
2021-07-22 12:47:54;8992761136161;COCACOLA 1L;2;10000;0;20000;18000;2000;
2021-07-22 12:56:08;8999999390198;SUNLIGHT LIME NEW POUCH 755ML;2;17000;0;34000;30800;3200;
2021-07-22 12:56:08;ROTI;ROTI 2000;6;2000;0;12000;10800;1200;
2021-07-22 12:56:08;8991102987639;WFR TANGO LONG VNL 130G;3;5000;0;15000;11319;3681;
2021-07-22 12:56:08;711844110083;KECAP ABC 275 ML;1;14500;0;14500;13400;1100;
2021-07-22 12:56:08;ARG;ARGUS 220ML;1;14500;0;14500;13300;1200;
2021-07-22 12:56:08;8998866203104;MIE SEDAAP SINGAPORE;2;2500;0;5000;4532;468;
2021-07-22 12:56:08;PRG;PARAGO;2;500;0;1000;800;200;
2021-07-22 12:56:08;8996001318430;BETTER 1000;1;1000;0;1000;820;180;
2021-07-22 12:56:08;AMPLOP;AMPLOP;2;250;0;500;280;220;
2021-07-22 12:56:08;RT BAKPIA;ROTI BAKPIA;6;1000;0;6000;4500;1500;
2021-07-22 12:56:08;8999999531515;MOLTO WHITE MUSK SC 10ML;1;5500;0;5500;4800;700;
2021-07-22 12:56:08;8992979190986;TOTAL PUTIH SOFTENER;1;13000;0;13000;11532;1468;
2021-07-22 12:56:08;TS;TISSUE TESSY;1;5000;0;5000;4200;800;
2021-07-22 12:56:08;8996001302316;MALKIST ABON SCT;1;1000;0;1000;840;160;
2021-07-22 12:56:08;8992775913000SCT;CHOCOLATOS CKLT DRINK SCT;4;2000;0;8000;6344;1656;
2021-07-22 12:56:08;SF TAWAR ORI;SAFFANAH TAWAR ORI;1;9000;0;9000;8000;1000;
2021-07-22 12:56:08;8992696404441;BEAR BRAND 189ML;1;9000;0;9000;7887;1113;
2021-07-22 12:56:08;8998866202930;SEDAAP AYAM JERIT CUP;1;4500;0;4500;3738;762;
2021-07-22 13:04:47;8996001600610;TORA MILKY LATTE 180ML;1;3500;0;3500;2750;750;
2021-07-22 13:04:47;8998866203104;MIE SEDAAP SINGAPORE;1;2500;0;2500;2266;234;
2021-07-22 13:04:47;8998866202619;MIE SEDAAP KOREAN SPICY SOUP;1;2500;0;2500;2273;227;
2021-07-22 13:04:47;8992761122331;FRESTEA APPEL 500ML;2;6500;0;13000;9416;3584;
2021-07-22 13:04:47;8998866200561;EKOMIE SUPER 600GR;1;10000;0;10000;8615;1385;
2021-07-22 13:04:47;8995333032113;TERIGU GATOT KACA 1 KG;1;8500;0;8500;8012;488;
2021-07-22 13:04:47;COKLAT;COKLAT COIN;3;500;0;1500;1275;225;
2021-07-22 13:04:47;8991102228053;TEH GELAS BOTOL;1;3000;0;3000;1695;1305;
2021-07-22 13:04:47;8998866611701;EKONOMI PENCUCI PIRING  LIQ 132ML;1;2000;0;2000;1337;663;
2021-07-22 13:04:47;9556001004673;MILO NESTLE MALAYSIA ACTIVE GO;1;85000;0;85000;80000;5000;
2021-07-22 13:33:40;8999909096004;SAMPOERNA 16 FILTER;1;24000;0;24000;23000;1000;
2021-07-22 13:33:40;8992761002039;FANTA STRAWBERRY PET 390 ML;1;5500;0;5500;4300;1200;
2021-07-22 13:33:40;8996001600269;LE MINERAL 600ML;1;3000;0;3000;1688;1312;
2021-07-22 13:33:40;8992761166038;MMP ORANGE 300ML;1;5000;0;5000;3750;1250;
2021-07-22 13:33:40;8992761002022;SPRITE PET 390ML;1;5500;0;5500;4300;1200;
2021-07-22 13:33:40;8992775000076;GERY SNACK RING CKLT;1;2000;0;2000;1712;288;
2021-07-22 13:33:40;8992775211410;PILUS GARUDA PEDAS;1;5000;0;5000;4886;114;
2021-07-22 13:33:40;8992775000663;GERY SNACK KEJU;1;2000;0;2000;1712;288;
2021-07-22 13:33:40;123124;KOREK BIASA;1;2000;0;2000;1800;200;
2021-07-22 13:52:12;8991102281416;PERMEN MINTZ PPMINT;1;5000;0;5000;4000;1000;
2021-07-22 14:38:54;ARG;ARGUS 220ML;1;14500;0;14500;13300;1200;
2021-07-22 14:39:13;8996001600146;TEH PUCUK HARUM 350ML;1;3000;0;3000;2314;686;
2021-07-22 14:56:02;8998866105637;EMERON LOVELY MOIST&BRIGHT 200ML;1;7500;0;7500;6475;1025;
2021-07-22 14:56:02;HT;HOT-HOT;1;500;0;500;350;150;
2021-07-22 16:40:49;8992696404441;BEAR BRAND 189ML;1;9000;0;9000;7887;1113;
2021-07-22 16:40:49;8992775110157;GARUDA KACANG KULIT;1;5000;0;5000;3925;1075;
2021-07-22 17:20:38;8991188943536;SASA SANTAN KELAPA 65ML;2;3000;0;6000;4874;1126;
2021-07-22 17:20:38;8993226112508;GARAM REFINA;1;3000;0;3000;2461;539;
2021-07-22 18:03:39;TEMBAK;TEMBAK SNIPPER;1;3500;0;3500;2500;1000;
2021-07-22 18:03:39;BALON;BALON CABUT;1;1000;0;1000;900;100;
2021-07-22 18:35:31;8998866202343;MIE SEDAAP KOREAN SPICY;1;2500;0;2500;2023;477;
2021-07-22 18:35:40;8998866202343;MIE SEDAAP KOREAN SPICY;1;2500;0;2500;2023;477;
2021-07-22 18:46:53;089686060027;POP MIE AYAM JUMBO;1;4500;0;4500;3833;667;
2021-07-22 19:11:41;8998866202770;MIE SEDAAP SALERO PADANG;1;2500;0;2500;2362;138;
2021-07-22 19:11:41;8998866613262;SUKSESMIE SOTO 111 GR;1;3500;0;3500;2770;730;
2021-07-22 19:11:41;089686044249;SUPERMI NUTRIMI STEAK AYAM;1;3500;0;3500;2800;700;
2021-07-22 19:11:41;8998866613729;EMERON LOVELY NTRL 100ML;1;3500;0;3500;2900;600;
2021-07-22 19:17:47;8999999016128;RINSO MOLTO ROSE FRESH 750ML;2;15000;0;30000;25014;4986;
2021-07-22 19:17:47;8998866201964;MINYAK GORENG SABRINA 2L POUCH;1;28000;0;28000;26753;1247;
2021-07-22 19:17:47;8999999057640;MOLTO EDP BLK PURPLE 20ML;5;1000;0;5000;4000;1000;
2021-07-22 19:17:47;8991002330504;RELAXA MANGO MINT;1;5000;0;5000;4500;500;
2021-07-22 19:17:47;8996001355978;BENG-BENG SHARE IT 9.5G;1;10000;0;10000;8700;1300;
2021-07-22 19:24:50;8998989300261;GUDANG GARAM SURYA 12 FILTER;1;18500;0;18500;17200;1300;
2021-07-23 11:39:29;RT BAKPIA;ROTI BAKPIA;1;1000;0;1000;750;250;
2021-07-23 11:55:54;8992775318201;GERY SNACK BANTAL COKLAT;1;2000;0;2000;1712;288;
2021-07-23 15:11:03;6907992825076;JD WATERMELON APPLE;1;2000;0;2000;1700;300;
2021-07-23 15:47:33;6907992823645;JD COCONUT BLISS;1;4000;0;4000;3500;500;
2021-07-23 15:48:32;8991001121615;SILVERQUEEN NUT;1;15000;0;15000;13200;1800;
2021-07-23 16:01:33;GL;GULA 1 LITER;5;11500;0;57500;52500;5000;
2021-07-23 16:01:33;8995102703534;TERASI DUO 6 GR;1;4000;0;4000;3720;280;
2021-07-23 16:02:29;8999999007768;FAIR&LOVELY MULTIVITAMIN  CREAM 9 ML;2;4500;0;9000;6400;2600;
2021-07-23 16:03:14;8994834006128;TICTIC PEDAS;2;2000;0;4000;3400;600;
2021-07-23 16:14:57;711844140011;ABC SAUS TIRAM 425ML;1;28000;0;28000;26000;2000;
2021-07-23 16:19:47;8996001600399;LE MINERAL 1500ML;1;5000;0;5000;4042;958;
2021-07-23 16:40:32;8992761002022;SPRITE PET 390ML;1;5500;0;5500;4300;1200;
2021-07-23 16:40:32;8992761166052;FRESTEA MELATI 350ML;1;4500;0;4500;3000;1500;
2021-07-23 16:40:32;8993571003827;CAP 19 BEDAK SALICYL MENTHOL 100G;1;8000;0;8000;7000;1000;
2021-07-23 16:41:10;BALON;BALON CABUT;2;1000;0;2000;1800;200;
2021-07-23 16:42:55;896867700494;CLUB 1500ML;1;5000;0;5000;2987;2013;
2021-07-23 17:12:15;8992761122331;FRESTEA APPEL 500ML;1;6500;0;6500;4708;1792;
2021-07-23 17:12:15;089686021219;INTER MIE GORENG;2;1000;0;2000;1770;230;
2021-07-23 17:12:15;PD;PENDEKAR;2;500;0;1000;700;300;
2021-07-23 17:38:23;8992694242717;ZWITSAL NAT ALOE VERA PWD 100G;1;8400;0;8400;7590;810;
2021-07-23 17:38:23;8992694242502;ZWITZAL SOAP CALSSIC 70G;1;3800;0;3800;3410;390;
2021-07-23 17:39:00;8997231980039;O`JELLY KONYAKU (MAXI APPLE STRAWBERRY);1;5000;0;5000;4620;380;
2021-07-23 17:39:00;8992775002582;DILAN CHOCO;1;2000;0;2000;1503;497;
2021-07-23 18:16:41;8991001503114;CHACHA MILK CHOCOLATE 35G;1;5500;0;5500;4900;600;
2021-07-23 18:16:41;8997210107877;VORTEX SMART 3;1;5000;0;5000;4750;250;
2021-07-23 19:38:05;8992388133017;NU MILK TEA ORI 330ML;1;6000;0;6000;5125;875;
2021-07-23 19:38:05;8993379200855;SABUN HARMONY STRAWBERRY 70G;1;2000;0;2000;1652;348;
2021-07-23 19:38:05;8993379152017;SABUN CUCI SURYA 200G;1;3000;0;3000;2281;719;
2021-07-23 19:38:05;8996001301562;MALKIST TABUR KELAPA;1;1000;0;1000;820;180;
2021-07-23 19:38:05;8999999055769;FAIR&LOVELY MVIT FC FOAM 50 G;1;12500;0;12500;11180;1320;
2021-07-23 19:38:05;JL;JELLY;2;500;0;1000;800;200;
2021-07-23 19:38:05;8991102384841;WFR TANGO LONG CKLT 130G;1;5000;0;5000;4345;655;
2021-07-23 19:38:05;8991102989381;TANGO LONG BUBBLEGUM 130G;1;5000;0;5000;4345;655;
2021-07-23 19:38:05;8992959117590;SFX DS REG FLOW WING 20;1;12000;0;12000;11250;750;
2021-07-23 19:38:05;8992775000250GT;CHOCOLATOS MATCHA DRINK;1;18000;0;18000;15862;2138;
2021-07-23 19:38:05;8992775002582;DILAN CHOCO;1;2000;0;2000;1503;497;
2021-07-23 19:38:20;8991188943062;SASA 250G;5;10000;0;50000;42500;7500;
2021-07-23 19:55:55;8998866201964;MINYAK GORENG SABRINA 2L POUCH;1;28000;0;28000;26753;1247;
2021-07-23 20:01:33;8992761111533;SPRITE SLIM CAM250ML;4;5000;0;20000;15000;5000;
2021-07-23 20:01:33;8998989300261;GUDANG GARAM SURYA 12 FILTER;1;18500;0;18500;17200;1300;
2021-07-23 20:10:48;8998866501026;MINYAK GORENG SEDAAP POUCH 1 L;24;14110;0;338640;338640;0;
2021-07-23 20:45:20;ROTI;ROTI 2000;1;2000;0;2000;1800;200;
2021-07-23 20:49:44;8999999552343;LUX BW BIRD OF PARADISE 250ML;1;20000;0;20000;17900;2100;
2021-07-23 20:50:05;8998989300261;GUDANG GARAM SURYA 12 FILTER;1;18500;0;18500;17200;1300;
2021-07-23 21:45:04;8991102714846;MILKIDO CKLT;1;3000;0;3000;2153;847;
2021-07-23 21:45:04;ROTI;ROTI 2000;1;2000;0;2000;1800;200;
2021-07-23 21:57:19;8992736424293;SASA BUMBU NASI GORENG 20G;2;2000;0;4000;2272;1728;
2021-07-23 21:57:19;RT BAKPIA;ROTI BAKPIA;1;1000;0;1000;750;250;
2021-07-23 21:57:19;8998866108317;EMERON HJB ANTDNDF 10ML;1;5000;0;5000;4185;815;
2021-07-23 22:03:09;9311931024036;COFFEEMIX SCT;1;1500;0;1500;1200;300;
2021-07-23 22:03:09;8999999192150;ROYCO FDS CHICKEN 100GR;1;5000;0;5000;4300;700;
2021-07-23 22:03:09;8997027490018;LADAMAS MERICA BUBUK;1;9500;0;9500;8898;602;
2021-07-23 22:03:09;8992775002933;GERY MALKIST DOUBLE ABON;1;6500;0;6500;5516;984;
2021-07-23 22:03:09;RT BAKPIA;ROTI BAKPIA;1;1000;0;1000;750;250;
2021-07-23 22:03:09;RT MNTG;ROTI SISIR MENTEGA;1;2000;0;2000;1600;400;
2021-07-23 22:03:09;6907992825076;JD WATERMELON APPLE;2;2000;0;4000;3400;600;
2021-07-23 22:03:09;8996001600146;TEH PUCUK HARUM 350ML;1;3000;0;3000;2314;686;
2021-07-23 22:03:09;8998866201483;POTABEE REGULER GRILLED SEAWEED 35GR;1;5000;0;5000;4150;850;
2021-07-23 22:03:09;ff;FULLO BLASTO;1;1000;0;1000;995;5;
2021-07-23 22:03:09;8992761145026;SPRITE PET 250ML;1;3500;0;3500;2417;1083;
2021-07-23 22:03:09;8992761002022;SPRITE PET 390ML;1;5500;0;5500;4300;1200;
2021-07-23 22:03:09;8992696430860;KOKO KRUNCH 80G;1;9000;0;9000;8063;937;
2021-07-23 22:03:09;8993007000680;INDOMILK 1L;1;16500;0;16500;14792;1708;
2021-07-23 22:03:44;8994867000162;ROKOK PUNDIMAS KRETEK16;2;10000;0;20000;17200;2800;
2021-07-23 22:12:57;8996001600399;LE MINERAL 1500ML;1;5000;0;5000;4042;958;
2021-07-23 22:21:32;089686043273;INDOMIE SAMBAL RICA;2;2700;0;5400;4904;496;
2021-07-23 22:44:18;089686611519;QTELA SINGKONG;1;5000;0;5000;4266;734;
2021-07-23 23:01:13;MILKITA;MILKITA;4;250;0;1000;800;200;
2021-07-24 12:49:50;8998898852127;KKB ENER-G MANGGA;1;5500;0;5500;4824;676;
2021-07-24 12:49:50;8998866500708;FLORIDINA ORANGE;1;3000;0;3000;2500;500;
2021-07-24 12:50:05;MILKITA;MILKITA;2;250;0;500;400;100;
2021-07-24 12:59:56;8999999195649;SARI WANGI 25X1.86G;1;6000;0;6000;5050;950;
2021-07-24 12:59:56;8995333032113;TERIGU GATOT KACA 1 KG;1;8500;0;8500;8012;488;
2021-07-24 13:17:01;8992759120264;LARISST 220;1;10000;0;10000;9200;800;
2021-07-24 13:17:01;TBR;TEPUNG BERAS ROSE BRAND;1;8000;0;8000;5800;2200;
2021-07-24 13:17:01;ARG;ARGUS 220ML;1;14500;0;14500;13300;1200;
2021-07-24 13:17:01;089686834307;FREISS LECI;1;11000;0;11000;8750;2250;
2021-07-24 13:17:01;RT MNTG;ROTI SISIR MENTEGA;1;2000;0;2000;1600;400;
2021-07-24 13:17:01;8991188943536;SASA SANTAN KELAPA 65ML;1;3000;0;3000;2437;563;
2021-07-24 13:17:01;YP;YUPI;2;250;0;500;416;84;
2021-07-24 13:17:01;MILKITA;MILKITA;4;250;0;1000;800;200;
2021-07-24 13:17:01;PRG;PARAGO;1;500;0;500;400;100;
2021-07-24 13:17:01;RT 1000;ROTI 1000;2;1000;0;2000;1600;400;
2021-07-24 13:17:01;8992775000663;GERY SNACK KEJU;1;2000;0;2000;1712;288;
2021-07-24 13:17:01;8998866202244;EKOMIE BUMBU KALDU AYAM;3;1000;0;3000;2394;606;
2021-07-24 13:17:01;8998989300261;GUDANG GARAM SURYA 12 FILTER;1;18500;0;18500;17200;1300;
2021-07-24 13:17:01;8998866202435;JAPOTA UMAMI JAPANESE SEAWEED 35GR;2;5000;0;10000;8300;1700;
2021-07-24 13:17:01;8996001318980;BETTER 120G;1;6000;0;6000;5100;900;
2021-07-24 13:17:01;8998866201865;KRISBEE PILLOW CHOCOLAVA 120 GR;1;8000;0;8000;7250;750;
2021-07-24 13:17:01;8996001305003;SARI GANDUM SANDWICH;1;6000;0;6000;5100;900;
2021-07-24 13:17:01;8998009010569;ULTRA CHO 200;2;5000;0;10000;7660;2340;
2021-07-24 13:17:01;TEMBAK;TEMBAK SNIPPER;1;3500;0;3500;2500;1000;
2021-07-24 13:17:01;8998866201452;POTABEE REGULER BBQ BEEF 35GR;1;5000;0;5000;4150;850;
2021-07-24 13:17:01;8998866609494;SOKLIN SOFTERGEN 280G BIRU;1;5000;0;5000;4425;575;
2021-07-24 13:17:01;8992959117514;SFX NON WING 20;1;10000;0;10000;9091;909;
2021-07-24 13:17:01;8992761111533;SPRITE SLIM CAM250ML;1;5000;0;5000;3750;1250;
2021-07-24 13:17:45;8998866200646;KOPI TOP MURNI;1;11000;0;11000;9600;1400;
2021-07-24 13:21:47;8992761111533;SPRITE SLIM CAM250ML;1;5000;0;5000;3750;1250;
2021-07-24 13:21:47;8998866201452;POTABEE REGULER BBQ BEEF 35GR;1;5000;0;5000;4150;850;
2021-07-24 13:21:47;8999999528966;CITRA FRESH WHITE 120ML;1;13200;0;13200;11875;1325;
2021-07-24 13:21:47;8999999520892;FAIR&LOVELY POWDER CREAM 20 G;1;18500;0;18500;16830;1670;
2021-07-24 13:21:47;8992959974001;SFX SIRIH SLIM 36CM 6+1;1;10000;0;10000;8315;1685;
2021-07-24 13:21:47;8998009010569;ULTRA CHO 200;1;5000;0;5000;3830;1170;
2021-07-24 13:21:47;8996001305003;SARI GANDUM SANDWICH;1;6000;0;6000;5100;900;
2021-07-24 13:21:47;8998866201889;KRISBEE PILLOW STRAWBERRY ICE CREAM 120GR;1;8000;0;8000;7250;750;
2021-07-24 13:21:47;8998866202466;JAPOTA HAPPY HONEY BUTTER;1;5000;0;5000;4150;850;
2021-07-24 13:21:47;8998866601429;POWDET DAIA BUNGA BAG 290GR;1;5000;0;5000;4450;550;
2021-07-24 13:21:47;8999999557447;PEPSODENT ACTION123 SIWAK 110G;1;9000;0;9000;8000;1000;
2021-07-24 13:21:47;8996001600269;LE MINERAL 600ML;1;3000;0;3000;1688;1312;
2021-07-24 13:21:47;8994834003752;TICTIC;1;2000;0;2000;1700;300;
2021-07-24 13:34:13;MLTO PINK;MOLTO ALL IN ONE;8;1000;0;8000;6400;1600;
2021-07-24 13:34:13;8998866609029;DAIA PUTIH GUSSWET 565G;1;10000;0;10000;8700;1300;
2021-07-24 13:34:13;8999999706081;PEPSODENT WHITE 75G;1;5000;0;5000;3850;1150;
2021-07-24 13:34:13;8998866200844;NOODLE SEDAAP MIE KARI SPESIAL CUP 81 GR;1;4500;0;4500;3650;850;
2021-07-24 13:34:13;8992761145033;FANTA STRAW PET 250ML;2;3500;0;7000;4834;2166;
2021-07-24 13:34:13;8998866200325;MIE SEDAAP SOTO;6;2500;0;15000;11712;3288;
2021-07-24 13:34:13;8993379152017;SABUN CUCI SURYA 200G;1;3000;0;3000;2281;719;
2021-07-24 13:34:13;8996001355237;SUPER STAR;2;11000;0;22000;19800;2200;
2021-07-24 13:34:13;8998866200561;EKOMIE SUPER 600GR;1;10000;0;10000;8615;1385;
2021-07-24 13:34:13;8992696404441;BEAR BRAND 189ML;1;9000;0;9000;7887;1113;
2021-07-24 13:34:13;8992959974018;SFX SIRIH 36CM 12+1;1;17000;0;17000;15958;1042;
2021-07-24 13:34:13;8992761164478;FRESTEA MILK TEA;1;8000;0;8000;6575;1425;
2021-07-24 13:34:13;8998866202312;NOODLE SEDAAP TASTY BAKMI AYAM 129 GR;1;5000;0;5000;4167;833;
2021-07-24 13:34:13;8998866203104;MIE SEDAAP SINGAPORE;1;2500;0;2500;2266;234;
2021-07-24 13:34:13;MENTOS;MENTOS;4;250;0;1000;700;300;
2021-07-24 13:34:13;GL;GULA 1 LITER;3;11500;0;34500;31500;3000;
2021-07-24 13:34:13;8998009040023;TEH KOTAK;1;5000;0;5000;2827;2173;
2021-07-24 13:35:33;8992761111533;SPRITE SLIM CAM250ML;3;5000;0;15000;11250;3750;
2021-07-24 13:35:33;RT KN;ROTI KASUR NANAS;1;8000;0;8000;7200;800;
2021-07-24 13:35:33;SNDL;SENDAL BLACK;1;15000;0;15000;10833;4167;
2021-07-24 13:35:33;896867700494;AIR CLUB 1500ML;1;5000;0;5000;2987;2013;
2021-07-24 13:52:10;8998866202244;EKOMIE BUMBU KALDU AYAM;4;1000;0;4000;3192;808;
2021-07-24 13:52:10;089686021127;INTER MIE KALDU;3;1000;0;3000;2439;561;
2021-07-24 13:52:10;089686021141;INTER MIE SOTO;3;1000;0;3000;2562;438;
2021-07-24 14:42:01;711844120433;SAMBAL ABC 600 ML;1;22000;0;22000;20300;1700;
2021-07-24 16:07:03;8993989311699;CLAS MILD 16 FILTER;1;23000;0;23000;21700;1300;
2021-07-24 16:12:51;089686021127;INTER MIE KALDU;2;1000;0;2000;1626;374;
2021-07-24 16:12:51;8998866200561;EKOMIE SUPER 600GR;1;10000;0;10000;8615;1385;
2021-07-24 16:15:09;8996001600146;TEH PUCUK HARUM 350ML;1;3000;0;3000;2314;686;
2021-07-24 16:22:46;8992761166052;FRESTEA MELATI 350ML;1;4500;0;4500;3000;1500;
2021-07-24 17:20:23;089686535044;SUN BERAS MERAH;1;8500;0;8500;7410;1090;
2021-07-24 17:35:38;8994867007161;ROKOK PENA GOLD 20;1;17000;0;17000;15500;1500;
2021-07-24 18:11:46;8998866501033;MINYAK GORENG SEDAAP POUCH 2L;1;29000;0;29000;27746;1254;
2021-07-24 18:11:46;8999999030186;PEPSODENT ACTION 123 COMPLETE 190G;1;14000;0;14000;13200;800;
2021-07-24 19:12:23;JGR SHN;JOGER SHINY SACHET;2;500;0;1000;874;126;
2021-07-24 20:42:15;8998989110167;SURYA GUDANG GARAM 16 FILTER;1;25000;0;25000;23200;1800;
2021-07-24 20:43:52;8992761166052;FRESTEA MELATI 350ML;1;4500;0;4500;3000;1500;
2021-07-24 20:43:52;MENTOS;MENTOS;2;250;0;500;350;150;
2021-07-24 21:10:44;8992959117590;SFX DS REG FLOW WING 20;1;12000;0;12000;11250;750;
2021-07-24 21:10:44;8999999571924;MOLTO PURE 1OML;1;5000;0;5000;4800;200;
2021-07-24 21:10:44;8993324850449;BABY LOVE COTTON BUDS;1;5000;0;5000;4500;500;
2021-07-24 21:10:44;8998866202466;JAPOTA HAPPY HONEY BUTTER;1;5000;0;5000;4150;850;
2021-07-24 21:10:44;MBL;MOBIL;2;5000;0;10000;7000;3000;
2021-07-24 21:10:44;8993001003908;INDOMILK KENTAL MANIS 545G;1;15000;0;15000;13333;1667;
2021-07-24 22:37:19;8998866202770;MIE SEDAAP SALERO PADANG;1;2500;0;2500;2362;138;
2021-07-24 22:37:19;8996001402023SCT;TB TORA SUSU SCT;1;1500;0;1500;848;652;
2021-07-24 22:37:19;8999909085114;SAMPOERNA KRETEK HIJAU 12;1;13000;0;13000;11650;1350;
2021-07-24 22:37:19;6907992823874;JD CRUNCHY CHOCO BLUEBERRY;1;5500;0;5500;4700;800;
2021-07-24 22:38:16;8991102987875;WFR TANGO POUCH CKL 115G;1;8000;0;8000;6786;1214;
2021-07-24 22:38:16;8998866203104;MIE SEDAAP SINGAPORE;2;2500;0;5000;4532;468;
2021-07-24 22:38:16;8991102989381;TANGO LONG BUBBLEGUM 130G;1;5000;0;5000;4345;655;
2021-07-24 22:38:16;8992775002582;DILAN CHOCO;1;2000;0;2000;1503;497;
2021-07-25 11:16:38;8992736424293;SASA BUMBU NASI GORENG 20G;3;2000;0;6000;3408;2592;
2021-07-25 11:16:38;8992770154026;SAJIKU SAYUR SOP;2;2500;0;5000;4000;1000;
2021-07-25 11:16:38;8996001312438;MALKIST CAPPUCINO SCT;2;1000;0;2000;1640;360;
2021-07-25 11:16:38;8996001302316;MALKIST ABON SCT;2;1000;0;2000;1680;320;
2021-07-25 11:16:38;8996001312582;MALKIST KELAPA KOPYOR SCT;1;1000;0;1000;820;180;
2021-07-25 11:16:38;8992628022156;BIMOLI KLASIK TOUCH 1 LT;1;16000;0;16000;14350;1650;
2021-07-25 11:16:38;TBR;TEPUNG BERAS ROSE BRAND;1;8000;0;8000;5800;2200;
2021-07-25 11:16:38;8995333000822;TERIGU KOMPAS SOFT 500GR;1;5500;0;5500;4967;533;
2021-07-25 11:16:38;8992696521797SCT;MILO ACT GO 22G SCT;1;2000;0;2000;1553;447;
2021-07-25 11:16:38;8998866202770;MIE SEDAAP SALERO PADANG;4;2500;0;10000;9448;552;
2021-07-25 11:16:38;8850507002951;BONCHA EGG SQUISHY;1;12000;0;12000;10841;1159;
2021-07-25 11:16:38;8992759120264;LARISST 220;1;10000;0;10000;9200;800;
2021-07-25 11:16:38;8996001600399;LE MINERAL 1500ML;1;5000;0;5000;4042;958;
2021-07-25 11:16:38;GL;GULA 1 LITER;1;11500;0;11500;10500;1000;
2021-07-25 11:16:38;8997231980039;O`JELLY KONYAKU (MAXI APPLE STRAWBERRY);1;5000;0;5000;4620;380;
2021-07-25 11:16:38;8994935000070;MINYAK DUNIA 450 ML;1;7500;0;7500;6779;721;
2021-07-25 11:16:38;8998898853100;SUSU JAHE;2;1500;0;3000;2360;640;
2021-07-25 11:52:18;8999999558086;RINSO MOLTO FERFUME ESSENSE PWD 44G;2;1000;0;2000;1610;390;
2021-07-25 11:53:37;8999999558086;RINSO MOLTO FERFUME ESSENSE PWD 44G;1;1000;0;1000;805;195;
2021-07-25 11:53:37;MOLTO PINK;MOLTO ALL IN ONE 11 ML;4;500;0;2000;1600;400;
2021-07-25 11:53:37;8993007001557;INDOMILK SKM 37G;2;1500;0;3000;2162;838;
2021-07-25 11:53:53;8991102385060;TANGO WAFFLE CHOX;1;9000;0;9000;8498;502;
2021-07-25 11:54:05;8993470671752;JOGER STICK DUO KACANG;1;1000;0;1000;850;150;
2021-07-25 12:42:29;8998866202930;SEDAAP AYAM JERIT CUP;1;4500;0;4500;3738;762;
2021-07-25 12:42:29;8996001600146;TEH PUCUK HARUM 350ML;1;3000;0;3000;2314;686;
2021-07-25 12:42:29;8992761122331;FRESTEA APPEL 500ML;1;6500;0;6500;4708;1792;
2021-07-25 13:14:59;GL;GULA 1 LITER;1;11500;0;11500;10500;1000;
2021-07-25 13:14:59;8992959107539;SFX WING 23CM;4;500;0;2000;2000;0;
2021-07-25 13:14:59;8999999195656;SARI WANGI 50X1.85;1;10000;0;10000;9500;500;
2021-07-25 13:29:38;089686010190;INDOMIE KARI AYAM;3;2800;0;8400;7566;834;
2021-07-25 13:29:38;PD;PENDEKAR;1;500;0;500;350;150;
2021-07-25 13:29:38;WC;WAFER COKELAT MADE;1;1000;0;1000;800;200;
2021-07-25 13:31:23;ARG;ARGUS 220ML;1;14500;0;14500;13300;1200;
2021-07-25 13:31:23;RT;ROTI;1;9000;0;9000;8000;1000;
2021-07-25 13:39:40;8992775001783;GERY SALUT MALKIST KELAPA;1;6500;0;6500;5516;984;
2021-07-25 13:39:40;8991001780492;SELAMAT COKLAT;1;13000;0;13000;11800;1200;
2021-07-25 14:19:10;GL;GULA 1 LITER;4;11500;0;46000;42000;4000;
2021-07-25 14:19:10;COKLAT;COKLAT COIN;10;500;0;5000;4250;750;
2021-07-25 14:19:10;8991102230308;BLASTER PINK;1;5000;0;5000;3106;1894;
2021-07-25 14:21:17;8991002307209;COFFE CANDY;1;5000;0;5000;4500;500;
2021-07-25 14:24:02;089686010190;INDOMIE KARI AYAM;2;2800;0;5600;5044;556;
2021-07-25 14:33:46;ARG;ARGUS 220ML;6;14500;0;87000;79800;7200;
2021-07-25 15:15:39;8992775311325;GERY SNACK&SEREAL 100G;2;7000;0;14000;12024;1976;
2021-07-25 15:15:39;8999999031930;PEPSODENT TB TRIPLE CLEAN;1;3500;0;3500;2850;650;
2021-07-25 15:15:39;8992775312414;GERY CHOCO HEZELNUT;1;11000;0;11000;9983;1017;
2021-07-25 15:15:39;RT ISI 6;ROTI ISI 6;1;6000;0;6000;5000;1000;
2021-07-25 15:39:45;PRG;PARAGO;2;500;0;1000;800;200;
2021-07-25 15:39:45;6907992825076;JD WATERMELON APPLE;2;2000;0;4000;3400;600;
2021-07-25 15:39:45;6907992824963;JD MILKY CHOCOLATE;1;3000;0;3000;2600;400;
2021-07-25 15:39:45;8997028590014;ARGUS 220ML;2;500;0;1000;604;396;
2021-07-25 15:42:42;8996001354018;WFR KALPA;1;20200;0;20200;18400;1800;
2021-07-25 15:42:42;8992775310212;GERY PASTA COKELAT;1;18000;0;18000;16029;1971;
2021-07-25 15:42:42;6907992825076;JD WATERMELON APPLE;1;2000;0;2000;1700;300;
2021-07-25 15:42:42;8992761166205;FRESTEA GREEN HONEY 350ML;2;4500;0;9000;6000;3000;
2021-07-25 15:42:42;6907992823591;JD STRAW MILKSHAKE;2;5000;0;10000;8600;1400;
2021-07-25 15:42:42;MOBIL;GULA GULA HP;2;2000;0;4000;3400;600;
2021-07-25 15:42:42;PD;PENDEKAR;1;500;0;500;350;150;
2021-07-25 15:42:42;HT;HOT-HOT;1;500;0;500;350;150;
2021-07-25 15:45:28;HT;HOT-HOT;1;500;0;500;350;150;
2021-07-25 16:18:57;8999909002821;MARLBORO BLACK 16;1;22000;0;22000;20850;1150;
2021-07-25 16:18:57;8994867007161;ROKOK PENA GOLD 20;1;17000;0;17000;15500;1500;
2021-07-25 16:57:45;8998866201889;KRISBEE PILLOW STRAWBERRY ICE CREAM 120GR;1;8000;0;8000;7250;750;
2021-07-25 16:57:45;6907992825076;JD WATERMELON APPLE;1;2000;0;2000;1700;300;
2021-07-25 17:18:20;8991111111971;C&C FACIAL WASH 100ML;1;17500;0;17500;16070;1430;
2021-07-25 17:18:20;8999999559861;AXE DARK POCKET FRAG 17ML;1;10000;0;10000;8000;2000;
2021-07-25 17:18:20;8999999027049;LIFEBUOY PRWTN RMBT RNTK 9ML;1;5000;0;5000;4500;500;
2021-07-25 17:18:20;8999999006006;RINSO ANTI NODA CLASSISC 750ML;1;15000;0;15000;12507;2493;
2021-07-25 17:18:20;8993324850449;BABY LOVE COTTON BUDS;1;5000;0;5000;4500;500;
2021-07-25 17:18:20;8997231980039;O`JELLY KONYAKU (MAXI APPLE STRAWBERRY);1;5000;0;5000;4620;380;
2021-07-25 17:18:20;8992775000076;GERY SNACK RING CKLT;1;2000;0;2000;1712;288;
2021-07-25 17:18:20;JL;JELLY;1;500;0;500;400;100;
2021-07-25 17:29:22;JL;JELLY;1;500;0;500;400;100;
2021-07-25 17:30:26;8992775211434;PILUS GARUDA SAPI PANGGANG;1;5000;0;5000;4810;190;
2021-07-25 17:30:26;8998866203104;MIE SEDAAP SINGAPORE;1;2500;0;2500;2266;234;
2021-07-25 17:37:37;8994867000162;ROKOK PUNDIMAS KRETEK16;3;10000;0;30000;25800;4200;
2021-07-25 18:09:06;8997231980039;O`JELLY KONYAKU (MAXI APPLE STRAWBERRY);2;5000;0;10000;9240;760;
2021-07-25 18:48:40;089686021141;INTER MIE SOTO;2;1000;0;2000;1708;292;
2021-07-25 18:48:40;089686021219;INTER MIE GORENG;2;1000;0;2000;1770;230;
2021-07-25 19:00:14;8998989110167;SURYA GUDANG GARAM 16 FILTER;1;25000;0;25000;23200;1800;
2021-07-25 19:00:14;8998866200301;MIE SEDAAP GORENG;2;2500;0;5000;4046;954;
2021-07-25 19:00:14;089686060027;POP MIE AYAM JUMBO;1;4500;0;4500;3833;667;
2021-07-25 19:08:17;8992761139018;ADES 600ML;1;3500;0;3500;2292;1208;
2021-07-25 19:11:24;8996001600146;TEH PUCUK HARUM 350ML;2;3000;0;6000;4628;1372;
2021-07-25 19:11:24;SF KEMASAN;SAFFANAH ROTI KEMASAN;1;3500;0;3500;3000;500;
2021-07-25 19:11:24;JL;JELLY;6;500;0;3000;2400;600;
2021-07-25 19:13:00;MTR;MOTOR;1;5000;0;5000;3500;1500;
2021-07-25 19:13:00;TEMBAK;TEMBAK SNIPPER;1;3500;0;3500;2500;1000;
2021-07-25 19:13:00;8886013213208;FRENCH FREIS 2000;2;5000;0;10000;7500;2500;
2021-07-25 19:13:00;JL;JELLY;5;500;0;2500;2000;500;
2021-07-25 19:13:00;8991001503107;CHACHA PEANUT 35GR;1;5500;0;5500;4900;600;
2021-07-25 19:13:59;KOPIKO;KOPIKO;2;250;0;500;350;150;
2021-07-25 19:24:53;089686060362;POP MIE SOTO AYAM JUMBO;1;4500;0;4500;3833;667;
2021-07-25 19:24:53;COKLAT;COKLAT COIN;3;500;0;1500;1275;225;
2021-07-25 19:41:19;8992761139018;ADES 600ML;1;3500;0;3500;2292;1208;
2021-07-25 19:43:33;8999909096004;SAMPOERNA 16 FILTER;1;24000;0;24000;23000;1000;
2021-07-25 19:59:23;8999999560720;MOLTO TRIKA JAPANESE PEACH 720ML;1;5000;0;5000;4000;1000;
2021-07-25 19:59:23;711844140059;ABC SAUS TIRAM 135 ML;1;8500;0;8500;7750;750;
2021-07-25 19:59:23;711844110113;KECAP ABC 135 ML;1;7000;0;7000;6400;600;
2021-07-25 19:59:23;8999999059323;LIFEBUOY TS LEMONFRESH 75G;2;3000;0;6000;5280;720;
2021-07-25 20:12:43;8998866201964;MINYAK GORENG SABRINA 2L POUCH;1;28000;0;28000;26753;1247;
2021-07-25 20:12:43;JL;JELLY;4;500;0;2000;1600;400;
2021-07-25 20:36:27;8999909010567;234 DJI SAM SOE 16;1;22000;0;22000;21500;500;
2021-07-25 21:04:48;8991002105409;KOPI KAPAL API;1;20000;0;20000;18888;1112;
2021-07-25 21:08:40;8997025911058;HATARI SHP KELAPA;1;6000;0;6000;4911;1089;
2021-07-25 21:08:40;8993470279651;JOGER CHOCKY BAR;5;1000;0;5000;4335;665;
2021-07-25 21:16:06;8992959508312;SWEETY SILVER PANTS XL RTG;1;15500;0;15500;13944;1556;
2021-07-25 21:48:34;8991102714860;MILKIDO STRAW;1;3000;0;3000;2153;847;
2021-07-25 22:05:29;089686010190;INDOMIE KARI AYAM;1;2800;0;2800;2522;278;
2021-07-25 22:05:29;RT BAKPIA;ROTI BAKPIA;1;1000;0;1000;750;250;
2021-07-25 22:10:34;ARG;ARGUS 220ML;2;14500;0;29000;26600;2400;
2021-07-25 22:13:34;6907992824963;JD MILKY CHOCOLATE;1;3000;0;3000;2600;400;
2021-07-25 22:17:25;6907992823645;JD COCONUT BLISS;1;4000;0;4000;3500;500;
2021-07-25 22:17:25;6907992823829;JD MILKY MILK;1;3000;0;3000;2600;400;
2021-07-26 11:53:11;8998866203104;MIE SEDAAP SINGAPORE;2;2500;0;5000;4532;468;
2021-07-26 11:53:11;PRG;PARAGO;1;500;0;500;400;100;
2021-07-26 11:53:11;8997210107877;VORTEX SMART 3;1;5000;0;5000;4750;250;
2021-07-26 11:53:11;8998989300261;GUDANG GARAM SURYA 12 FILTER;1;18500;0;18500;17200;1300;
2021-07-26 11:53:11;8993470671752;JOGER STICK DUO KACANG;1;1000;0;1000;850;150;
2021-07-26 11:53:11;HT;HOT-HOT;2;500;0;1000;700;300;
2021-07-26 11:53:11;8992761111540;FANTA STRAWBERY SLIM CAM 250ML;2;5000;0;10000;7500;2500;
2021-07-26 11:53:11;8998866201889;KRISBEE PILLOW STRAWBERRY ICE CREAM 120GR;1;8000;0;8000;7250;750;
2021-07-26 11:53:11;8992775001691;GARUDA ROSTA WAGYU BEEF;1;8000;0;8000;7322;678;
2021-07-26 11:53:11;8851019210193;POCKY CHOCO BANANA 47G;1;7300;0;7300;5671;1629;
2021-07-26 11:53:11;8992696404441;BEAR BRAND 189ML;1;9000;0;9000;7887;1113;
2021-07-26 11:53:11;8998866200301;MIE SEDAAP GORENG;1;2500;0;2500;2023;477;
2021-07-26 11:53:11;PD;PENDEKAR;1;500;0;500;350;150;
2021-07-26 11:53:11;8997009510116;LEMON WATER;1;7000;0;7000;5694;1306;
2021-07-26 11:53:11;8997009510123;ORANGE WATER;1;7000;0;7000;6089;911;
2021-07-26 12:57:26;8998866200301;MIE SEDAAP GORENG;1;2500;0;2500;2023;477;
2021-07-26 12:57:26;8998866200325;MIE SEDAAP SOTO;1;2500;0;2500;1952;548;
2021-07-26 12:57:26;8998866202404;NOODLE SEDAAP MIE KOREAN SPICY CHICKEN CUP;1;5000;0;5000;4002;998;
2021-07-26 12:57:26;8998866200837;NOODLE SEDAAPMIE SOTO CUP 81 GR;1;4500;0;4500;3650;850;
2021-07-26 13:02:42;8994834006128;TICTIC PEDAS;3;2000;0;6000;5100;900;
2021-07-26 13:02:42;8992696422735;DNCO CKLT UHT 110ML;1;2500;0;2500;2041;459;
2021-07-26 13:02:42;8992696523081;MILO UHT 110ML;2;2500;0;5000;3924;1076;
2021-07-26 13:02:42;8992775002582;DILAN CHOCO;1;2000;0;2000;1503;497;
2021-07-26 13:02:42;COKLAT;COKLAT COIN;1;500;0;500;425;75;
2021-07-26 13:44:23;8998989300261;GUDANG GARAM SURYA 12 FILTER;1;18500;0;18500;17200;1300;
2021-07-26 13:44:23;VCL;VITAMIN C500 LEMON;20;1000;0;20000;11500;8500;
2021-07-26 13:56:19;HT;HOT-HOT;2;500;0;1000;700;300;
2021-07-26 13:56:19;8992775001653;GERY SALUT CHOCOLATE COCONUT;1;2000;0;2000;1476;524;
2021-07-26 13:56:19;8992775002582;DILAN CHOCO;1;2000;0;2000;1503;497;
2021-07-26 14:02:45;8997011700123;BIHUN JAGUNG 300GR;2;6000;0;12000;9958;2042;
2021-07-26 14:42:38;8999999529604;CLEAR SHP COMPLETE CARE MEN 160ML;1;24800;0;24800;22700;2100;
2021-07-26 15:31:40;8999909096004;SAMPOERNA 16 FILTER;1;24000;0;24000;23000;1000;
2021-07-26 15:41:43;8998866203104;MIE SEDAAP SINGAPORE;1;2500;0;2500;2266;234;
2021-07-26 15:41:43;089686044249;SUPERMI NUTRIMI STEAK AYAM;1;3500;0;3500;2800;700;
2021-07-26 16:45:20;8998866201520;KOPI TOP TORAJA MURNI;1;11000;0;11000;9600;1400;
2021-07-26 16:45:34;8999909002821;MARLBORO BLACK 16;1;22000;0;22000;20850;1150;
2021-07-26 16:45:47;8997009510123;ORANGE WATER;1;7000;0;7000;6089;911;
2021-07-26 17:25:18;8997231980039;O`JELLY KONYAKU (MAXI APPLE STRAWBERRY);2;5000;0;10000;9240;760;
2021-07-26 17:52:58;8996001355756;BENG-BENG MAXX SCT;1;2500;0;2500;2041;459;
2021-07-26 17:52:58;8992775002582;DILAN CHOCO;1;2000;0;2000;1503;497;
2021-07-26 17:52:58;ff;FULLO BLASTO;1;1000;0;1000;995;5;
2021-07-26 17:53:31;ff;FULLO BLASTO;1;1000;0;1000;995;5;
2021-07-26 18:27:05;8999999037765;PEPSODENT WHITE 225G;1;12000;0;12000;10750;1250;
2021-07-26 18:27:05;8998866608459;POWDET DAIA PUTIH BAG 290GR;1;5000;0;5000;4450;550;
2021-07-26 18:27:05;8992946512223;SHINZUI;1;4000;0;4000;2500;1500;
2021-07-26 18:29:31;089686021219;INTER MIE GORENG;4;1000;0;4000;3540;460;
2021-07-26 18:29:31;8997028590014;ARGUS 220ML;2;500;0;1000;604;396;
2021-07-26 18:52:18;8991102300544;WFR TANGO VNL 176G;1;10000;0;10000;8694;1306;
2021-07-26 18:52:18;8992747180126;VIXAL PEMB PORS 470ML;1;15000;0;15000;13420;1580;
2021-07-26 18:52:18;8992959508992;SWEETY SILVER PANTS L 28;1;56800;0;56800;51819;4981;
2021-07-26 19:03:29;8999999707835;CLOSEUP GREEN 65G;1;7000;0;7000;6000;1000;
2021-07-26 19:03:29;8998866106979;CIPTADENT TB CHARCOAL PROTEC;1;6000;0;6000;5250;750;
2021-07-26 19:32:21;8992696404441;BEAR BRAND 189ML;1;9000;0;9000;7887;1113;
2021-07-26 19:32:21;8999909003439;MARLBORO CRAFTED 12;1;8000;0;8000;7250;750;
2021-07-26 19:56:51;8992959953037;SWEETY BRONZE L1;1;3000;0;3000;2671;329;
2021-07-26 20:24:31;8998898853100;SUSU JAHE;2;1500;0;3000;2360;640;
2021-07-26 20:26:44;8996001600146;TEH PUCUK HARUM 350ML;1;3000;0;3000;2314;686;
2021-07-26 20:26:44;8997012321174;CHILLI-QU;1;1000;0;1000;800;200;
2021-07-26 20:26:44;089686043617;INDOMIE MIEGHETTI;1;2700;0;2700;2452;248;
2021-07-26 20:26:44;JL;JELLY;2;500;0;1000;800;200;
2021-07-26 20:26:44;MENTOS;MENTOS;1;250;0;250;175;75;
2021-07-26 20:30:32;8998866201452;POTABEE REGULER BBQ BEEF 35GR;1;5000;0;5000;4150;850;
2021-07-26 20:30:32;JL;JELLY;2;500;0;1000;800;200;
2021-07-26 20:31:41;8998866200301;MIE SEDAAP GORENG;1;2500;0;2500;2023;477;
2021-07-26 20:31:41;8998866613262;SUKSESMIE SOTO 111 GR;1;3500;0;3500;2770;730;
2021-07-26 21:40:14;GL;GULA 1 LITER;1;11500;0;11500;10500;1000;
2021-07-26 21:40:14;8998989300261;GUDANG GARAM SURYA 12 FILTER;1;18500;0;18500;17200;1300;
2021-07-26 22:14:47;8992959953174;SWEETY BRONZE M34+2;1;58000;0;58000;53182;4818;
2021-07-26 22:14:47;8992388112401;MIE ABC SELERA PEDAS- GORENG AYAM PEDAS LIMAU;2;2600;0;5200;4736;464;
2021-07-27 10:51:10;8999999192150;ROYCO FDS CHICKEN 100GR;1;5000;0;5000;4300;700;
2021-07-27 10:51:10;8999999538439;CLEAR SHP CSC UNISEX 55ML;1;5000;0;5000;3750;1250;
2021-07-27 10:51:10;8996001318911;BETTER ISI 4;1;2000;0;2000;1700;300;
2021-07-27 10:51:10;8997231980039;O`JELLY KONYAKU (MAXI APPLE STRAWBERRY);1;5000;0;5000;4620;380;
2021-07-27 10:51:10;8998866200325;MIE SEDAAP SOTO;2;2500;0;5000;3904;1096;
2021-07-27 10:51:10;RT 1000;ROTI 1000;1;1000;0;1000;800;200;
2021-07-27 10:51:10;8994867000179;ROKOK PENA MILD 16;1;14500;0;14500;13500;1000;
2021-07-27 10:51:10;8993989311699;CLAS MILD 16 FILTER;1;23000;0;23000;21700;1300;
2021-07-27 10:55:39;089686043617;INDOMIE MIEGHETTI;2;2700;0;5400;4904;496;
2021-07-27 11:00:18;8998866202244;EKOMIE BUMBU KALDU AYAM;4;1000;0;4000;3192;808;
2021-07-27 11:00:18;8998866202404;NOODLE SEDAAP MIE KOREAN SPICY CHICKEN CUP;2;5000;0;10000;8004;1996;
2021-07-27 11:04:37;8992696523081;MILO UHT 110ML;2;2500;0;5000;3924;1076;
2021-07-27 11:04:37;8998866202602;KRISBEE FRENCH FRIES 18GR;2;2000;0;4000;3000;1000;
2021-07-27 11:09:50;8997231980039;O`JELLY KONYAKU (MAXI APPLE STRAWBERRY);1;5000;0;5000;4620;380;
2021-07-27 12:08:11;GL;GULA 1 LITER;2;11500;0;23000;21000;2000;
2021-07-27 12:08:11;8999999524807;SUNLIGHT HABBATUSSAUDA POUCH 755ML;1;17000;0;17000;15400;1600;
2021-07-27 12:08:11;8991002105409;KOPI KAPAL API;1;20000;0;20000;18888;1112;
2021-07-27 12:59:24;8994037800042;WENIS MERAH;1;8000;0;8000;6500;1500;
2021-07-27 12:59:24;8998866600101;CREAM EKONOMI LEMON 455G;1;5500;0;5500;4750;750;
2021-07-27 13:03:14;089686043273;INDOMIE SAMBAL RICA;1;2700;0;2700;2452;248;
2021-07-27 13:07:39;8998989500166;GUDANG GARAM MERAH BESAR 16KS;2;18000;0;36000;34000;2000;
2021-07-27 14:07:37;8998866201964;MINYAK GORENG SABRINA 2L POUCH;1;28000;0;28000;26753;1247;
2021-07-27 14:07:37;8995333032113;TERIGU GATOT KACA 1 KG;1;8500;0;8500;8012;488;
2021-07-27 14:20:01;ARG;ARGUS 220ML;4;14500;0;58000;53200;4800;
2021-07-27 14:59:12;8992628510158;SIMAS PALMIA;1;6000;0;6000;4832;1168;
2021-07-27 15:01:34;711844110144;KECAP ABC 225 ML;1;9000;0;9000;8200;800;
2021-07-27 15:01:34;8996001354018;WFR KALPA;1;20200;0;20200;18400;1800;
2021-07-27 15:01:34;8992775310212;GERY PASTA COKELAT;1;18000;0;18000;16029;1971;
2021-07-27 15:01:34;089686010190;INDOMIE KARI AYAM;2;2800;0;5600;5044;556;
2021-07-27 15:01:34;8998866200301;MIE SEDAAP GORENG;3;2500;0;7500;6069;1431;
2021-07-27 15:01:34;8992761166205;FRESTEA GREEN HONEY 350ML;1;4500;0;4500;3000;1500;
2021-07-28 11:17:59;8992959953198;SWEETY BRONZE  XL 26+2;1;60000;0;60000;54091;5909;
2021-07-28 11:46:08;8993365600089;MADU TJ JOYBEE JERUK 200ML;1;20000;0;20000;9440;10560;
2021-07-28 11:46:08;8992761122331;FRESTEA APPEL 500ML;1;6500;0;6500;4708;1792;
2021-07-28 11:46:08;GL;GULA 1 LITER;2;11500;0;23000;21000;2000;
2021-07-28 11:46:08;8996001402023SCT;TB TORA SUSU SCT;7;1500;0;10500;5936;4564;
2021-07-28 11:46:08;BTS;BIMURA TARO SEAWEED 250G;1;10000;0;10000;9300;700;
2021-07-28 11:46:08;8998866202343;MIE SEDAAP KOREAN SPICY;1;2500;0;2500;2023;477;
2021-07-28 11:46:08;8999999059309;LIFEBUOY TS TOTAL 10 DG 75G;1;3000;0;3000;2640;360;
2021-07-28 11:46:08;8998866202244;EKOMIE BUMBU KALDU AYAM;6;1000;0;6000;4788;1212;
2021-07-28 11:46:08;089686021219;INTER MIE GORENG;3;1000;0;3000;2655;345;
2021-07-28 11:46:08;8992696523081;MILO UHT 110ML;1;2500;0;2500;1962;538;
2021-07-28 11:46:08;8994867000179;ROKOK PENA MILD 16;1;14500;0;14500;13500;1000;
2021-07-28 11:46:08;8998989300261;GUDANG GARAM SURYA 12 FILTER;2;18500;0;37000;34400;2600;
2021-07-28 11:46:08;8998989500166;GUDANG GARAM MERAH BESAR 16KS;1;18000;0;18000;17000;1000;
2021-07-28 11:46:08;MILKITA;MILKITA;2;250;0;500;400;100;
2021-07-28 12:31:14;8996001338056;TAMARIN;1;6000;0;6000;5100;900;
2021-07-28 12:31:14;8886013257400;TWISTKO;2;1000;0;2000;1800;200;
2021-07-28 12:31:14;6907992823669;JD MILKY STRAW;1;3000;0;3000;2600;400;
2021-07-28 13:18:25;8992761166038;MMP ORANGE 300ML;1;5000;0;5000;3750;1250;
2021-07-28 13:18:25;089686386127;BUMBU RACIK NASI GORENG SOSIS;1;2000;0;2000;1620;380;
2021-07-28 13:18:25;MILKITA;MILKITA;2;250;0;500;400;100;
2021-07-28 13:24:01;76239878;MARLBORO GOLD;1;30000;0;30000;27700;2300;
2021-07-28 13:24:01;76164217;MARLBORO MERAH;1;30000;0;30000;27700;2300;
2021-07-28 13:49:52;8992696404441;BEAR BRAND 189ML;1;9000;0;9000;7887;1113;
2021-07-28 13:49:52;6907992825076;JD WATERMELON APPLE;1;2000;0;2000;1700;300;
2021-07-28 13:49:52;6907992823669;JD MILKY STRAW;1;3000;0;3000;2600;400;
2021-07-28 14:01:46;8998866501026;MINYAK GORENG SEDAAP POUCH 1 L;24;14110;0;338640;338640;0;
2021-07-28 14:01:46;8997210107877;VORTEX SMART 3;120;4750;0;570000;570000;0;
2021-07-28 14:07:01;GL;GULA 1 LITER;1;11500;0;11500;10500;1000;
2021-07-28 14:26:43;8992696404441;BEAR BRAND 189ML;1;9000;0;9000;7887;1113;
2021-07-28 14:26:43;8996001312582;MALKIST KELAPA KOPYOR SCT;1;1000;0;1000;820;180;
2021-07-28 14:26:43;8991001770301;SELAMAT CLACK VANILA;1;13000;0;13000;11800;1200;
2021-07-28 14:26:43;896867700494;AIR CLUB 1500ML;1;5000;0;5000;2987;2013;
2021-07-28 14:31:57;8996001600146;TEH PUCUK HARUM 350ML;1;3000;0;3000;2314;686;
2021-07-28 15:32:13;RT ISI 6;ROTI ISI 6;1;6000;0;6000;5000;1000;
2021-07-28 16:47:33;TGL;TEH GELAS DOS;1;20000;0;20000;17496;2504;
2021-07-28 18:49:38;8999999558086;RINSO MOLTO FERFUME ESSENSE PWD 44G;2;1000;0;2000;1610;390;
2021-07-28 18:49:38;089686043273;INDOMIE SAMBAL RICA;1;2700;0;2700;2452;248;
2021-07-28 18:49:38;8998866693608;SOKLIN FLOORCLENER HIJAU 900ML;1;14000;0;14000;12436;1564;
2021-07-28 18:53:18;8994935000070;MINYAK DUNIA 450 ML;1;7500;0;7500;6779;721;
2021-07-28 19:16:11;8991102228053;TEH GELAS BOTOL;1;3000;0;3000;1695;1305;
2021-07-28 19:16:11;JL;JELLY;4;500;0;2000;1600;400;
2021-07-28 19:54:31;GL;GULA 1 LITER;2;11500;0;23000;21000;2000;
2021-07-28 20:15:15;8998866200301;MIE SEDAAP GORENG;2;2500;0;5000;4046;954;
2021-07-28 20:45:16;8999801700054;SUSU FOYU 1 KG;1;22000;0;22000;19791;2209;
2021-07-28 22:15:14;8998866106979;CIPTADENT TB CHARCOAL PROTEC;1;6000;0;6000;5250;750;
2021-07-28 22:15:14;8998866102605;KODOMO TB REG 2IN1;1;7500;0;7500;6600;900;
2021-07-28 22:15:27;8991002121065;GOOD DAY AVOCADO DELIGHT;1;6000;0;6000;4295;1705;
2021-07-28 22:16:57;8999999195656;SARI WANGI 50X1.85;1;10000;0;10000;9500;500;
2021-07-28 22:16:57;8992775000250GT;CHOCOLATOS MATCHA DRINK;1;18000;0;18000;15862;2138;
2021-07-28 22:16:57;8991102384841;WFR TANGO LONG CKLT 130G;1;5000;0;5000;4345;655;
2021-07-28 22:16:57;8991002121065;GOOD DAY AVOCADO DELIGHT;1;6000;0;6000;4295;1705;
2021-07-28 22:16:57;VCO;VITAMIN C500 ORANGE;1;1000;0;1000;575;425;
2021-07-28 22:16:57;896867700494;AIR CLUB 1500ML;1;5000;0;5000;2987;2013;
2021-07-28 22:17:51;8992959974018;SFX SIRIH 36CM 12+1;1;17000;0;17000;15958;1042;
2021-07-28 22:20:43;8999908284907;MY BABY MINYAK TELON 90ML;1;25000;0;25000;22700;2300;
2021-07-28 22:32:21;8998866692601;SOKLIN FLOORCLENER HIJAU 450ML;1;7000;0;7000;6385;615;
2021-07-29 12:52:52;8999909010567;234 DJI SAM SOE 16;1;22000;0;22000;21500;500;
2021-07-29 12:52:52;8998866202770;MIE SEDAAP SALERO PADANG;1;2500;0;2500;2362;138;
2021-07-29 12:52:52;8998989110167;SURYA GUDANG GARAM 16 FILTER;1;25000;0;25000;23200;1800;
2021-07-29 12:52:52;GL;GULA 1 LITER;1;11500;0;11500;10500;1000;
2021-07-29 12:52:52;RT ISI 6;ROTI ISI 6;1;6000;0;6000;5000;1000;
2021-07-29 12:52:52;8991188943536;SASA SANTAN KELAPA 65ML;1;3000;0;3000;2437;563;
2021-07-29 12:52:52;8998866501033;MINYAK GORENG SEDAAP POUCH 2L;1;29000;0;29000;27746;1254;
2021-07-29 12:52:52;8992696523081;MILO UHT 110ML;1;2500;0;2500;1962;538;
2021-07-29 12:52:52;8994834003752;TICTIC;2;2000;0;4000;3400;600;
2021-07-29 13:18:00;8997009510123;ORANGE WATER;2;7000;0;14000;12178;1822;
2021-07-29 13:18:00;8998866200646;KOPI TOP MURNI;2;11000;0;22000;19200;2800;
2021-07-29 13:41:15;8993989311699;CLAS MILD 16 FILTER;1;23000;0;23000;21700;1300;
2021-07-29 14:28:00;8992696523067;MILO ACTVGO UHT 180ML;1;4500;0;4500;3515;985;
2021-07-29 17:00:20;8998866601429;POWDET DAIA BUNGA BAG 290GR;1;5000;0;5000;4450;550;
2021-07-29 17:34:11;MARS;MARSHMELLOW;8;500;0;4000;3464;536;
2021-07-29 17:42:56;PD;PENDEKAR;1;500;0;500;350;150;
2021-07-29 17:42:56;HT;HOT-HOT;1;500;0;500;350;150;
2021-07-29 17:42:56;8993470411433;JOGER CLASSIC;1;1000;0;1000;850;150;
2021-07-29 17:44:59;8991102714860;MILKIDO STRAW;1;3000;0;3000;2153;847;
2021-07-29 17:49:20;8996001355978;BENG-BENG SHARE IT 9.5G;1;10000;0;10000;8700;1300;
2021-07-29 17:49:20;8991001770301;SELAMAT CLACK VANILA;1;13000;0;13000;11800;1200;
2021-07-29 18:03:01;8996001600399;LE MINERAL 1500ML;1;5000;0;5000;4042;958;
2021-07-29 19:19:18;8992628022156;BIMOLI KLASIK TOUCH 1 LT;1;16000;0;16000;14350;1650;
2021-07-29 19:19:18;GL;GULA 1 LITER;1;11500;0;11500;10500;1000;
2021-07-29 19:19:18;8997002060168;KRP SINGKOG PDS PANDA DUO;1;8000;0;8000;7300;700;
2021-07-29 19:19:18;8995333032113;TERIGU GATOT KACA 1 KG;1;8500;0;8500;8012;488;
2021-07-29 19:19:18;8992979190986;TOTAL PUTIH SOFTENER;2;13000;0;26000;23064;2936;
2021-07-29 19:19:18;8999999707859;CLOSEUP GREEN 160G;1;15000;0;15000;13600;1400;
2021-07-29 19:19:18;8998866600538;SOKLIN FLOORCLENER PINK 400ML;1;6000;0;6000;5025;975;
2021-07-29 19:19:18;8999999561123;MOLTO PEWANGI PURPLE 820ML;1;12500;0;12500;11275;1225;
2021-07-29 19:19:18;8999999048242;SUNSILK SHP SOFT&SMOOTH 9ML;1;11000;0;11000;9300;1700;
2021-07-29 19:19:18;8999999548698;LUXTS VALVET JASMINE 4X60G;1;8500;0;8500;7650;850;
2021-07-29 20:28:03;711844610095;LARISSA UDANG 500 GR;2;11000;0;22000;19580;2420;
2021-07-29 20:28:03;8999801700054;SUSU FOYU 1 KG;1;22000;0;22000;19791;2209;
2021-07-29 21:01:26;8998989110167;SURYA GUDANG GARAM 16 FILTER;1;25000;0;25000;23200;1800;
2021-07-29 21:18:03;8992736225401;SASA TEPUNG BAKWAN 235G;1;5000;0;5000;4455;545;
2021-07-29 21:18:03;8996001600146;TEH PUCUK HARUM 350ML;1;3000;0;3000;2314;686;
2021-07-29 21:18:03;RT BAKPIA;ROTI BAKPIA;1;1000;0;1000;750;250;
2021-07-29 21:18:03;8992775002582;DILAN CHOCO;1;2000;0;2000;1503;497;
2021-07-29 21:18:03;8996001600399;LE MINERAL 1500ML;1;5000;0;5000;4042;958;
2021-07-29 21:18:03;8998866202602;KRISBEE FRENCH FRIES 18GR;1;2000;0;2000;1500;500;
2021-07-29 21:18:03;8991002105430;KAPAL API 65G;1;5000;0;5000;4145;855;
2021-07-29 21:18:03;8999999195649;SARI WANGI 25X1.86G;1;6000;0;6000;5050;950;
2021-07-29 21:18:03;8998866201964;MINYAK GORENG SABRINA 2L POUCH;1;28000;0;28000;26753;1247;
2021-07-29 21:18:03;8991102714846;MILKIDO CKLT;2;3000;0;6000;4306;1694;
2021-07-29 21:18:03;8998989300261;GUDANG GARAM SURYA 12 FILTER;1;18500;0;18500;17200;1300;
2021-07-29 21:18:03;8992696422650;NESCAFE FRENCH VANILLA;1;5000;0;5000;4099;901;
2021-07-29 21:20:59;GGK;PERMEN KARET;4;500;0;2000;1600;400;
2021-07-29 21:36:54;8999999502393;ROYCO FDS CHICKEN 8G;1;5000;0;5000;4500;500;
2021-07-29 21:36:54;8997025914059;HATARI SEE HONG;1;6000;0;6000;4911;1089;
2021-07-29 21:36:54;8998666001306GT;TB CREAMY LATTE;1;13000;0;13000;9900;3100;
2021-07-29 21:36:54;8993001003908;INDOMILK KENTAL MANIS 545G;1;15000;0;15000;13333;1667;
2021-07-29 21:36:54;8999999571924;MOLTO PURE 1OML;1;5000;0;5000;4800;200;
2021-07-29 21:46:50;8992696404441;BEAR BRAND 189ML;1;9000;0;9000;7887;1113;
2021-07-29 21:46:50;8992959508312;SWEETY SILVER PANTS XL RTG;1;15500;0;15500;13944;1556;
2021-07-29 21:46:50;8998866200837;NOODLE SEDAAPMIE SOTO CUP 81 GR;1;4500;0;4500;3650;850;
2021-07-29 21:46:50;MOBIL;GULA GULA HP;1;2000;0;2000;1700;300;
2021-07-29 22:23:47;6907992823850;JD CHOCO CIRLE;1;5500;0;5500;4700;800;
2021-07-29 22:23:47;8991002122000;ABC CHOCO MALT COFFE;1;3000;0;3000;2278;722;
2021-07-30 10:28:51;MLTO PINK;MOLTO ALL IN ONE;2;1000;0;2000;1600;400;
2021-07-30 10:28:51;8992696404441;BEAR BRAND 189ML;1;9000;0;9000;7887;1113;
2021-07-30 10:28:51;8992775315057;GERY SALUT MALKIST COKLAT;1;6500;0;6500;5516;984;
2021-07-30 10:28:51;8992959117538;SFX COMFORT SLIM WING 20;1;12000;0;12000;10947;1053;
2021-07-30 10:28:51;8991102714846;MILKIDO CKLT;1;3000;0;3000;2153;847;
2021-07-30 10:28:51;089686048704;SARIMIE GORENG AYAM KCP ISI 2;1;3500;0;3500;3120;380;
2021-07-30 10:28:51;8997210107877;VORTEX SMART 3;1;5000;0;5000;4750;250;
2021-07-30 10:28:51;8999999559854;AXE BLACK POCKET FRAG 17ML;1;10000;0;10000;8000;2000;
2021-07-30 10:28:51;8998898853100;SUSU JAHE;1;1500;0;1500;1180;320;
2021-07-30 10:28:51;8998866501033;MINYAK GORENG SEDAAP POUCH 2L;1;29000;0;29000;27746;1254;
2021-07-30 10:28:51;8998989300261;GUDANG GARAM SURYA 12 FILTER;1;18500;0;18500;17200;1300;
2021-07-30 10:28:51;CC;NICE FACIAL KILOAN 900 GR DUO;1;34500;0;34500;31325;3175;
2021-07-30 10:28:51;GL;GULA 1 LITER;1;11500;0;11500;10500;1000;
2021-07-30 10:28:51;8999999045913;LIFEBUOY MILDCARE 110GR;1;15000;0;15000;14245;755;
2021-07-30 10:28:51;8999999195649;SARI WANGI 25X1.86G;1;6000;0;6000;5050;950;
2021-07-30 10:28:51;GGK;PERMEN KARET;1;500;0;500;400;100;
2021-07-30 10:54:27;GL;GULA 1 LITER;1;11500;0;11500;10500;1000;
2021-07-30 10:58:18;8992628605151;AMANDA MARGARINE;1;5000;0;5000;3806;1194;
2021-07-30 10:58:18;8997001245887;TERIGU KITA 1KG;1;9500;0;9500;8500;1000;
2021-07-30 10:58:18;8999999192150;ROYCO FDS CHICKEN 100GR;1;5000;0;5000;4300;700;
2021-07-30 10:58:18;MENTOS;MENTOS;2;250;0;500;350;150;
2021-07-30 11:10:18;GGK;PERMEN KARET;2;500;0;1000;800;200;
2021-07-30 11:13:53;8999999556341;MOLTO EDP PINK ROSE 20ML;15;1000;0;15000;12000;3000;
2021-07-30 11:13:53;8999999057640;MOLTO EDP BLK PURPLE 20ML;5;1000;0;5000;4000;1000;
2021-07-30 12:07:06;8998866202732;MILKU STROBERI 200ML;1;3000;0;3000;2375;625;
2021-07-30 12:16:49;ARG;ARGUS 220ML;4;14500;0;58000;53200;4800;
2021-07-30 12:28:53;8999909003439;MARLBORO CRAFTED 12;1;8000;0;8000;7250;750;
2021-07-30 12:38:36;8991111112084;C&C DAILY PORE CLEANSER 50G;1;14000;0;14000;12900;1100;
2021-07-30 12:38:36;8994834003752;TICTIC;1;2000;0;2000;1700;300;
2021-07-30 12:38:36;8992761166212;FRESTEA APPLE 350ML;1;4500;0;4500;3000;1500;
2021-07-30 13:08:30;8998866203104;MIE SEDAAP SINGAPORE;2;2500;0;5000;4532;468;
2021-07-30 13:08:30;089686011036;INDOMIE GORENG PEDAS;2;2700;0;5400;4904;496;
2021-07-30 13:08:30;8998866202619;MIE SEDAAP KOREAN SPICY SOUP;4;2500;0;10000;9092;908;
2021-07-30 13:08:30;089686021219;INTER MIE GORENG;10;1000;0;10000;8850;1150;
2021-07-30 13:08:30;089686021127;INTER MIE KALDU;10;1000;0;10000;8130;1870;
2021-07-30 13:08:30;8996001600399;LE MINERAL 1500ML;1;5000;0;5000;4042;958;
2021-07-30 13:28:45;089686043051;INDOMIE COTO MAKASSAR;2;2800;0;5600;5050;550;
2021-07-30 13:28:45;8992628022156;BIMOLI KLASIK TOUCH 1 LT;1;16000;0;16000;14350;1650;
2021-07-30 13:28:45;8998866200301;MIE SEDAAP GORENG;2;2500;0;5000;4046;954;
2021-07-30 14:41:59;ROTI;ROTI 2000;1;2000;0;2000;1800;200;
2021-07-30 14:42:53;8999999536244;SUNSILK SHP THICK N LONG170ML;1;20000;0;20000;18150;1850;
2021-07-30 14:45:58;8992761002022;SPRITE PET 390ML;1;5500;0;5500;4300;1200;
2021-07-30 14:45:58;8991102387286SCT;TANGO LONG CKLT 47G;1;2000;0;2000;1551;449;
2021-07-30 14:49:37;6907992823874;JD CRUNCHY CHOCO BLUEBERRY;1;5500;0;5500;4700;800;
2021-07-30 16:33:03;089686043273;INDOMIE SAMBAL RICA;5;2700;0;13500;12260;1240;
2021-07-30 16:33:03;089686021219;INTER MIE GORENG;4;1000;0;4000;3540;460;
2021-07-30 16:33:03;8993072254056;MELROSE COTTON BUDS KCL;1;3000;0;3000;2450;550;
2021-07-30 16:33:03;KOPIKO;KOPIKO;6;250;0;1500;1050;450;
2021-07-30 16:54:26;001;PASEO SMART FACIAL SF 250S GT;1;10000;0;10000;9500;500;
2021-07-30 16:54:26;ARG;ARGUS 220ML;2;14500;0;29000;26600;2400;
2021-07-30 17:33:09;8996001600146;TEH PUCUK HARUM 350ML;1;3000;0;3000;2314;686;
2021-07-30 17:33:09;8992761166212;FRESTEA APPLE 350ML;1;4500;0;4500;3000;1500;
2021-07-30 17:50:57;8998866609043;DAIA SOFTENER GUSSET 565G;1;10000;0;10000;8700;1300;
2021-07-30 17:50:57;8992959508992;SWEETY SILVER PANTS L 28;1;56800;0;56800;51819;4981;
2021-07-30 17:50:57;8992775311998;GERY CHOCOLATOS;1;17000;0;17000;15483;1517;
2021-07-30 17:51:53;BB;PASEO SMARTY FACIAL TRAVEL PACK 50S GT;2;3000;0;6000;3960;2040;
2021-07-30 17:51:53;8997018720018;SIRUP DHT;1;23000;0;23000;20958;2042;
2021-07-30 18:58:40;8992745320326;STELLA ORG 200ML;1;15000;0;15000;13300;1700;
2021-07-30 19:08:21;8999909085114;SAMPOERNA KRETEK HIJAU 12;1;13000;0;13000;11650;1350;
2021-07-30 19:56:12;8999909085114;SAMPOERNA KRETEK HIJAU 12;1;13000;0;13000;11650;1350;
2021-07-30 20:04:32;8993989311699;CLAS MILD 16 FILTER;1;23000;0;23000;21700;1300;
2021-07-30 20:07:56;089686060362;POP MIE SOTO AYAM JUMBO;2;4500;0;9000;7666;1334;
2021-07-30 20:07:56;8998009020186;BUAVITA GUAVA 250ML;4;7000;0;28000;24332;3668;
2021-07-30 20:07:56;8998866200851;NOODLE SEDAAP MIE BAKSO SPESIAL CUP 77 GR;1;4500;0;4500;3650;850;
2021-07-30 20:07:56;8998866200813;NOODLE SEDAAP MIE GORENG CUP 85 GR;2;5000;0;10000;7834;2166;
2021-07-30 20:09:09;8992761111533;SPRITE SLIM CAM250ML;1;5000;0;5000;3750;1250;
2021-07-30 20:55:09;8998989500128;GUDANG GARAM MERAH KECIL 12KS;2;14000;0;28000;26000;2000;
2021-07-30 21:55:00;8992959508312;SWEETY SILVER PANTS XL RTG;1;15500;0;15500;13944;1556;
2021-07-30 21:55:00;8992959953037;SWEETY BRONZE L1;2;3000;0;6000;5342;658;
2021-07-30 22:08:11;8886001038011;BENG-BENG SCT;2;1500;0;3000;2900;100;
2021-07-30 22:08:11;RT MENARA;ROTI TAWAR MENARA;1;8000;0;8000;7200;800;
2021-07-30 22:08:19;8886001038011;BENG-BENG SCT;1;1500;0;1500;1450;50;
2021-07-30 22:37:35;8993072254056;MELROSE COTTON BUDS KCL;1;3000;0;3000;2450;550;
2021-07-31 10:21:47;089686440287;OPOR AYAM;1;5000;0;5000;4500;500;
2021-07-31 10:21:47;8997011700123;BIHUN JAGUNG 300GR;1;6000;0;6000;4979;1021;
2021-07-31 10:21:47;8991188943543;SASA SANTAN KELAPA 200ML;2;9500;0;19000;16800;2200;
2021-07-31 10:33:40;8994867000179;ROKOK PENA MILD 16;1;14500;0;14500;13500;1000;
2021-07-31 10:51:33;089686043051;INDOMIE COTO MAKASSAR;2;2800;0;5600;5050;550;
2021-07-31 10:51:33;ROTI;ROTI 2000;2;2000;0;4000;3600;400;
2021-07-31 10:51:33;BTS;BIMURA TARO SEAWEED 250G;1;10000;0;10000;9300;700;
2021-07-31 10:57:55;9556001004673;MILO NESTLE MALAYSIA ACTIVE GO;1;85000;0;85000;80000;5000;
2021-07-31 10:57:55;8992628020152;BIMOLI POUCH 2L;1;31000;0;31000;29800;1200;
2021-07-31 10:57:55;ROTI;ROTI 2000;2;2000;0;4000;3600;400;
2021-07-31 13:39:45;8998866500708;FLORIDINA ORANGE;1;3000;0;3000;2500;500;
2021-07-31 13:56:36;8992775315057;GERY SALUT MALKIST COKLAT;1;6500;0;6500;5516;984;
2021-07-31 13:56:36;8992775002933;GERY MALKIST DOUBLE ABON;1;6500;0;6500;5516;984;
2021-07-31 14:09:03;8998989110167;SURYA GUDANG GARAM 16 FILTER;1;25000;0;25000;23200;1800;
2021-07-31 14:11:37;8996001440001SCT;TB SUSU JAHE SCT;2;1500;0;3000;1740;1260;
2021-07-31 14:11:37;8993379200879;SABUN HARMONY MELON 70G;1;2000;0;2000;1652;348;
2021-07-31 14:11:37;8998866500708;FLORIDINA ORANGE;1;3000;0;3000;2500;500;
2021-07-31 14:11:37;8886013213208;FRENCH FREIS 2000;1;5000;0;5000;3750;1250;
2021-07-31 14:11:37;BAYFLAST;BAYPLAST;4;500;0;2000;1400;600;
2021-07-31 15:10:15;8999908082800;MARINA HEALTHY AND GLOW;1;10000;0;10000;8500;1500;
2021-07-31 15:10:15;8999908010704;MARINA BRIGHT AND FRESH;1;10000;0;10000;8500;1500;
2021-07-31 16:30:41;CK;COOKIEZ;2;1000;0;2000;1450;550;
2021-07-31 16:32:14;8998989300261;GUDANG GARAM SURYA 12 FILTER;1;18500;0;18500;17200;1300;
2021-07-31 16:55:27;8998866611718;EKONOMI PENCUCI PIRING  LIQ 780ML;1;12000;0;12000;10900;1100;
2021-07-31 16:55:27;8998866610223;DAIA VIOLET BAG 850G & PIRING;1;18000;0;18000;15627;2373;
2021-07-31 16:55:27;SKT;SIKAT CUCI;1;6000;0;6000;5000;1000;
2021-07-31 16:57:24;8992959953198;SWEETY BRONZE  XL 26+2;1;60000;0;60000;54091;5909;
2021-07-31 16:57:24;8999999032128;ZWITSAL BATH NAT HAIR&BODY 100ML;1;12100;0;12100;10835;1265;
2021-07-31 16:57:24;8999999706180;PEPSODENT WHITE 190GR;1;10000;0;10000;9350;650;
2021-07-31 16:57:24;8998866202923;FLORIDINA COCO;1;3000;0;3000;2500;500;
2021-07-31 16:58:31;001;PASEO SMART FACIAL SF 250S GT;1;10000;0;10000;9500;500;
2021-07-31 17:17:44;8992775305164;GERY MALKIST GREEN TEA;1;6500;0;6500;5500;1000;
2021-07-31 17:17:44;8997218380135;ICHITAN GREEN TEA;1;8000;0;8000;6583;1417;
2021-07-31 17:44:02;8991102714860;MILKIDO STRAW;1;3000;0;3000;2153;847;
2021-07-31 17:47:23;ARG;ARGUS 220ML;1;14500;0;14500;13300;1200;
2021-07-31 17:56:28;8998009010569;ULTRA CHO 200;1;5000;0;5000;3830;1170;
2021-07-31 18:48:19;HT;HOT-HOT;2;500;0;1000;700;300;
2021-07-31 19:06:18;ARG;ARGUS 220ML;1;14500;0;14500;13300;1200;
2021-07-31 19:06:18;8997027300089;NOMOS;1;4000;0;4000;2963;1037;
2021-07-31 19:06:18;8996001600146;TEH PUCUK HARUM 350ML;1;3000;0;3000;2314;686;
2021-07-31 19:12:33;8993989311699;CLAS MILD 16 FILTER;1;23000;0;23000;21700;1300;
2021-07-31 19:12:33;8992761164478;FRESTEA MILK TEA;1;8000;0;8000;6575;1425;
2021-07-31 19:12:33;8998866201452;POTABEE REGULER BBQ BEEF 35GR;1;5000;0;5000;4150;850;
2021-07-31 19:58:41;GL;GULA 1 LITER;4;11500;0;46000;42000;4000;
2021-07-31 20:14:19;8992696422735;DNCO CKLT UHT 110ML;1;2500;0;2500;2041;459;
2021-07-31 20:14:19;8992696523081;MILO UHT 110ML;1;2500;0;2500;1962;538;
2021-07-31 20:14:19;8994834003752;TICTIC;2;2000;0;4000;3400;600;
2021-07-31 20:22:33;8993989311699;CLAS MILD 16 FILTER;1;23000;0;23000;21700;1300;
2021-07-31 20:22:33;089686014280;SUPERMI AYAM BAWANG;2;2500;0;5000;4624;376;
2021-07-31 20:22:33;089686010107;INDOMIE KALDU AYAM;1;2500;0;2500;2150;350;
2021-07-31 21:27:53;GL;GULA 1 LITER;1;11500;0;11500;10500;1000;
2021-07-31 21:27:53;8997027300089;NOMOS;1;4000;0;4000;2963;1037;
2021-07-31 21:27:53;8993379260026;SABUN MEDICARE BLACK;1;2500;0;2500;2237;263;
2021-07-31 21:27:53;8993379260804;SABUN MEDICARE BLUE;1;2500;0;2500;2237;263;
2021-07-31 21:27:53;8991002105584;KAPAL API 6.5 G;10;500;0;5000;3900;1100;
2021-07-31 21:27:53;8998866200882;SUKSESMIE GORENG AYAM KRMS 133GR;1;3500;0;3500;3047;453;
2021-07-31 21:27:53;HT;HOT-HOT;2;500;0;1000;700;300;
2021-07-31 21:28:36;ROTI;ROTI 2000;3;2000;0;6000;5400;600;
2021-07-31 21:40:20;8999999528829;CITRA SAKURA FAIR UV 120ML;1;11200;0;11200;10082;1118;
2021-07-31 21:40:20;8992222091961;PUCELLE MIST COL SPRAY 75ML;1;13000;0;13000;11650;1350;
2021-07-31 21:40:20;8991111109114;JB BEDTIME 150+50G;1;10000;0;10000;9210;790;
2021-07-31 21:40:20;8999999555122;MOLTO K-ROMANCE 20ML;10;1000;0;10000;8000;2000;
2021-07-31 21:40:20;8998866201377;KRISBEE FRIES KENTANG GORENG 68 GR;1;5500;0;5500;4620;880;
2021-07-31 21:40:20;089686010824;INDOMIE GORENG SPESIAL;4;2700;0;10800;9808;992;
2021-07-31 21:40:20;8997218380135;ICHITAN GREEN TEA;1;8000;0;8000;6583;1417;
2021-08-01 12:51:51;8992959954058;SWEETY BRONZE NB 44;1;48000;0;48000;45682;2318;
2021-08-01 12:51:51;8992759120264;LARISST 220;1;10000;0;10000;9200;800;
2021-08-01 13:42:33;8998989110167;SURYA GUDANG GARAM 16 FILTER;1;25000;0;25000;23200;1800;
2021-08-01 14:07:01;8992696404441;BEAR BRAND 189ML;1;9000;0;9000;7887;1113;
2021-08-01 14:43:01;GL;GULA 1 LITER;2;11500;0;23000;21000;2000;
2021-08-01 14:43:01;ROTI;ROTI 2000;5;2000;0;10000;9000;1000;
2021-08-01 14:43:01;089686060102;POP MIE PEDE GLEDEEK;1;5000;0;5000;4450;550;
2021-08-01 14:43:01;8996001600399;LE MINERAL 1500ML;1;5000;0;5000;4042;958;
2021-08-01 14:43:01;SLAIM;SLAIM WARNA;1;2000;0;2000;1743;257;
2021-08-01 14:46:39;089686067002;POP MIE PDS DOWER RS AYAM;1;5000;0;5000;4450;550;
2021-08-01 14:46:39;089686043617;INDOMIE MIEGHETTI;1;2700;0;2700;2452;248;
2021-08-01 14:46:39;8997028590014;ARGUS 220ML;4;500;0;2000;1208;792;
2021-08-01 14:46:52;8997009510017;YOU C1000 LEMON;1;10000;0;10000;9166;834;
2021-08-01 14:54:40;8997009510017;YOU C1000 LEMON;2;10000;0;20000;18332;1668;
2021-08-01 14:54:40;8992959953037;SWEETY BRONZE L1;2;3000;0;6000;5342;658;
2021-08-01 14:54:40;089686386127;BUMBU RACIK NASI GORENG SOSIS;1;2000;0;2000;1620;380;
2021-08-01 14:54:40;8998989500166;GUDANG GARAM MERAH BESAR 16KS;2;18000;0;36000;34000;2000;
2021-08-01 14:54:40;GGK;PERMEN KARET;1;500;0;500;400;100;
2021-08-01 14:54:40;8993226365522;GARAM MEJA GYURI 200GR;2;2000;0;4000;3400;600;
2021-08-01 14:54:40;089686010190;INDOMIE KARI AYAM;2;2800;0;5600;5044;556;
2021-08-01 14:54:40;8992696521797GT;MILO ACT GO 22G GT;1;20000;0;20000;17090;2910;
2021-08-01 14:54:40;8992761139018;ADES 600ML;1;3500;0;3500;2292;1208;
2021-08-01 14:54:40;8992761122430;FRESTEA GREEN HONEY 500ML;1;6500;0;6500;4708;1792;
2021-08-01 14:54:40;8994834006128;TICTIC PEDAS;1;2000;0;2000;1700;300;
2021-08-01 14:54:40;8992696404441;BEAR BRAND 189ML;2;9000;0;18000;15774;2226;
2021-08-01 14:54:40;8994867007161;ROKOK PENA GOLD 20;1;17000;0;17000;15500;1500;
2021-08-01 14:54:40;8996001600146;TEH PUCUK HARUM 350ML;1;3000;0;3000;2314;686;
2021-08-01 14:54:40;8998866201841;GOLDA DOLCE LATTE 200ML;1;3000;0;3000;2500;500;
2021-08-01 14:54:40;001;PASEO SMART FACIAL SF 250S GT;1;10000;0;10000;9500;500;
2021-08-01 14:54:40;8998989300261;GUDANG GARAM SURYA 12 FILTER;1;18500;0;18500;17200;1300;
2021-08-01 14:54:40;8992696523081;MILO UHT 110ML;2;2500;0;5000;3924;1076;
2021-08-01 14:54:40;8992696422735;DNCO CKLT UHT 110ML;2;2500;0;5000;4082;918;
2021-08-01 14:54:40;8994834003752;TICTIC;1;2000;0;2000;1700;300;
2021-08-01 14:54:40;8998866201452;POTABEE REGULER BBQ BEEF 35GR;1;5000;0;5000;4150;850;
2021-08-01 14:54:40;8994867000179;ROKOK PENA MILD 16;1;14500;0;14500;13500;1000;
2021-08-01 14:54:40;8999909010567;234 DJI SAM SOE 16;2;22000;0;44000;43000;1000;
2021-08-01 15:32:25;CK;COOKIEZ;2;1000;0;2000;1450;550;
2021-08-01 15:34:43;8996001355817;BENG-BENG MAXX;1;27000;0;27000;24500;2500;
2021-08-01 15:34:43;8996001600399;LE MINERAL 1500ML;3;5000;0;15000;12126;2874;
2021-08-01 15:36:07;8996001318430;BETTER 1000;2;1000;0;2000;1640;360;
2021-08-01 15:36:07;8992775000076;GERY SNACK RING CKLT;1;2000;0;2000;1712;288;
2021-08-01 15:36:07;8998009040023;TEH KOTAK;1;5000;0;5000;2827;2173;
2021-08-01 15:36:07;8991001503107;CHACHA PEANUT 35GR;1;5500;0;5500;4900;600;
2021-08-01 15:36:07;HT;HOT-HOT;1;500;0;500;350;150;
2021-08-01 15:51:24;001;PASEO SMART FACIAL SF 250S GT;1;10000;0;10000;9500;500;
2021-08-01 15:51:24;8992696404441;BEAR BRAND 189ML;1;9000;0;9000;7887;1113;
2021-08-01 16:19:36;GGK;PERMEN KARET;4;500;0;2000;1600;400;
2021-08-01 16:19:36;8994834003752;TICTIC;2;2000;0;4000;3400;600;
2021-08-01 16:19:36;8998866501033;MINYAK GORENG SEDAAP POUCH 2L;1;29000;0;29000;27746;1254;
2021-08-01 16:24:56;8994834003752;TICTIC;2;2000;0;4000;3400;600;
2021-08-01 16:48:31;8992761139018;ADES 600ML;1;3500;0;3500;2292;1208;
2021-08-01 17:06:03;VCO;VITAMIN C500 ORANGE;6;1000;0;6000;3450;2550;
2021-08-01 17:20:51;8992696422735;DNCO CKLT UHT 110ML;1;2500;0;2500;2041;459;
2021-08-01 17:20:51;8994834003752;TICTIC;1;2000;0;2000;1700;300;
2021-08-01 17:30:21;8991004011906;KOPI BORONG;1;10000;0;10000;8333;1667;
2021-08-01 17:30:21;GL;GULA 1 LITER;1;11500;0;11500;10500;1000;
2021-08-01 17:30:21;8998989300261;GUDANG GARAM SURYA 12 FILTER;1;18500;0;18500;17200;1300;
2021-08-01 18:10:13;GGK;PERMEN KARET;10;500;0;5000;4000;1000;
2021-08-01 18:39:53;8998866203104;MIE SEDAAP SINGAPORE;1;2500;0;2500;2266;234;
2021-08-01 18:39:53;8998866202770;MIE SEDAAP SALERO PADANG;1;2500;0;2500;2362;138;
2021-08-01 19:12:25;ff;FULLO BLASTO;3;1000;0;3000;2985;15;
2021-08-01 19:12:25;GGK;PERMEN KARET;1;500;0;500;400;100;
2021-08-01 19:56:25;GL;GULA 1 LITER;1;11500;0;11500;10500;1000;
2021-08-01 19:57:51;8886013213208;FRENCH FREIS 2000;1;5000;0;5000;3750;1250;
2021-08-01 20:03:53;ARG;ARGUS 220ML;2;14500;0;29000;26600;2400;
2021-08-01 20:16:45;8998866613736;EMERON LOVELY NAT 200ML;1;6000;0;6000;5075;925;
2021-08-01 20:16:45;8991111101408;JB POWDER 50G;1;3500;0;3500;3000;500;
2021-08-01 20:16:45;8992959974018;SFX SIRIH 36CM 12+1;1;17000;0;17000;15958;1042;
2021-08-01 20:18:34;8992959953037;SWEETY BRONZE L1;2;3000;0;6000;5342;658;
2021-08-01 20:30:17;ROTI;ROTI 2000;3;2000;0;6000;5400;600;
2021-08-01 20:30:17;9556001025272;NESCAFE LATTE 240ML;1;8500;0;8500;7834;666;
2021-08-01 20:30:17;8991102714860;MILKIDO STRAW;1;3000;0;3000;2153;847;
2021-08-01 20:30:17;8996001402023SCT;TB TORA SUSU SCT;1;1500;0;1500;848;652;
2021-08-01 20:30:17;8992775000076;GERY SNACK RING CKLT;1;2000;0;2000;1712;288;
2021-08-01 20:30:17;089686060126;POP MIE BASO JUMBO;1;4500;0;4500;3833;667;
2021-08-01 20:38:34;ARG;ARGUS 220ML;4;14500;0;58000;53200;4800;
2021-08-01 20:49:03;GL;GULA 1 LITER;1;11500;0;11500;10500;1000;
2021-08-01 20:49:03;8991102385121;WFR TANGO VNL 7G;1;8300;0;8300;7455;845;
2021-08-01 20:51:05;8998866202770;MIE SEDAAP SALERO PADANG;1;2500;0;2500;2362;138;
2021-08-01 20:51:05;089686010824;INDOMIE GORENG SPESIAL;1;2700;0;2700;2452;248;
2021-08-01 20:51:05;089686021127;INTER MIE KALDU;1;1000;0;1000;813;187;
2021-08-01 20:51:05;089686043051;INDOMIE COTO MAKASSAR;2;2800;0;5600;5050;550;
2021-08-01 20:58:05;8998866610087;JAVANA ORIGINAL 350ML;1;3000;0;3000;2150;850;
2021-08-01 20:58:05;8991102989381;TANGO LONG BUBBLEGUM 130G;1;5000;0;5000;4345;655;
2021-08-01 21:02:42;8998989110167;SURYA GUDANG GARAM 16 FILTER;1;25000;0;25000;23200;1800;
2021-08-01 21:02:42;8994867000162;ROKOK PUNDIMAS KRETEK16;1;10000;0;10000;8600;1400;
2021-08-01 21:02:42;8991102714631;TANGO TETRA CKLT;1;5000;0;5000;4545;455;
2021-08-01 21:08:41;001;PASEO SMART FACIAL SF 250S GT;3;10000;0;30000;28500;1500;
2021-08-01 21:18:21;8997231980039;O`JELLY KONYAKU (MAXI APPLE STRAWBERRY);2;5000;0;10000;9240;760;
2021-08-01 21:20:17;8992959508312;SWEETY SILVER PANTS XL RTG;1;15500;0;15500;13944;1556;
2021-08-01 21:20:17;COKLAT;COKLAT COIN;1;500;0;500;425;75;
2021-08-01 22:00:55;8886001038011;BENG-BENG SCT;1;1500;0;1500;1450;50;
2021-08-01 22:00:55;GGK;PERMEN KARET;1;500;0;500;400;100;
2021-08-01 22:00:55;8998989110167;SURYA GUDANG GARAM 16 FILTER;1;25000;0;25000;23200;1800;
2021-08-02 10:58:11;8992979130012;TOTAL LEMON SOFTENER;1;13000;0;13000;11532;1468;
2021-08-02 11:07:53;8994867000179;ROKOK PENA MILD 16;1;14500;0;14500;13500;1000;
2021-08-02 11:07:53;8991188943536;SASA SANTAN KELAPA 65ML;1;3000;0;3000;2437;563;
2021-08-02 11:38:23;8995333000822;TERIGU KOMPAS SOFT 500GR;1;5500;0;5500;4967;533;
2021-08-02 11:38:23;8999999524722;SUNLIGHT LIME NEW PCH 435ML;1;10000;0;10000;9100;900;
2021-08-02 12:07:14;089686021127;INTER MIE KALDU;2;1000;0;2000;1626;374;
2021-08-02 12:07:14;089686010824;INDOMIE GORENG SPESIAL;2;2700;0;5400;4904;496;
2021-08-02 12:07:14;8994834005923;SPIX 1000;5;1000;0;5000;4250;750;
2021-08-02 12:07:14;8994834001901;SUKI;3;1000;0;3000;2283;717;
2021-08-02 12:07:14;8999908042408;MY BABY POWDER BIRU;1;5000;0;5000;3275;1725;
2021-08-02 12:11:51;8998866611725;EKONOMI PENCUCI PIRING  LIQ 290ML;1;5000;0;5000;4200;800;
2021-08-02 12:11:51;8999999531492;MOLTO GLAMOUR;1;5000;0;5000;4800;200;
2021-08-02 12:11:51;8991102387286SCT;TANGO LONG CKLT 47G;2;2000;0;4000;3102;898;
2021-08-02 12:15:14;8997028590014;ARGUS 220ML;4;500;0;2000;1208;792;
2021-08-02 12:21:59;8991909101016;URBAN MILD 16;1;17000;0;17000;15800;1200;
2021-08-02 12:37:09;GGK;PERMEN KARET;2;500;0;1000;800;200;
2021-08-02 12:50:44;8998866202695;KOPI MAYOR;1;6000;0;6000;4500;1500;
2021-08-02 12:57:16;8998866501033;MINYAK GORENG SEDAAP POUCH 2L;3;29000;0;87000;83238;3762;
2021-08-02 12:57:16;ROTI;ROTI 2000;1;2000;0;2000;1800;200;
2021-08-02 12:57:16;CK;COOKIEZ;2;1000;0;2000;1450;550;
2021-08-02 14:20:30;8886001038011;BENG-BENG SCT;2;1500;0;3000;2900;100;
2021-08-02 14:20:36;6907992825076;JD WATERMELON APPLE;1;2000;0;2000;1700;300;
2021-08-02 14:55:08;8992761139018;ADES 600ML;3;3500;0;10500;6876;3624;
2021-08-02 14:55:08;8886057883665;KRATING DAENG;1;6000;0;6000;4286;1714;
2021-08-02 15:00:34;8991102213189;BLASTER UNGU;1;5000;0;5000;3106;1894;
2021-08-02 15:16:39;8992761166212;FRESTEA APPLE 350ML;1;4500;0;4500;3000;1500;
2021-08-02 15:16:39;8998866202770;MIE SEDAAP SALERO PADANG;1;2500;0;2500;2362;138;
2021-08-02 15:16:39;8998866200325;MIE SEDAAP SOTO;1;2500;0;2500;1952;548;
2021-08-02 15:16:39;8998866200301;MIE SEDAAP GORENG;1;2500;0;2500;2023;477;
2021-08-02 15:44:02;8997218380074;ICHITAN MILK TEA;1;8000;0;8000;6583;1417;
2021-08-02 15:50:00;8993989311699;CLAS MILD 16 FILTER;1;23000;0;23000;21700;1300;
2021-08-02 16:36:17;711844150027;ABC NANAS;1;13000;0;13000;12241;759;
2021-08-02 16:36:17;8995333060772;TERIGU GATOT KACA 500GR;1;4500;0;4500;4065;435;
2021-08-02 16:36:17;8998866608008;KECAP MANIS SEDAAP BOTOL 135 ML;1;6500;0;6500;5875;625;
2021-08-02 16:36:17;8999999192150;ROYCO FDS CHICKEN 100GR;1;5000;0;5000;4300;700;
2021-08-02 16:36:17;8998866609494;SOKLIN SOFTERGEN 280G BIRU;1;5000;0;5000;4425;575;
2021-08-02 16:36:17;8992696523081;MILO UHT 110ML;1;2500;0;2500;1962;538;
2021-08-02 17:01:30;VCO;VITAMIN C500 ORANGE;3;1000;0;3000;1725;1275;
2021-08-02 17:01:30;8992775002933;GERY MALKIST DOUBLE ABON;1;6500;0;6500;5516;984;
2021-08-02 17:01:30;8992388133345;NU MILK TEA TEH TARIK 330ML;1;6000;0;6000;5125;875;
2021-08-02 18:04:02;GL;GULA 1 LITER;1;11500;0;11500;10500;1000;
2021-08-02 18:04:02;PD;PENDEKAR;1;500;0;500;350;150;
2021-08-02 18:04:02;8993989311279;CLAS MILD 12;1;17000;0;17000;15700;1300;
2021-08-02 18:08:57;GGK;PERMEN KARET;4;500;0;2000;1600;400;
2021-08-02 18:08:57;8994834003752;TICTIC;1;2000;0;2000;1700;300;
2021-08-02 18:19:06;8992759120264;LARISST 220;1;10000;0;10000;9200;800;
2021-08-02 18:19:06;MARS;MARSHMELLOW;2;500;0;1000;866;134;
2021-08-02 18:19:36;8999099923005;SGM 6-12 600G;1;53000;0;53000;51951;1049;
2021-08-02 18:27:54;8886013213208;FRENCH FREIS 2000;1;5000;0;5000;3750;1250;
2021-08-02 18:27:54;089686041705;INDOMIE GORENG JUMBO;1;3500;0;3500;3143;357;
2021-08-02 18:27:54;8998866202060;POTABEE AYAM BAKAR PEDAS 35 GR;1;5000;0;5000;4150;850;
2021-08-02 18:27:54;8994834003752;TICTIC;1;2000;0;2000;1700;300;
2021-08-02 18:27:54;8850507000094;POLICE BONCHA;2;2000;0;4000;1600;2400;
2021-08-02 18:27:54;8998009010231;ULTRA CHO 250;1;6000;0;6000;4784;1216;
2021-08-02 18:27:54;8992761166038;MMP ORANGE 300ML;1;5000;0;5000;3750;1250;
2021-08-02 19:09:11;8992959974001;SFX SIRIH SLIM 36CM 6+1;1;10000;0;10000;8315;1685;
2021-08-02 19:09:11;8998989110167;SURYA GUDANG GARAM 16 FILTER;1;25000;0;25000;23200;1800;
2021-08-02 19:19:10;8999999195649;SARI WANGI 25X1.86G;1;6000;0;6000;5050;950;
2021-08-02 19:19:10;8999999529673;CLEARA  IC MENTHOL 80ML;1;11200;0;11200;10120;1080;
2021-08-02 19:19:10;8998866619004;ROYALE SUNNY DAY;1;5000;0;5000;4560;440;
2021-08-02 19:19:10;8998866609036;DAIA BUNGA GUSSET 565G;1;10000;0;10000;8700;1300;
2021-08-02 19:19:10;8992959117583;SFX DS REG FLOW WING 20;1;5000;0;5000;4288;712;
2021-08-02 19:19:10;8999999524722;SUNLIGHT LIME NEW PCH 435ML;1;10000;0;10000;9100;900;
2021-08-02 19:19:10;8998866602570;NUVO FAMILY KUNING 76G;1;2000;0;2000;1820;180;
2021-08-02 19:19:10;001;PASEO SMART FACIAL SF 250S GT;1;10000;0;10000;9500;500;
2021-08-02 19:19:10;8997013790108;BIMURA KACANG TELUR 25G;3;1000;0;3000;2625;375;
2021-08-02 19:19:10;8994834001901;SUKI;2;1000;0;2000;1522;478;
2021-08-02 19:52:59;8994834003752;TICTIC;1;2000;0;2000;1700;300;
2021-08-02 19:52:59;ROTI;ROTI 2000;2;2000;0;4000;3600;400;
2021-08-02 19:53:14;GL;GULA 1 LITER;1;11500;0;11500;10500;1000;
2021-08-02 19:53:14;8998989500166;GUDANG GARAM MERAH BESAR 16KS;2;18000;0;36000;34000;2000;
2021-08-02 19:55:38;MILKITA;MILKITA;2;250;0;500;400;100;
2021-08-02 20:07:12;8998866202619;MIE SEDAAP KOREAN SPICY SOUP;1;2500;0;2500;2273;227;
2021-08-02 20:07:12;089686041705;INDOMIE GORENG JUMBO;1;3500;0;3500;3143;357;
2021-08-02 20:07:12;089686048704;SARIMIE GORENG AYAM KCP ISI 2;1;3500;0;3500;3120;380;
2021-08-02 20:07:12;8998866613262;SUKSESMIE SOTO 111 GR;1;3500;0;3500;2770;730;
2021-08-02 20:07:12;089686010343;INDOMIE SOTO MIE;2;2600;0;5200;4734;466;
2021-08-02 20:09:48;8998866610438;SOKLIN SOFTERGENT RED BAG 770G & PIRING;1;18000;0;18000;16680;1320;
2021-08-02 21:00:30;GGK;PERMEN KARET;20;500;0;10000;8000;2000;
2021-08-02 21:26:09;8992628605151;AMANDA MARGARINE;1;5000;0;5000;3806;1194;
2021-08-02 21:26:09;8992761164546;NUTRIBOOST STRAWBERRY 300ML;1;6500;0;6500;5300;1200;
2021-08-02 21:41:32;8994935000285;MINYAK GORENG DUNIA 4500ML;1;70000;0;70000;66433;3567;
2021-08-02 21:41:32;8992959117514;SFX NON WING 20;1;10000;0;10000;9091;909;
2021-08-02 22:41:46;8992696404441;BEAR BRAND 189ML;1;9000;0;9000;7887;1113;
2021-08-02 22:41:46;089686611618;QTELA BARBEQUE;1;5000;0;5000;4266;734;
2021-08-02 22:41:46;8992761164539;NUTRIBOOST ORANGE 300ML;1;6500;0;6500;5300;1200;
2021-08-02 22:41:46;ff;FULLO BLASTO;1;1000;0;1000;995;5;
2021-08-02 22:41:46;896867700494;AIR CLUB 1500ML;1;5000;0;5000;2987;2013;
2021-08-02 22:41:46;RT ISI 6;ROTI ISI 6;1;6000;0;6000;5000;1000;
2021-08-02 22:44:04;8994867000162;ROKOK PUNDIMAS KRETEK16;1;10000;0;10000;8600;1400;
2021-08-02 22:44:04;8992696404441;BEAR BRAND 189ML;1;9000;0;9000;7887;1113;
2021-08-02 22:47:30;RB;RED BOLD;1;19000;0;19000;17900;1100;
2021-08-02 22:48:39;8992696422735;DNCO CKLT UHT 110ML;1;2500;0;2500;2041;459;
2021-08-02 22:48:39;8994834003752;TICTIC;1;2000;0;2000;1700;300;
2021-08-02 22:51:38;8996001600146;TEH PUCUK HARUM 350ML;1;3000;0;3000;2314;686;
2021-08-02 22:51:38;8992959953037;SWEETY BRONZE L1;2;3000;0;6000;5342;658;
2021-08-02 22:55:17;GL;GULA 1 LITER;1;11500;0;11500;10500;1000;
2021-08-02 22:55:17;ROTI;ROTI 2000;2;2000;0;4000;3600;400;
2021-08-02 22:55:17;RT MNTG;ROTI SISIR MENTEGA;1;2000;0;2000;1600;400;
2021-08-02 22:55:17;8999999195656;SARI WANGI 50X1.85;1;10000;0;10000;9500;500;
2021-08-02 22:55:17;COKLAT;COKLAT COIN;1;500;0;500;425;75;
2021-08-03 09:40:12;8993226112508;GARAM REFINA;1;3000;0;3000;2461;539;
2021-08-03 09:40:12;8998666002525SCT;TB TORA CAFE CAPPUCINO SCT;5;1000;0;5000;3900;1100;
2021-08-03 09:45:48;8998866608459;POWDET DAIA PUTIH BAG 290GR;1;5000;0;5000;4450;550;
2021-08-03 09:45:48;8999999571924;MOLTO PURE 1OML;1;5000;0;5000;4800;200;
2021-08-03 09:45:48;ROTI;ROTI 2000;3;2000;0;6000;5400;600;
2021-08-03 09:45:48;8993989311699;CLAS MILD 16 FILTER;2;23000;0;46000;43400;2600;
2021-08-03 09:45:48;089686535044;SUN BERAS MERAH;1;8500;0;8500;7410;1090;
2021-08-03 09:45:48;8992628020152;BIMOLI POUCH 2L;1;31000;0;31000;29800;1200;
2021-08-03 09:45:48;8992979130012;TOTAL LEMON SOFTENER;1;13000;0;13000;11532;1468;
2021-08-03 09:45:48;8999999057640;MOLTO EDP BLK PURPLE 20ML;5;1000;0;5000;4000;1000;
2021-08-03 09:45:48;089686043051;INDOMIE COTO MAKASSAR;1;2800;0;2800;2525;275;
2021-08-03 09:45:48;8996001318430;BETTER 1000;3;1000;0;3000;2460;540;
2021-08-03 09:45:48;8994834003752;TICTIC;1;2000;0;2000;1700;300;
2021-08-03 09:45:48;8992696422735;DNCO CKLT UHT 110ML;1;2500;0;2500;2041;459;
2021-08-03 09:45:48;VTM;VITAMIN;2;500;0;1000;850;150;
2021-08-03 09:45:48;GGK;PERMEN KARET;4;500;0;2000;1600;400;
2021-08-03 09:45:48;8994834006128;TICTIC PEDAS;1;2000;0;2000;1700;300;
2021-08-03 09:45:48;089686010343;INDOMIE SOTO MIE;2;2600;0;5200;4734;466;
2021-08-03 09:45:48;8999999033200;LIFEBUOY SHP ANTI KETOMBE 70+21 ML;1;8000;0;8000;7260;740;
2021-08-03 09:45:48;8998866501033;MINYAK GORENG SEDAAP POUCH 2L;2;29000;0;58000;55492;2508;
2021-08-03 09:45:48;8992775315057;GERY SALUT MALKIST COKLAT;1;6500;0;6500;5516;984;
2021-08-03 09:58:03;8991111101316;JB OIL 50ML;1;9500;0;9500;8700;800;
2021-08-03 09:58:03;8996001305041;ROMA SANDWICH CKLT;1;7000;0;7000;5000;2000;
2021-08-03 09:58:03;8998009010231;ULTRA CHO 250;1;6000;0;6000;4784;1216;
2021-08-03 10:09:50;8999999524838;SUNLIGHT MINT POUCH 755ML;1;17000;0;17000;15400;1600;
2021-08-03 10:09:50;8992775610008;TING-TING GARUDA 2.5G;1;7500;0;7500;6296;1204;
2021-08-03 10:09:50;8992753100101;BKM FULL CREAM GOLD 370;1;15000;0;15000;14000;1000;
2021-08-03 10:09:50;8999999048488;SUNSILK SHP REFRESH ANTI DDRF 70+21ML;1;10000;0;10000;9075;925;
2021-08-03 10:09:50;VCL;VITAMIN C500 LEMON;6;1000;0;6000;3450;2550;
2021-08-03 10:56:14;8993007003063;ENAAK 500G;1;11000;0;11000;9625;1375;
2021-08-03 10:56:14;8991002103238;GOOD DAY MOCACINNO;2;1500;0;3000;1780;1220;
2021-08-03 10:56:14;8998866107518;ZINC BLACK SHINE SHT 10ML;1;5000;0;5000;4500;500;
2021-08-03 10:56:14;8992933219111;NUTRIJELL CINCAU;2;6000;0;12000;10000;2000;
2021-08-03 10:56:14;8992959117583;SFX DS REG FLOW WING 20;1;5000;0;5000;4288;712;
2021-08-03 10:56:14;8991002103832;GOOD DAY CHOCOCINNO;2;1500;0;3000;1780;1220;
2021-08-03 10:56:14;8992959953167;SWEETY BRONZE S36+2;1;48000;0;48000;45682;2318;
2021-08-03 10:56:14;RB;RED BOLD;1;19000;0;19000;17900;1100;
2021-08-03 10:59:03;8998866106498;EMERON  LOVELY NTRL VT 100ML;1;3500;0;3500;2900;600;
2021-08-03 10:59:03;8992696521797SCT;MILO ACT GO 22G SCT;2;2000;0;4000;3106;894;
2021-08-03 10:59:03;8998866888622;GIV MERAH KOTAK 76G;1;2000;0;2000;1820;180;
2021-08-03 13:14:53;KJ;KINDER JOY;1;2000;0;2000;1583;417;
2021-08-03 13:42:02;6907992823911;JD CRUNCHY HONEYDEW MELON;1;8000;0;8000;6800;1200;
2021-08-03 13:42:02;6907992823904;JD CRUNCHY CHOCOLATE VAN;1;8000;0;8000;6800;1200;
2021-08-03 13:42:02;6907992824963;JD MILKY CHOCOLATE;3;3000;0;9000;7800;1200;
2021-08-03 13:54:18;8995333000822;TERIGU KOMPAS SOFT 500GR;1;5500;0;5500;4967;533;
2021-08-03 13:54:18;8994867000179;ROKOK PENA MILD 16;1;14500;0;14500;13500;1000;
2021-08-03 13:54:18;8992775315057;GERY SALUT MALKIST COKLAT;1;6500;0;6500;5516;984;
2021-08-03 13:56:32;8992959971093;SFX COMFORT SLIME 6;1;8500;0;8500;7798;702;
2021-08-03 13:58:07;8994867000162;ROKOK PUNDIMAS KRETEK16;1;10000;0;10000;8600;1400;
2021-08-03 13:58:47;8992761166205;FRESTEA GREEN HONEY 350ML;1;4500;0;4500;3000;1500;
2021-08-03 13:58:47;HT;HOT-HOT;2;500;0;1000;700;300;
2021-08-03 13:58:47;MBL;MOBIL;1;5000;0;5000;3500;1500;
2021-08-03 14:10:30;8994867000162;ROKOK PUNDIMAS KRETEK16;1;10000;0;10000;8600;1400;
2021-08-03 14:10:30;8992705045122;AGAR-AGAR SATELIT HIJAU;2;3500;0;7000;5208;1792;
2021-08-03 14:34:42;8999801700054;SUSU FOYU 1 KG;1;22000;0;22000;19791;2209;
2021-08-03 14:41:20;001;PASEO SMART FACIAL SF 250S GT;2;10000;0;20000;19000;1000;
2021-08-03 15:07:33;HT;HOT-HOT;4;500;0;2000;1400;600;
2021-08-03 15:29:29;8991689668006;SWALLOW;1;3500;0;3500;3500;0;
2021-08-03 15:33:09;8996001600146;TEH PUCUK HARUM 350ML;1;3000;0;3000;2314;686;
2021-08-03 17:17:19;8991102714631;TANGO TETRA CKLT;1;5000;0;5000;4545;455;
2021-08-03 17:17:19;8998866202732;MILKU STROBERI 200ML;1;3000;0;3000;2375;625;
2021-08-03 17:17:19;VTM;VITAMIN;1;500;0;500;425;75;
2021-08-03 17:17:19;TG APEL;TEH GELAS APEL;1;2000;0;2000;1178;822;
2021-08-03 17:17:19;PD;PENDEKAR;4;500;0;2000;1400;600;
2021-08-03 17:17:19;8994834003752;TICTIC;1;2000;0;2000;1700;300;
2021-08-03 17:17:19;GGK;PERMEN KARET;2;500;0;1000;800;200;
2021-08-03 17:33:19;8998866501026;MINYAK GORENG SEDAAP POUCH 1 L;2;15000;0;30000;28220;1780;
2021-08-03 17:37:17;8998866202312;NOODLE SEDAAP TASTY BAKMI AYAM 129 GR;1;5000;0;5000;4167;833;
2021-08-03 17:47:33;ARG;ARGUS 220ML;4;14500;0;58000;53200;4800;
2021-08-03 17:48:23;8999999007768;FAIR&LOVELY MULTIVITAMIN  CREAM 9 ML;2;4500;0;9000;6400;2600;
2021-08-03 17:48:34;ARG;ARGUS 220ML;4;14500;0;58000;53200;4800;
2021-08-03 17:49:11;ARG;ARGUS 220ML;4;14500;0;58000;53200;4800;
2021-08-03 18:07:36;8998898853100;SUSU JAHE;6;1500;0;9000;7080;1920;
2021-08-03 18:44:22;8991102020305;FORMULA TRIPLE ACTION;1;3000;0;3000;2500;500;
2021-08-03 18:44:22;8999999706180;PEPSODENT WHITE 190GR;1;10000;0;10000;9350;650;
2021-08-03 18:44:22;8993379241858;SABUN HARMONY LEMON 70G;2;2000;0;4000;3304;696;
2021-08-03 18:44:22;089686010107;INDOMIE KALDU AYAM;5;2500;0;12500;10750;1750;
2021-08-03 18:44:22;089686010824;INDOMIE GORENG SPESIAL;5;2700;0;13500;12260;1240;
2021-08-03 18:44:22;8998666001924GT;TB TORA CAFE CHOCO LATTE;1;9000;0;9000;7800;1200;
2021-08-03 18:44:22;8999999529284;MOLTO EDP FRENCH LILY SC 10ML;1;5500;0;5500;4800;700;
2021-08-03 18:44:22;8999999006006;RINSO ANTI NODA CLASSISC 750ML;1;15000;0;15000;12507;2493;
2021-08-03 18:44:22;8992979190986;TOTAL PUTIH SOFTENER;1;13000;0;13000;11532;1468;
2021-08-03 18:44:22;8994037703749;WENIS JERUK;1;8000;0;8000;6500;1500;
2021-08-03 20:35:16;8994935000070;MINYAK DUNIA 450 ML;1;7500;0;7500;6779;721;
2021-08-03 20:35:16;8992770061034;SAJIKU;2;2000;0;4000;3000;1000;
2021-08-03 21:02:27;8992761002022;SPRITE PET 390ML;1;5500;0;5500;4300;1200;
2021-08-03 21:02:27;089686010107;INDOMIE KALDU AYAM;1;2500;0;2500;2150;350;
2021-08-03 21:02:27;8998866202237;NOODLE SEDAAP TASTY AYAM GEPREK 124 GR;1;5000;0;5000;4167;833;
2021-08-03 21:55:57;089686010107;INDOMIE KALDU AYAM;1;2500;0;2500;2150;350;
2021-08-03 21:55:57;089686010824;INDOMIE GORENG SPESIAL;1;2700;0;2700;2452;248;
2021-08-03 21:55:57;8998866501026;MINYAK GORENG SEDAAP POUCH 1 L;2;15000;0;30000;28220;1780;
2021-08-03 21:56:43;GL;GULA 1 LITER;1;11500;0;11500;10500;1000;
2021-08-03 21:59:42;8998866202404;NOODLE SEDAAP MIE KOREAN SPICY CHICKEN CUP;2;5000;0;10000;8004;1996;
2021-08-03 22:01:41;8998989110167;SURYA GUDANG GARAM 16 FILTER;1;25000;0;25000;23200;1800;
2021-08-03 22:07:31;TG MARKISA;TEH GELAS MARKISA;1;2000;0;2000;1178;822;
2021-08-03 22:11:50;8996001600399;LE MINERAL 1500ML;1;5000;0;5000;4042;958;
2021-08-03 22:13:24;089686021219;INTER MIE GORENG;1;1000;0;1000;885;115;
2021-08-03 22:14:29;8992702000063;INDOMILK COKLAT 370G;1;10000;0;10000;9020;980;
2021-08-03 22:16:56;8998866202770;MIE SEDAAP SALERO PADANG;3;2500;0;7500;7086;414;
2021-08-03 22:37:31;8998866501026;MINYAK GORENG SEDAAP POUCH 1 L;1;15000;0;15000;14110;890;
2021-08-03 22:40:49;ROTI;ROTI 2000;1;2000;0;2000;1800;200;
2021-08-03 22:41:37;ROTI;ROTI 2000;1;2000;0;2000;1800;200;
2021-08-03 22:42:06;ROTI;ROTI 2000;1;2000;0;2000;1800;200;
2021-08-03 22:43:59;8998866202770;MIE SEDAAP SALERO PADANG;1;2500;0;2500;2362;138;
2021-08-03 22:43:59;089686010107;INDOMIE KALDU AYAM;1;2500;0;2500;2150;350;
2021-08-03 22:48:18;8992761166052;FRESTEA MELATI 350ML;1;4500;0;4500;3000;1500;
2021-08-03 22:49:15;8992775318201;GERY SNACK BANTAL COKLAT;1;2000;0;2000;1712;288;
2021-08-03 22:50:02;8998866201452;POTABEE REGULER BBQ BEEF 35GR;1;5000;0;5000;4150;850;
2021-08-03 22:52:49;8998866202732;MILKU STROBERI 200ML;1;3000;0;3000;2375;625;
2021-08-03 22:53:36;8992761166205;FRESTEA GREEN HONEY 350ML;1;4500;0;4500;3000;1500;
2021-08-03 23:02:49;TG APEL;TEH GELAS APEL;1;2000;0;2000;1178;822;
2021-08-03 23:04:32;TG;TEH GELAS;1;1000;0;1000;729;271;
2021-08-03 23:05:03;TG APEL;TEH GELAS APEL;1;2000;0;2000;1178;822;
2021-08-03 23:05:42;8999999001179;LIFEBUOY BW COOLFRESH LD REFF 450 ML;1;25000;0;25000;22110;2890;
2021-08-03 23:07:41;8999999571924;MOLTO PURE 1OML;1;5000;0;5000;4800;200;
2021-08-03 23:09:33;8998989300261;GUDANG GARAM SURYA 12 FILTER;1;18500;0;18500;17200;1300;
2021-08-04 11:54:43;8998866202237;NOODLE SEDAAP TASTY AYAM GEPREK 124 GR;1;5000;0;5000;4167;833;
2021-08-04 16:27:19;089686021219;INTER MIE GORENG;2;1000;0;2000;1770;230;
2021-08-04 17:57:14;8991188943536;SASA SANTAN KELAPA 65ML;2;3000;0;6000;4874;1126;
2021-08-04 20:10:21;ARG;ARGUS 220ML;1;14500;0;14500;13300;1200;
2021-08-04 20:11:29;8998009010569;ULTRA CHO 200;1;5000;0;5000;3830;1170;
2021-08-04 20:12:16;8998866201841;GOLDA DOLCE LATTE 200ML;1;3000;0;3000;2500;500;
2021-08-04 20:12:50;8998009040023;TEH KOTAK;1;5000;0;5000;2827;2173;
2021-08-04 20:15:21;ROTI;ROTI 2000;4;2000;0;8000;7200;800;
2021-08-04 20:16:02;ARG;ARGUS 220ML;1;14500;0;14500;13300;1200;
2021-08-04 20:17:53;BB;PASEO SMARTY FACIAL TRAVEL PACK 50S GT;1;3000;0;3000;1980;1020;
2021-08-04 20:21:21;8993470279651;JOGER CHOCKY BAR;3;1000;0;3000;2601;399;
2021-08-04 20:22:42;8886001038011;BENG-BENG SCT;2;1500;0;3000;2900;100;
2021-08-04 20:26:35;8996001302316;MALKIST ABON SCT;1;1000;0;1000;840;160;
2021-08-04 20:30:52;8992959953037;SWEETY BRONZE L1;2;3000;0;6000;5342;658;
2021-08-04 20:31:54;8998898853100;SUSU JAHE;1;1500;0;1500;1180;320;
2021-08-04 20:32:54;8994834006128;TICTIC PEDAS;1;2000;0;2000;1700;300;
2021-08-04 20:34:36;089686535044;SUN BERAS MERAH;1;8500;0;8500;7410;1090;
2021-08-04 20:36:35;8996001355978;BENG-BENG SHARE IT 9.5G;1;10000;0;10000;8700;1300;
2021-08-04 20:37:35;GL;GULA 1 LITER;2;11500;0;23000;21000;2000;
2021-08-04 21:01:39;8992959508862;SWEETY SILVER PANTS M 8;1;16800;0;16800;15229;1571;
2021-08-04 21:01:39;8998866203104;MIE SEDAAP SINGAPORE;4;2500;0;10000;9064;936;
2021-08-04 21:01:39;8998989300261;GUDANG GARAM SURYA 12 FILTER;1;18500;0;18500;17200;1300;
2021-08-04 21:24:40;089686021219;INTER MIE GORENG;2;1000;0;2000;1770;230;
2021-08-04 21:24:40;8997028590014;ARGUS 220ML;2;500;0;1000;604;396;
2021-08-04 21:25:37;8992759218046;JOLLY KLNR FCL CR LUNAK EMBOSS 10 ROLL;3;9000;0;27000;24225;2775;
2021-08-04 21:25:37;gula;GULA;3;11500;0;34500;30000;4500;
2021-08-04 21:33:38;8996001355978;BENG-BENG SHARE IT 9.5G;2;10000;0;20000;17400;2600;
2021-08-04 21:33:38;089686010343;INDOMIE SOTO MIE;4;2600;0;10400;9468;932;
2021-08-04 21:33:38;089686043051;INDOMIE COTO MAKASSAR;3;2800;0;8400;7575;825;
2021-08-04 21:33:38;9556001004673;MILO NESTLE MALAYSIA ACTIVE GO;1;85000;0;85000;80000;5000;
2021-08-04 21:33:38;8999999037765;PEPSODENT WHITE 225G;1;12000;0;12000;10750;1250;
2021-08-04 21:33:38;8999999524722;SUNLIGHT LIME NEW PCH 435ML;1;10000;0;10000;9100;900;
2021-08-04 21:33:38;8999999706661;PEPSODENT TB DBL CARE SENSITIVE;1;11500;0;11500;10400;1100;
2021-08-04 21:33:38;8999999525590;PEPSODENT TB KIDS;1;12900;0;12900;11700;1200;
2021-08-04 21:33:38;8998866805414;SOKLIN SMART SOFTERNER 800G & PIRING;1;20000;0;20000;18630;1370;
2021-08-04 21:33:38;8999801700054;SUSU FOYU 1 KG;1;22000;0;22000;19791;2209;
2021-08-04 21:33:38;8998866611237;FRES&NATURAL DARKBLUE 100ML;1;11500;0;11500;10310;1190;
2021-08-04 21:33:38;8999999502393;ROYCO FDS CHICKEN 8G;1;5000;0;5000;4500;500;
2021-08-04 21:34:30;8998866202466;JAPOTA HAPPY HONEY BUTTER;1;5000;0;5000;4150;850;
2021-08-04 21:45:33;8999909002821;MARLBORO BLACK 16;1;22000;0;22000;20850;1150;
2021-08-04 22:03:23;8998989300261;GUDANG GARAM SURYA 12 FILTER;1;18500;0;18500;17200;1300;
2021-08-04 22:19:48;089686010824;INDOMIE GORENG SPESIAL;2;2700;0;5400;4904;496;
2021-08-04 22:19:48;8998866200882;SUKSESMIE GORENG AYAM KRMS 133GR;2;3500;0;7000;6094;906;
2021-08-04 22:51:29;GL;GULA 1 LITER;2;11500;0;23000;21000;2000;
2021-08-04 22:52:29;8999999502393;ROYCO FDS CHICKEN 8G;1;5000;0;5000;4500;500;
2021-08-04 22:54:15;089686021141;INTER MIE SOTO;2;1000;0;2000;1708;292;
2021-08-04 22:55:42;8992696404441;BEAR BRAND 189ML;1;9000;0;9000;7887;1113;
2021-08-04 23:08:50;8995333060772;TERIGU GATOT KACA 500GR;1;4500;0;4500;4065;435;
2021-08-04 23:08:50;8995333032113;TERIGU GATOT KACA 1 KG;1;8500;0;8500;8012;488;
2021-08-04 23:08:50;8998866501026;MINYAK GORENG SEDAAP POUCH 1 L;1;15000;0;15000;14110;890;
2021-08-04 23:08:50;8994935000070;MINYAK DUNIA 450 ML;1;7500;0;7500;6779;721;
2021-08-04 23:08:50;089686043051;INDOMIE COTO MAKASSAR;1;2800;0;2800;2525;275;
2021-08-04 23:08:50;089686010824;INDOMIE GORENG SPESIAL;1;2700;0;2700;2452;248;
2021-08-04 23:08:50;089686010343;INDOMIE SOTO MIE;1;2600;0;2600;2367;233;
2021-08-04 23:08:50;8998866202770;MIE SEDAAP SALERO PADANG;3;2500;0;7500;7086;414;
2021-08-04 23:08:50;8992628510158;SIMAS PALMIA;1;6000;0;6000;4832;1168;
2021-08-04 23:08:50;8997027490018;LADAMAS MERICA BUBUK;1;9500;0;9500;8898;602;
2021-08-04 23:15:26;8993072254018;MELROSE COTTON BUDS BSR;1;5000;0;5000;4050;950;
2021-08-05 11:50:03;8992761166052;FRESTEA MELATI 350ML;1;4500;0;4500;3000;1500;
2021-08-05 12:38:17;8998866105491;EMERON LOVELY SMOTH&BRIGHT 100ML;1;4300;0;4300;3800;500;
2021-08-05 16:35:26;8992696523081;MILO UHT 110ML;2;2500;0;5000;3924;1076;
2021-08-05 16:40:55;8992696422735;DNCO CKLT UHT 110ML;1;2500;0;2500;2041;459;
2021-08-05 16:40:55;8994834006128;TICTIC PEDAS;1;2000;0;2000;1700;300;
2021-08-05 17:43:41;8998989300261;GUDANG GARAM SURYA 12 FILTER;1;18500;0;18500;17200;1300;
2021-08-05 17:43:41;8999909096004;SAMPOERNA 16 FILTER;1;24000;0;24000;23000;1000;
2021-08-05 17:47:11;711844150027;ABC NANAS;2;13000;0;26000;24482;1518;
2021-08-05 17:52:12;8998866203104;MIE SEDAAP SINGAPORE;4;2500;0;10000;9064;936;
2021-08-05 18:19:37;8998866501026;MINYAK GORENG SEDAAP POUCH 1 L;1;15000;0;15000;14110;890;
2021-08-05 18:31:13;8992761111533;SPRITE SLIM CAM250ML;3;5000;0;15000;11250;3750;
2021-08-05 19:09:55;8999909982000;SAMPOERNA 12 FILTER;1;18000;0;18000;16000;2000;
2021-08-05 19:09:55;6907992823942;JD JUJUBE;1;4500;0;4500;3800;700;
2021-08-05 19:14:12;8992959020005;SWEETY SILVER PANTS XXL 5;1;16800;0;16800;15228;1572;
2021-08-05 19:26:47;8993989311699;CLAS MILD 16 FILTER;1;23000;0;23000;21700;1300;
2021-08-05 19:34:32;8991102714860;MILKIDO STRAW;1;3000;0;3000;2153;847;
2021-08-05 20:06:24;8994867000162;ROKOK PUNDIMAS KRETEK16;1;10000;0;10000;8600;1400;
2021-08-05 21:02:21;8999909002821;MARLBORO BLACK 16;1;22000;0;22000;20850;1150;
2021-08-05 21:16:19;8994867000162;ROKOK PUNDIMAS KRETEK16;1;10000;0;10000;8600;1400;
2021-08-05 21:17:28;8992959953037;SWEETY BRONZE L1;2;3000;0;6000;5342;658;
2021-08-05 21:17:28;YP;YUPI;2;250;0;500;416;84;
2021-08-05 21:17:28;MILKITA;MILKITA;2;250;0;500;400;100;
2021-08-05 21:44:52;ARG;ARGUS 220ML;1;14500;0;14500;13300;1200;
2021-08-05 21:44:52;089686010824;INDOMIE GORENG SPESIAL;1;2700;0;2700;2452;248;
2021-08-05 21:44:52;6907992823645;JD COCONUT BLISS;1;4000;0;4000;3500;500;
2021-08-05 21:55:54;8991002122000;ABC CHOCO MALT COFFE;1;3000;0;3000;2278;722;
2021-08-05 22:20:34;8992628510158;SIMAS PALMIA;1;6000;0;6000;4832;1168;
2021-08-05 22:20:34;8995333032113;TERIGU GATOT KACA 1 KG;1;8500;0;8500;8012;488;
2021-08-05 22:20:57;MENTOS;MENTOS;2;250;0;500;350;150;
2021-08-05 22:26:25;8997027300089;NOMOS;1;4000;0;4000;2963;1037;
2021-08-05 22:26:25;8998989300261;GUDANG GARAM SURYA 12 FILTER;1;18500;0;18500;17200;1300;
2021-08-05 22:26:25;8994867007161;ROKOK PENA GOLD 20;1;17000;0;17000;15500;1500;
2021-08-06 10:39:22;8998898847109;KOPI JAHE;2;1500;0;3000;2360;640;
2021-08-06 10:39:22;8991002103238;GOOD DAY MOCACINNO;1;1500;0;1500;890;610;
2021-08-06 11:30:41;HT;HOT-HOT;8;500;0;4000;2800;1200;
2021-08-06 11:30:41;VTM;VITAMIN;10;500;0;5000;4250;750;
2021-08-06 11:30:41;GGK;PLAYGUM PERMEN KARET;12;500;0;6000;4800;1200;
2021-08-06 11:30:41;MBL;MOBIL;1;5000;0;5000;3500;1500;
2021-08-06 11:30:41;123124;KOREK BIASA;2;2000;0;4000;2600;1400;
2021-08-06 11:30:41;ROTI;ROTI 2000;9;2000;0;18000;16200;1800;
2021-08-06 11:30:41;8992959508862;SWEETY SILVER PANTS M 8;1;16800;0;16800;15229;1571;
2021-08-06 11:30:41;8992959953037;SWEETY BRONZE L1;2;3000;0;6000;5342;658;
2021-08-06 11:30:41;8991102714846;MILKIDO CKLT;2;3000;0;6000;4306;1694;
2021-08-06 11:30:41;8998866202770;MIE SEDAAP SALERO PADANG;5;2500;0;12500;11810;690;
2021-08-06 11:30:41;8998866200882;SUKSESMIE GORENG AYAM KRMS 133GR;2;3500;0;7000;6094;906;
2021-08-06 11:30:41;ARG;ARGUS 220ML;2;14500;0;29000;26600;2400;
2021-08-06 11:30:41;8999909002821;MARLBORO BLACK 16;1;22000;0;22000;20850;1150;
2021-08-06 11:30:41;8991102714860;MILKIDO STRAW;2;3000;0;6000;4306;1694;
2021-08-06 11:30:41;8992775311325;GERY SNACK&SEREAL 100G;1;7000;0;7000;6012;988;
2021-08-06 11:30:41;8886013213208;FRENCH FREIS 2000;2;5000;0;10000;7500;2500;
2021-08-06 11:30:41;8994834003752;TICTIC;3;2000;0;6000;5100;900;
2021-08-06 11:30:41;8996001600399;LE MINERAL 1500ML;1;5000;0;5000;4042;958;
2021-08-06 11:30:41;8992959953327;SWEETY BRONZE L52;1;85000;0;85000;80304;4696;
2021-08-06 11:30:41;BALON;BALON CABUT;3;1000;0;3000;2700;300;
2021-08-06 11:30:41;RT 1000;ROTI 1000;1;1000;0;1000;800;200;
2021-08-06 11:30:41;8993470671752;JOGER STICK DUO KACANG;2;1000;0;2000;1700;300;
2021-08-06 11:30:41;8992959508930;SWEETY SILVER PANTS L 54;1;108000;0;108000;99697;8303;
2021-08-06 11:30:41;8992694246340;ZWITSAL SHP NAT AVKS 100ML;1;11800;0;11800;10395;1405;
2021-08-06 11:30:41;COKLAT;COKLAT COIN;1;500;0;500;425;75;
2021-08-06 11:30:41;MENTOS;MENTOS;2;250;0;500;350;150;
2021-08-06 11:30:41;GL;GULA 1 LITER;2;11500;0;23000;21000;2000;
2021-08-06 11:30:41;8992628022156;BIMOLI KLASIK TOUCH 1 LT;1;16000;0;16000;14350;1650;
2021-08-06 11:30:41;8991102384841;WFR TANGO LONG CKLT 130G;1;5000;0;5000;4345;655;
2021-08-06 11:30:41;8991102989381;TANGO LONG BUBBLEGUM 130G;1;5000;0;5000;4345;655;
2021-08-06 11:30:41;8991102300421;WFR TANGO COKLAT 176GR;1;10000;0;10000;8694;1306;
2021-08-06 11:30:41;8993001003908;INDOMILK KENTAL MANIS 545G;1;15000;0;15000;13333;1667;
2021-08-06 11:30:41;8998989500166;GUDANG GARAM MERAH BESAR 16KS;1;18000;0;18000;17000;1000;
2021-08-06 11:30:41;MILKITA;MILKITA;8;250;0;2000;1600;400;
2021-08-06 11:30:41;8997012321174;CHILLI-QU;4;1000;0;4000;3200;800;
2021-08-06 11:30:41;JL;JELLY;4;500;0;2000;1600;400;
2021-08-06 11:30:41;TG;TEH GELAS;1;1000;0;1000;729;271;
2021-08-06 11:30:41;MARS;MARSHMELLOW;1;500;0;500;433;67;
2021-08-06 11:30:41;8992959508312;SWEETY SILVER PANTS XL RTG;1;15500;0;15500;13944;1556;
2021-08-06 11:30:41;089686021219;INTER MIE GORENG;1;1000;0;1000;885;115;
2021-08-06 11:30:41;089686021141;INTER MIE SOTO;1;1000;0;1000;854;146;
2021-08-06 11:30:41;8999909000377;SAMPOERNA AVOLUTION;1;30000;0;30000;28450;1550;
2021-08-06 11:30:41;8994867007161;ROKOK PENA GOLD 20;1;17000;0;17000;15500;1500;
2021-08-06 11:30:41;8992959953310;SWEETY BRONZE M58;1;85000;0;85000;80304;4696;
2021-08-06 11:30:41;8998866501026;MINYAK GORENG SEDAAP POUCH 1 L;2;15000;0;30000;28220;1780;
2021-08-06 11:30:41;8994867000162;ROKOK PUNDIMAS KRETEK16;2;10000;0;20000;17200;2800;
2021-08-06 11:30:41;8993058304201;BEJO JAHE MERAH;2;3000;0;6000;3786;2214;
2021-08-06 11:30:41;8991002103238;GOOD DAY MOCACINNO;1;1500;0;1500;890;610;
2021-08-06 11:30:41;TG APEL;TEH GELAS APEL;2;2000;0;4000;2356;1644;
2021-08-06 11:30:41;8994834006128;TICTIC PEDAS;4;2000;0;8000;6800;1200;
2021-08-06 11:30:41;8992696523067;MILO ACTVGO UHT 180ML;1;4500;0;4500;3515;985;
2021-08-06 11:30:41;8991102281416;PERMEN MINTZ PPMINT;2;5000;0;10000;8000;2000;
2021-08-06 11:30:41;RT ISI 6;ROTI ISI 6;1;6000;0;6000;5000;1000;
2021-08-06 11:30:41;8998866804516;GIV LEMON KOTAK 76G;1;2000;0;2000;1820;180;
2021-08-06 11:30:41;8992775001691;GARUDA ROSTA WAGYU BEEF;1;8000;0;8000;7322;678;
2021-08-06 11:30:41;8998989300261;GUDANG GARAM SURYA 12 FILTER;2;18500;0;37000;34400;2600;
2021-08-06 11:30:41;089686017748;SARIMIE GORENG ISI 2;3;3500;0;10500;9360;1140;
2021-08-06 11:30:41;8996001440124;ENERGEN VANILA;3;1500;0;4500;3450;1050;
2021-08-06 11:30:41;8998866200837;NOODLE SEDAAPMIE SOTO CUP 81 GR;1;4500;0;4500;3650;850;
2021-08-06 11:30:41;8998009020186;BUAVITA GUAVA 250ML;1;7000;0;7000;6083;917;
2021-08-06 11:30:41;8991102987875;WFR TANGO POUCH CKL 115G;1;8000;0;8000;6786;1214;
2021-08-06 11:30:41;8999909982000;SAMPOERNA 12 FILTER;1;18000;0;18000;16000;2000;
2021-08-06 11:30:41;8998866202671;NOODLE SEDAAP MIE KOREAN SPICY SOUP CUP;1;5000;0;5000;4002;998;
2021-08-06 11:30:41;089686611878;QTELA TEMPE;1;6000;0;6000;5370;630;
2021-08-06 11:30:41;089686043051;INDOMIE COTO MAKASSAR;2;2800;0;5600;5050;550;
2021-08-06 11:30:41;8997013790108;BIMURA KACANG TELUR 25G;2;1000;0;2000;1750;250;
2021-08-06 11:30:41;711844610095;LARISSA UDANG 500 GR;2;11000;0;22000;19580;2420;
2021-08-06 11:30:41;8999909001909;MAGNUM REVAMP BLACK 12;1;18000;0;18000;16300;1700;
2021-08-06 11:30:41;8991002105409;KOPI KAPAL API;1;20000;0;20000;18888;1112;
2021-08-06 11:30:41;8991002114067;PIKOPI;1;1000;0;1000;545;455;
2021-08-06 11:30:41;8991002122000;ABC CHOCO MALT COFFE;1;3000;0;3000;2278;722;
2021-08-06 11:30:41;8996001600269;LE MINERAL 600ML;2;3000;0;6000;3376;2624;
2021-08-06 11:30:41;TG MARKISA;TEH GELAS MARKISA;1;2000;0;2000;1178;822;
2021-08-06 11:30:41;KOPIKO;KOPIKO;2;250;0;500;350;150;
2021-08-06 11:30:41;8996001318430;BETTER 1000;1;1000;0;1000;820;180;
2021-08-06 11:30:41;8998866613262;SUKSESMIE SOTO 111 GR;2;3500;0;7000;5540;1460;
2021-08-06 11:30:41;8996001302316;MALKIST ABON SCT;3;1000;0;3000;2520;480;
2021-08-06 11:30:41;8999999059309;LIFEBUOY TS TOTAL 10 DG 75G;1;3000;0;3000;2640;360;
2021-08-06 11:30:41;8993379200879;SABUN HARMONY MELON 70G;1;2000;0;2000;1652;348;
2021-08-06 11:30:41;089686043204;INDOMIE MIE ACEH;2;2700;0;5400;4904;496;
2021-08-06 11:30:41;8996001355237;SUPER STAR;1;11000;0;11000;9900;1100;
2021-08-06 11:30:41;8992702000018;INDOMILK PUTIH 370G;1;10000;0;10000;9020;980;
2021-08-06 11:30:41;8998866202732;MILKU STROBERI 200ML;1;3000;0;3000;2375;625;
2021-08-06 11:30:41;RT MNTG;ROTI SISIR MENTEGA;1;2000;0;2000;1600;400;
2021-08-06 11:30:41;8999999524722;SUNLIGHT LIME NEW PCH 435ML;1;10000;0;10000;9100;900;
2021-08-06 11:30:41;001;PASEO SMART FACIAL SF 250S GT;1;10000;0;10000;9500;500;
2021-08-06 11:30:41;8992761166212;FRESTEA APPLE 350ML;1;4500;0;4500;3000;1500;
2021-08-06 11:30:41;089686834055;FREISS JERUK;1;11000;0;11000;8750;2250;
2021-08-06 11:30:41;8992742360844;POLYTEX SABUT STENLESS;1;4000;0;4000;2200;1800;
2021-08-06 11:30:41;8998866203104;MIE SEDAAP SINGAPORE;4;2500;0;10000;9064;936;
2021-08-06 11:30:41;8998866609487;SOKLIN SOFTERGEN 280G;1;5000;0;5000;4425;575;
2021-08-06 11:30:41;8999999195656;SARI WANGI 50X1.85;1;10000;0;10000;9500;500;
2021-08-06 11:30:41;089686067002;POP MIE PDS DOWER RS AYAM;1;5000;0;5000;4450;550;
2021-08-06 11:30:41;8992761002039;FANTA STRAWBERRY PET 390 ML;1;5500;0;5500;4300;1200;
2021-08-06 11:30:41;8992761002022;SPRITE PET 390ML;1;5500;0;5500;4300;1200;
2021-08-06 11:58:34;8992775002933;GERY MALKIST DOUBLE ABON;1;6500;0;6500;5516;984;
2021-08-06 11:58:45;8992761166205;FRESTEA GREEN HONEY 350ML;1;4500;0;4500;3000;1500;
2021-08-06 12:11:03;8992761164478;FRESTEA MILK TEA;1;8000;0;8000;6575;1425;
2021-08-06 12:11:03;JL;JELLY;4;500;0;2000;1600;400;
2021-08-06 12:15:23;8991909101016;URBAN MILD 16;1;17000;0;17000;15800;1200;
2021-08-06 12:15:23;123124;KOREK BIASA;1;2000;0;2000;1300;700;
2021-08-06 12:41:07;8999999042592;RINSO MOLTO PERFUME ESSENSE LIQ 4OML;1;6000;0;6000;4817;1183;
2021-08-06 12:41:07;8998009010569;ULTRA CHO 200;1;5000;0;5000;3830;1170;
2021-08-06 13:16:14;8998989500166;GUDANG GARAM MERAH BESAR 16KS;1;18000;0;18000;17000;1000;
2021-08-06 13:16:14;MILKITA;MILKITA;8;250;0;2000;1600;400;
2021-08-06 13:22:24;8994867000162;ROKOK PUNDIMAS KRETEK16;1;10000;0;10000;8600;1400;
2021-08-06 13:22:24;GGK;PLAYGUM PERMEN KARET;2;500;0;1000;800;200;
2021-08-06 13:51:45;8999999049409;REXONA MEN ICE COOL 45 ML;1;15000;0;15000;13550;1450;
2021-08-06 13:51:45;8992761139018;ADES 600ML;1;3500;0;3500;2292;1208;
2021-08-06 13:54:16;8991188943536;SASA SANTAN KELAPA 65ML;2;3000;0;6000;4874;1126;
2021-08-06 14:00:16;GL;GULA 1 LITER;3;11500;0;34500;31500;3000;
2021-08-06 14:12:39;8998898830125;KKB ENER-G ANGGUR;1;5500;0;5500;4824;676;
2021-08-06 14:12:39;8997013790108;BIMURA KACANG TELUR 25G;2;1000;0;2000;1750;250;
2021-08-06 14:12:39;089686067002;POP MIE PDS DOWER RS AYAM;1;5000;0;5000;4450;550;
2021-08-06 14:17:59;COKLAT;COKLAT COIN;2;500;0;1000;850;150;
2021-08-06 14:17:59;JGR SHN;JOGER SHINY SACHET;1;500;0;500;437;63;
2021-08-06 14:17:59;JL;JELLY;1;500;0;500;400;100;
2021-08-06 14:41:18;8993989311699;CLAS MILD 16 FILTER;1;23000;0;23000;21700;1300;
2021-08-06 15:38:39;089686021141;INTER MIE SOTO;5;1000;0;5000;4270;730;
2021-08-06 15:38:39;6907992825076;JD WATERMELON APPLE;5;2000;0;10000;8500;1500;
2021-08-06 15:38:39;6907992824963;JD MILKY CHOCOLATE;1;3000;0;3000;2600;400;
2021-08-06 16:08:38;ARG;ARGUS 220ML;4;14500;0;58000;53200;4800;
2021-08-06 16:21:50;ROTI;ROTI 2000;2;2000;0;4000;3600;400;
2021-08-06 17:10:20;8992696404441;BEAR BRAND 189ML;2;9000;0;18000;15774;2226;
2021-08-06 17:10:20;8997009510123;ORANGE WATER;1;7000;0;7000;6089;911;
2021-08-06 17:10:20;8998989300261;GUDANG GARAM SURYA 12 FILTER;1;18500;0;18500;17200;1300;
2021-08-06 17:46:47;8997018720018;SIRUP DHT;1;23000;0;23000;20958;2042;
2021-08-06 17:46:47;8998866202671;NOODLE SEDAAP MIE KOREAN SPICY SOUP CUP;1;5000;0;5000;4002;998;
2021-08-06 17:57:09;8996001600269;LE MINERAL 600ML;1;3000;0;3000;1688;1312;
2021-08-06 17:57:09;8886013257400;TWISTKO;1;1000;0;1000;900;100;
2021-08-06 17:57:09;ROTI;ROTI 2000;1;2000;0;2000;1800;200;
2021-08-06 17:57:09;8996001600375;LE MINERAL 330ML;1;2000;0;2000;1417;583;
2021-08-06 17:57:09;GGK;PLAYGUM PERMEN KARET;1;500;0;500;400;100;
2021-08-06 18:36:24;8992696523081;MILO UHT 110ML;1;2500;0;2500;1962;538;
2021-08-06 18:36:24;8994834006128;TICTIC PEDAS;2;2000;0;4000;3400;600;
2021-08-06 18:36:24;8992696422735;DNCO CKLT UHT 110ML;1;3000;0;3000;2041;959;
2021-08-06 18:36:24;089686021219;INTER MIE GORENG;3;1000;0;3000;2655;345;
2021-08-06 18:36:24;TG MARKISA;TEH GELAS MARKISA;1;2000;0;2000;1178;822;
2021-08-06 19:35:06;8999999706661;PEPSODENT TB DBL CARE SENSITIVE;3;11500;0;34500;31200;3300;
2021-08-06 19:35:38;76164217;MARLBORO MERAH;1;30000;0;30000;27700;2300;
2021-08-06 19:35:38;8999999706661;PEPSODENT TB DBL CARE SENSITIVE;3;11500;0;34500;31200;3300;
2021-08-06 19:37:13;089686043051;INDOMIE COTO MAKASSAR;1;2800;0;2800;2525;275;
2021-08-06 19:37:13;8991102022460;FORMULA DIAMOND;1;3000;0;3000;2500;500;
2021-08-06 19:37:13;8999999520151;PEPSODENT TB FAMILY SOFT;2;2500;0;5000;3800;1200;
2021-08-06 19:37:13;8991102020305;FORMULA TRIPLE ACTION;1;3000;0;3000;2500;500;
2021-08-06 19:37:13;089686010107;INDOMIE KALDU AYAM;2;2500;0;5000;4300;700;
2021-08-06 19:37:13;089686043273;INDOMIE SAMBAL RICA;3;2700;0;8100;7356;744;
2021-08-06 19:37:13;8991188943062;SASA 250G;1;10000;0;10000;8500;1500;
2021-08-06 19:37:13;GL;GULA 1 LITER;1;11500;0;11500;10500;1000;
2021-08-06 19:45:05;8998898847109;KOPI JAHE;5;1500;0;7500;5900;1600;
2021-08-06 19:45:51;GGK;PLAYGUM PERMEN KARET;1;500;0;500;400;100;
2021-08-06 20:02:21;8993989311699;CLAS MILD 16 FILTER;1;23000;0;23000;21700;1300;
2021-08-06 20:02:21;089686021127;INTER MIE KALDU;1;1000;0;1000;813;187;
2021-08-06 20:20:36;76239878;MARLBORO GOLD;1;30000;0;30000;27700;2300;
2021-08-06 20:22:16;8992761166038;MMP ORANGE 300ML;3;5000;0;15000;11250;3750;
2021-08-06 20:22:16;8992761111519;COCA COLA SLIM CAM 250ML;1;5000;0;5000;3750;1250;
2021-08-06 20:34:49;8996001600399;LE MINERAL 1500ML;1;5000;0;5000;4042;958;
2021-08-06 21:44:54;8995333032113;TERIGU GATOT KACA 1 KG;2;8500;0;17000;16024;976;
2021-08-06 21:44:54;8994935000070;MINYAK DUNIA 450 ML;1;7500;0;7500;6779;721;
2021-08-06 21:44:54;8998866501026;MINYAK GORENG SEDAAP POUCH 1 L;1;15000;0;15000;14110;890;
2021-08-06 21:44:54;GL;GULA 1 LITER;1;11500;0;11500;10500;1000;
2021-08-06 21:58:22;8992959953174;SWEETY BRONZE M34+2;1;58000;0;58000;53182;4818;
2021-08-06 21:58:22;8992775002582;DILAN CHOCO;1;2000;0;2000;1503;497;
2021-08-06 21:58:22;ARG;ARGUS 220ML;1;14500;0;14500;13300;1200;
2021-08-06 21:58:59;8999909000544;MARLBORO F BLACK;1;29000;0;29000;27800;1200;
2021-08-06 21:58:59;8992696404441;BEAR BRAND 189ML;1;9000;0;9000;7887;1113;
2021-08-06 22:22:29;9556001025272;NESCAFE LATTE 240ML;1;8500;0;8500;7834;666;
2021-08-06 22:22:29;8996001600399;LE MINERAL 1500ML;1;5000;0;5000;4042;958;
2021-08-06 22:51:28;8991102714846;MILKIDO CKLT;1;3000;0;3000;2153;847;
2021-08-06 22:51:28;ROTI;ROTI 2000;3;2000;0;6000;5400;600;
2021-08-06 22:51:28;8992761164546;NUTRIBOOST STRAWBERRY 300ML;1;6500;0;6500;5300;1200;
2021-08-07 09:34:37;8999909010567;234 DJI SAM SOE 16;2;22000;0;44000;43000;1000;
2021-08-07 09:34:37;8999909096004;SAMPOERNA 16 FILTER;2;24000;0;48000;46000;2000;
2021-08-07 09:39:19;8992696422735;DNCO CKLT UHT 110ML;1;3000;0;3000;2041;959;
2021-08-07 09:39:19;8994834006128;TICTIC PEDAS;1;2000;0;2000;1700;300;
2021-08-07 10:02:16;8996001338056;TAMARIN;1;6000;0;6000;5100;900;
2021-08-07 10:40:36;8992761139018;ADES 600ML;1;3500;0;3500;2292;1208;
2021-08-07 10:40:36;8992761166205;FRESTEA GREEN HONEY 350ML;1;4500;0;4500;3000;1500;
2021-08-07 10:43:26;8998989110167;SURYA GUDANG GARAM 16 FILTER;1;25000;0;25000;23200;1800;
2021-08-07 10:44:25;8996001338056;TAMARIN;1;6000;0;6000;5100;900;
2021-08-07 10:52:00;8998866610261;DAIA VIOLET GUSSET BAG 290 GR;1;5000;0;5000;4450;550;
2021-08-07 10:53:22;8998989100120;GUDANG GARAM MINI;1;18000;0;18000;16600;1400;
2021-08-07 11:21:11;8992979130012;TOTAL LEMON SOFTENER;1;13000;0;13000;11532;1468;
2021-08-07 11:21:11;ROTI;ROTI 2000;1;2000;0;2000;1800;200;
2021-08-07 11:21:11;GL;GULA 1 LITER;4;11500;0;46000;42000;4000;
2021-08-07 12:09:58;6907992825076;JD WATERMELON APPLE;1;2000;0;2000;1700;300;
2021-08-07 12:09:58;HT;HOT-HOT;2;500;0;1000;700;300;
2021-08-07 12:10:50;8992696404441;BEAR BRAND 189ML;2;9000;0;18000;15774;2226;
2021-08-07 12:17:11;8997009510123;ORANGE WATER;3;7000;0;21000;18267;2733;
2021-08-07 12:17:11;8998866501026;MINYAK GORENG SEDAAP POUCH 1 L;1;15000;0;15000;14110;890;
2021-08-07 12:17:59;VCO;VITAMIN C500 ORANGE;5;1000;0;5000;2875;2125;
2021-08-07 12:38:54;8992761166205;FRESTEA GREEN HONEY 350ML;1;4500;0;4500;3000;1500;
2021-08-07 12:38:54;089686043204;INDOMIE MIE ACEH;1;2700;0;2700;2452;248;
2021-08-07 12:38:54;YP;YUPI;1;250;0;250;208;42;
2021-08-07 12:43:49;9556001025272;NESCAFE LATTE 240ML;1;8500;0;8500;7834;666;
2021-08-07 12:43:49;8999908389008;HEMAVITON C1000;1;8000;0;8000;6000;2000;
2021-08-07 12:43:49;8991102320184;TANGO CHOCO JAVAMOCCA;1;5000;0;5000;4330;670;
2021-08-07 12:43:49;ROTI;ROTI 2000;1;2000;0;2000;1800;200;
2021-08-07 12:43:49;8998009020186;BUAVITA GUAVA 250ML;1;7000;0;7000;6083;917;
2021-08-07 12:54:00;8993989311279;CLAS MILD 12;1;17000;0;17000;15700;1300;
2021-08-07 13:15:41;8993989311279;CLAS MILD 12;2;17000;0;34000;31400;2600;
2021-08-07 14:54:40;8999909982000;SAMPOERNA 12 FILTER;1;18000;0;18000;16000;2000;
2021-08-07 15:20:01;8998866201841;GOLDA DOLCE LATTE 200ML;1;3000;0;3000;2500;500;
2021-08-07 15:20:01;ROTI;ROTI 2000;4;2000;0;8000;7200;800;
2021-08-07 15:44:57;8993007001359;INDOMILK KM SCT 37G;4;1500;0;6000;4332;1668;
2021-08-07 17:10:08;8996001600399;LE MINERAL 1500ML;1;5000;0;5000;4042;958;
2021-08-07 17:52:12;8998989300261;GUDANG GARAM SURYA 12 FILTER;1;18500;0;18500;17200;1300;
2021-08-07 17:52:12;8992752112013;MIZONE;4;5000;0;20000;15200;4800;
2021-08-07 17:52:12;8992761111540;FANTA STRAWBERY SLIM CAM 250ML;2;5000;0;10000;7500;2500;
2021-08-07 17:52:12;8992761111533;SPRITE SLIM CAM250ML;1;5000;0;5000;3750;1250;
2021-08-07 17:52:12;8886013213208;FRENCH FREIS 2000;1;5000;0;5000;3750;1250;
2021-08-07 17:52:12;8996001301562;MALKIST TABUR KELAPA;1;1000;0;1000;820;180;
2021-08-07 17:52:12;8992761002022;SPRITE PET 390ML;1;5500;0;5500;4300;1200;
2021-08-07 17:52:12;8996001600399;LE MINERAL 1500ML;1;5000;0;5000;4042;958;
2021-08-07 18:29:46;GGK;PLAYGUM PERMEN KARET;4;500;0;2000;1600;400;
2021-08-07 19:00:57;8992628022156;BIMOLI KLASIK TOUCH 1 LT;1;16000;0;16000;14350;1650;
2021-08-07 19:01:46;8999909096004;SAMPOERNA 16 FILTER;1;24000;0;24000;23000;1000;
2021-08-07 19:18:58;8999909096004;SAMPOERNA 16 FILTER;1;24000;0;24000;23000;1000;
2021-08-07 19:23:39;8998866608718;DAIA SOFTENER PINK;1;5000;0;5000;4450;550;
2021-08-07 19:25:21;8994867000162;ROKOK PUNDIMAS KRETEK16;1;10000;0;10000;8600;1400;
2021-08-07 20:22:39;8999999529284;MOLTO EDP FRENCH LILY SC 10ML;2;5500;0;11000;9600;1400;
2021-08-07 20:26:05;COKLAT;COKLAT COIN;12;500;0;6000;5100;900;
2021-08-07 20:28:08;8992957220025;GOLDEN CITY MINI;1;3000;0;3000;2500;500;
2021-08-07 20:38:36;8992775203422;GARUDA ROSTA OVEN 100G;1;8000;0;8000;7322;678;
2021-08-07 20:39:07;GL;GULA 1 LITER;1;11500;0;11500;10500;1000;
2021-08-07 21:06:41;8999999036638;LUX VELVET JAMINE 75G;3;3500;0;10500;8400;2100;
2021-08-07 21:09:56;8992761166212;FRESTEA APPLE 350ML;1;4500;0;4500;3000;1500;
2021-08-07 21:16:15;GL;GULA 1 LITER;1;11500;0;11500;10500;1000;
2021-08-07 21:16:15;8998989500166;GUDANG GARAM MERAH BESAR 16KS;1;18000;0;18000;17000;1000;
2021-08-07 21:28:56;089686611670;QTELA BALADO;1;5000;0;5000;4266;734;
2021-08-07 21:33:15;8992388133017;NU MILK TEA ORI 330ML;1;6000;0;6000;5125;875;
2021-08-07 21:35:27;8998989300261;GUDANG GARAM SURYA 12 FILTER;1;18500;0;18500;17200;1300;
2021-08-07 21:47:14;8998009020186;BUAVITA GUAVA 250ML;1;7000;0;7000;6083;917;
2021-08-07 21:47:14;8996001600375;LE MINERAL 330ML;1;2000;0;2000;1417;583;
2021-08-07 21:53:56;8996001600399;LE MINERAL 1500ML;4;5000;0;20000;16168;3832;
2021-08-07 21:54:13;8999909002821;MARLBORO BLACK 16;1;22000;0;22000;20850;1150;
2021-08-07 22:04:57;8719200177314;BLUE BAND 15G;1;2000;0;2000;1500;500;
2021-08-07 22:04:57;RT MENARA;ROTI TAWAR MENARA;1;8000;0;8000;7200;800;
2021-08-07 22:04:57;8992696404441;BEAR BRAND 189ML;1;9000;0;9000;7887;1113;
2021-08-07 22:07:13;8999909096004;SAMPOERNA 16 FILTER;1;24000;0;24000;23000;1000;
2021-08-08 10:16:41;8996001354001;KALPA SCT;1;2000;0;2000;1666;334;
2021-08-08 10:18:07;8992696523081;MILO UHT 110ML;2;2500;0;5000;3924;1076;
2021-08-08 10:18:07;8992696422735;DNCO CKLT UHT 110ML;1;3000;0;3000;2041;959;
2021-08-08 10:18:07;8886013213208;FRENCH FREIS 2000;1;5000;0;5000;3750;1250;
2021-08-08 10:24:10;089686386011;BUMBU RACIK NASI GORENG;1;2000;0;2000;1450;550;
2021-08-08 10:24:10;8997025914059;HATARI SEE HONG;1;6000;0;6000;4911;1089;
2021-08-08 10:27:11;8999999059323;LIFEBUOY TS LEMONFRESH 75G;2;3000;0;6000;5280;720;
2021-08-08 10:33:58;8992959953020;SWEETY BRONZE M1;1;3000;0;3000;2671;329;
2021-08-08 10:38:49;8999909002876;SAMPOERNA ULTRAMILD 12;1;17000;0;17000;14600;2400;
2021-08-08 10:41:49;8999999195656;SARI WANGI 50X1.85;1;10000;0;10000;9500;500;
2021-08-08 10:42:50;8998866202770;MIE SEDAAP SALERO PADANG;2;2500;0;5000;4724;276;
2021-08-08 10:48:04;8992388133345;NU MILK TEA TEH TARIK 330ML;1;6000;0;6000;5125;875;
2021-08-08 10:48:04;8998866202923;FLORIDINA COCO;2;3000;0;6000;5000;1000;
2021-08-08 11:00:18;8999909096004;SAMPOERNA 16 FILTER;1;24000;0;24000;23000;1000;
2021-08-08 11:00:18;8992761166205;FRESTEA GREEN HONEY 350ML;1;4500;0;4500;3000;1500;
2021-08-08 11:01:43;8992959117583;SFX DS REG FLOW WING 20;1;5000;0;5000;4288;712;
2021-08-08 11:49:03;ARG;ARGUS 220ML;1;14500;0;14500;13300;1200;
2021-08-08 11:50:46;8999909002821;MARLBORO BLACK 16;1;22000;0;22000;20850;1150;
2021-08-08 11:52:14;AMPLOP;AMPLOP;4;250;0;1000;560;440;
2021-08-08 11:53:38;AMPLOP;AMPLOP;8;250;0;2000;1120;880;
2021-08-08 11:54:32;8997025914059;HATARI SEE HONG;1;6000;0;6000;4911;1089;
2021-08-08 11:55:10;8992736424293;SASA BUMBU NASI GORENG 20G;1;2000;0;2000;1136;864;
2021-08-08 11:57:41;8999999558079;RINSO MOLTO ROSE FRESH PWD 44G;1;1000;0;1000;805;195;
2021-08-08 12:00:55;8999999558079;RINSO MOLTO ROSE FRESH PWD 44G;4;1000;0;4000;3220;780;
2021-08-08 12:07:35;8996001600375;LE MINERAL 330ML;19;2000;0;38000;26923;11077;
2021-08-08 12:18:42;8992959117613;SFX DAUN SIRIH 1 WP;1;500;0;500;413;87;
2021-08-08 12:28:29;TG APEL;TEH GELAS APEL;1;2000;0;2000;1178;822;
2021-08-08 12:33:30;8992775318201;GERY SNACK BANTAL COKLAT;1;2000;0;2000;1712;288;
2021-08-08 12:33:30;8994834005923;SPIX 1000;1;1000;0;1000;850;150;
2021-08-08 12:33:30;8992761139018;ADES 600ML;1;3500;0;3500;2292;1208;
2021-08-08 12:34:32;TG APEL;TEH GELAS APEL;1;2000;0;2000;1178;822;
2021-08-08 12:45:39;8991909101016;URBAN MILD 16;1;17000;0;17000;15800;1200;
2021-08-08 13:02:34;089686060102;POP MIE PEDE GLEDEEK;3;5000;0;15000;13350;1650;
2021-08-08 13:09:18;8999909010567;234 DJI SAM SOE 16;1;22000;0;22000;21500;500;
2021-08-08 13:29:43;ff;FULLO BLASTO;1;1000;0;1000;995;5;
2021-08-08 13:56:02;8993274532082;BULO COKLAT;1;1000;0;1000;833;167;
2021-08-08 14:01:10;8994834005923;SPIX 1000;2;1000;0;2000;1700;300;
2021-08-08 14:01:10;8994834001901;SUKI;1;1000;0;1000;761;239;
2021-08-08 14:01:10;8992696422735;DNCO CKLT UHT 110ML;1;3000;0;3000;2041;959;
2021-08-08 15:46:37;8992775311325;GERY SNACK&SEREAL 100G;1;7000;0;7000;6012;988;
2021-08-08 15:46:37;8992761164546;NUTRIBOOST STRAWBERRY 300ML;1;6500;0;6500;5300;1200;
2021-08-08 15:55:11;089686043051;INDOMIE COTO MAKASSAR;1;2800;0;2800;2525;275;
2021-08-08 15:55:11;089686021141;INTER MIE SOTO;12;1000;0;12000;10248;1752;
2021-08-08 15:57:04;089686021141;INTER MIE SOTO;2;1000;0;2000;1708;292;
2021-08-08 15:57:04;089686043051;INDOMIE COTO MAKASSAR;1;2800;0;2800;2525;275;
2021-08-08 16:11:38;8998989110167;SURYA GUDANG GARAM 16 FILTER;1;25000;0;25000;23200;1800;
2021-08-08 16:11:38;089686010824;INDOMIE GORENG SPESIAL;4;2700;0;10800;9808;992;
2021-08-08 16:11:38;089686060362;POP MIE SOTO AYAM JUMBO;1;4500;0;4500;3833;667;
2021-08-08 16:21:07;8992761002015;COCA COLA PET 390ML;2;5500;0;11000;8666;2334;
2021-08-08 16:21:07;8998866679572;SOKLIN LANTAI MERAH 780ML;1;12000;0;12000;10020;1980;
2021-08-08 17:07:03;8991102384841;WFR TANGO LONG CKLT 130G;1;5000;0;5000;4345;655;
2021-08-08 17:07:03;ROTI;ROTI 2000;2;2000;0;4000;3600;400;
2021-08-08 17:07:03;KRZ;KREZZ COKELAT;1;1000;0;1000;715;285;
2021-08-08 17:37:50;8998989110167;SURYA GUDANG GARAM 16 FILTER;1;25000;0;25000;23200;1800;
2021-08-08 17:51:10;8998989110167;SURYA GUDANG GARAM 16 FILTER;1;25000;0;25000;23200;1800;
2021-08-08 18:06:59;RT BAKPIA;ROTI BAKPIA;1;1000;0;1000;750;250;
2021-08-08 18:07:48;8992388133017;NU MILK TEA ORI 330ML;1;6000;0;6000;5125;875;
2021-08-08 18:20:36;8998866611718;EKONOMI PENCUCI PIRING  LIQ 780ML;1;12000;0;12000;10900;1100;
2021-08-08 18:33:10;ARG;ARGUS 220ML;1;14500;0;14500;13300;1200;
2021-08-08 18:33:10;8999909096004;SAMPOERNA 16 FILTER;1;24000;0;24000;23000;1000;
2021-08-08 18:33:10;8996001355237;SUPER STAR;1;11000;0;11000;9900;1100;
2021-08-08 18:50:24;8991689668006;SWALLOW;1;3500;0;3500;3500;0;
2021-08-08 18:54:41;089686067002;POP MIE PDS DOWER RS AYAM;1;5000;0;5000;4450;550;
2021-08-08 18:54:41;8991002121003;GOOD DAY TIRAMISU BLISS;1;6000;0;6000;4295;1705;
2021-08-08 19:11:24;711844340008;ABC TERASI;1;7000;0;7000;5800;1200;
2021-08-08 19:29:25;ROTI;ROTI 2000;1;2000;0;2000;1800;200;
2021-08-08 20:05:41;8994867000162;ROKOK PUNDIMAS KRETEK16;1;10000;0;10000;8600;1400;
2021-08-08 21:33:13;8995333060772;TERIGU GATOT KACA 500GR;1;4500;0;4500;4065;435;
2021-08-08 21:33:13;8995333032113;TERIGU GATOT KACA 1 KG;1;8500;0;8500;8012;488;
2021-08-08 21:33:13;MA;MALKIST ABON;1;9000;0;9000;8400;600;
2021-08-08 21:36:41;8998989300261;GUDANG GARAM SURYA 12 FILTER;1;18500;0;18500;17200;1300;
2021-08-08 21:39:07;6907992823669;JD MILKY STRAW;2;3000;0;6000;5200;800;
2021-08-08 22:09:23;RT MENARA;ROTI TAWAR MENARA;1;8000;0;8000;7200;800;
2021-08-08 22:27:45;089686010343;INDOMIE SOTO MIE;1;2600;0;2600;2367;233;
2021-08-08 22:27:45;089686010824;INDOMIE GORENG SPESIAL;1;2700;0;2700;2452;248;
2021-08-08 22:27:45;089686010107;INDOMIE KALDU AYAM;3;2500;0;7500;6450;1050;
2021-08-08 22:36:16;RT KJ;ROTI KASUR JUMBO;1;8000;0;8000;7200;800;
2021-08-09 12:12:07;8998989500166;GUDANG GARAM MERAH BESAR 16KS;1;18000;0;18000;17000;1000;
2021-08-09 12:43:36;8998866202619;MIE SEDAAP KOREAN SPICY SOUP;2;2500;0;5000;4546;454;
2021-08-09 16:44:00;GGK;PLAYGUM PERMEN KARET;1;500;0;500;400;100;
2021-08-09 16:44:00;ARG;ARGUS 220ML;1;14500;0;14500;13300;1200;
2021-08-09 17:05:40;8991002105430;KAPAL API 65G;1;5000;0;5000;4145;855;
2021-08-09 17:18:18;8991002105409;KOPI KAPAL API;1;20000;0;20000;18888;1112;
2021-08-09 17:20:32;8998866501026;MINYAK GORENG SEDAAP POUCH 1 L;1;15000;0;15000;14110;890;
2021-08-09 18:04:45;089686049053;SARIMI PUAS;1;3000;0;3000;2400;600;
2021-08-09 18:04:45;089686010343;INDOMIE SOTO MIE;1;2600;0;2600;2367;233;
2021-08-09 18:10:57;8997018460150;MARLBORO ICE BURST 20;1;30000;0;30000;27750;2250;
2021-08-09 18:21:27;8991102714846;MILKIDO CKLT;1;3000;0;3000;2153;847;
2021-08-09 18:25:47;8994867000179;ROKOK PENA MILD 16;1;14500;0;14500;13500;1000;
2021-08-09 18:28:49;8998989300261;GUDANG GARAM SURYA 12 FILTER;1;18500;0;18500;17200;1300;
2021-08-09 18:33:12;RT MENARA;ROTI TAWAR MENARA;1;8000;0;8000;7200;800;
2021-08-09 18:35:04;8993989311699;CLAS MILD 16 FILTER;1;23000;0;23000;21700;1300;
2021-08-09 18:36:38;8993989311699;CLAS MILD 16 FILTER;1;23000;0;23000;21700;1300;
2021-08-09 19:23:39;8992979190986;TOTAL PUTIH SOFTENER;1;13000;0;13000;11532;1468;
2021-08-09 19:23:39;8999999059781;SUNLIGHT LIME NEW POUCH 210ML;1;5000;0;5000;4300;700;
2021-08-09 19:33:44;8997009510123;ORANGE WATER;1;7000;0;7000;6089;911;
2021-08-09 19:40:33;8998866203104;MIE SEDAAP SINGAPORE;1;2500;0;2500;2266;234;
2021-08-09 20:00:20;8992702000018;INDOMILK PUTIH 370G;1;10000;0;10000;9020;980;
2021-08-09 20:00:20;089686021127;INTER MIE KALDU;2;1000;0;2000;1626;374;
2021-08-09 20:05:35;GGK;PLAYGUM PERMEN KARET;2;500;0;1000;800;200;
2021-08-09 20:08:10;GGK;PLAYGUM PERMEN KARET;2;500;0;1000;800;200;
2021-08-09 20:24:17;8992959953020;SWEETY BRONZE M1;1;3000;0;3000;2671;329;
2021-08-09 20:26:01;8999909085114;SAMPOERNA KRETEK HIJAU 12;1;13000;0;13000;11650;1350;
2021-08-09 20:26:54;8997018720469;TISSUE SE-KA;1;10000;0;10000;9300;700;
2021-08-09 21:05:16;8997027300089;NOMOS;1;4000;0;4000;2963;1037;
2021-08-09 21:44:43;8999999524722;SUNLIGHT LIME NEW PCH 435ML;1;10000;0;10000;9100;900;
2021-08-09 21:52:36;8992775001820;CHOCOLATOS WAFER CREAM;1;18000;0;18000;16083;1917;
2021-08-09 21:52:36;8996001350515;ZUPERRR KEJU CHOCO;1;10000;0;10000;8000;2000;
2021-08-09 22:41:17;ARG;ARGUS 220ML;1;14500;0;14500;13300;1200;
2021-08-10 11:11:54;089686611878;QTELA TEMPE;1;6000;0;6000;5370;630;
2021-08-10 11:11:54;8991102714846;MILKIDO CKLT;2;3000;0;6000;4306;1694;
2021-08-10 11:11:54;8992696404441;BEAR BRAND 189ML;1;9000;0;9000;7887;1113;
2021-08-10 11:11:54;8991102385091;WFR TANGO CKLT 7G;1;8300;0;8300;7455;845;
2021-08-10 11:11:54;8992959953198;SWEETY BRONZE  XL 26+2;1;60000;0;60000;54091;5909;
2021-08-10 11:11:54;MBL;MOBIL;1;5000;0;5000;3500;1500;
2021-08-10 11:27:33;8998989500166;GUDANG GARAM MERAH BESAR 16KS;1;18000;0;18000;17000;1000;
2021-08-10 11:30:44;8991002105409;KOPI KAPAL API;1;20000;0;20000;18888;1112;
2021-08-10 11:56:38;8999909010567;234 DJI SAM SOE 16;2;22000;0;44000;43000;1000;
2021-08-10 14:07:54;8999909002821;MARLBORO BLACK 16;1;22000;0;22000;20850;1150;
2021-08-10 14:29:58;8998866609487;SOKLIN SOFTERGEN 280G;1;5000;0;5000;4425;575;
2021-08-10 14:29:58;8998866619288;SOKLIN ANTISEP;1;5000;0;5000;4159;841;
2021-08-10 14:29:58;8999999556341;MOLTO EDP PINK ROSE 20ML;6;1000;0;6000;4800;1200;
2021-08-10 14:29:58;8999999526863;MOLTO ALL IN ONE PINK 11ML;1;5500;0;5500;4800;700;
2021-08-10 14:40:57;8993989311699;CLAS MILD 16 FILTER;1;23000;0;23000;21700;1300;
2021-08-10 14:49:36;8995333060703;TERIGU KOMPAS 1KG;1;10500;0;10500;9816;684;
2021-08-10 17:25:20;6907992823829;JD MILKY MILK;1;3000;0;3000;2600;400;
2021-08-10 17:54:04;8999999195656;SARI WANGI 50X1.85;1;10000;0;10000;9500;500;
2021-08-10 17:54:04;8992628020152;BIMOLI POUCH 2L;2;31000;0;62000;59600;2400;
2021-08-10 17:54:04;8998989300261;GUDANG GARAM SURYA 12 FILTER;1;18500;0;18500;17200;1300;
2021-08-10 17:54:04;8992775315095;GERY MALKIST SWEET CHEESE;1;6500;0;6500;5516;984;
2021-08-10 17:54:04;089686021219;INTER MIE GORENG;1;1000;0;1000;885;115;
2021-08-10 17:54:04;GGK;PLAYGUM PERMEN KARET;1;500;0;500;400;100;
2021-08-10 18:58:16;8991002103238;GOOD DAY MOCACINNO;1;1500;0;1500;890;610;
2021-08-10 18:58:16;8997018720469;TISSUE SE-KA;1;10000;0;10000;9300;700;
2021-08-10 18:58:16;8996001355008;BENG-BENG SP20G;1;29000;0;29000;26500;2500;
2021-08-10 19:05:04;8996001600399;LE MINERAL 1500ML;2;5000;0;10000;8084;1916;
2021-08-10 19:05:04;8998989110167;SURYA GUDANG GARAM 16 FILTER;1;25000;0;25000;23200;1800;
2021-08-10 19:06:26;8998989500166;GUDANG GARAM MERAH BESAR 16KS;1;18000;0;18000;17000;1000;
2021-08-10 19:09:50;8991002103238;GOOD DAY MOCACINNO;6;1500;0;9000;5340;3660;
2021-08-10 19:23:43;8993470671752;JOGER STICK DUO KACANG;2;1000;0;2000;1700;300;
2021-08-10 19:23:43;8998866202619;MIE SEDAAP KOREAN SPICY SOUP;1;2700;0;2700;2322;378;
2021-08-10 19:27:46;ARG;ARGUS 220ML;3;14500;0;43500;39900;3600;
2021-08-10 19:40:30;8992628020152;BIMOLI POUCH 2L;1;31000;0;31000;29800;1200;
2021-08-10 20:01:59;8998989300261;GUDANG GARAM SURYA 12 FILTER;1;18500;0;18500;17200;1300;
2021-08-10 20:25:08;089686060102;POP MIE PEDE GLEDEEK;1;5000;0;5000;4450;550;
2021-08-10 20:25:08;8998866200851;NOODLE SEDAAP MIE BAKSO SPESIAL CUP 77 GR;1;4500;0;4500;3738;762;
2021-08-10 20:25:08;8998866604512;FRES&NATURAL SOAP VIOLET 65G;1;1800;0;1800;1425;375;
2021-08-10 20:33:07;TS;TISSUE TESSY;1;5000;0;5000;4200;800;
2021-08-10 20:33:07;089686060102;POP MIE PEDE GLEDEEK;1;5000;0;5000;4450;550;
2021-08-10 20:33:07;8998866200851;NOODLE SEDAAP MIE BAKSO SPESIAL CUP 77 GR;1;4500;0;4500;3738;762;
2021-08-10 20:33:07;8998866604512;FRES&NATURAL SOAP VIOLET 65G;1;1800;0;1800;1425;375;
2021-08-10 20:54:08;8997011700123;BIHUN JAGUNG 300GR;1;6000;0;6000;4979;1021;
2021-08-10 21:09:49;8998866501026;MINYAK GORENG SEDAAP POUCH 1 L;1;15000;0;15000;14110;890;
2021-08-10 21:09:49;8995333060772;TERIGU GATOT KACA 500GR;1;4500;0;4500;4065;435;
2021-08-10 21:09:49;8995333032113;TERIGU GATOT KACA 1 KG;1;8500;0;8500;8012;488;
2021-08-10 21:09:49;711844330146;ABC SARDEN EXTRA PEDAS;1;10000;0;10000;8000;2000;
2021-08-10 21:10:34;8998989300261;GUDANG GARAM SURYA 12 FILTER;1;18500;0;18500;17200;1300;
2021-08-10 21:19:47;089686067002;POP MIE PDS DOWER RS AYAM;1;5000;0;5000;4450;550;
2021-08-10 21:25:06;8719200177314;BLUE BAND 15G;1;2000;0;2000;1500;500;
2021-08-10 21:34:29;8992959953020;SWEETY BRONZE M1;1;3000;0;3000;2671;329;
2021-08-10 21:41:46;8991102320184;TANGO CHOCO JAVAMOCCA;1;5000;0;5000;4330;670;
2021-08-10 21:41:46;8992388133345;NU MILK TEA TEH TARIK 330ML;1;6000;0;6000;5125;875;
2021-08-10 21:52:47;VTM;VITAMIN CIMIN;6;500;0;3000;2550;450;
2021-08-10 21:52:47;GGK;PLAYGUM PERMEN KARET;3;500;0;1500;1200;300;
2021-08-10 21:55:06;8999801700054;SUSU FOYU 1 KG;1;22000;0;22000;19791;2209;
2021-08-11 08:21:06;8992959117590;SFX DS REG FLOW WING 20;1;12000;0;12000;11250;750;
2021-08-11 08:31:20;8993989311279;CLAS MILD 12;1;17000;0;17000;15700;1300;
2021-08-11 08:31:20;8998866608459;POWDET DAIA PUTIH BAG 290GR;1;5000;0;5000;4450;550;
2021-08-11 08:36:19;8996001301562;MALKIST TABUR KELAPA;1;1000;0;1000;820;180;
2021-08-11 08:47:43;8993176110074;MINYAK KAYU PUTIH 60ML;1;20000;0;20000;17333;2667;
2021-08-11 09:09:04;GGK;PLAYGUM PERMEN KARET;2;500;0;1000;800;200;
2021-08-11 09:40:18;8999999059781;SUNLIGHT LIME NEW POUCH 210ML;1;5000;0;5000;4300;700;
2021-08-11 09:44:36;8997210107877;VORTEX SMART 3;1;5000;0;5000;4750;250;
2021-08-11 09:54:51;8998989500166;GUDANG GARAM MERAH BESAR 16KS;1;18000;0;18000;17000;1000;
2021-08-11 09:54:51;GL;GULA 1 LITER;1;11500;0;11500;10500;1000;
2021-08-11 10:02:27;8998866201483;POTABEE REGULER GRILLED SEAWEED 35GR;1;5000;0;5000;4150;850;
2021-08-11 12:20:37;8999999706081;PEPSODENT WHITE 75G;1;5000;0;5000;3850;1150;
2021-08-11 12:20:37;8992696422735;DNCO CKLT UHT 110ML;3;3000;0;9000;6123;2877;
2021-08-11 12:20:37;8999999534097;PEPSODENT PGB FCM 75G;1;5000;0;5000;3850;1150;
2021-08-11 12:20:37;8991102160711;COOKIEZ;1;16000;0;16000;14500;1500;
2021-08-11 12:25:26;GL;GULA 1 LITER;2;11500;0;23000;21000;2000;
2021-08-11 12:29:29;CK;COOKIEZ;1;1000;0;1000;725;275;
2021-08-11 12:30:59;GGK;PLAYGUM PERMEN KARET;2;500;0;1000;800;200;
2021-08-11 12:49:36;8992761111533;SPRITE SLIM CAM250ML;2;5000;0;10000;7500;2500;
2021-08-11 12:50:31;8999909002821;MARLBORO BLACK 16;1;22000;0;22000;20850;1150;
2021-08-11 19:28:34;8996001600399;LE MINERAL 1500ML;1;5000;0;5000;4042;958;
2021-08-11 19:28:34;8999099923005;SGM 6-12 600G;1;53000;0;53000;51951;1049;
2021-08-11 19:32:11;8992761139018;ADES 600ML;1;3500;0;3500;2292;1208;
2021-08-11 19:33:14;ROTI;ROTI 2000;2;2000;0;4000;3600;400;
2021-08-11 19:34:17;ROTI;ROTI 2000;3;2000;0;6000;5400;600;
2021-08-11 19:36:46;089686010343;INDOMIE SOTO MIE;2;2600;0;5200;4734;466;
2021-08-11 19:39:54;8999909096004;SAMPOERNA 16 FILTER;1;24000;0;24000;23000;1000;
2021-08-11 19:40:35;8998989300261;GUDANG GARAM SURYA 12 FILTER;1;18500;0;18500;17200;1300;
2021-08-11 19:41:33;8999909010567;234 DJI SAM SOE 16;1;22000;0;22000;21500;500;
2021-08-11 19:42:21;123124;KOREK BIASA;1;2000;0;2000;1300;700;
2021-08-11 19:44:07;ROTI;ROTI 2000;2;2000;0;4000;3600;400;
2021-08-11 19:44:33;123124;KOREK BIASA;1;2000;0;2000;1300;700;
2021-08-11 19:46:31;8998898853100;SUSU JAHE;1;1500;0;1500;1180;320;
2021-08-11 19:47:24;8997028590014;ARGUS 220ML;10;500;0;5000;3020;1980;
2021-08-11 19:48:17;8993989311699;CLAS MILD 16 FILTER;1;23000;0;23000;21700;1300;
2021-08-11 19:50:40;ROTI;ROTI 2000;2;2000;0;4000;3600;400;
2021-08-11 19:51:19;8997025911058;HATARI SHP KELAPA;1;6000;0;6000;4911;1089;
2021-08-11 19:53:54;VTM;VITAMIN CIMIN;40;500;0;20000;17000;3000;
2021-08-11 19:54:31;123124;KOREK BIASA;1;2000;0;2000;1300;700;
2021-08-11 19:57:29;8996001600399;LE MINERAL 1500ML;10;5000;0;50000;40420;9580;
2021-08-11 19:58:15;ARG;ARGUS 220ML;3;14500;0;43500;39900;3600;
2021-08-11 19:59:25;8993176110074;MINYAK KAYU PUTIH 60ML;2;20000;0;40000;34666;5334;
2021-08-11 20:01:16;ARG;ARGUS 220ML;1;14500;0;14500;13300;1200;
2021-08-11 20:01:16;8886020033431;KAPUR AJAIB ANTI KECOA DAN NYAMUK;1;3000;0;3000;2700;300;
2021-08-11 20:02:57;8998866203104;MIE SEDAAP SINGAPORE;1;2500;0;2500;2266;234;
2021-08-11 20:04:22;8999909010567;234 DJI SAM SOE 16;2;22000;0;44000;43000;1000;
2021-08-11 20:05:10;ARG;ARGUS 220ML;1;14500;0;14500;13300;1200;
2021-08-11 20:06:23;8996001600269;LE MINERAL 600ML;2;3000;0;6000;3376;2624;
2021-08-11 20:07:11;8992761002039;FANTA STRAWBERRY PET 390 ML;1;5500;0;5500;4300;1200;
2021-08-11 20:07:59;8992761002022;SPRITE PET 390ML;1;5500;0;5500;4300;1200;
2021-08-11 20:09:10;RB;RED BOLD;1;19000;0;19000;17900;1100;
2021-08-11 20:10:28;8998989300261;GUDANG GARAM SURYA 12 FILTER;1;18500;0;18500;17200;1300;
2021-08-11 20:12:35;8997028590014;ARGUS 220ML;8;500;0;4000;2416;1584;
2021-08-11 20:12:57;ARG;ARGUS 220ML;1;14500;0;14500;13300;1200;
2021-08-11 20:14:11;8996001600375;LE MINERAL 330ML;2;2000;0;4000;2834;1166;
2021-08-11 20:15:05;GL;GULA 1 LITER;2;11500;0;23000;21000;2000;
2021-08-11 20:16:08;8998989300261;GUDANG GARAM SURYA 12 FILTER;1;18500;0;18500;17200;1300;
2021-08-11 20:16:37;MG;MINYAK GOSOK SAFERTABAT;1;28000;0;28000;25000;3000;
2021-08-11 20:17:10;8999908284907;MY BABY MINYAK TELON 90ML;1;25000;0;25000;22700;2300;
2021-08-11 21:56:41;8992775211410;PILUS GARUDA PEDAS;1;5000;0;5000;4886;114;
2021-08-11 22:06:29;8993989311699;CLAS MILD 16 FILTER;1;23000;0;23000;21700;1300;
2021-08-11 22:08:52;8998989300261;GUDANG GARAM SURYA 12 FILTER;1;18500;0;18500;17200;1300;
2021-08-11 22:10:08;8999909010567;234 DJI SAM SOE 16;1;22000;0;22000;21500;500;
2021-08-11 22:23:16;8992696430860;KOKO KRUNCH 80G;1;9000;0;9000;8063;937;
2021-08-11 22:23:16;089686611670;QTELA BALADO;1;5000;0;5000;4266;734;
2021-08-11 22:23:16;ARG;ARGUS 220ML;1;14500;0;14500;13300;1200;
2021-08-11 22:23:16;8996001305041;ROMA SANDWICH CKLT;1;7000;0;7000;5000;2000;
2021-08-11 22:23:16;8998866202312;NOODLE SEDAAP TASTY BAKMI AYAM 129 GR;1;5000;0;5000;4167;833;
2021-08-11 22:23:16;8999999516208;ROYCO FDS CHICKEN NEW 230G;1;10000;0;10000;9000;1000;
2021-08-11 22:23:16;8998866501026;MINYAK GORENG SEDAAP POUCH 1 L;3;15000;0;45000;42330;2670;
2021-08-11 22:38:01;8996001370063;CHOKI-CHOKI;1;18200;0;18200;16500;1700;
2021-08-12 10:18:16;8886001038011;BENG-BENG SCT;1;1500;0;1500;1450;50;
2021-08-12 10:19:49;711844120419;SAMBAL ABC 275 ML;1;12000;0;12000;10800;1200;
2021-08-12 10:19:49;711844130128;ABC SAUS TOMAT 275 ML;1;10000;0;10000;8800;1200;
2021-08-12 11:00:08;8998866808699;ROYALE PURPLE DAWN 13ML;1;5000;0;5000;4500;500;
2021-08-12 11:00:41;8998866202435;JAPOTA UMAMI JAPANESE SEAWEED 35GR;1;5000;0;5000;4150;850;
2021-08-12 11:04:26;8998989110167;SURYA GUDANG GARAM 16 FILTER;1;25000;0;25000;23200;1800;
2021-08-12 11:22:51;8998989300261;GUDANG GARAM SURYA 12 FILTER;1;18500;0;18500;17200;1300;
2021-08-12 11:30:02;MA;MALKIST ABON;2;9000;0;18000;16800;1200;
2021-08-12 11:37:53;8992959953013;SWEETY BRONZE S1;2;2000;0;4000;2758;1242;
2021-08-12 12:43:15;8998866202923;FLORIDINA COCO;1;3000;0;3000;2500;500;
2021-08-12 16:47:05;8992959954034;SWEETY BRONZE NB 24;1;29000;0;29000;26762;2238;
2021-08-12 16:51:27;8993989311279;CLAS MILD 12;1;17000;0;17000;15700;1300;
2021-08-12 17:58:15;8999999519711;PEPSODENT TB HIMALAYAN ROCK SALT;1;13300;0;13300;12045;1255;
2021-08-12 18:13:43;8999909096004;SAMPOERNA 16 FILTER;1;24000;0;24000;23000;1000;
2021-08-12 19:02:47;8992775318201;GERY SNACK BANTAL COKLAT;1;2000;0;2000;1712;288;
2021-08-12 19:02:47;ff;FULLO BLASTO;2;1000;0;2000;1990;10;
2021-08-12 19:11:54;8999909096004;SAMPOERNA 16 FILTER;1;24000;0;24000;23000;1000;
2021-08-12 20:00:25;8999909010567;234 DJI SAM SOE 16;2;22000;0;44000;43000;1000;
2021-08-12 20:16:29;8993989311279;CLAS MILD 12;1;17000;0;17000;15700;1300;
2021-08-12 20:17:22;8999909096004;SAMPOERNA 16 FILTER;1;24000;0;24000;23000;1000;
2021-08-12 20:22:38;8994420107789;SARDEN SAUS TOMAT;2;7000;0;14000;11666;2334;
2021-08-12 20:22:38;8995333032113;TERIGU GATOT KACA 1 KG;1;8500;0;8500;8012;488;
2021-08-12 20:22:38;8995333060772;TERIGU GATOT KACA 500GR;1;4500;0;4500;4065;435;
2021-08-12 20:22:38;8994935000070;MINYAK DUNIA 450 ML;1;7500;0;7500;6779;721;
2021-08-12 20:22:38;8999908559500;MARINA HYDRO COOL;1;10000;0;10000;8500;1500;
2021-08-12 20:22:38;8998898830125;KKB ENER-G ANGGUR;2;5500;0;11000;9648;1352;
2021-08-12 20:25:26;8991909101016;URBAN MILD 16;1;17000;0;17000;15800;1200;
2021-08-12 20:25:26;8998989300261;GUDANG GARAM SURYA 12 FILTER;1;18500;0;18500;17200;1300;
2021-08-12 20:29:29;8995333060772;TERIGU GATOT KACA 500GR;1;4500;0;4500;4065;435;
2021-08-12 20:29:29;8995333032113;TERIGU GATOT KACA 1 KG;1;8500;0;8500;8012;488;
2021-08-12 20:29:29;8998898830125;KKB ENER-G ANGGUR;2;5500;0;11000;9648;1352;
2021-08-12 20:29:29;8994935000070;MINYAK DUNIA 450 ML;1;7500;0;7500;6779;721;
2021-08-12 20:29:29;8994420107789;SARDEN SAUS TOMAT;2;7000;0;14000;11666;2334;
2021-08-12 20:29:29;8999908559500;MARINA HYDRO COOL;1;10000;0;10000;8500;1500;
2021-08-12 20:31:26;8998989300261;GUDANG GARAM SURYA 12 FILTER;1;18500;0;18500;17200;1300;
2021-08-12 20:33:54;8998989300261;GUDANG GARAM SURYA 12 FILTER;1;18500;0;18500;17200;1300;
2021-08-12 20:33:54;8998009020186;BUAVITA GUAVA 250ML;1;7000;0;7000;6083;917;
2021-08-12 20:39:16;089686021127;INTER MIE KALDU;2;1000;0;2000;1626;374;
2021-08-12 20:40:16;8992628020152;BIMOLI POUCH 2L;1;31000;0;31000;29800;1200;
2021-08-12 20:43:04;8993989311699;CLAS MILD 16 FILTER;1;23000;0;23000;21700;1300;
2021-08-12 20:44:39;6907992825076;JD WATERMELON APPLE;1;2000;0;2000;1700;300;
2021-08-12 20:45:32;7118441101378;KECAP ABC 520 ML;1;19000;0;19000;17800;1200;
2021-08-12 21:10:47;8998866202343;MIE SEDAAP KOREAN SPICY;5;2700;0;13500;12065;1435;
2021-08-12 21:39:58;8999909096004;SAMPOERNA 16 FILTER;1;24000;0;24000;23000;1000;
2021-08-13 10:56:51;8999909002876;SAMPOERNA ULTRAMILD 12;1;17000;0;17000;14600;2400;
2021-08-13 10:57:33;8998898830125;KKB ENER-G ANGGUR;1;5500;0;5500;4824;676;
2021-08-13 11:03:47;8886020033431;KAPUR AJAIB ANTI KECOA DAN NYAMUK;1;3000;0;3000;2700;300;
2021-08-13 11:03:47;6907992823669;JD MILKY STRAW;2;3000;0;6000;5200;800;
2021-08-13 11:03:47;8996001301562;MALKIST TABUR KELAPA;1;1000;0;1000;820;180;
2021-08-13 11:05:05;089686021141;INTER MIE SOTO;3;1000;0;3000;2562;438;
2021-08-13 11:05:05;089686044249;SUPERMI NUTRIMI STEAK AYAM;2;3500;0;7000;5600;1400;
2021-08-13 11:06:11;8999909010567;234 DJI SAM SOE 16;2;22000;0;44000;43000;1000;
2021-08-13 11:11:40;GGK;PLAYGUM PERMEN KARET;2;500;0;1000;800;200;
2021-08-13 11:43:51;8992761111533;SPRITE SLIM CAM250ML;1;5000;0;5000;3750;1250;
2021-08-13 11:43:51;8992752112013;MIZONE;1;5000;0;5000;3800;1200;
2021-08-13 11:46:30;8999909096004;SAMPOERNA 16 FILTER;1;24000;0;24000;23000;1000;
2021-08-13 11:46:30;123124;KOREK BIASA;1;2000;0;2000;1300;700;
2021-08-13 11:47:14;123124;KOREK BIASA;1;2000;0;2000;1300;700;
2021-08-13 11:47:14;8999909096004;SAMPOERNA 16 FILTER;1;24000;0;24000;23000;1000;
2021-08-13 13:11:08;8997025914059;HATARI SEE HONG;1;6000;0;6000;4911;1089;
2021-08-13 13:11:08;8997028590014;ARGUS 220ML;1;500;0;500;302;198;
2021-08-13 19:59:56;8999909002821;MARLBORO BLACK 16;1;22000;0;22000;20850;1150;
2021-08-13 20:12:29;123124;KOREK BIASA;1;2000;0;2000;1300;700;
2021-08-13 20:21:15;8998989100120;GUDANG GARAM MINI;1;18000;0;18000;16600;1400;
2021-08-13 20:21:15;8998989110167;SURYA GUDANG GARAM 16 FILTER;1;25000;0;25000;23200;1800;
2021-08-13 20:49:13;8993989311699;CLAS MILD 16 FILTER;1;23000;0;23000;21700;1300;
2021-08-13 20:52:41;8992761166038;MMP ORANGE 300ML;1;5000;0;5000;3750;1250;
2021-08-13 20:53:12;8996001355237;SUPER STAR;1;11000;0;11000;9900;1100;
2021-08-13 20:53:12;8999909096004;SAMPOERNA 16 FILTER;1;24000;0;24000;23000;1000;
2021-08-13 21:29:52;8992959953099;SWEETY BRONZE XL7;1;16000;0;16000;15190;810;
2021-08-13 21:31:51;8999909096004;SAMPOERNA 16 FILTER;1;24000;0;24000;23000;1000;
2021-08-13 21:31:51;8996001355237;SUPER STAR;1;11000;0;11000;9900;1100;
2021-08-13 21:52:23;GL;GULA 1 LITER;2;11500;0;23000;21000;2000;
2021-08-13 21:52:23;711844110144;KECAP ABC 225 ML;1;9000;0;9000;8200;800;
2021-08-13 21:52:23;RT;ROTI;2;9000;0;18000;16000;2000;
2021-08-13 21:52:23;SMBL;SAMBAL ABC BLINK 335 ML;1;14000;0;14000;12550;1450;
2021-08-13 22:18:37;8998866202312;NOODLE SEDAAP TASTY BAKMI AYAM 129 GR;2;5000;0;10000;8334;1666;
2021-08-13 22:18:37;ARG;ARGUS 220ML;1;14500;0;14500;13300;1200;
2021-08-13 22:21:23;8991102300421;WFR TANGO COKLAT 176GR;1;10000;0;10000;8694;1306;
2021-08-13 22:21:23;ROTI;ROTI 2000;2;2000;0;4000;3600;400;
2021-08-13 22:21:23;PRG;PARAGO;2;500;0;1000;800;200;
2021-08-14 09:02:54;8992761139018;ADES 600ML;2;3500;0;7000;4584;2416;
2021-08-14 10:20:56;8998866501026;MINYAK GORENG SEDAAP POUCH 1 L;6;15000;0;90000;84660;5340;
2021-08-14 10:21:19;8999999571887;MOLTO EDP PURPLE 10ML;1;5000;0;5000;4800;200;
2021-08-14 10:54:57;8996001600399;LE MINERAL 1500ML;1;5000;0;5000;4042;958;
2021-08-14 10:54:57;8999909002876;SAMPOERNA ULTRAMILD 12;1;17000;0;17000;14600;2400;
2021-08-14 10:58:44;8998866607315;SOKLIN SOFTERGENT SAKURA 770G & PIRING;1;18000;0;18000;16680;1320;
2021-08-14 10:58:44;8992628020152;BIMOLI POUCH 2L;1;31000;0;31000;29800;1200;
2021-08-14 10:58:44;8996001302316;MALKIST ABON SCT;1;1000;0;1000;840;160;
2021-08-14 12:01:49;8999909096004;SAMPOERNA 16 FILTER;1;24000;0;24000;23000;1000;
2021-08-14 12:06:12;8992775001691;GARUDA ROSTA WAGYU BEEF;1;8000;0;8000;7322;678;
2021-08-14 13:08:22;8998866202923;FLORIDINA COCO;2;3000;0;6000;5000;1000;
2021-08-14 13:08:22;SNDL;SENDAL BLACK;1;15000;0;15000;10833;4167;
2021-08-14 13:08:22;8886013257400;TWISTKO;4;1000;0;4000;3600;400;
2021-08-14 13:12:19;8991102320184;TANGO CHOCO JAVAMOCCA;1;5000;0;5000;4330;670;
2021-08-14 13:27:54;8992806145417;SCOTCH BRITE;2;3500;0;7000;4814;2186;
2021-08-14 13:27:54;8999999524722;SUNLIGHT LIME NEW PCH 435ML;1;10000;0;10000;9100;900;
2021-08-14 13:27:54;ARG;ARGUS 220ML;1;14500;0;14500;13300;1200;
2021-08-14 13:37:07;8998866501026;MINYAK GORENG SEDAAP POUCH 1 L;1;15000;0;15000;14110;890;
2021-08-14 13:37:07;8999999048174;SUNSILK  BLK SHINE 70+21ML;1;9600;0;9600;8525;1075;
2021-08-14 13:37:07;8999999059781;SUNLIGHT LIME NEW POUCH 210ML;1;5000;0;5000;4300;700;
2021-08-14 13:37:07;8999999059309;LIFEBUOY TS TOTAL 10 DG 75G;1;3000;0;3000;2640;360;
2021-08-14 13:37:07;8999999706081;PEPSODENT WHITE 75G;1;5000;0;5000;3850;1150;
2021-08-14 13:37:07;8998866609029;DAIA PUTIH GUSSWET 565G;1;10000;0;10000;8700;1300;
2021-08-14 13:37:07;089686048704;SARIMIE GORENG AYAM KCP ISI 2;1;3500;0;3500;3120;380;
2021-08-14 13:37:07;ARG;ARGUS 220ML;1;14500;0;14500;13300;1200;
2021-08-14 13:38:29;8996001318911;BETTER ISI 4;1;2000;0;2000;1700;300;
2021-08-14 13:38:29;089686041705;INDOMIE GORENG JUMBO;1;3500;0;3500;3143;357;
2021-08-14 13:38:29;8996001440049;ENERGEN;1;1500;0;1500;1200;300;
2021-08-14 13:41:06;8998866618298;DAIA CLEAN&FRESH HJB 320GR;1;5000;0;5000;4450;550;
2021-08-14 16:06:37;8995333060772;TERIGU GATOT KACA 500GR;1;4500;0;4500;4065;435;
2021-08-14 17:24:21;RT MNTG;ROTI SISIR MENTEGA;5;2000;0;10000;8000;2000;
2021-08-14 17:24:21;8991004011906;KOPI BORONG;1;10000;0;10000;8333;1667;
2021-08-14 17:47:03;8998989300261;GUDANG GARAM SURYA 12 FILTER;1;18500;0;18500;17200;1300;
2021-08-14 17:47:03;8991004011906;KOPI BORONG;1;10000;0;10000;8333;1667;
2021-08-14 17:49:00;8994867007161;ROKOK PENA GOLD 20;1;17000;0;17000;15500;1500;
2021-08-14 17:49:00;8992759120264;LARISST 220;1;10000;0;10000;9200;800;
2021-08-14 19:20:46;8886001038011;BENG-BENG SCT;3;1500;0;4500;4350;150;
2021-08-14 19:50:21;8999999519711;PEPSODENT TB HIMALAYAN ROCK SALT;1;13300;0;13300;12045;1255;
2021-08-14 19:50:21;8991111102986;JB COOTON TOUCH 375ML;1;24000;0;24000;22300;1700;
2021-08-14 19:50:21;8991002105584;KAPAL API 6.5 G;10;500;0;5000;3900;1100;
2021-08-14 19:50:21;8999999534752;PEPSODENT ACTION123 CHARCOAL 65G;1;7400;0;7400;6710;690;
2021-08-14 19:50:21;8999908284907;MY BABY MINYAK TELON 90ML;1;25000;0;25000;22700;2300;
2021-08-14 19:50:21;8999999045265;RINSO MOLTO ROSE FRESH PWD 770GR;1;21600;0;21600;19338;2262;
2021-08-14 19:50:21;8996200900092;HEROCYN 85GR;1;13000;0;13000;11650;1350;
2021-08-14 19:50:21;8999099920691;SGM 1+ MADU 1000G;1;85000;0;85000;78510;6490;
2021-08-14 21:09:10;8998989500166;GUDANG GARAM MERAH BESAR 16KS;1;18000;0;18000;17000;1000;
2021-08-14 21:33:49;8995333032113;TERIGU GATOT KACA 1 KG;2;8500;0;17000;16024;976;
2021-08-15 08:24:54;8993989311699;CLAS MILD 16 FILTER;1;23000;0;23000;21700;1300;
2021-08-15 08:31:32;8992775315057;GERY SALUT MALKIST COKLAT;1;6500;0;6500;5516;984;
2021-08-15 08:33:58;8996001302316;MALKIST ABON SCT;1;1000;0;1000;840;160;
2021-08-15 09:00:17;8992736925134;SASA TEPUNG BUMBU SERBAGUNA;1;5500;0;5500;4700;800;
2021-08-15 09:00:17;ARG;ARGUS 220ML;1;14500;0;14500;13300;1200;
2021-08-15 09:03:19;8998866608459;POWDET DAIA PUTIH BAG 290GR;1;5000;0;5000;4450;550;
2021-08-15 09:03:19;8999999524722;SUNLIGHT LIME NEW PCH 435ML;1;10000;0;10000;9100;900;
2021-08-15 09:03:19;ARG;ARGUS 220ML;1;14500;0;14500;13300;1200;
2021-08-15 09:04:35;8998866202770;MIE SEDAAP SALERO PADANG;1;2500;0;2500;2362;138;
2021-08-15 09:11:13;76239878;MARLBORO GOLD;1;30000;0;30000;27700;2300;
2021-08-15 09:23:50;gula;GULA;3;11500;0;34500;30000;4500;
2021-08-15 09:23:50;8992759120264;LARISST 220;1;10000;0;10000;9200;800;
2021-08-15 09:23:50;8995333060703;TERIGU KOMPAS 1KG;2;10500;0;21000;19632;1368;
2021-08-15 09:23:50;8993072254018;MELROSE COTTON BUDS BSR;1;5000;0;5000;4050;950;
2021-08-15 09:45:40;8998989300261;GUDANG GARAM SURYA 12 FILTER;1;18500;0;18500;17200;1300;
2021-08-15 09:48:31;8992761139018;ADES 600ML;2;3500;0;7000;4584;2416;
2021-08-15 09:48:31;PRG;PARAGO;2;500;0;1000;800;200;
2021-08-15 13:59:30;6907992823867;JD CRUNCHY CHOCOLATE MALT;2;5500;0;11000;9400;1600;
2021-08-15 13:59:30;6907992823935;JD SWEETCORN;1;3500;0;3500;3000;500;
2021-08-15 13:59:30;ARG;ARGUS 220ML;1;14500;0;14500;13300;1200;
2021-08-15 16:26:53;8992696419742;NESCAFE COFFE CREAM;1;5000;0;5000;4099;901;
2021-08-15 16:26:53;8996001600641;TORA CAPPUCINO;1;3500;0;3500;2750;750;
2021-08-15 18:11:33;9556001004673;MILO NESTLE MALAYSIA ACTIVE GO;1;85000;0;85000;80000;5000;
2021-08-15 18:56:56;8997027300089;NOMOS;1;4000;0;4000;2963;1037;
2021-08-15 19:29:19;089686060102;POP MIE PEDE GLEDEEK;1;5000;0;5000;4450;550;
2021-08-15 19:57:37;089686611670;QTELA BALADO;1;5000;0;5000;4266;734;
2021-08-15 19:58:03;8999909002821;MARLBORO BLACK 16;1;22000;0;22000;20850;1150;
2021-08-15 20:10:45;8998866608008;KECAP MANIS SEDAAP BOTOL 135 ML;1;6500;0;6500;5875;625;
2021-08-15 20:20:06;8998898810622;KKB JERUK VIT C1000;1;7500;0;7500;6690;810;
2021-08-15 20:21:53;8991002121089;GOOD DAY ORI CAPPUCINO;1;6000;0;6000;4295;1705;
2021-08-15 20:21:53;8991002121010;GOOD DAY FANTASTIC MOCACINNO;1;6000;0;6000;4295;1705;
2021-08-15 20:27:01;8995333032113;TERIGU GATOT KACA 1 KG;4;8500;0;34000;32048;1952;
2021-08-15 20:27:01;8995333060772;TERIGU GATOT KACA 500GR;1;4500;0;4500;4065;435;
2021-08-15 20:29:59;8998866202343;MIE SEDAAP KOREAN SPICY;1;2700;0;2700;2413;287;
2021-08-15 20:50:33;8998866501026;MINYAK GORENG SEDAAP POUCH 1 L;3;15000;0;45000;42330;2670;
2021-08-16 12:04:27;089686041705;INDOMIE GORENG JUMBO;1;3500;0;3500;3143;357;
2021-08-16 12:04:27;8994867007161;ROKOK PENA GOLD 20;1;17000;0;17000;15500;1500;
2021-08-16 12:04:27;8998989500166;GUDANG GARAM MERAH BESAR 16KS;1;18000;0;18000;17000;1000;
2021-08-16 12:04:27;8998866108317;EMERON HJB ANTDNDF 10ML;1;5000;0;5000;4500;500;
2021-08-16 12:04:27;123124;KOREK BIASA;1;2000;0;2000;1300;700;
2021-08-16 12:04:27;8994935000285;MINYAK GORENG DUNIA 4500ML;1;70000;0;70000;66433;3567;
2021-08-16 12:29:09;8997028590014;ARGUS 220ML;2;500;0;1000;604;396;
2021-08-16 20:56:28;8998866611725;EKONOMI PENCUCI PIRING  LIQ 290ML;1;5000;0;5000;4200;800;
2021-08-16 20:56:28;8998866888639;GIV HIJAU KOTAK 76G;2;2000;0;4000;3640;360;
2021-08-16 20:56:28;8993007003063;ENAAK 500G;1;11000;0;11000;9625;1375;
2021-08-16 21:04:06;8992959953099;SWEETY BRONZE XL7;1;16000;0;16000;15190;810;
2021-08-16 21:04:06;8998866608459;POWDET DAIA PUTIH BAG 290GR;1;5000;0;5000;4450;550;
2021-08-16 21:04:06;8999999531492;MOLTO GLAMOUR;1;5000;0;5000;4800;200;
2021-08-16 21:04:46;TBR;TEPUNG BERAS ROSE BRAND;5;8000;0;40000;29000;11000;
2021-08-16 21:07:11;089686834055;FREISS JERUK;1;11000;0;11000;8750;2250;
2021-08-16 21:10:59;8992222010221;TANCHO TREATMENT;1;17000;0;17000;15650;1350;
2021-08-16 21:13:05;711844150027;ABC NANAS;1;13000;0;13000;12241;759;
2021-08-16 21:29:23;8999909002821;MARLBORO BLACK 16;1;22000;0;22000;20850;1150;
2021-08-16 21:34:01;8992959508985;SWEETY SILVER PANTS M 30;1;56800;0;56800;51819;4981;
2021-08-16 21:37:14;8998866501026;MINYAK GORENG SEDAAP POUCH 1 L;1;15000;0;15000;14110;890;
2021-08-16 21:41:08;8992696404441;BEAR BRAND 189ML;2;9000;0;18000;15774;2226;
2021-08-16 21:43:27;8992696523081;MILO UHT 110ML;2;2500;0;5000;3924;1076;
2021-08-16 21:43:27;8997009510123;ORANGE WATER;1;7000;0;7000;6089;911;
2021-08-16 21:43:27;8998989110167;SURYA GUDANG GARAM 16 FILTER;1;25000;0;25000;23200;1800;
2021-08-16 21:46:56;CLUB;AIR CLUB 600ML;1;3000;0;3000;1452;1548;
2021-08-16 21:47:23;123124;KOREK BIASA;1;2000;0;2000;1300;700;
2021-08-16 21:48:26;PUL;PULPEN;5;1500;0;7500;4165;3335;
2021-08-16 21:57:43;8992696404441;BEAR BRAND 189ML;1;9000;0;9000;7887;1113;
2021-08-16 21:57:43;8998009010569;ULTRA CHO 200;1;5000;0;5000;3830;1170;
2021-08-16 21:57:43;8998866201490;POTABEE REGULER GRILLED SEAWED 68 GR;1;8000;0;8000;7200;800;
2021-08-16 22:04:50;8999909096004;SAMPOERNA 16 FILTER;1;24000;0;24000;23000;1000;
2021-08-16 22:04:50;8998989300261;GUDANG GARAM SURYA 12 FILTER;1;18500;0;18500;17200;1300;
2021-08-16 22:12:17;8998989300261;GUDANG GARAM SURYA 12 FILTER;1;18500;0;18500;17200;1300;
2021-08-16 22:13:28;ARG;ARGUS 220ML;3;14500;0;43500;39900;3600;
2021-08-16 22:14:12;GL;GULA 1 LITER;4;11500;0;46000;42000;4000;
2021-08-16 22:17:11;8992761166038;MMP ORANGE 300ML;2;5000;0;10000;7500;2500;
2021-08-16 22:17:11;9556001004673;MILO NESTLE MALAYSIA ACTIVE GO;1;85000;0;85000;80000;5000;
2021-08-16 22:19:57;8994935000070;MINYAK DUNIA 450 ML;1;7500;0;7500;6779;721;
2021-08-16 22:19:57;8992628510158;SIMAS PALMIA;1;6000;0;6000;4832;1168;
2021-08-16 22:19:57;FUZO;KUACI FUZO;1;1000;0;1000;850;150;
2021-08-16 22:19:57;8991102320184;TANGO CHOCO JAVAMOCCA;1;5000;0;5000;4330;670;
2021-08-16 23:10:25;8992959930533;CONFI PREMIUM PAN XL1;2;8500;0;17000;15570;1430;
2021-08-16 23:15:33;8999999055752;FAIR&LOVELY MVIT FC FOAM 9 G;1;3500;0;3500;2450;1050;
2021-08-17 09:22:11;GL;GULA 1 LITER;1;11500;0;11500;10500;1000;
2021-08-17 09:22:11;8992628022156;BIMOLI KLASIK TOUCH 1 LT;1;16000;0;16000;14350;1650;
2021-08-17 09:23:01;ARG;ARGUS 220ML;2;14500;0;29000;26600;2400;
2021-08-17 10:06:42;8999909010567;234 DJI SAM SOE 16;2;22000;0;44000;43000;1000;
2021-08-17 10:47:39;8995333032113;TERIGU GATOT KACA 1 KG;2;8500;0;17000;16024;976;
2021-08-17 10:49:05;8996001600399;LE MINERAL 1500ML;1;5000;0;5000;4042;958;
2021-08-17 10:55:55;8996001318911;BETTER ISI 4;1;2000;0;2000;1700;300;
2021-08-17 10:55:55;PRG;PARAGO;6;500;0;3000;2400;600;
2021-08-17 11:54:50;8998866501026;MINYAK GORENG SEDAAP POUCH 1 L;5;15000;0;75000;70550;4450;
2021-08-17 11:54:50;8992775318201;GERY SNACK BANTAL COKLAT;1;2000;0;2000;1712;288;
2021-08-17 11:54:50;CK;COOKIEZ;1;1000;0;1000;725;275;
2021-08-17 12:12:03;8998989300261;GUDANG GARAM SURYA 12 FILTER;1;18500;0;18500;17200;1300;
2021-08-17 12:12:03;123124;KOREK BIASA;1;2000;0;2000;1300;700;
2021-08-17 16:55:04;GL;GULA 1 LITER;1;11500;0;11500;10500;1000;
2021-08-17 16:55:46;8992628022156;BIMOLI KLASIK TOUCH 1 LT;1;16000;0;16000;14350;1650;
2021-08-17 16:56:19;ARG;ARGUS 220ML;1;14500;0;14500;13300;1200;
2021-08-17 16:59:35;089686611618;QTELA BARBEQUE;1;5000;0;5000;4266;734;
2021-08-17 17:20:30;8998866501026;MINYAK GORENG SEDAAP POUCH 1 L;3;15000;0;45000;42330;2670;
2021-08-17 17:27:14;ARG;ARGUS 220ML;1;14500;0;14500;13300;1200;
2021-08-17 17:29:01;8992696523081;MILO UHT 110ML;1;2500;0;2500;1962;538;
2021-08-17 17:37:33;8994834006128;TICTIC PEDAS;1;2000;0;2000;1700;300;
2021-08-17 18:38:43;8993989311279;CLAS MILD 12;1;17000;0;17000;15700;1300;
2021-08-17 18:38:43;8998989300261;GUDANG GARAM SURYA 12 FILTER;1;18500;0;18500;17200;1300;
2021-08-17 18:55:12;8999999529918;CLEAR SPR FRESH APPLE 80ML;1;11300;0;11300;10120;1180;
2021-08-17 20:00:11;8993007000086;INDOMILK CKLT 1L;1;16500;0;16500;14791;1709;
2021-08-17 20:02:52;8992696523067;MILO ACTVGO UHT 180ML;2;4500;0;9000;7030;1970;
2021-08-17 20:02:52;8998989300261;GUDANG GARAM SURYA 12 FILTER;1;18500;0;18500;17200;1300;
2021-08-17 20:02:52;123124;KOREK BIASA;1;2000;0;2000;1300;700;
2021-08-17 20:10:08;8994834006128;TICTIC PEDAS;1;2000;0;2000;1700;300;
2021-08-17 20:10:08;8992775110157;GARUDA KACANG KULIT;1;5000;0;5000;3925;1075;
2021-08-17 20:11:22;8998866501026;MINYAK GORENG SEDAAP POUCH 1 L;1;15000;0;15000;14110;890;
2021-08-17 20:16:29;8991102989381;TANGO LONG BUBBLEGUM 130G;1;5000;0;5000;4345;655;
2021-08-17 20:22:16;8999999559533;LIFEBUOY BW TOTAL 10 90ML;1;5000;0;5000;4000;1000;
2021-08-17 20:23:01;ROTI;ROTI 2000;1;2000;0;2000;1800;200;
2021-08-17 20:23:55;8999909096004;SAMPOERNA 16 FILTER;1;24000;0;24000;23000;1000;
2021-08-17 20:25:25;8996001600399;LE MINERAL 1500ML;1;5000;0;5000;4042;958;
2021-08-17 20:36:29;8992775001783;GERY SALUT MALKIST KELAPA;1;6500;0;6500;5516;984;
2021-08-17 20:36:29;8991102320184;TANGO CHOCO JAVAMOCCA;1;5000;0;5000;4330;670;
2021-08-17 20:36:29;8991909101016;URBAN MILD 16;1;17000;0;17000;15800;1200;
2021-08-17 20:36:29;8886013213208;FRENCH FREIS 2000;2;5000;0;10000;7500;2500;
2021-08-17 20:38:23;8997011700123;BIHUN JAGUNG 300GR;1;6000;0;6000;4979;1021;
2021-08-17 20:38:23;8991102320184;TANGO CHOCO JAVAMOCCA;1;5000;0;5000;4330;670;
2021-08-17 20:38:59;6907992823652;JD CHOCOLATE MILKSHAKE;2;6000;0;12000;10400;1600;
2021-08-17 20:42:37;8998866201841;GOLDA DOLCE LATTE 200ML;2;3000;0;6000;5000;1000;
2021-08-17 20:50:32;089686611618;QTELA BARBEQUE;1;5000;0;5000;4266;734;
2021-08-17 20:50:32;8992959953020;SWEETY BRONZE M1;2;3000;0;6000;5342;658;
2021-08-17 20:53:10;8886022941512;BATERAI ALKALINE 03;1;11000;0;11000;9970;1030;
2021-08-17 20:58:52;8993072254056;MELROSE COTTON BUDS KCL;1;3000;0;3000;2450;550;
2021-08-17 21:02:33;8998866501026;MINYAK GORENG SEDAAP POUCH 1 L;1;15000;0;15000;14110;890;
2021-08-17 21:02:33;ARG;ARGUS 220ML;1;14500;0;14500;13300;1200;
2021-08-17 21:02:58;8994867007161;ROKOK PENA GOLD 20;1;17000;0;17000;15500;1500;
2021-08-17 21:05:58;8886013213208;FRENCH FREIS 2000;3;5000;0;15000;11250;3750;
2021-08-17 21:09:24;8992761166052;FRESTEA MELATI 350ML;1;4500;0;4500;3000;1500;
2021-08-17 21:10:55;8998866200837;NOODLE SEDAAPMIE SOTO CUP 81 GR;1;4500;0;4500;3738;762;
2021-08-17 21:31:27;YP;YUPI;12;250;0;3000;2496;504;
2021-08-17 21:32:27;089686060102;POP MIE PEDE GLEDEEK;1;5000;0;5000;4450;550;
2021-08-17 21:36:55;8998866200325;MIE SEDAAP SOTO;1;2700;0;2700;2331;369;
2021-08-17 21:36:55;8998866202343;MIE SEDAAP KOREAN SPICY;1;2700;0;2700;2413;287;
2021-08-17 21:36:55;8991188943536;SASA SANTAN KELAPA 65ML;2;3000;0;6000;4874;1126;
2021-08-17 21:41:13;8992761166205;FRESTEA GREEN HONEY 350ML;1;4500;0;4500;3000;1500;
2021-08-17 21:43:50;8998866201841;GOLDA DOLCE LATTE 200ML;1;3000;0;3000;2500;500;
2021-08-17 21:43:50;PRG;PARAGO;2;500;0;1000;800;200;
2021-08-17 21:57:56;089686017748;SARIMIE GORENG ISI 2;1;3500;0;3500;3120;380;
2021-08-17 21:57:56;8998866202602;KRISBEE FRENCH FRIES 18GR;1;2000;0;2000;1500;500;
2021-08-17 21:58:53;8992946512223;SHINZUI;1;4000;0;4000;2500;1500;
2021-08-17 22:04:08;8999999049409;REXONA MEN ICE COOL 45 ML;2;15000;0;30000;27100;2900;
2021-08-17 22:04:08;8999999049478;REXONA WMN RO NATURALS BIO 45 ML;1;16500;0;16500;14900;1600;
2021-08-17 22:11:05;8996001600641;TORA CAPPUCINO;1;3500;0;3500;2750;750;
2021-08-17 22:11:05;089686021127;INTER MIE KALDU;3;1000;0;3000;2439;561;
2021-08-17 22:12:02;8997027300089;NOMOS;1;4000;0;4000;2963;1037;
2021-08-17 22:19:31;8999999027056;LIFEBUOY ANTI KETOMBE 9ML;2;5000;0;10000;9000;1000;
2021-08-17 22:22:06;8993072254018;MELROSE COTTON BUDS BSR;2;5000;0;10000;8100;1900;
2021-08-17 22:24:12;8993083929912;BISKITOP ASSORTED WAFER STICK;1;30000;0;30000;28400;1600;
2021-08-17 22:26:01;8991102381024;FULLO VNL PCK;2;10000;0;20000;18000;2000;
2021-08-17 22:26:01;8991188943536;SASA SANTAN KELAPA 65ML;1;3000;0;3000;2437;563;
2021-08-17 22:28:40;8991111101408;JB POWDER 50G;1;3500;0;3500;3000;500;
2021-08-17 22:29:03;8998989110167;SURYA GUDANG GARAM 16 FILTER;1;25000;0;25000;23200;1800;
2021-08-17 22:30:13;BALON;BALON CABUT;4;1000;0;4000;3600;400;
2021-08-17 22:31:24;VTM;VITAMIN CIMIN;3;500;0;1500;1275;225;
2021-08-17 22:32:42;089686010107;INDOMIE KALDU AYAM;2;2500;0;5000;4300;700;
2021-08-17 22:35:15;8998866609029;DAIA PUTIH GUSSWET 565G;1;10000;0;10000;8700;1300;
2021-08-17 22:39:19;8992628020152;BIMOLI POUCH 2L;1;31000;0;31000;29800;1200;
2021-08-17 22:39:19;ARG;ARGUS 220ML;1;14500;0;14500;13300;1200;
2021-08-17 22:40:15;8991102303309;WFR TANGO SBJ 176G;2;10000;0;20000;17388;2612;
2021-08-17 22:43:39;8991102987875;WFR TANGO POUCH CKL 115G;1;8000;0;8000;6786;1214;
2021-08-17 22:43:39;8998009010569;ULTRA CHO 200;2;5000;0;10000;7660;2340;
2021-08-17 22:47:41;8991102320184;TANGO CHOCO JAVAMOCCA;1;5000;0;5000;4330;670;
2021-08-17 22:49:37;8998866202626;Top Kopi Gula Aren 22gr;2;1000;0;2000;1660;340;
2021-08-17 22:49:37;8991102989381;TANGO LONG BUBBLEGUM 130G;1;5000;0;5000;4345;655;
2021-08-17 22:52:12;8992761139018;ADES 600ML;1;3500;0;3500;2292;1208;
2021-08-17 22:53:42;8998898830125;KKB ENER-G ANGGUR;1;5500;0;5500;4824;676;
2021-08-17 22:54:45;RT MNTG;ROTI SISIR MENTEGA;2;2000;0;4000;3200;800;
2021-08-17 22:55:33;GL;GULA 1 LITER;1;11500;0;11500;10500;1000;
2021-08-17 22:57:53;YP;YUPI;20;250;0;5000;4160;840;
2021-08-17 22:58:57;8991002105409;KOPI KAPAL API;1;20000;0;20000;18888;1112;
2021-08-17 23:09:07;8998866500135;HERSPROTEX SOFTCARE WINGS;2;5500;0;11000;9640;1360;
2021-08-17 23:10:48;8998866202770;MIE SEDAAP SALERO PADANG;1;2500;0;2500;2362;138;
2021-08-17 23:12:42;8998866201377;KRISBEE FRIES KENTANG GORENG 68 GR;2;5500;0;11000;9240;1760;
2021-08-17 23:15:06;8999909003439;MARLBORO CRAFTED 12;1;8000;0;8000;7250;750;
2021-08-17 23:15:31;123124;KOREK BIASA;1;2000;0;2000;1300;700;
2021-08-17 23:16:35;8991102714860;MILKIDO STRAW;2;3000;0;6000;4306;1694;
2021-08-17 23:19:27;8994834006128;TICTIC PEDAS;1;2000;0;2000;1700;300;
2021-08-17 23:19:27;ROTI;ROTI 2000;3;2000;0;6000;5400;600;
2021-08-17 23:20:39;8992761002015;COCA COLA PET 390ML;1;5500;0;5500;4333;1167;
2021-08-17 23:20:39;8992761166038;MMP ORANGE 300ML;1;5000;0;5000;3750;1250;
2021-08-17 23:21:02;8998989500166;GUDANG GARAM MERAH BESAR 16KS;1;18000;0;18000;17000;1000;
2021-08-17 23:21:30;123124;KOREK BIASA;1;2000;0;2000;1300;700;
2021-08-17 23:23:42;8991102714860;MILKIDO STRAW;1;3000;0;3000;2153;847;
2021-08-17 23:23:42;8998866202770;MIE SEDAAP SALERO PADANG;1;2500;0;2500;2362;138;
2021-08-18 12:09:18;ARG;ARGUS 220ML;2;14500;0;29000;26600;2400;
2021-08-18 12:09:18;8996001600269;LE MINERAL 600ML;1;3000;0;3000;1688;1312;
2021-08-18 12:14:04;8992959117583;SFX DS REG FLOW WING 20;1;5000;0;5000;4288;712;
2021-08-18 12:18:05;9556001004673;MILO NESTLE MALAYSIA ACTIVE GO;1;85000;0;85000;80000;5000;
2021-08-18 12:38:29;8998866200561;EKOMIE SUPER 600GR;4;10000;0;40000;34460;5540;
2021-08-18 12:40:10;8995333060703;TERIGU KOMPAS 1KG;1;10500;0;10500;9816;684;
2021-08-18 12:42:44;089686060102;POP MIE PEDE GLEDEEK;1;5000;0;5000;4450;550;
2021-08-18 12:45:34;PRG;PARAGO;1;500;0;500;400;100;
2021-08-18 12:46:43;8998989500166;GUDANG GARAM MERAH BESAR 16KS;1;18000;0;18000;17000;1000;
2021-08-18 12:48:11;8998989500166;GUDANG GARAM MERAH BESAR 16KS;1;18000;0;18000;17000;1000;
2021-08-18 16:44:02;8992696404441;BEAR BRAND 189ML;14;9000;0;126000;110418;15582;
2021-08-18 17:06:18;8998866605106;CLING BIRU BTL 440ML;1;8500;0;8500;7600;900;
2021-08-18 17:06:18;8998866601429;POWDET DAIA BUNGA BAG 290GR;1;5000;0;5000;4450;550;
2021-08-18 17:06:18;8998866608459;POWDET DAIA PUTIH BAG 290GR;1;5000;0;5000;4450;550;
2021-08-18 17:06:18;8999999706180;PEPSODENT WHITE 190GR;1;10000;0;10000;9350;650;
2021-08-18 18:18:10;8991002105409;KOPI KAPAL API;1;20000;0;20000;18888;1112;
2021-08-18 18:31:20;8886013213208;FRENCH FREIS 2000;2;5000;0;10000;7500;2500;
2021-08-18 18:57:41;8994420107789;SARDEN SAUS TOMAT;1;7000;0;7000;5833;1167;
2021-08-18 18:58:06;8997028590014;ARGUS 220ML;2;500;0;1000;604;396;
2021-08-18 19:09:22;8998989300261;GUDANG GARAM SURYA 12 FILTER;1;18500;0;18500;17200;1300;
2021-08-18 19:13:42;8996001600375;LE MINERAL 330ML;1;2000;0;2000;1417;583;
2021-08-18 19:13:42;8886013257400;TWISTKO;2;1000;0;2000;1800;200;
2021-08-18 19:13:42;ff;FULLO BLASTO;1;1000;0;1000;995;5;
2021-08-18 19:16:43;8996001600399;LE MINERAL 1500ML;4;5000;0;20000;16168;3832;
2021-08-18 19:16:43;8997018720469;TISSUE SE-KA;1;10000;0;10000;9300;700;
2021-08-18 19:16:43;8998989110167;SURYA GUDANG GARAM 16 FILTER;1;25000;0;25000;23200;1800;
2021-08-18 19:19:04;ff;FULLO BLASTO;1;1000;0;1000;995;5;
2021-08-18 19:28:48;8998989110167;SURYA GUDANG GARAM 16 FILTER;1;25000;0;25000;23200;1800;
2021-08-18 19:28:48;8999999056841;PONDS WB SKIN PERFCTNG CRM NRML 20G;1;20000;0;20000;18185;1815;
2021-08-18 19:28:48;8991111111964;C&C FACIAL WASH 50ML;1;12000;0;12000;10870;1130;
2021-08-18 19:28:48;8998866611220;FRES&NATURAL PUTIH 100ML;1;11500;0;11500;10310;1190;
2021-08-18 19:28:48;8992775000076;GERY SNACK RING CKLT;1;2000;0;2000;1712;288;
2021-08-18 19:28:48;8991002105584;KAPAL API 6.5 G;4;500;0;2000;1560;440;
2021-08-18 19:28:48;TBR;TEPUNG BERAS ROSE BRAND;1;8000;0;8000;5800;2200;
2021-08-18 19:31:58;8998989110167;SURYA GUDANG GARAM 16 FILTER;1;25000;0;25000;23200;1800;
2021-08-18 19:47:06;8992753100101;BKM FULL CREAM GOLD 370;2;15000;0;30000;28000;2000;
2021-08-18 19:47:06;8992696404441;BEAR BRAND 189ML;2;9000;0;18000;15774;2226;
2021-08-18 19:47:06;8993072254018;MELROSE COTTON BUDS BSR;1;5000;0;5000;4050;950;
2021-08-18 19:49:27;8999099920691;SGM 1+ MADU 1000G;1;85000;0;85000;78510;6490;
2021-08-18 20:20:40;8993989311699;CLAS MILD 16 FILTER;1;23000;0;23000;21700;1300;
2021-08-18 20:58:01;8996001600269;LE MINERAL 600ML;4;3000;0;12000;6752;5248;
2021-08-18 21:08:49;089686611878;QTELA TEMPE;1;6000;0;6000;5370;630;
2021-08-18 21:08:49;8994834006128;TICTIC PEDAS;1;2000;0;2000;1700;300;
2021-08-18 21:08:49;8991111101408;JB POWDER 50G;1;3500;0;3500;3000;500;
2021-08-18 21:22:20;8999999024789;VASELINE PERFECT 10 PJ 200ML;1;33500;0;33500;30855;2645;
2021-08-18 21:23:02;8992775214008;Garuda Kacang Atom;2;1000;0;2000;1620;380;
2021-08-18 21:25:10;089686021141;INTER MIE SOTO;3;1000;0;3000;2562;438;
2021-08-18 21:26:47;8999909002821;MARLBORO BLACK 16;1;22000;0;22000;20850;1150;
2021-08-18 21:33:44;ARG;ARGUS 220ML;3;14500;0;43500;39900;3600;
2021-08-18 21:58:01;8997025914059;HATARI SEE HONG;1;6000;0;6000;4911;1089;
2021-08-18 21:58:01;8992775315095;GERY MALKIST SWEET CHEESE;1;6500;0;6500;5516;984;
2021-08-18 21:59:33;8996001318430;BETTER 1000;2;1000;0;2000;1640;360;
2021-08-18 21:59:33;GGK;PLAYGUM PERMEN KARET;1;500;0;500;400;100;
2021-08-18 22:11:51;SFX;SOFTEX DAUN SIRIH 1;10;500;0;5000;4130;870;
2021-08-18 22:12:26;8996001600269;LE MINERAL 600ML;1;3000;0;3000;1688;1312;
2021-08-18 22:13:07;8992761002022;SPRITE PET 390ML;1;5500;0;5500;4300;1200;
2021-08-18 22:14:16;089686386011;BUMBU RACIK NASI GORENG;3;2000;0;6000;4350;1650;
2021-08-18 22:18:33;8992959954034;SWEETY BRONZE NB 24;1;29000;0;29000;26762;2238;
2021-08-18 22:28:53;8996001600399;LE MINERAL 1500ML;2;5000;0;10000;8084;1916;
2021-08-18 22:30:55;089686041705;INDOMIE GORENG JUMBO;1;3500;0;3500;3143;357;
2021-08-18 22:33:40;089686043051;INDOMIE COTO MAKASSAR;2;2800;0;5600;5050;550;
2021-08-19 10:24:31;ARG;ARGUS 220ML;2;14500;0;29000;26600;2400;
2021-08-19 10:24:31;8999999042646;RINSO MOLTO ROSE FRESH LIQ 40ML;2;1000;0;2000;1604;396;
2021-08-19 10:53:03;8992717781001;NATA DE COCO;1;13000;0;13000;12083;917;
2021-08-19 10:53:03;8992933214116;NUTRIJELL MELON;1;6000;0;6000;5041;959;
2021-08-19 10:53:03;8992933216110;NUTRIJELL MANGO;2;6000;0;12000;9900;2100;
2021-08-19 10:53:03;8992933219111;NUTRIJELL CINCAU;1;6000;0;6000;5000;1000;
2021-08-19 10:53:03;8992933215113;NUTRIJELL TANPA RASA;1;6000;0;6000;4950;1050;
2021-08-19 10:53:03;8997018720018;SIRUP DHT;1;23000;0;23000;20958;2042;
2021-08-19 10:57:35;8992761164478;FRESTEA MILK TEA;1;8000;0;8000;6575;1425;
2021-08-19 11:07:50;8997028590014;ARGUS 220ML;2;500;0;1000;604;396;
2021-08-19 11:09:19;8997028590014;ARGUS 220ML;2;500;0;1000;604;396;
2021-08-19 11:09:19;8886030322907;PORSTEX BIRU 500ML;1;15500;0;15500;13000;2500;
2021-08-19 11:12:44;8992696405417;DNCO INSTANT 27G;5;3500;0;17500;15000;2500;
2021-08-19 11:37:03;8998009020186;BUAVITA GUAVA 250ML;1;7000;0;7000;6083;917;
2021-08-19 11:37:46;8996001600375;LE MINERAL 330ML;2;2000;0;4000;2834;1166;
2021-08-19 11:45:31;8992775203422;GARUDA ROSTA OVEN 100G;1;8000;0;8000;7322;678;
2021-08-19 11:45:31;8996001600375;LE MINERAL 330ML;1;2000;0;2000;1417;583;
2021-08-19 11:48:53;8998866202923;FLORIDINA COCO;1;3000;0;3000;2500;500;
2021-08-19 11:50:53;8998866500708;FLORIDINA ORANGE;1;3000;0;3000;2500;500;
2021-08-19 11:51:42;9556001047175;NESCAFE ORI 240ML;1;8500;0;8500;7834;666;
2021-08-19 11:51:42;9556001051509;MILO ACT GO HICAL 240ML;1;8500;0;8500;7437;1063;
2021-08-19 12:14:11;8998866692601;SOKLIN FLOORCLENER HIJAU 450ML;1;7000;0;7000;6385;615;
2021-08-19 12:14:11;8993226112508;GARAM REFINA;1;3000;0;3000;2461;539;
2021-08-19 12:14:11;8991111112206;C&C DEEP ACTION CLEANSER 50G;1;14000;0;14000;12900;1100;
2021-08-19 12:15:11;8992761166038;MMP ORANGE 300ML;1;5000;0;5000;3750;1250;
2021-08-19 12:23:19;8992775610008;TING-TING GARUDA 2.5G;1;7500;0;7500;6296;1204;
2021-08-19 12:25:53;8998866105491;EMERON LOVELY SMOTH&BRIGHT 100ML;1;4300;0;4300;3800;500;
2021-08-19 12:25:53;8992775610008;TING-TING GARUDA 2.5G;1;7500;0;7500;6296;1204;
2021-08-19 12:32:23;8996001600269;LE MINERAL 600ML;1;3000;0;3000;1688;1312;
2021-08-19 14:49:19;8991102714860;MILKIDO STRAW;1;3000;0;3000;2153;847;
2021-08-19 19:11:49;8999999524838;SUNLIGHT MINT POUCH 755ML;1;17000;0;17000;15400;1600;
2021-08-19 19:11:49;8998009020186;BUAVITA GUAVA 250ML;1;7000;0;7000;6083;917;
2021-08-19 19:12:47;8995102703534;TERASI DUO 6 GR;1;4000;0;4000;3720;280;
2021-08-19 19:30:46;8998989300391;SURYA PRO PUTIH;2;20000;0;40000;37200;2800;
2021-08-19 19:39:38;8991004011906;KOPI BORONG;1;10000;0;10000;8333;1667;
2021-08-19 19:39:38;GL;GULA 1 LITER;1;11500;0;11500;10500;1000;
2021-08-19 19:39:38;8999999524807;SUNLIGHT HABBATUSSAUDA POUCH 755ML;1;17000;0;17000;15400;1600;
2021-08-19 19:39:38;089686060102;POP MIE PEDE GLEDEEK;1;5000;0;5000;4450;550;
2021-08-19 19:39:38;089686535242;SUN PISANG SUSU;1;8500;0;8500;7410;1090;
2021-08-19 19:55:31;8998989300261;GUDANG GARAM SURYA 12 FILTER;1;19000;0;19000;17700;1300;
2021-08-19 19:59:44;8994420100018;SARDEN SAUS PEDAS;1;7000;0;7000;5833;1167;
2021-08-19 20:01:53;8991004011906;KOPI BORONG;1;10000;0;10000;8333;1667;
2021-08-19 20:01:53;8998866501026;MINYAK GORENG SEDAAP POUCH 1 L;5;15000;0;75000;70550;4450;
2021-08-19 20:02:25;ARG;ARGUS 220ML;1;14500;0;14500;13300;1200;
2021-08-19 20:03:08;ARG;ARGUS 220ML;3;14500;0;43500;39900;3600;
2021-08-19 20:04:45;8995333032113;TERIGU GATOT KACA 1 KG;1;8500;0;8500;8012;488;
2021-08-19 20:04:45;8995333060772;TERIGU GATOT KACA 500GR;1;4500;0;4500;4065;435;
2021-08-19 20:05:29;8991004011906;KOPI BORONG;1;10000;0;10000;8333;1667;
2021-08-19 20:06:15;089686386127;BUMBU RACIK NASI GORENG SOSIS;1;2000;0;2000;1620;380;
2021-08-19 20:06:58;8992702000063;INDOMILK COKLAT 370G;1;10000;0;10000;9020;980;
2021-08-19 20:08:17;8998989300261;GUDANG GARAM SURYA 12 FILTER;1;19000;0;19000;17700;1300;
2021-08-19 20:11:25;8996001305058;ROMA SANDWICH KACANG;1;7000;0;7000;5000;2000;
2021-08-19 20:12:49;8991188943536;SASA SANTAN KELAPA 65ML;2;3000;0;6000;4874;1126;
2021-08-19 20:15:53;8993226365522;GARAM MEJA GYURI 200GR;2;2000;0;4000;3400;600;
2021-08-19 20:18:11;8992753100101;BKM FULL CREAM GOLD 370;2;15000;0;30000;28000;2000;
2021-08-19 20:26:31;ARG;ARGUS 220ML;1;14500;0;14500;13300;1200;
2021-08-19 20:26:31;LT;LIPSTIK HANASUI;1;27000;0;27000;27000;0;
2021-08-19 20:27:59;089686021141;INTER MIE SOTO;2;1000;0;2000;1708;292;
2021-08-19 20:28:30;8994834006128;TICTIC PEDAS;1;2000;0;2000;1700;300;
2021-08-19 20:30:46;089686067002;POP MIE PDS DOWER RS AYAM;1;5000;0;5000;4450;550;
2021-08-19 20:31:39;8886013213208;FRENCH FREIS 2000;2;5000;0;10000;7500;2500;
2021-08-19 20:33:25;8999999042639;RINSO ANTI NODA CLS LIQ 40ML;2;1000;0;2000;1610;390;
2021-08-19 20:35:32;8998989300261;GUDANG GARAM SURYA 12 FILTER;1;19000;0;19000;17700;1300;
2021-08-19 20:36:12;8997025914059;HATARI SEE HONG;1;6000;0;6000;4911;1089;
2021-08-19 20:38:25;089686048704;SARIMIE GORENG AYAM KCP ISI 2;1;3500;0;3500;3120;380;
2021-08-19 20:38:25;8998989110167;SURYA GUDANG GARAM 16 FILTER;1;25000;0;25000;23700;1300;
2021-08-19 20:38:44;8997018720469;TISSUE SE-KA;1;10000;0;10000;9300;700;
2021-08-19 20:40:27;8996001600269;LE MINERAL 600ML;5;3000;0;15000;8440;6560;
2021-08-19 20:43:14;RB;RED BOLD;1;19000;0;19000;17900;1100;
2021-08-19 20:43:59;CLUB;AIR CLUB 600ML;1;3000;0;3000;1452;1548;
2021-08-19 20:44:44;8886001038011;BENG-BENG SCT;2;1500;0;3000;2900;100;
2021-08-19 20:46:11;8997025911058;HATARI SHP KELAPA;1;6000;0;6000;4911;1089;
2021-08-19 20:47:58;8999909982000;SAMPOERNA 12 FILTER;1;18000;0;18000;16000;2000;
2021-08-19 20:47:58;MBL;MOBIL;1;5000;0;5000;3500;1500;
2021-08-19 20:47:58;8996001600269;LE MINERAL 600ML;1;3000;0;3000;1688;1312;
2021-08-19 20:48:57;8992761166038;MMP ORANGE 300ML;1;5000;0;5000;3750;1250;
2021-08-19 20:49:44;8997013790108;BIMURA KACANG TELUR 25G;2;1000;0;2000;1750;250;
2021-08-19 20:54:25;8998898830125;KKB ENER-G ANGGUR;1;5500;0;5500;4824;676;
2021-08-19 20:54:25;8999999059781;SUNLIGHT LIME NEW POUCH 210ML;1;5000;0;5000;4300;700;
2021-08-19 21:03:50;8999999710873;PEPSODENT ACTION123 HERBAL 120G;1;11400;0;11400;10400;1000;
2021-08-19 21:05:20;8997011700123;BIHUN JAGUNG 300GR;1;6000;0;6000;4979;1021;
2021-08-19 21:08:52;8996001355756;BENG-BENG MAXX SCT;5;2500;0;12500;10205;2295;
2021-08-19 21:09:56;8992959117583;SFX DS REG FLOW WING 20;1;5000;0;5000;4288;712;
2021-08-19 21:10:39;8998989500166;GUDANG GARAM MERAH BESAR 16KS;1;18000;0;18000;17000;1000;
2021-08-19 21:13:45;8994867007161;ROKOK PENA GOLD 20;1;17000;0;17000;15500;1500;
2021-08-19 21:13:45;8998009020186;BUAVITA GUAVA 250ML;1;7000;0;7000;6083;917;
2021-08-19 21:15:50;KPS;KAPAS MEI QIAN;1;5000;0;5000;4750;250;
2021-08-19 21:18:19;8991909101016;URBAN MILD 16;1;17000;0;17000;15800;1200;
2021-08-19 21:22:54;8999999048259;SUNSILK  SOFT&SMOOTH 70+21ML;1;9400;0;9400;8525;875;
2021-08-19 21:22:54;089686043204;INDOMIE MIE ACEH;1;2700;0;2700;2452;248;
2021-08-19 21:22:54;8998866203104;MIE SEDAAP SINGAPORE;1;2500;0;2500;2266;234;
2021-08-19 21:22:54;8998989300261;GUDANG GARAM SURYA 12 FILTER;1;19000;0;19000;17700;1300;
2021-08-19 21:28:23;RT;ROTI;1;9000;0;9000;8000;1000;
2021-08-19 21:29:29;8992761139018;ADES 600ML;2;3500;0;7000;4584;2416;
2021-08-19 21:31:44;LT;LIPSTIK HANASUI;1;27000;0;27000;27000;0;
2021-08-19 21:36:59;089686010107;INDOMIE KALDU AYAM;2;2500;0;5000;4300;700;
2021-08-19 21:37:55;KLOP;KLOP SALUTO;1;16000;0;16000;14545;1455;
2021-08-19 21:46:02;8991102320184;TANGO CHOCO JAVAMOCCA;1;5000;0;5000;4330;670;
2021-08-19 21:47:43;8992775315057;GERY SALUT MALKIST COKLAT;1;6500;0;6500;5516;984;
2021-08-19 21:51:00;8995333060772;TERIGU GATOT KACA 500GR;1;4500;0;4500;4065;435;
2021-08-19 22:03:14;8998866202312;NOODLE SEDAAP TASTY BAKMI AYAM 129 GR;2;5000;0;10000;8334;1666;
2021-08-19 22:03:14;8996001370063;CHOKI-CHOKI;1;18200;0;18200;16500;1700;
2021-08-19 22:03:14;8996001440520;ENERGEN JAGUNG;1;1500;0;1500;1150;350;
2021-08-19 22:03:14;8991002330504;RELAXA MANGO MINT;1;5000;0;5000;4500;500;
2021-08-19 22:03:14;8998866202671;NOODLE SEDAAP MIE KOREAN SPICY SOUP CUP;2;5000;0;10000;8004;1996;
2021-08-19 22:03:14;8994834006128;TICTIC PEDAS;1;2000;0;2000;1700;300;
2021-08-19 22:03:14;8998866202404;NOODLE SEDAAP MIE KOREAN SPICY CHICKEN CUP;1;5000;0;5000;4002;998;
2021-08-19 22:03:14;BB;PASEO SMARTY FACIAL TRAVEL PACK 50S GT;1;3000;0;3000;1980;1020;
2021-08-19 22:18:02;8992959953099;SWEETY BRONZE XL7;1;16000;0;16000;15190;810;
2021-08-19 22:21:45;089686043273;INDOMIE SAMBAL RICA;1;2700;0;2700;2452;248;
2021-08-19 22:21:45;089686010343;INDOMIE SOTO MIE;1;2600;0;2600;2367;233;
2021-08-19 22:21:45;8998989300261;GUDANG GARAM SURYA 12 FILTER;1;19000;0;19000;17700;1300;
2021-08-19 22:24:29;8999999059781;SUNLIGHT LIME NEW POUCH 210ML;1;5000;0;5000;4300;700;
2021-08-19 22:31:33;8999909010567;234 DJI SAM SOE 16;1;22000;0;22000;21500;500;
2021-08-19 22:32:45;8998989110167;SURYA GUDANG GARAM 16 FILTER;1;25000;0;25000;23700;1300;
2021-08-20 10:09:31;8999999516208;ROYCO FDS CHICKEN NEW 230G;1;10000;0;10000;9000;1000;
2021-08-20 10:09:31;8998866501026;MINYAK GORENG SEDAAP POUCH 1 L;5;15000;0;75000;70550;4450;
2021-08-20 10:24:28;8994834006128;TICTIC PEDAS;2;2000;0;4000;3400;600;
2021-08-20 10:24:28;8991102714860;MILKIDO STRAW;1;3000;0;3000;2153;847;
2021-08-20 10:34:20;8991102320184;TANGO CHOCO JAVAMOCCA;2;5000;0;10000;8660;1340;
2021-08-20 10:36:09;8992775610008;TING-TING GARUDA 2.5G;1;7500;0;7500;6296;1204;
2021-08-20 10:44:19;ROTI;ROTI 2000;1;2000;0;2000;1800;200;
2021-08-20 10:44:19;8991102320184;TANGO CHOCO JAVAMOCCA;1;5000;0;5000;4330;670;
2021-08-20 10:44:19;8998866692601;SOKLIN FLOORCLENER HIJAU 450ML;1;7000;0;7000;6385;615;
2021-08-20 10:44:19;8999999059781;SUNLIGHT LIME NEW POUCH 210ML;1;5000;0;5000;4300;700;
2021-08-20 10:46:39;8998009020186;BUAVITA GUAVA 250ML;1;7000;0;7000;6083;917;
2021-08-20 10:49:34;8999909028234;234 DJI SAM SOE 12;1;17000;0;17000;15850;1150;
2021-08-20 10:54:47;8992761164546;NUTRIBOOST STRAWBERRY 300ML;2;6500;0;13000;10600;2400;
2021-08-20 10:54:47;8991001121400;SILVERQUEEN ALMOND 65G;2;15000;0;30000;26400;3600;
2021-08-20 11:31:47;8991102989381;TANGO LONG BUBBLEGUM 130G;2;5000;0;10000;8690;1310;
2021-08-20 11:42:12;8996001600269;LE MINERAL 600ML;1;3000;0;3000;1688;1312;
2021-08-20 12:01:20;8998989300261;GUDANG GARAM SURYA 12 FILTER;1;19000;0;19000;17700;1300;
2021-08-20 12:01:20;6907992824963;JD MILKY CHOCOLATE;1;3000;0;3000;2600;400;
2021-08-20 12:02:47;6907992824963;JD MILKY CHOCOLATE;1;3000;0;3000;2600;400;
2021-08-20 12:02:47;8998989300261;GUDANG GARAM SURYA 12 FILTER;1;19000;0;19000;17700;1300;
2021-08-20 12:09:18;089686043273;INDOMIE SAMBAL RICA;1;2700;0;2700;2452;248;
2021-08-20 12:09:41;8993989311279;CLAS MILD 12;1;17000;0;17000;15700;1300;
2021-08-20 12:37:48;8992775311325;GERY SNACK&SEREAL 100G;1;7000;0;7000;6012;988;
2021-08-20 12:37:48;8996001355756;BENG-BENG MAXX SCT;2;2500;0;5000;4082;918;
2021-08-20 12:37:48;8886001038011;BENG-BENG SCT;4;1500;0;6000;5800;200;
2021-08-20 12:37:48;8992761002022;SPRITE PET 390ML;1;5500;0;5500;4300;1200;
2021-08-20 12:37:48;8992696523067;MILO ACTVGO UHT 180ML;1;4500;0;4500;3515;985;
2021-08-20 12:37:48;8998866202923;FLORIDINA COCO;1;3000;0;3000;2500;500;
2021-08-20 13:01:40;8991002307209;COFFE CANDY;1;5000;0;5000;4500;500;
2021-08-20 13:02:32;8999909982000;SAMPOERNA 12 FILTER;1;18000;0;18000;16000;2000;
2021-08-20 18:03:10;8998009010569;ULTRA CHO 200;2;5000;0;10000;7660;2340;
2021-08-20 18:03:10;8998866202060;POTABEE AYAM BAKAR PEDAS 35 GR;3;5000;0;15000;12450;2550;
2021-08-20 18:03:10;8997218380135;ICHITAN GREEN TEA;3;8000;0;24000;19749;4251;
2021-08-20 18:03:10;8998866202435;JAPOTA UMAMI JAPANESE SEAWEED 35GR;3;5000;0;15000;12450;2550;
2021-08-20 18:03:10;8991102987875;WFR TANGO POUCH CKL 115G;1;8000;0;8000;6786;1214;
2021-08-20 18:03:10;8991102320184;TANGO CHOCO JAVAMOCCA;1;5000;0;5000;4330;670;
2021-08-20 18:03:10;8998009020186;BUAVITA GUAVA 250ML;1;7000;0;7000;6083;917;
2021-08-20 18:03:10;8991102714860;MILKIDO STRAW;1;3000;0;3000;2153;847;
2021-08-20 18:03:10;8998866201865;KRISBEE PILLOW CHOCOLAVA 120 GR;1;8000;0;8000;7250;750;
2021-08-20 18:04:50;8996001338056;TAMARIN;1;6000;0;6000;5100;900;
2021-08-20 18:04:50;8999999034726;PONDS MEN WHITE BOOST 50G;1;18500;0;18500;17160;1340;
2021-08-20 19:36:21;8992959020012;SWEETY SILVER PANTS XL 34;1;78000;0;78000;73637;4363;
2021-08-20 20:44:09;8992761166038;MMP ORANGE 300ML;1;5000;0;5000;3750;1250;
2021-08-20 20:45:16;8996001305003;SARI GANDUM SANDWICH;1;6000;0;6000;5100;900;
2021-08-20 20:47:07;RB;RED BOLD;1;19000;0;19000;17900;1100;
2021-08-20 20:56:20;8999909096004;SAMPOERNA 16 FILTER;1;24000;0;24000;23000;1000;
2021-08-20 20:56:20;8997018250218;JAHE MERAH;3;1000;0;3000;2499;501;
2021-08-20 20:56:20;8998866201865;KRISBEE PILLOW CHOCOLAVA 120 GR;1;8000;0;8000;7250;750;
2021-08-20 20:56:20;8886001038011;BENG-BENG SCT;2;1500;0;3000;2900;100;
2021-08-20 20:56:20;PRG;PARAGO;4;500;0;2000;1600;400;
2021-08-20 20:56:20;8991111109107;JB POWDER BEDTIME 75+25g;1;6000;0;6000;5440;560;
2021-08-20 20:58:12;TEMBAK;TEMBAK SNIPPER;1;3500;0;3500;2500;1000;
2021-08-20 21:00:35;PUL;PULPEN;4;1500;0;6000;3332;2668;
2021-08-20 21:04:38;8998989110167;SURYA GUDANG GARAM 16 FILTER;1;25000;0;25000;23700;1300;
2021-08-20 21:04:38;ROTI;ROTI 2000;10;2000;0;20000;18000;2000;
2021-08-20 21:05:17;8997018720018;SIRUP DHT;1;23000;0;23000;20958;2042;
2021-08-20 21:16:53;ROTI;ROTI 2000;2;2000;0;4000;3600;400;
2021-08-20 21:16:53;8997009510116;LEMON WATER;1;7000;0;7000;5694;1306;
2021-08-20 21:16:53;8992761002039;FANTA STRAWBERRY PET 390 ML;1;5500;0;5500;4300;1200;
2021-08-20 21:16:53;8992761139018;ADES 600ML;1;3500;0;3500;2292;1208;
2021-08-20 21:16:53;8991102714860;MILKIDO STRAW;1;3000;0;3000;2153;847;
2021-08-20 21:16:53;089686611618;QTELA BARBEQUE;4;5000;0;20000;17064;2936;
2021-08-20 21:16:53;8997018720469;TISSUE SE-KA;1;10000;0;10000;9300;700;
2021-08-20 21:16:53;8999909096004;SAMPOERNA 16 FILTER;1;24000;0;24000;23000;1000;
2021-08-20 21:16:53;8997218380135;ICHITAN GREEN TEA;3;8000;0;24000;19749;4251;
2021-08-20 21:16:53;RB;RED BOLD;1;19000;0;19000;17900;1100;
2021-08-20 21:20:57;8993470411433;JOGER CLASSIC;8;1000;0;8000;6800;1200;
2021-08-20 21:25:15;8999999524722;SUNLIGHT LIME NEW PCH 435ML;1;10000;0;10000;9100;900;
2021-08-20 21:25:15;8992775002933;GERY MALKIST DOUBLE ABON;2;6500;0;13000;11032;1968;
2021-08-20 21:27:52;ROTI;ROTI 2000;1;2000;0;2000;1800;200;
2021-08-20 21:27:52;8991909101016;URBAN MILD 16;1;17000;0;17000;15800;1200;
2021-08-20 21:27:52;8992761139018;ADES 600ML;1;3500;0;3500;2292;1208;
2021-08-20 21:32:08;089686044249;SUPERMI NUTRIMI STEAK AYAM;1;3500;0;3500;2800;700;
2021-08-20 21:32:08;089686021141;INTER MIE SOTO;2;1000;0;2000;1708;292;
2021-08-20 21:32:08;TORT;TORTILA;2;1000;0;2000;2000;0;
2021-08-20 21:35:45;8994834001901;SUKI;1;1000;0;1000;761;239;
2021-08-20 21:45:09;8999801700030;SUSU FOYU;1;11500;0;11500;10450;1050;
2021-08-20 21:47:29;ROTI;ROTI 2000;3;2000;0;6000;5400;600;
2021-08-20 22:05:20;8999999195649;SARI WANGI 25X1.86G;1;6000;0;6000;5050;950;
2021-08-20 22:05:54;8997011700123;BIHUN JAGUNG 300GR;2;6000;0;12000;9958;2042;
2021-08-20 22:35:06;8998866501026;MINYAK GORENG SEDAAP POUCH 1 L;1;15000;0;15000;14110;890;
2021-08-20 22:35:06;8993226112508;GARAM REFINA;1;3000;0;3000;2461;539;
2021-08-20 22:35:06;8998866202626;Top Kopi Gula Aren 22gr;10;1000;0;10000;8300;1700;
2021-08-20 22:35:06;8991002105584;KAPAL API 6.5 G;4;500;0;2000;1560;440;
2021-08-20 22:51:34;8998866604512;FRES&NATURAL SOAP VIOLET 65G;3;1800;0;5400;4275;1125;
2021-08-20 22:53:48;8991102300544;WFR TANGO VNL 176G;1;10000;0;10000;8694;1306;
2021-08-20 22:57:29;8993989311279;CLAS MILD 12;1;17000;0;17000;15700;1300;
2021-08-20 22:59:23;8999908204202;MY BABY MINYAK TELON 60ML;1;18000;0;18000;16900;1100;
2021-08-20 23:12:35;GL;GULA 1 LITER;3;11500;0;34500;31500;3000;
2021-08-21 10:48:59;089686021219;INTER MIE GORENG;2;1000;0;2000;1770;230;
2021-08-21 10:51:34;089686011036;INDOMIE GORENG PEDAS;1;2700;0;2700;2452;248;
2021-08-21 10:54:17;ARG;ARGUS 220ML;1;14500;0;14500;13300;1200;
2021-08-21 10:54:17;6907992823935;JD SWEETCORN;1;3500;0;3500;3000;500;
2021-08-21 10:56:02;8998989300261;GUDANG GARAM SURYA 12 FILTER;1;19000;0;19000;17700;1300;
2021-08-21 11:08:49;GL;GULA 1 LITER;1;11500;0;11500;10500;1000;
2021-08-21 11:08:49;ARG;ARGUS 220ML;1;14500;0;14500;13300;1200;
2021-08-21 11:24:08;6907992823843;JD MOCHA CRISPY;1;5000;0;5000;4400;600;
2021-08-21 11:24:08;8992388133017;NU MILK TEA ORI 330ML;1;6000;0;6000;5125;875;
2021-08-21 11:24:08;8998666002525;TB TORA CAFE CAPPUCINO;2;1000;0;2000;1560;440;
2021-08-21 11:28:49;8991102714860;MILKIDO STRAW;8;3000;0;24000;17224;6776;
2021-08-21 11:35:08;ARG;ARGUS 220ML;1;14500;0;14500;13300;1200;
2021-08-21 12:41:03;8998866501026;MINYAK GORENG SEDAAP POUCH 1 L;1;15000;0;15000;14110;890;
2021-08-21 13:00:56;8999999538453;SUNSILK SHP SOFT AND  SMOOTH 55 ML;1;5000;0;5000;3750;1250;
2021-08-21 13:02:04;GL;GULA 1 LITER;1;11500;0;11500;10500;1000;
2021-08-21 13:02:04;8996001305058;ROMA SANDWICH KACANG;2;7000;0;14000;10000;4000;
2021-08-21 13:02:36;8992761002015;COCA COLA PET 390ML;1;5500;0;5500;4333;1167;
2021-08-21 13:03:01;8992979130012;TOTAL LEMON SOFTENER;1;13000;0;13000;11532;1468;
2021-08-21 13:12:31;6901997923072;SILET SEAGULL;1;6000;0;6000;5500;500;
2021-08-21 13:15:04;TORT;TORTILA;2;1000;0;2000;2000;0;
2021-08-21 13:31:28;8997210107877;VORTEX SMART 3;1;5000;0;5000;4750;250;
2021-08-21 13:58:16;8997018460150;MARLBORO ICE BURST 20;1;30000;0;30000;27750;2250;
2021-08-21 13:58:16;8998989300261;GUDANG GARAM SURYA 12 FILTER;1;19000;0;19000;17700;1300;
2021-08-21 14:22:29;GL;GULA 1 LITER;2;11500;0;23000;21000;2000;
2021-08-21 15:02:42;8993989311699;CLAS MILD 16 FILTER;1;23000;0;23000;21700;1300;
2021-08-21 15:24:24;8999999401252;RINSO ANTI NODA CLASSIC 1.8KG;1;44800;0;44800;40726;4074;
2021-08-21 15:32:44;8998989300261;GUDANG GARAM SURYA 12 FILTER;1;19000;0;19000;17700;1300;
2021-08-21 16:05:20;8992775318201;GERY SNACK BANTAL COKLAT;1;2000;0;2000;1712;288;
2021-08-21 16:07:19;8991909101016;URBAN MILD 16;1;17000;0;17000;15800;1200;
2021-08-21 16:07:19;123124;KOREK BIASA;1;2000;0;2000;1300;700;
2021-08-21 16:27:33;8993083929912;BISKITOP ASSORTED WAFER STICK;1;30000;0;30000;28400;1600;
2021-08-21 16:27:33;8997011931107;Ketumbar bubuk;1;1000;0;1000;833;167;
2021-08-21 16:29:04;8999999050009;SUNLIGHT LIME NEW POUCH 95ML;1;2000;0;2000;1600;400;
2021-08-21 16:29:47;8993083929837;BISKITOP BLACK COOKIES;1;27000;0;27000;23700;3300;
2021-08-21 16:34:42;8992775312469;GERY SALUT COKELAT;1;11000;0;11000;9983;1017;
2021-08-21 17:11:15;8992388101085;NU GREEN TEA ORIGINAL 330ML;1;3500;0;3500;2854;646;
2021-08-21 17:15:06;8886020033431;KAPUR AJAIB ANTI KECOA DAN NYAMUK;1;3000;0;3000;2700;300;
2021-08-21 17:15:06;8997018720469;TISSUE SE-KA;2;10000;0;20000;18600;1400;
2021-08-21 17:32:07;8996001600399;LE MINERAL 1500ML;2;5000;0;10000;8084;1916;
2021-08-21 17:32:07;8992959954034;SWEETY BRONZE NB 24;1;29000;0;29000;26762;2238;
2021-08-21 17:32:07;ROTI;ROTI 2000;3;2000;0;6000;5400;600;
2021-08-21 17:32:07;8998009010569;ULTRA CHO 200;1;5000;0;5000;3830;1170;
2021-08-21 17:32:07;8992696422650;NESCAFE FRENCH VANILLA;1;5000;0;5000;4099;901;
2021-08-21 17:33:29;8850007090281;JB BATH MILK 500ML;1;39000;0;39000;37160;1840;
2021-08-21 17:34:46;8999999559557;LUX BW MAGICAL ORCHID 85ML;2;5000;0;10000;8000;2000;
2021-08-21 17:34:46;8991111101408;JB POWDER 50G;1;3500;0;3500;3000;500;
2021-08-21 17:34:46;8998866202923;FLORIDINA COCO;1;3000;0;3000;2500;500;
2021-08-21 17:38:08;8886013213208;FRENCH FREIS 2000;3;5000;0;15000;11250;3750;
2021-08-21 17:39:28;8992628020152;BIMOLI POUCH 2L;1;31000;0;31000;29800;1200;
2021-08-21 17:39:28;089686043051;INDOMIE COTO MAKASSAR;2;2800;0;5600;5050;550;
2021-08-21 17:39:28;089686010107;INDOMIE KALDU AYAM;2;2500;0;5000;4300;700;
2021-08-21 17:58:42;GL;GULA 1 LITER;1;11500;0;11500;10500;1000;
2021-08-21 17:58:42;8997018720469;TISSUE SE-KA;1;10000;0;10000;9300;700;
2021-08-21 18:21:45;089686044249;SUPERMI NUTRIMI STEAK AYAM;1;3500;0;3500;2800;700;
2021-08-21 18:21:45;089686021219;INTER MIE GORENG;3;1000;0;3000;2655;345;
2021-08-21 18:21:45;8994834006128;TICTIC PEDAS;1;2000;0;2000;1700;300;
2021-08-21 18:23:55;8996001600269;LE MINERAL 600ML;1;3000;0;3000;1688;1312;
2021-08-21 18:23:55;089686611618;QTELA BARBEQUE;1;5000;0;5000;4266;734;
2021-08-21 18:32:53;8998989110167;SURYA GUDANG GARAM 16 FILTER;1;25000;0;25000;23700;1300;
2021-08-21 19:00:22;8999909002821;MARLBORO BLACK 16;1;22000;0;22000;20850;1150;
2021-08-21 19:00:22;8994867007161;ROKOK PENA GOLD 20;1;17000;0;17000;15500;1500;
2021-08-21 19:01:30;8991102320184;TANGO CHOCO JAVAMOCCA;1;5000;0;5000;4330;670;
2021-08-21 19:01:30;TG;TEH GELAS;1;1000;0;1000;729;271;
2021-08-21 19:51:30;8998989500166;GUDANG GARAM MERAH BESAR 16KS;1;18000;0;18000;17000;1000;
2021-08-21 19:55:38;ROTI;ROTI 2000;5;2000;0;10000;9000;1000;
2021-08-21 19:55:38;8991102385060;TANGO WAFFLE CHOX;1;9000;0;9000;8498;502;
2021-08-21 19:57:46;8992959953167;SWEETY BRONZE S36+2;1;48000;0;48000;45682;2318;
2021-08-21 19:57:46;8996001600399;LE MINERAL 1500ML;1;5000;0;5000;4042;958;
2021-08-21 20:22:55;8992628020152;BIMOLI POUCH 2L;1;31000;0;31000;29800;1200;
2021-08-21 20:24:21;8992959508855;SWEETY SILVER PANTS XL 18;1;47800;0;47800;43353;4447;
2021-08-21 20:36:24;Gula gula pulpen;gula gula pulpen;3;2000;0;6000;5250;750;
2021-08-21 20:38:53;089686386127;BUMBU RACIK NASI GORENG SOSIS;2;2000;0;4000;3240;760;
2021-08-21 20:38:53;089686386011;BUMBU RACIK NASI GORENG;1;2000;0;2000;1450;550;
2021-08-21 20:55:52;6907992823843;JD MOCHA CRISPY;1;5000;0;5000;4400;600;
2021-08-21 20:55:52;6907992823867;JD CRUNCHY CHOCOLATE MALT;1;5500;0;5500;4700;800;
2021-08-21 21:17:38;8992959117583;SFX DS REG FLOW WING 20;1;5000;0;5000;4288;712;
2021-08-21 21:17:38;8999999533366;VASELINE FRESH&FAIR 100ML;1;13000;0;13000;11805;1195;
2021-08-21 21:26:00;telur;telur;2;2000;0;4000;2468;1532;
2021-08-21 21:27:03;8991102320184;TANGO CHOCO JAVAMOCCA;1;5000;0;5000;4330;670;
2021-08-21 21:27:03;8992761166205;FRESTEA GREEN HONEY 350ML;1;4500;0;4500;3000;1500;
2021-08-21 21:43:16;089686010343;INDOMIE SOTO MIE;1;2600;0;2600;2367;233;
2021-08-21 21:43:16;8998866200578;MIE SEDAAP KARI KENTAL;1;2700;0;2700;2331;369;
2021-08-21 21:43:16;089686043273;INDOMIE SAMBAL RICA;1;2700;0;2700;2452;248;
2021-08-21 22:04:18;ARG;ARGUS 220ML;1;14500;0;14500;13300;1200;
2021-08-21 22:09:53;8999999518998;RINSO MOLTO PERFUME ESSENSE 770GR;1;21300;0;21300;19338;1962;
2021-08-21 22:09:53;8991102023115;Sikat Gigi Formula;1;11000;0;11000;10000;1000;
2021-08-21 22:12:53;8993989311699;CLAS MILD 16 FILTER;1;23000;0;23000;21700;1300;
2021-08-21 22:12:53;8992761164478;FRESTEA MILK TEA;1;8000;0;8000;6575;1425;
2021-08-21 22:36:00;8998866200813;NOODLE SEDAAP MIE GORENG CUP 85 GR;2;5000;0;10000;7834;2166;
2021-08-21 22:36:00;8991102320184;TANGO CHOCO JAVAMOCCA;1;5000;0;5000;4330;670;
2021-08-21 22:36:00;8886013213208;FRENCH FREIS 2000;1;5000;0;5000;3750;1250;
2021-08-21 22:36:00;089686611618;QTELA BARBEQUE;1;5000;0;5000;4266;734;
2021-08-21 22:36:00;8992775311325;GERY SNACK&SEREAL 100G;1;7000;0;7000;6012;988;
2021-08-21 22:36:00;8996001440520;ENERGEN JAGUNG;9;1500;0;13500;10350;3150;
2021-08-21 22:36:00;8996001600269;LE MINERAL 600ML;2;3000;0;6000;3376;2624;
2021-08-21 22:36:00;8991001121400;SILVERQUEEN ALMOND 65G;2;15000;0;30000;26400;3600;
2021-08-22 09:07:46;8998866202343;MIE SEDAAP KOREAN SPICY;1;2700;0;2700;2413;287;
2021-08-22 09:16:39;8997028590014;ARGUS 220ML;1;500;0;500;302;198;
2021-08-22 09:19:46;089686021219;INTER MIE GORENG;2;1000;0;2000;1770;230;
2021-08-22 09:19:46;Gula gula pulpen;gula gula pulpen;1;2000;0;2000;1750;250;
2021-08-22 09:31:53;089686021219;INTER MIE GORENG;1;1000;0;1000;885;115;
2021-08-22 11:58:32;telur;telur;3;2000;0;6000;3702;2298;
2021-08-22 12:08:41;8996001600269;LE MINERAL 600ML;1;3000;0;3000;1688;1312;
2021-08-22 12:16:12;089686611618;QTELA BARBEQUE;2;5000;0;10000;8532;1468;
2021-08-22 12:16:12;8992696521797;MILO 22G;10;2500;0;25000;15720;9280;
2021-08-22 12:16:12;8992775318201;GERY SNACK BANTAL COKLAT;2;2000;0;4000;3424;576;
2021-08-22 12:16:12;8991002121003;GOOD DAY TIRAMISU BLISS;2;6000;0;12000;8590;3410;
2021-08-22 12:16:12;ARG;ARGUS 220ML;1;14500;0;14500;13300;1200;
2021-08-22 15:14:05;ARG;ARGUS 220ML;1;14500;0;14500;13300;1200;
2021-08-22 15:18:08;8999909000711;MAGNUM MILD 16;1;21000;0;21000;19350;1650;
2021-08-22 15:19:00;8886057883665;KRATING DAENG;1;6000;0;6000;4286;1714;
2021-08-22 15:19:41;ROTI;ROTI 2000;1;2000;0;2000;1800;200;
2021-08-22 15:23:27;8994867006997;ROKOK PENA BOLD 20BTG;1;17000;0;17000;15000;2000;
2021-08-22 15:33:59;8998866202060;POTABEE AYAM BAKAR PEDAS 35 GR;1;5000;0;5000;4150;850;
2021-08-22 15:33:59;089686611878;QTELA TEMPE;1;6000;0;6000;5370;630;
2021-08-22 15:33:59;8992761166052;FRESTEA MELATI 350ML;3;4500;0;13500;9000;4500;
2021-08-22 15:33:59;8995150101771;M+SUSU RASA JERUK;1;5000;0;5000;4000;1000;
2021-08-22 15:37:02;8998666001924;TB TORA CAFE CHOCO LATTE;3;1000;0;3000;2340;660;
2021-08-22 15:41:36;8998866202732;MILKU STROBERI 200ML;1;3000;0;3000;2375;625;
2021-08-22 15:41:36;ROTI;ROTI 2000;1;2000;0;2000;1800;200;
2021-08-22 15:42:59;JL;JELLY;10;500;0;5000;4000;1000;
2021-08-22 16:30:01;8993083929912;BISKITOP ASSORTED WAFER STICK;1;30000;0;30000;28400;1600;
2021-08-22 16:30:01;8997025914059;HATARI SEE HONG;2;6000;0;12000;9822;2178;
2021-08-22 16:56:36;9556040040038;SUSU F&N;2;33000;0;66000;60000;6000;
2021-08-22 16:56:36;8992761166038;MMP ORANGE 300ML;1;5000;0;5000;3750;1250;
2021-08-22 16:56:36;8992761166052;FRESTEA MELATI 350ML;1;4500;0;4500;3000;1500;
2021-08-22 16:56:36;6907992823935;JD SWEETCORN;1;3500;0;3500;3000;500;
2021-08-22 17:08:07;8992628020152;BIMOLI POUCH 2L;1;31000;0;31000;29800;1200;
2021-08-22 17:08:07;8992770034175;MASAKO;1;5000;0;5000;4000;1000;
2021-08-22 17:12:47;8992747180126;VIXAL PEMB PORS 470ML;1;15000;0;15000;13420;1580;
2021-08-22 17:12:47;8997025914059;HATARI SEE HONG;1;6000;0;6000;4911;1089;
2021-08-22 17:15:53;8996001355978;BENG-BENG SHARE IT 9.5G;1;10000;0;10000;8700;1300;
2021-08-22 17:15:53;8992761139018;ADES 600ML;1;3500;0;3500;2292;1208;
2021-08-22 17:15:53;8996001600375;LE MINERAL 330ML;1;2000;0;2000;1417;583;
2021-08-22 17:15:53;8994834005923;SPIX 1000;3;1000;0;3000;2550;450;
2021-08-22 17:15:53;YP;YUPI;3;250;0;750;624;126;
2021-08-22 17:45:42;8992628020152;BIMOLI POUCH 2L;1;31000;0;31000;29800;1200;
2021-08-22 17:54:49;JL;JELLY;2;500;0;1000;800;200;
2021-08-22 17:56:13;JL;JELLY;2;500;0;1000;800;200;
2021-08-22 18:03:32;JL;JELLY;10;500;0;5000;4000;1000;
2021-08-22 18:37:57;089686646047;SUNMARIE;1;7000;0;7000;6626;374;
2021-08-22 19:12:50;TORT;TORTILA;4;1000;0;4000;4000;0;
2021-08-22 19:15:15;8997018720469;TISSUE SE-KA;1;10000;0;10000;9300;700;
2021-08-22 19:15:15;8992775001042;PILUS GARUDA MI GORENG;1;5000;0;5000;4810;190;
2021-08-22 19:15:15;8991102020305;FORMULA TRIPLE ACTION;1;3000;0;3000;2500;500;
2021-08-22 19:15:15;8998866106979;CIPTADENT TB CHARCOAL PROTEC;1;6000;0;6000;5250;750;
2021-08-22 20:01:33;8998866501026;MINYAK GORENG SEDAAP POUCH 1 L;1;15000;0;15000;14110;890;
2021-08-22 20:01:33;8999999053291;LIFEBUOY LEMONFRESH 110G;1;15000;0;15000;14245;755;
2021-08-22 20:01:33;8995333060772;TERIGU GATOT KACA 500GR;1;5000;0;5000;4346;654;
2021-08-22 20:01:33;8996001440049;ENERGEN;7;1500;0;10500;8400;2100;
2021-08-22 20:03:50;8999801700054;SUSU FOYU 1 KG;1;22000;0;22000;19791;2209;
2021-08-22 20:03:50;ROTI;ROTI 2000;2;2000;0;4000;3600;400;
2021-08-22 20:18:01;8999909096004;SAMPOERNA 16 FILTER;1;24000;0;24000;23000;1000;
2021-08-22 20:18:01;8998989300261;GUDANG GARAM SURYA 12 FILTER;1;19000;0;19000;17700;1300;
2021-08-22 20:26:04;8995333060703;TERIGU KOMPAS 1KG;2;10500;0;21000;19632;1368;
2021-08-22 20:26:04;8995333000822;TERIGU KOMPAS SOFT 500GR;1;5500;0;5500;4967;533;
2021-08-22 20:28:03;8991102714846;MILKIDO CKLT;1;3000;0;3000;2153;847;
2021-08-22 20:28:03;VTM;VITAMIN CIMIN;4;500;0;2000;1700;300;
2021-08-22 20:58:33;8998866201865;KRISBEE PILLOW CHOCOLAVA 120 GR;1;8000;0;8000;7250;750;
2021-08-22 21:20:46;8993989311279;CLAS MILD 12;1;17000;0;17000;15700;1300;
2021-08-22 22:06:20;8998866202343;MIE SEDAAP KOREAN SPICY;2;2700;0;5400;4826;574;
2021-08-22 22:06:20;RB;RED BOLD;1;19000;0;19000;17900;1100;
2021-08-22 22:08:54;089686049053;SARIMI PUAS;2;3000;0;6000;4800;1200;
2021-08-22 22:08:54;ARG;ARGUS 220ML;1;14500;0;14500;13300;1200;
2021-08-22 22:14:30;8998866202060;POTABEE AYAM BAKAR PEDAS 35 GR;1;5000;0;5000;4150;850;
2021-08-22 22:14:30;WC;WAFER COKELAT MADE;5;1000;0;5000;4000;1000;
2021-08-22 22:20:35;8991001121400;SILVERQUEEN ALMOND 65G;1;15000;0;15000;13200;1800;
2021-08-22 22:20:35;8992775913000;CHOCOLATOS CKLT 28G;6;2000;0;12000;9342;2658;
2021-08-22 22:34:48;089686021219;INTER MIE GORENG;5;1000;0;5000;4425;575;
2021-08-22 22:44:35;8992696405417;DNCO INSTANT 27G;6;3500;0;21000;18000;3000;
2021-08-23 07:36:35;ROTI;ROTI 2000;3;2000;0;6000;5400;600;
2021-08-23 07:36:35;8996001600269;LE MINERAL 600ML;2;3000;0;6000;3376;2624;
2021-08-23 07:47:13;8991102714846;MILKIDO CKLT;1;3000;0;3000;2153;847;
2021-08-23 11:04:46;8992775001691;GARUDA ROSTA WAGYU BEEF;1;8000;0;8000;7322;678;
2021-08-23 11:10:23;8991102714594;TANGO DRINK BLCK VNL;1;5000;0;5000;3818;1182;
2021-08-23 11:18:02;8992775203422;GARUDA ROSTA OVEN 100G;1;8000;0;8000;7322;678;
2021-08-23 11:21:04;8999099920486;SGM 0-6 1000G;1;87000;0;87000;83707;3293;
2021-08-23 11:21:04;8992959954058;SWEETY BRONZE NB 44;1;48000;0;48000;45682;2318;
2021-08-23 12:19:03;8996001600665;COOL TIME;1;3500;0;3500;2750;750;
2021-08-23 12:19:59;8886013213208;FRENCH FREIS 2000;1;5000;0;5000;3750;1250;
2021-08-23 12:25:16;8991002121010;GOOD DAY FANTASTIC MOCACINNO;1;6000;0;6000;4295;1705;
2021-08-23 12:25:50;8999999508609;LIFEBUOY HAND SANITIZER 50ML;1;13000;0;13000;11600;1400;
2021-08-23 12:25:50;8996200900092;HEROCYN 85GR;1;13000;0;13000;11650;1350;
2021-08-23 12:32:29;ROTI;ROTI 2000;3;2000;0;6000;5400;600;
2021-08-23 12:33:45;TG;TEH GELAS;3;1000;0;3000;2187;813;
2021-08-23 12:33:45;8992761139018;ADES 600ML;1;3500;0;3500;2292;1208;
2021-08-23 12:34:59;8996001600269;LE MINERAL 600ML;3;3000;0;9000;5064;3936;
2021-08-23 12:36:08;8998866202695;KOPI MAYOR;1;6000;0;6000;4500;1500;
2021-08-23 12:54:43;8886013213208;FRENCH FREIS 2000;3;5000;0;15000;11250;3750;
2021-08-23 12:55:26;8991102320184;TANGO CHOCO JAVAMOCCA;1;5000;0;5000;4330;670;
2021-08-23 13:02:48;089686611670;QTELA BALADO;1;5000;0;5000;4266;734;
2021-08-23 13:02:48;8991002121003;GOOD DAY TIRAMISU BLISS;1;6000;0;6000;4295;1705;
2021-08-23 13:02:48;8992696523081;MILO UHT 110ML;1;2500;0;2500;1962;538;
2021-08-23 13:04:22;4800888141125;AXE DEO BODYSPRAY DARK 150ML;1;20000;0;20000;10615;9385;
2021-08-23 13:11:53;6949586607033;SILET ALSHABAB;1;8500;0;8500;7500;1000;
2021-08-23 13:11:53;8996001600269;LE MINERAL 600ML;1;3000;0;3000;1688;1312;
2021-08-23 13:11:53;RT;ROTI;1;9000;0;9000;8000;1000;
2021-08-23 13:11:53;8997028590014;ARGUS 220ML;3;500;0;1500;906;594;
2021-08-23 13:21:29;8997028590014;ARGUS 220ML;6;500;0;3000;1812;1188;
2021-08-23 13:22:25;8996001600269;LE MINERAL 600ML;1;3000;0;3000;1688;1312;
2021-08-23 13:22:25;8991002121065;GOOD DAY AVOCADO DELIGHT;1;6000;0;6000;4295;1705;
2021-08-23 13:22:25;8999999534356;MOLTO DETERGEN CARE PINK PCH 700ML;1;20500;0;20500;18570;1930;
2021-08-23 13:49:02;8995333032113;TERIGU GATOT KACA 1 KG;1;10000;0;10000;8572;1428;
2021-08-23 13:56:55;Gula gula pulpen;gula gula pulpen;1;2000;0;2000;1750;250;
2021-08-23 14:04:48;8998989110167;SURYA GUDANG GARAM 16 FILTER;1;25000;0;25000;23700;1300;
2021-08-23 15:45:18;8998866200301;MIE SEDAAP GORENG;3;2700;0;8100;7239;861;
2021-08-23 15:45:18;8998866602563;NUVO FAMILY HIJAU 76G;1;2000;0;2000;1820;180;
2021-08-23 15:45:18;8998866602556;NUVO FAMILY MERAH 76G;2;2000;0;4000;3640;360;
2021-08-23 15:46:43;8996001312582;MALKIST KELAPA KOPYOR SCT;1;1000;0;1000;820;180;
2021-08-23 16:16:17;8991111109138;JB POWDER BLOSSOM 150+50G;1;10000;0;10000;9210;790;
2021-08-23 16:16:17;telur;telur;3;2000;0;6000;3702;2298;
2021-08-23 16:54:56;9999;ISOLASI LAKBAN;1;8000;0;8000;6500;1500;
2021-08-23 17:02:14;8997028590014;ARGUS 220ML;2;500;0;1000;604;396;
2021-08-23 17:02:14;8998989300261;GUDANG GARAM SURYA 12 FILTER;1;19000;0;19000;17700;1300;
2021-08-23 17:02:14;8992933216110;NUTRIJELL MANGO;2;6000;0;12000;9900;2100;
2021-08-23 17:02:14;8995150101696;M+SUSU ORIGINAL;1;5000;0;5000;4000;1000;
2021-08-23 17:02:14;8993007001557;INDOMILK SKM 37G;2;1500;0;3000;2162;838;
2021-08-23 17:02:14;8995333000822;TERIGU KOMPAS SOFT 500GR;2;5500;0;11000;9934;1066;
2021-08-23 17:03:02;8992775211434;PILUS GARUDA SAPI PANGGANG;1;5000;0;5000;4810;190;
2021-08-23 17:07:18;8995333000822;TERIGU KOMPAS SOFT 500GR;4;5500;0;22000;19868;2132;
2021-08-23 17:07:18;8995333060703;TERIGU KOMPAS 1KG;1;10500;0;10500;9816;684;
2021-08-23 17:09:21;8991102308823;KLOP COCONUT ORI;1;6000;0;6000;4969;1031;
2021-08-23 17:09:21;8994834005923;SPIX 1000;6;1000;0;6000;5100;900;
2021-08-23 17:09:21;TS;TISSUE TESSY;1;5000;0;5000;4200;800;
2021-08-23 17:10:38;TBR;TEPUNG BERAS ROSE BRAND;1;8000;0;8000;5800;2200;
2021-08-23 18:19:05;8993989311699;CLAS MILD 16 FILTER;1;23000;0;23000;21700;1300;
2021-08-23 18:19:05;8998866201865;KRISBEE PILLOW CHOCOLAVA 120 GR;1;8000;0;8000;7250;750;
2021-08-23 18:31:26;ff;FULLO BLASTO;2;1000;0;2000;1990;10;
2021-08-23 18:31:26;8998866202619;MIE SEDAAP KOREAN SPICY SOUP;1;2700;0;2700;2322;378;
2021-08-23 19:38:01;8992959117583;SFX DS REG FLOW WING 20;1;5000;0;5000;4288;712;
2021-08-23 19:38:01;8997018720469;TISSUE SE-KA;1;10000;0;10000;9300;700;
2021-08-23 19:41:47;8995333060772;TERIGU GATOT KACA 500GR;1;5000;0;5000;4346;654;
2021-08-23 19:41:47;8995333032113;TERIGU GATOT KACA 1 KG;4;10000;0;40000;34288;5712;
2021-08-23 20:03:38;ARG;ARGUS 220ML;1;14500;0;14500;13300;1200;
2021-08-23 20:03:38;6907992823843;JD MOCHA CRISPY;1;5000;0;5000;4400;600;
2021-08-23 20:17:36;123124;KOREK BIASA;1;2000;0;2000;1300;700;
2021-08-23 22:07:03;GL;GULA 1 LITER;5;11500;0;57500;52500;5000;
2021-08-23 22:11:00;8992959953105;SWEETY BRONZE XXL6;1;16000;0;16000;15230;770;
2021-08-23 22:13:07;PUL;PULPEN;6;1500;0;9000;4998;4002;
2021-08-23 22:14:08;8998989500166;GUDANG GARAM MERAH BESAR 16KS;1;18000;0;18000;17000;1000;
2021-08-23 22:14:33;123124;KOREK BIASA;1;2000;0;2000;1300;700;
2021-08-23 22:19:14;ROTI;ROTI 2000;1;2000;0;2000;1800;200;
2021-08-23 22:20:20;8996001600399;LE MINERAL 1500ML;1;5000;0;5000;4042;958;
2021-08-23 22:21:14;8998989110167;SURYA GUDANG GARAM 16 FILTER;2;25000;0;50000;47400;2600;
2021-08-23 22:22:43;milkita;milkita;4;500;0;2000;1480;520;
2021-08-23 22:23:27;8996001600597;KOPIKO LUCKY DAY;1;5000;0;5000;4283;717;
2021-08-23 22:24:10;8996001600399;LE MINERAL 1500ML;1;5000;0;5000;4042;958;
2021-08-23 22:24:38;ROTI;ROTI 2000;5;2000;0;10000;9000;1000;
2021-08-23 22:25:51;8998898280401;TOLAK ANGIN FLU;6;3500;0;21000;16248;4752;
2021-08-23 22:27:22;KOPIKO;KOPIKO;12;250;0;3000;2100;900;
2021-08-23 22:28:10;ROTI;ROTI 2000;1;2000;0;2000;1800;200;
2021-08-23 22:28:52;8996001600399;LE MINERAL 1500ML;1;5000;0;5000;4042;958;
2021-08-23 22:31:51;089686611519;QTELA SINGKONG;3;5000;0;15000;12798;2202;
2021-08-23 22:32:48;8996001600269;LE MINERAL 600ML;1;3000;0;3000;1688;1312;
2021-08-23 22:33:59;CLUB;AIR CLUB 600ML;2;3000;0;6000;2904;3096;
2021-08-23 22:34:51;8996001600269;LE MINERAL 600ML;3;3000;0;9000;5064;3936;
2021-08-23 22:35:38;8992761139018;ADES 600ML;1;3500;0;3500;2292;1208;
2021-08-23 22:37:02;9556001004673;MILO NESTLE MALAYSIA ACTIVE GO;1;85000;0;85000;80000;5000;
2021-08-23 22:37:40;8996001600269;LE MINERAL 600ML;1;3000;0;3000;1688;1312;
2021-08-23 22:39:11;MILKITA;MILKITA;12;250;0;3000;2400;600;
2021-08-23 22:47:11;JL;JELLY;12;500;0;6000;4800;1200;
2021-08-23 22:49:26;CLUB;AIR CLUB 600ML;4;3000;0;12000;5808;6192;
2021-08-23 22:49:26;896867700494;AIR CLUB 1500ML;1;5000;0;5000;2987;2013;
2021-08-24 09:51:55;8991002103764;GOOD DAY CAPPUCINO 10X25G;5;1500;0;7500;6975;525;
2021-08-24 09:51:55;KPS;KAPAS MEI QIAN;1;5000;0;5000;4750;250;
2021-08-24 09:55:19;8991102230308;BLASTER PINK;1;5000;0;5000;3106;1894;
2021-08-24 09:55:19;8996001600269;LE MINERAL 600ML;1;3000;0;3000;1688;1312;
2021-08-24 10:32:33;11;PASEO SMART FHSTD PERF 6P 12S;1;5000;0;5000;4264;736;
2021-08-24 10:55:30;6907992823829;JD MILKY MILK;3;3000;0;9000;7800;1200;
2021-08-24 10:56:31;8992761166052;FRESTEA MELATI 350ML;1;4500;0;4500;3000;1500;
2021-08-24 11:00:46;8992761002039;FANTA STRAWBERRY PET 390 ML;2;5500;0;11000;8600;2400;
2021-08-24 11:03:17;8998866500708;FLORIDINA ORANGE;1;3000;0;3000;2500;500;
2021-08-24 11:03:17;6907992823829;JD MILKY MILK;1;3000;0;3000;2600;400;
2021-08-24 11:03:17;8991102987875;WFR TANGO POUCH CKL 115G;1;8000;0;8000;6786;1214;
2021-08-24 11:12:24;8992761166205;FRESTEA GREEN HONEY 350ML;1;4500;0;4500;3000;1500;
2021-08-24 11:17:34;8998989121163;SURYA PRO MERAH;1;20000;0;20000;18600;1400;
2021-08-24 11:17:34;8992761002039;FANTA STRAWBERRY PET 390 ML;1;5500;0;5500;4300;1200;
2021-08-24 11:34:59;8991001780492;SELAMAT COKLAT;1;13000;0;13000;11800;1200;
2021-08-24 11:34:59;8996001600269;LE MINERAL 600ML;1;3000;0;3000;1688;1312;
2021-08-24 11:36:49;8996001600269;LE MINERAL 600ML;1;3000;0;3000;1688;1312;
2021-08-24 11:36:49;8991001780492;SELAMAT COKLAT;1;13000;0;13000;11800;1200;
2021-08-24 11:41:48;8998989110167;SURYA GUDANG GARAM 16 FILTER;1;25000;0;25000;23700;1300;
2021-08-24 11:42:15;8993053641042;PASEO BABY WIPES GAZETTE 50S;1;17000;0;17000;15400;1600;
2021-08-24 11:46:27;8992753184002;FF MILKY STRW 115G;1;3000;0;3000;2178;822;
2021-08-24 11:49:49;8992775002933;GERY MALKIST DOUBLE ABON;1;6500;0;6500;5516;984;
2021-08-24 11:49:49;8991102384841;WFR TANGO LONG CKLT 130G;1;5000;0;5000;4345;655;
2021-08-24 11:49:49;8992761164478;FRESTEA MILK TEA;2;8000;0;16000;13150;2850;
2021-08-24 11:51:29;8992761002015;COCA COLA PET 390ML;1;5500;0;5500;4333;1167;
2021-08-24 11:51:29;8991102384841;WFR TANGO LONG CKLT 130G;1;5000;0;5000;4345;655;
2021-08-24 11:52:33;8991102384841;WFR TANGO LONG CKLT 130G;1;5000;0;5000;4345;655;
2021-08-24 11:52:33;8992761002015;COCA COLA PET 390ML;2;5500;0;11000;8666;2334;
2021-08-24 11:54:53;8996001600269;LE MINERAL 600ML;2;3000;0;6000;3376;2624;
2021-08-24 12:07:54;8850507002951;BONCHA EGG SQUISHY;1;12000;0;12000;10841;1159;
2021-08-24 12:19:16;ARG;ARGUS 220ML;1;14500;0;14500;13300;1200;
2021-08-24 12:20:27;8992933216110;NUTRIJELL MANGO;1;6000;0;6000;4950;1050;
2021-08-24 12:20:27;8996001600269;LE MINERAL 600ML;1;3000;0;3000;1688;1312;
2021-08-24 12:46:57;8993989311699;CLAS MILD 16 FILTER;2;23000;0;46000;43400;2600;
2021-08-24 13:05:33;089686010343;INDOMIE SOTO MIE;1;2600;0;2600;2367;233;
2021-08-24 13:05:33;089686010107;INDOMIE KALDU AYAM;1;2500;0;2500;2150;350;
2021-08-24 13:05:33;089686041705;INDOMIE GORENG JUMBO;1;3500;0;3500;3143;357;
2021-08-24 13:13:01;8992761164539;NUTRIBOOST ORANGE 300ML;5;6500;0;32500;26500;6000;
2021-08-24 13:14:58;8996001600269;LE MINERAL 600ML;1;3000;0;3000;1688;1312;
2021-08-24 13:19:16;6907992823911;JD CRUNCHY HONEYDEW MELON;1;8000;0;8000;6800;1200;
2021-08-24 13:21:51;ARG;ARGUS 220ML;1;14500;0;14500;13300;1200;
2021-08-24 13:21:51;8994867007161;ROKOK PENA GOLD 20;1;17000;0;17000;15500;1500;
2021-08-24 13:26:02;8998866501026;MINYAK GORENG SEDAAP POUCH 1 L;4;15000;0;60000;56440;3560;
2021-08-24 13:26:02;ARG;ARGUS 220ML;2;14500;0;29000;26600;2400;
2021-08-24 13:27:39;8992959953082;SWEETY BRONZE L8;1;17000;0;17000;15380;1620;
2021-08-24 13:29:28;8992761111533;SPRITE SLIM CAM250ML;1;5000;0;5000;3750;1250;
2021-08-24 13:29:28;8998009040023;TEH KOTAK;1;5000;0;5000;2827;2173;
2021-08-24 13:43:51;8996001354001;KALPA SCT;1;2000;0;2000;1666;334;
2021-08-24 14:05:22;089686010107;INDOMIE KALDU AYAM;2;2500;0;5000;4300;700;
2021-08-24 14:05:22;089686041705;INDOMIE GORENG JUMBO;1;3500;0;3500;3143;357;
2021-08-24 14:09:41;VCO;VICEE C500 ORANGE;15;1000;0;15000;8625;6375;
2021-08-24 14:10:02;VCO;VICEE C500 ORANGE;1;1000;0;1000;575;425;
2021-08-24 14:14:45;8999999036492;LUX BW PINK SOFT BTL 100ML;1;10000;0;10000;8690;1310;
2021-08-24 16:10:14;8993989311699;CLAS MILD 16 FILTER;1;23000;0;23000;21700;1300;
2021-08-24 16:10:14;8992753182008;FF MILKY CKLT 115ML;1;3000;0;3000;2179;821;
2021-08-24 16:10:14;8991102100823;Formula Acttion Protector 190 gr;1;10000;0;10000;9000;1000;
2021-08-24 16:10:14;8992959107607;SFX COMFORT SLIM 1;1;5000;0;5000;4000;1000;
2021-08-24 16:10:14;8998866202053;POTABEE AYAM BAKAR PEDAS 68GR;1;8000;0;8000;7200;800;
2021-08-24 17:42:57;TORT;TORTILA;2;1000;0;2000;2000;0;
2021-08-24 17:42:57;8998989110129;SURYA KECIL MERAH 12KS;1;19000;0;19000;16450;2550;
2021-08-24 17:42:57;6907992823935;JD SWEETCORN;1;3500;0;3500;3000;500;
2021-08-24 17:42:57;8998989110167;SURYA GUDANG GARAM 16 FILTER;1;25000;0;25000;23700;1300;
2021-08-24 18:25:58;GL;GULA 1 LITER;2;11500;0;23000;21000;2000;
2021-08-24 18:25:58;SMC;BIMURA MAKARONI CINCIN 250G;1;10000;0;10000;9300;700;
2021-08-24 19:27:23;ff;FULLO BLASTO;2;1000;0;2000;1990;10;
2021-08-24 19:27:23;8994867007161;ROKOK PENA GOLD 20;1;17000;0;17000;15500;1500;
2021-08-24 19:46:52;8995333032113;TERIGU GATOT KACA 1 KG;4;10000;0;40000;34288;5712;
2021-08-24 19:50:08;8998866200301;MIE SEDAAP GORENG;2;2700;0;5400;4826;574;
2021-08-24 19:54:00;8995333060772;TERIGU GATOT KACA 500GR;1;5000;0;5000;4346;654;
2021-08-24 19:54:31;8992761002039;FANTA STRAWBERRY PET 390 ML;1;5500;0;5500;4300;1200;
2021-08-24 19:55:56;telur;telur;6;2000;0;12000;7404;4596;
2021-08-24 19:56:49;089686021127;INTER MIE KALDU;2;1000;0;2000;1626;374;
2021-08-24 19:57:38;8993989311699;CLAS MILD 16 FILTER;1;23000;0;23000;21700;1300;
2021-08-24 19:59:04;9999;ISOLASI LAKBAN;2;8000;0;16000;13000;3000;
2021-08-24 20:03:36;8999909010567;234 DJI SAM SOE 16;1;22000;0;22000;21500;500;
2021-08-24 20:09:58;8999999706081;PEPSODENT WHITE 75G;1;5000;0;5000;3850;1150;
2021-08-24 20:09:58;8993379121211;SABUN MEDICARE PUTIH;1;2500;0;2500;2237;263;
2021-08-24 20:09:58;8993379260026;SABUN MEDICARE BLACK;1;2500;0;2500;2237;263;
2021-08-24 20:09:58;8996001440001;TB JAHE SUSU;3;1500;0;4500;2610;1890;
2021-08-24 20:09:58;8998866611152;CREAM EKONOMI VIOLET 455G;1;5500;0;5500;4750;750;
2021-08-24 20:11:53;76164217;MARLBORO MERAH;1;30000;0;30000;27700;2300;
2021-08-24 20:13:55;telur;telur;10;2000;0;20000;12340;7660;
2021-08-24 20:14:20;8886020033431;KAPUR AJAIB ANTI KECOA DAN NYAMUK;1;3000;0;3000;2700;300;
2021-08-24 20:16:19;8997018720469;TISSUE SE-KA;1;10000;0;10000;9300;700;
2021-08-24 20:18:49;8998866888622;GIV MERAH KOTAK 76G;2;2000;0;4000;3640;360;
2021-08-24 20:20:16;MOLTO PINK;MOLTO ALL IN ONE 11 ML;5;500;0;2500;2000;500;
2021-08-24 20:21:17;RB;RED BOLD;1;19000;0;19000;17900;1100;
2021-08-24 20:22:11;RT 1000;ROTI 1000;1;1000;0;1000;800;200;
2021-08-24 20:25:05;8998866608459;POWDET DAIA PUTIH BAG 290GR;1;5000;0;5000;4450;550;
2021-08-24 20:27:07;8998866613002;CREAM EKONOMI PINK 455G;1;5500;0;5500;4750;750;
2021-08-24 20:27:57;8997213203118;INLITE 12W;1;46000;0;46000;42000;4000;
2021-08-24 20:32:18;8998866609036;DAIA BUNGA GUSSET 565G;1;10000;0;10000;8700;1300;
2021-08-24 20:33:22;8998989100120;GUDANG GARAM MINI;1;18000;0;18000;16600;1400;
2021-08-24 20:33:38;123124;KOREK BIASA;1;2000;0;2000;1300;700;
2021-08-24 20:39:06;8991111112206;C&C DEEP ACTION CLEANSER 50G;1;14000;0;14000;12900;1100;
2021-08-24 20:42:44;8992775203415;GARUDA ROSTA 25G;1;8000;0;8000;7322;678;
2021-08-24 20:42:44;8992775211434;PILUS GARUDA SAPI PANGGANG;1;5000;0;5000;4810;190;
2021-08-24 20:43:55;8991102989381;TANGO LONG BUBBLEGUM 130G;1;5000;0;5000;4345;655;
2021-08-24 20:43:55;8992770034175;MASAKO;1;5000;0;5000;4000;1000;
2021-08-24 20:44:51;8997028590014;ARGUS 220ML;1;500;0;500;302;198;
2021-08-24 20:45:33;8995333032113;TERIGU GATOT KACA 1 KG;1;10000;0;10000;8572;1428;
2021-08-24 20:47:31;TORT;TORTILA;2;1000;0;2000;2000;0;
2021-08-24 20:49:10;8999999571887;MOLTO EDP PURPLE 10ML;1;5000;0;5000;4800;200;
2021-08-24 20:54:09;8999999531492;MOLTO GLAMOUR;1;5000;0;5000;4800;200;
2021-08-24 20:54:58;8992761139018;ADES 600ML;1;3500;0;3500;2292;1208;
2021-08-24 20:55:39;8992775001691;GARUDA ROSTA WAGYU BEEF;1;8000;0;8000;7322;678;
2021-08-24 20:57:01;8992775001691;GARUDA ROSTA WAGYU BEEF;1;8000;0;8000;7322;678;
2021-08-24 20:57:47;8996001600269;LE MINERAL 600ML;3;3000;0;9000;5064;3936;
2021-08-24 20:58:51;GL;GULA 1 LITER;2;11500;0;23000;21000;2000;
2021-08-24 21:00:15;8991102303309;WFR TANGO SBJ 176G;1;10000;0;10000;8694;1306;
2021-08-24 21:01:10;8996001305003;SARI GANDUM SANDWICH;1;6000;0;6000;5100;900;
2021-08-24 21:01:55;8997025914042;ATB MARIE SUSU 185G;1;7000;0;7000;4554;2446;
2021-08-24 21:02:55;8992775000663;GERY SNACK KEJU;2;2000;0;4000;3424;576;
2021-08-24 21:03:40;8994867000162;ROKOK PUNDIMAS KRETEK16;1;10000;0;10000;8600;1400;
2021-08-24 21:04:34;8999909982000;SAMPOERNA 12 FILTER;1;18000;0;18000;16000;2000;
2021-08-24 21:04:52;VTM;VITAMIN CIMIN;1;500;0;500;425;75;
2021-08-24 21:05:27;RT 1000;ROTI 1000;2;1000;0;2000;1600;400;
2021-08-24 21:05:54;8992761164478;FRESTEA MILK TEA;1;8000;0;8000;6575;1425;
2021-08-24 21:06:23;8992761166212;FRESTEA APPLE 350ML;1;4500;0;4500;3000;1500;
2021-08-24 21:07:03;PUL;PULPEN;1;1500;0;1500;833;667;
2021-08-24 21:07:34;8996001600269;LE MINERAL 600ML;1;3000;0;3000;1688;1312;
2021-08-24 21:10:00;8997028590014;ARGUS 220ML;6;500;0;3000;1812;1188;
2021-08-24 21:10:00;KOPIKO;KOPIKO;12;250;0;3000;2100;900;
2021-08-24 21:11:02;8998866501026;MINYAK GORENG SEDAAP POUCH 1 L;5;15000;0;75000;70550;4450;
2021-08-24 21:11:33;8995333060703;TERIGU KOMPAS 1KG;1;10500;0;10500;9816;684;
2021-08-24 21:12:43;8991102320184;TANGO CHOCO JAVAMOCCA;1;5000;0;5000;4330;670;
2021-08-24 21:13:50;8999999195656;SARI WANGI 50X1.85;1;10000;0;10000;9500;500;
2021-08-24 21:14:11;8991102320184;TANGO CHOCO JAVAMOCCA;1;5000;0;5000;4330;670;
2021-08-24 21:14:41;8991102320184;TANGO CHOCO JAVAMOCCA;2;5000;0;10000;8660;1340;
2021-08-24 21:16:34;8998989110167;SURYA GUDANG GARAM 16 FILTER;1;25000;0;25000;23700;1300;
2021-08-24 21:18:01;8996001600269;LE MINERAL 600ML;1;3000;0;3000;1688;1312;
2021-08-24 21:18:38;8997028590014;ARGUS 220ML;4;500;0;2000;1208;792;
2021-08-24 21:26:31;8993989311699;CLAS MILD 16 FILTER;1;23000;0;23000;21700;1300;
2021-08-24 21:26:31;8996001600269;LE MINERAL 600ML;5;3000;0;15000;8440;6560;
2021-08-24 21:29:31;8992761166205;FRESTEA GREEN HONEY 350ML;1;4500;0;4500;3000;1500;
2021-08-24 21:29:31;RT BAKPIA;ROTI BAKPIA;10;1000;0;10000;7500;2500;
2021-08-24 21:30:43;8992761139018;ADES 600ML;1;3500;0;3500;2292;1208;
2021-08-24 21:33:56;8992775610008;TING-TING GARUDA 2.5G;1;7500;0;7500;6296;1204;
2021-08-24 21:33:56;089686611670;QTELA BALADO;2;5000;0;10000;8532;1468;
2021-08-24 21:34:30;8998866610377;ISOPLUS;2;3000;0;6000;4700;1300;
2021-08-24 21:37:48;8992959117613;SFX DAUN SIRIH 1 WP;10;500;0;5000;4130;870;
2021-08-24 21:42:34;8992696521797;MILO 22G;4;2500;0;10000;6288;3712;
2021-08-24 21:42:58;8996001600375;LE MINERAL 330ML;1;2000;0;2000;1417;583;
2021-08-24 21:47:34;8995333032113;TERIGU GATOT KACA 1 KG;4;10000;0;40000;34288;5712;
2021-08-24 21:49:37;8998866679596;SOKLIN LANTAI BIRU 780ML;1;12000;0;12000;10020;1980;
2021-08-24 21:50:12;JL;JELLY;5;500;0;2500;2000;500;
2021-08-24 21:50:44;8995333060703;TERIGU KOMPAS 1KG;1;10500;0;10500;9816;684;
2021-08-24 21:51:30;JL;JELLY;4;500;0;2000;1600;400;
2021-08-24 21:53:02;8993379254469;SABUN LERVIA 90G;1;5000;0;5000;3077;1923;
2021-08-24 21:53:30;8998989500166;GUDANG GARAM MERAH BESAR 16KS;1;18000;0;18000;17000;1000;
2021-08-24 22:01:00;8998866202312;NOODLE SEDAAP TASTY BAKMI AYAM 129 GR;2;5000;0;10000;8334;1666;
2021-08-24 22:01:00;089686611670;QTELA BALADO;1;5000;0;5000;4266;734;
2021-08-24 22:01:00;8996001600399;LE MINERAL 1500ML;1;5000;0;5000;4042;958;
2021-08-24 22:05:33;8997009510123;ORANGE WATER;1;7000;0;7000;6089;911;
2021-08-24 22:23:04;VCL;VICEE C500 LEMON;5;1000;0;5000;2875;2125;
2021-08-24 22:25:02;VCO;VICEE C500 ORANGE;5;1000;0;5000;2875;2125;
2021-08-24 22:31:08;TORT;TORTILA;1;1000;0;1000;1000;0;
2021-08-24 22:31:38;8993470671752;JOGER STICK DUO KACANG;1;1000;0;1000;850;150;
2021-08-24 22:32:58;milkita;milkita;1;500;0;500;370;130;
2021-08-24 22:34:11;VCL;VICEE C500 LEMON;5;1000;0;5000;2875;2125;
2021-08-24 22:37:02;PUL;PULPEN;2;1500;0;3000;1666;1334;
2021-08-24 22:39:12;8999909002821;MARLBORO BLACK 16;1;22000;0;22000;20850;1150;
2021-08-24 22:40:39;8992775000663;GERY SNACK KEJU;2;2000;0;4000;3424;576;
2021-08-24 22:49:32;8992775311486;CHOCOLATOS DARK 16G;1;18000;0;18000;15173;2827;
2021-08-24 22:50:36;8998009010231;ULTRA CHO 250;1;6000;0;6000;4784;1216;
2021-08-24 23:02:21;8991102320184;TANGO CHOCO JAVAMOCCA;1;5000;0;5000;4330;670;
2021-08-24 23:08:29;8999999195656;SARI WANGI 50X1.85;1;10000;0;10000;9500;500;
2021-08-24 23:08:29;8994834001901;SUKI;1;1000;0;1000;761;239;
2021-08-24 23:08:29;Gula gula pulpen;gula gula pulpen;1;2000;0;2000;1750;250;
2021-08-24 23:09:42;8992959955024;SWEETY BABY WIPES 36X50;1;17000;0;17000;14293;2707;
2021-08-24 23:10:47;8992959001875;SWEETY SILVER PANTS S RTG;1;10200;0;10200;9168;1032;
2021-08-24 23:11:23;8991002121010;GOOD DAY FANTASTIC MOCACINNO;1;6000;0;6000;4295;1705;
2021-08-25 09:46:56;8991102385091;WFR TANGO CKLT 7G;1;8300;0;8300;7455;845;
2021-08-25 10:39:17;8992696523067;MILO ACTVGO UHT 180ML;1;4500;0;4500;3515;985;
2021-08-25 10:39:17;8998009010569;ULTRA CHO 200;1;5000;0;5000;3830;1170;
2021-08-25 10:40:59;8991102987875;WFR TANGO POUCH CKL 115G;1;8000;0;8000;6786;1214;
2021-08-25 10:43:43;8992696523067;MILO ACTVGO UHT 180ML;2;4500;0;9000;7030;1970;
2021-08-25 10:44:52;8992388133017;NU MILK TEA ORI 330ML;1;6000;0;6000;5125;875;
2021-08-25 10:44:52;8992761145033;FANTA STRAW PET 250ML;2;3500;0;7000;4834;2166;
2021-08-25 10:44:52;8998009040023;TEH KOTAK;1;5000;0;5000;2827;2173;
2021-08-25 10:47:47;8998989500166;GUDANG GARAM MERAH BESAR 16KS;1;18000;0;18000;17000;1000;
2021-08-25 10:55:21;8996001301562;MALKIST TABUR KELAPA;5;1000;0;5000;4100;900;
2021-08-25 10:56:26;8992775000663;GERY SNACK KEJU;1;2000;0;2000;1712;288;
2021-08-25 11:06:05;8993470672858;SAKU-SAKU RASA BALADO;1;2000;0;2000;1530;470;
2021-08-25 11:06:05;8998866201841;GOLDA DOLCE LATTE 200ML;3;3000;0;9000;7500;1500;
2021-08-25 11:19:03;8991102320184;TANGO CHOCO JAVAMOCCA;1;5000;0;5000;4330;670;
2021-08-25 11:19:03;8996001600269;LE MINERAL 600ML;3;3000;0;9000;5064;3936;
2021-08-25 11:48:49;8991102230308;BLASTER PINK;1;5000;0;5000;3106;1894;
2021-08-25 11:54:56;8996001600269;LE MINERAL 600ML;1;3000;0;3000;1688;1312;
2021-08-25 12:19:25;8998989500166;GUDANG GARAM MERAH BESAR 16KS;1;18000;0;18000;17000;1000;
2021-08-25 12:21:41;BPO;BIMURA POTATO ORIGINAL 250G;1;10000;0;10000;9300;700;
2021-08-25 12:22:15;8992775210215;GARUDA ATOM PEDAS;1;17000;0;17000;15363;1637;
2021-08-25 12:24:10;6907992825076;JD WATERMELON APPLE;3;2000;0;6000;5100;900;
2021-08-25 12:24:10;6907992823959;JD HAWTHORN BERRY;2;2000;0;4000;3400;600;
2021-08-25 12:24:57;8994867000162;ROKOK PUNDIMAS KRETEK16;1;10000;0;10000;8600;1400;
2021-08-25 12:25:15;8996001600597;KOPIKO LUCKY DAY;1;5000;0;5000;4283;717;
2021-08-25 12:38:23;TORT;TORTILA;1;1000;0;1000;1000;0;
2021-08-25 16:39:51;8992775002933;GERY MALKIST DOUBLE ABON;1;6500;0;6500;5516;984;
2021-08-25 16:39:51;8991102320184;TANGO CHOCO JAVAMOCCA;1;5000;0;5000;4330;670;
2021-08-25 16:43:17;8993379152017;SABUN CUCI SURYA 200G;1;3000;0;3000;2281;719;
2021-08-25 16:43:17;8999999059309;LIFEBUOY TS TOTAL 10 DG 75G;1;3000;0;3000;2640;360;
2021-08-25 16:43:17;8999999045920;LIFEBUOY TS TOTAL 10 110GR;1;15000;0;15000;14245;755;
2021-08-25 16:43:17;8999999706081;PEPSODENT WHITE 75G;1;5000;0;5000;3850;1150;
2021-08-25 16:43:17;8999999534097;PEPSODENT PGB FCM 75G;1;5000;0;5000;3850;1150;
2021-08-25 16:43:17;8992628020152;BIMOLI POUCH 2L;1;31000;0;31000;29800;1200;
2021-08-25 16:43:17;7118441101378;KECAP ABC 520 ML;1;19000;0;19000;17800;1200;
2021-08-25 17:15:30;8992775002582;DILAN CHOCO;2;2000;0;4000;3006;994;
2021-08-25 17:56:28;8993007003902;Susu Kental Manis Indo milk;1;15000;0;15000;13333;1667;
2021-08-25 17:58:40;8992775311486;CHOCOLATOS DARK 16G;1;18000;0;18000;15173;2827;
2021-08-25 17:58:40;8997028590014;ARGUS 220ML;3;500;0;1500;906;594;
2021-08-25 18:16:01;8997025911058;HATARI SHP KELAPA;1;6000;0;6000;4911;1089;
2021-08-25 18:16:01;GL;GULA 1 LITER;2;11500;0;23000;21000;2000;
2021-08-25 18:21:20;089686043204;INDOMIE MIE ACEH;1;2700;0;2700;2452;248;
2021-08-25 18:21:20;8996001355978;BENG-BENG SHARE IT 9.5G;1;10000;0;10000;8700;1300;
2021-08-25 18:21:20;8996001318911;BETTER ISI 4;1;2000;0;2000;1700;300;
2021-08-25 18:21:20;8996001355756;BENG-BENG MAXX SCT;1;2500;0;2500;2041;459;
2021-08-25 18:21:20;8996001354001;KALPA SCT;1;2000;0;2000;1666;334;
2021-08-25 18:21:20;8998866200301;MIE SEDAAP GORENG;1;2700;0;2700;2413;287;
2021-08-25 18:21:20;ARG;ARGUS 220ML;1;14500;0;14500;13300;1200;
2021-08-25 18:38:54;8992761164546;NUTRIBOOST STRAWBERRY 300ML;2;6500;0;13000;10600;2400;
2021-08-25 18:38:54;8999999049669;REXONA MEN RO INVISIBLE DRY 45 ML;1;15000;0;15000;13550;1450;
2021-08-25 18:40:17;8992761164546;NUTRIBOOST STRAWBERRY 300ML;1;6500;0;6500;5300;1200;
2021-08-25 18:47:19;8992761164546;NUTRIBOOST STRAWBERRY 300ML;1;6500;0;6500;5300;1200;
2021-08-25 19:06:56;ARG;ARGUS 220ML;1;14500;0;14500;13300;1200;
2021-08-25 19:06:56;8995333060772;TERIGU GATOT KACA 500GR;1;5000;0;5000;4346;654;
2021-08-25 19:24:21;8994935000070;MINYAK DUNIA 450 ML;1;7500;0;7500;6779;721;
2021-08-25 19:24:21;8999999559045;SUNLIGHT LIME CREAM 110G;1;2000;0;2000;1800;200;
2021-08-25 19:24:21;8934868015024;REXONA DEO LOTION FREE SPIRIT 9G;1;2500;0;2500;2000;500;
2021-08-25 19:26:48;8999909002821;MARLBORO BLACK 16;1;22000;0;22000;20850;1150;
2021-08-25 19:26:48;8998989110167;SURYA GUDANG GARAM 16 FILTER;2;25000;0;50000;47400;2600;
2021-08-25 20:17:57;8998989500166;GUDANG GARAM MERAH BESAR 16KS;1;18000;0;18000;17000;1000;
2021-08-25 20:25:05;123124;KOREK BIASA;1;2000;0;2000;1300;700;
2021-08-25 20:25:05;089686611618;QTELA BARBEQUE;1;5000;0;5000;4266;734;
2021-08-25 20:25:05;8992775002735;CHOCOLATOS SUSU COKELAT;1;4000;0;4000;3520;480;
2021-08-25 20:39:29;PUL;PULPEN;2;1500;0;3000;1666;1334;
2021-08-25 20:58:48;76239878;MARLBORO GOLD;1;30000;0;30000;27700;2300;
2021-08-25 21:08:05;8998866202602;KRISBEE FRENCH FRIES 18GR;1;2000;0;2000;1500;500;
2021-08-25 21:08:05;KOPIKO;KOPIKO;24;250;0;6000;4200;1800;
2021-08-25 21:08:05;8991002304413;RELAXA GRAPE MINT;1;5000;0;5000;4500;500;
2021-08-25 21:09:02;PUL;PULPEN;2;1500;0;3000;1666;1334;
2021-08-25 21:14:34;TG;TEH GELAS;3;1000;0;3000;2187;813;
2021-08-25 21:14:34;8996001600269;LE MINERAL 600ML;1;3000;0;3000;1688;1312;
2021-08-25 21:14:34;8996001302620;MALKIST COKLAT SCT;2;1000;0;2000;1680;320;
2021-08-25 21:14:34;8992761145033;FANTA STRAW PET 250ML;1;3500;0;3500;2417;1083;
2021-08-25 21:14:34;8999909010567;234 DJI SAM SOE 16;1;22000;0;22000;21500;500;
2021-08-25 21:14:34;123124;KOREK BIASA;1;2000;0;2000;1300;700;
2021-08-25 21:19:52;8992761145026;SPRITE PET 250ML;1;3500;0;3500;2417;1083;
2021-08-25 21:19:52;milkita;milkita;2;500;0;1000;740;260;
2021-08-25 21:19:52;8992761166038;MMP ORANGE 300ML;2;5000;0;10000;7500;2500;
2021-08-25 21:19:52;8998989300261;GUDANG GARAM SURYA 12 FILTER;1;19000;0;19000;17700;1300;
2021-08-25 21:25:36;089686021219;INTER MIE GORENG;1;1000;0;1000;885;115;
2021-08-25 21:25:36;8992761166038;MMP ORANGE 300ML;1;5000;0;5000;3750;1250;
2021-08-25 21:25:36;8992775210215;GARUDA ATOM PEDAS;1;17000;0;17000;15363;1637;
2021-08-25 21:29:44;8999909096004;SAMPOERNA 16 FILTER;1;24000;0;24000;23000;1000;
2021-08-25 21:31:18;8992761166038;MMP ORANGE 300ML;1;5000;0;5000;3750;1250;
2021-08-25 21:31:18;8996001600269;LE MINERAL 600ML;1;3000;0;3000;1688;1312;
2021-08-25 21:31:58;8992761145026;SPRITE PET 250ML;1;3500;0;3500;2417;1083;
2021-08-25 21:32:59;8998989300261;GUDANG GARAM SURYA 12 FILTER;1;19000;0;19000;17700;1300;
2021-08-25 21:35:48;8998866613002;CREAM EKONOMI PINK 455G;1;5500;0;5500;4750;750;
2021-08-25 21:35:48;8991002304413;RELAXA GRAPE MINT;1;5000;0;5000;4500;500;
2021-08-25 21:36:25;8996001600269;LE MINERAL 600ML;1;3000;0;3000;1688;1312;
2021-08-25 21:42:40;GL;GULA 1 LITER;1;11500;0;11500;10500;1000;
2021-08-25 21:42:40;8992761164546;NUTRIBOOST STRAWBERRY 300ML;1;6500;0;6500;5300;1200;
2021-08-25 21:42:40;ARG;ARGUS 220ML;2;14500;0;29000;26600;2400;
2021-08-25 21:46:02;CLUB;AIR CLUB 600ML;1;3000;0;3000;1452;1548;
2021-08-25 21:46:38;8996001600269;LE MINERAL 600ML;2;3000;0;6000;3376;2624;
2021-08-25 21:47:42;8992761166038;MMP ORANGE 300ML;1;5000;0;5000;3750;1250;
2021-08-25 21:47:42;RT 1000;ROTI 1000;5;1000;0;5000;4000;1000;
2021-08-25 21:48:25;8992775110140;GARUDA KACANG KULIT 160G;1;12000;0;12000;10012;1988;
2021-08-25 21:50:28;8994867000162;ROKOK PUNDIMAS KRETEK16;1;10000;0;10000;8600;1400;
2021-08-25 21:52:34;8998989500166;GUDANG GARAM MERAH BESAR 16KS;1;18000;0;18000;17000;1000;
2021-08-25 21:52:34;8999099920486;SGM 0-6 1000G;2;87000;0;174000;167414;6586;
2021-08-25 21:52:34;ARG;ARGUS 220ML;1;14500;0;14500;13300;1200;
2021-08-25 21:55:43;8998866200301;MIE SEDAAP GORENG;2;2700;0;5400;4826;574;
2021-08-25 21:55:43;8998866200325;MIE SEDAAP SOTO;2;2700;0;5400;4662;738;
2021-08-25 22:00:06;8996001600399;LE MINERAL 1500ML;1;5000;0;5000;4042;958;
2021-08-25 22:00:06;8992761002039;FANTA STRAWBERRY PET 390 ML;1;5500;0;5500;4300;1200;
2021-08-25 22:00:06;telur;telur;5;2000;0;10000;6170;3830;
2021-08-25 22:00:06;8998866200325;MIE SEDAAP SOTO;1;2700;0;2700;2331;369;
2021-08-25 22:00:06;YOUTOP;YOUTOP;2;1000;0;2000;1750;250;
2021-08-25 22:08:49;8992388133017;NU MILK TEA ORI 330ML;1;6000;0;6000;5125;875;
2021-08-25 22:08:49;8991001503107;CHACHA PEANUT 35GR;1;5500;0;5500;4900;600;
2021-08-25 22:08:49;8991001242013;Top;2;1000;0;2000;1000;1000;
2021-08-25 22:10:42;8991001503107;CHACHA PEANUT 35GR;1;5500;0;5500;4900;600;
2021-08-25 22:20:22;8997218380074;ICHITAN MILK TEA;1;8000;0;8000;6583;1417;
2021-08-25 22:20:22;8999999552527;ZWITSAL KIDS BB CLN&FRSH BLUE 280 ML;1;21500;0;21500;19855;1645;
2021-08-25 22:24:19;8998866202312;NOODLE SEDAAP TASTY BAKMI AYAM 129 GR;1;5000;0;5000;4167;833;
2021-08-25 22:24:19;8998866200301;MIE SEDAAP GORENG;1;2700;0;2700;2413;287;
2021-08-25 22:24:19;8998866202060;POTABEE AYAM BAKAR PEDAS 35 GR;1;5000;0;5000;4150;850;
2021-08-25 22:24:19;8992742360844;POLYTEX SABUT STENLESS;1;4000;0;4000;2200;1800;
2021-08-25 22:24:19;SKT;SIKAT CUCI;1;6000;0;6000;5000;1000;
2021-08-25 22:24:19;balon air;balon air;1;2000;0;2000;1700;300;
2021-08-25 22:26:59;MENTOS;MENTOS;18;250;0;4500;3150;1350;
2021-08-25 22:29:03;8992775315057;GERY SALUT MALKIST COKLAT;1;6500;0;6500;5516;984;
2021-08-25 22:33:08;8991102320184;TANGO CHOCO JAVAMOCCA;1;5000;0;5000;4330;670;
2021-08-25 22:33:08;balon air;balon air;1;2000;0;2000;1700;300;
2021-08-25 22:33:08;8995333060703;TERIGU KOMPAS 1KG;1;10500;0;10500;9816;684;
2021-08-25 22:33:08;8995333032113;TERIGU GATOT KACA 1 KG;6;10000;0;60000;51432;8568;
2021-08-25 22:42:54;8998866201452;POTABEE REGULER BBQ BEEF 35GR;1;5000;0;5000;4150;850;
2021-08-25 22:45:13;8994935000070;MINYAK DUNIA 450 ML;1;7500;0;7500;6779;721;
2021-08-25 22:50:33;8998866603409;RAPIKA UNGU POUCH 400ML;1;5000;0;5000;4500;500;
2021-08-25 22:59:00;8998866200301;MIE SEDAAP GORENG;2;2700;0;5400;4826;574;
2021-08-25 22:59:00;089686021219;INTER MIE GORENG;6;1000;0;6000;5310;690;
2021-08-25 22:59:00;8998866202244;EKOMIE BUMBU KALDU AYAM;3;1000;0;3000;2394;606;
2021-08-25 22:59:00;8998866200325;MIE SEDAAP SOTO;4;2700;0;10800;9324;1476;
2021-08-25 23:01:17;8992959508992;SWEETY SILVER PANTS L 28;1;56800;0;56800;51819;4981;
2021-08-25 23:02:28;ARG;ARGUS 220ML;1;14500;0;14500;13300;1200;
2021-08-25 23:03:02;8996001600399;LE MINERAL 1500ML;2;5000;0;10000;8084;1916;
2021-08-25 23:03:51;8998989110167;SURYA GUDANG GARAM 16 FILTER;3;25000;0;75000;71100;3900;
2021-08-25 23:04:42;8999909002821;MARLBORO BLACK 16;1;22000;0;22000;20850;1150;
2021-08-25 23:04:42;telur rak;telur rak;1;40000;0;40000;37000;3000;
2021-08-26 12:51:25;8995333060772;TERIGU GATOT KACA 500GR;1;5000;0;5000;4346;654;
2021-08-26 12:58:22;8999909982000;SAMPOERNA 12 FILTER;1;18000;0;18000;16000;2000;
2021-08-26 12:59:25;8992761164539;NUTRIBOOST ORANGE 300ML;2;6500;0;13000;10600;2400;
2021-08-26 12:59:59;8992761164539;NUTRIBOOST ORANGE 300ML;1;6500;0;6500;5300;1200;
2021-08-26 13:00:49;8998009010231;ULTRA CHO 250;2;6000;0;12000;9568;2432;
2021-08-26 13:02:32;8998866202732;MILKU STROBERI 200ML;1;3000;0;3000;2375;625;
2021-08-26 13:02:55;8998989300261;GUDANG GARAM SURYA 12 FILTER;1;19000;0;19000;17700;1300;
2021-08-26 13:04:02;8998866202435;JAPOTA UMAMI JAPANESE SEAWEED 35GR;1;5000;0;5000;4150;850;
2021-08-26 13:04:48;8998866201452;POTABEE REGULER BBQ BEEF 35GR;1;5000;0;5000;4150;850;
2021-08-26 13:05:46;8992775001783;GERY SALUT MALKIST KELAPA;2;6500;0;13000;11032;1968;
2021-08-26 13:07:59;8992775001691;GARUDA ROSTA WAGYU BEEF;1;8000;0;8000;7322;678;
2021-08-26 13:08:59;8996001600399;LE MINERAL 1500ML;1;5000;0;5000;4042;958;
2021-08-26 13:11:34;8998866200301;MIE SEDAAP GORENG;2;2700;0;5400;4826;574;
2021-08-26 13:11:34;089686010343;INDOMIE SOTO MIE;2;2600;0;5200;4734;466;
2021-08-26 13:11:34;8992775211434;PILUS GARUDA SAPI PANGGANG;1;5000;0;5000;4810;190;
2021-08-26 13:11:34;ROTI;ROTI 2000;3;2000;0;6000;5400;600;
2021-08-26 13:13:44;8998989300261;GUDANG GARAM SURYA 12 FILTER;1;19000;0;19000;17700;1300;
2021-08-26 13:51:05;ff;FULLO BLASTO;1;1000;0;1000;995;5;
2021-08-26 13:51:05;TORT;TORTILA;1;1000;0;1000;1000;0;
2021-08-26 16:04:22;8992959508855;SWEETY SILVER PANTS XL 18;1;47800;0;47800;43353;4447;
2021-08-26 16:20:34;8999909096004;SAMPOERNA 16 FILTER;1;24000;0;24000;23000;1000;
2021-08-26 16:30:52;8999909982000;SAMPOERNA 12 FILTER;1;18000;0;18000;16000;2000;
2021-08-26 16:49:25;6907992825076;JD WATERMELON APPLE;2;2000;0;4000;3400;600;
2021-08-26 16:50:35;TORT;TORTILA;1;1000;0;1000;1000;0;
2021-08-26 19:13:32;8998009040023;TEH KOTAK;3;5000;0;15000;8481;6519;
2021-08-26 19:15:14;8992696521797;MILO 22G;1;2500;0;2500;1572;928;
2021-08-26 19:17:16;8992761111533;SPRITE SLIM CAM250ML;1;5000;0;5000;3750;1250;
2021-08-26 19:23:21;8992761164546;NUTRIBOOST STRAWBERRY 300ML;1;6500;0;6500;5300;1200;
2021-08-26 19:23:52;089686611878;QTELA TEMPE;1;6000;0;6000;5370;630;
2021-08-26 19:24:31;8992761139018;ADES 600ML;1;3500;0;3500;2292;1208;
2021-08-26 19:24:56;RB;RED BOLD;1;19000;0;19000;17900;1100;
2021-08-26 19:25:30;RB;RED BOLD;1;19000;0;19000;17900;1100;
2021-08-26 19:29:45;8991102230308;BLASTER PINK;1;5000;0;5000;3106;1894;
2021-08-26 19:32:06;GL;GULA 1 LITER;1;11500;0;11500;10500;1000;
2021-08-26 19:34:38;ROTI;ROTI 2000;2;2000;0;4000;3600;400;
2021-08-26 19:35:11;ROTI;ROTI 2000;2;2000;0;4000;3600;400;
2021-08-26 19:36:05;ROTI;ROTI 2000;1;2000;0;2000;1800;200;
2021-08-26 19:38:02;8994867000162;ROKOK PUNDIMAS KRETEK16;1;10000;0;10000;8600;1400;
2021-08-26 19:38:45;089686611519;QTELA SINGKONG;1;5000;0;5000;4266;734;
2021-08-26 19:40:52;ROTI;ROTI 2000;3;2000;0;6000;5400;600;
2021-08-26 19:43:47;8998989500166;GUDANG GARAM MERAH BESAR 16KS;2;18000;0;36000;34000;2000;
2021-08-26 19:48:31;8998866201841;GOLDA DOLCE LATTE 200ML;1;3000;0;3000;2500;500;
2021-08-26 19:50:01;089686611519;QTELA SINGKONG;1;5000;0;5000;4266;734;
2021-08-26 19:50:44;8993470411433;JOGER CLASSIC;1;1000;0;1000;850;150;
2021-08-26 19:52:20;ROTI;ROTI 2000;3;2000;0;6000;5400;600;
2021-08-26 19:54:59;8997009510116;LEMON WATER;1;7000;0;7000;5694;1306;
2021-08-26 19:59:03;8999909096004;SAMPOERNA 16 FILTER;2;24000;0;48000;46000;2000;
2021-08-26 20:04:19;8998009040023;TEH KOTAK;1;5000;0;5000;2827;2173;
2021-08-26 20:05:04;8998989500128;GUDANG GARAM MERAH KECIL 12KS;1;14000;0;14000;13000;1000;
2021-08-26 20:20:47;telur rak;telur rak;1;40000;0;40000;37000;3000;
2021-08-26 20:37:40;8992761111533;SPRITE SLIM CAM250ML;2;5000;0;10000;7500;2500;
2021-08-26 20:40:51;8995333000822;TERIGU KOMPAS SOFT 500GR;3;5500;0;16500;14901;1599;
2021-08-26 20:45:23;8998866200301;MIE SEDAAP GORENG;3;2700;0;8100;7239;861;
2021-08-26 20:45:23;ARG;ARGUS 220ML;1;14500;0;14500;13300;1200;
2021-08-26 21:03:00;8998866501026;MINYAK GORENG SEDAAP POUCH 1 L;1;15000;0;15000;14110;890;
2021-08-26 22:16:36;8998866200301;MIE SEDAAP GORENG;2;2700;0;5400;4826;574;
2021-08-26 22:32:55;123124;KOREK BIASA;1;2000;0;2000;1300;700;
2021-08-26 22:36:07;8999999195649;SARI WANGI 25X1.86G;1;6000;0;6000;5050;950;
2021-08-26 22:36:51;8999999031602;SARI MURNI 20X1.6G;1;6000;0;6000;5400;600;
2021-08-26 22:45:30;KIKO;KIKO;3;1000;0;3000;1500;1500;
2021-08-26 22:45:30;123124;KOREK BIASA;1;2000;0;2000;1300;700;
2021-08-26 22:45:30;089686043051;INDOMIE COTO MAKASSAR;1;2800;0;2800;2525;275;
2021-08-26 22:45:30;8992761111533;SPRITE SLIM CAM250ML;1;5000;0;5000;3750;1250;
2021-08-26 22:45:30;8998009040023;TEH KOTAK;3;5000;0;15000;8481;6519;
2021-08-26 22:45:30;MTR;MOTOR;1;5000;0;5000;3500;1500;
2021-08-26 22:45:30;Gula gula tusuk;gula gula tusuk;2;500;0;1000;800;200;
2021-08-26 22:45:30;8992696521797;MILO 22G;1;2500;0;2500;1572;928;
2021-08-26 22:46:42;123124;KOREK BIASA;2;2000;0;4000;2600;1400;
2021-08-26 22:51:13;8999909096004;SAMPOERNA 16 FILTER;1;24000;0;24000;23100;900;
2021-08-26 22:51:13;8998989300261;GUDANG GARAM SURYA 12 FILTER;1;19000;0;19000;17700;1300;
2021-08-26 22:52:56;8997028590014;ARGUS 220ML;2;500;0;1000;604;396;
2021-08-26 22:54:51;ICE CREAM 5.000;ICE CREAM 5.000;1;5000;0;5000;4700;300;
2021-08-26 22:55:19;8997028590014;ARGUS 220ML;2;500;0;1000;604;396;
2021-08-26 22:58:58;8992761145019;COCA COLA PET 250ML;1;3500;0;3500;2417;1083;
2021-08-26 22:59:52;8992696521629;DNCO COKLT UHT 180ML;2;5000;0;10000;7066;2934;
2021-08-26 23:01:10;ICE CREAM 5;ICE CREAM 5000;1;5000;0;5000;4400;600;
2021-08-26 23:02:09;8991001242013;Top;2;1000;0;2000;1000;1000;
2021-08-26 23:03:15;8991102320184;TANGO CHOCO JAVAMOCCA;1;5000;0;5000;4330;670;
2021-08-26 23:06:49;8996001355756;BENG-BENG MAXX SCT;1;2500;0;2500;2041;459;
2021-08-26 23:08:11;8996001600597;KOPIKO LUCKY DAY;1;5000;0;5000;4283;717;
2021-08-26 23:08:11;ROTI;ROTI 2000;1;2000;0;2000;1800;200;
2021-08-26 23:10:03;8991001770301;SELAMAT CLACK VANILA;1;13000;0;13000;11800;1200;
2021-08-26 23:11:20;Gula gula tusuk;gula gula tusuk;2;500;0;1000;800;200;
2021-08-26 23:12:58;Beras;Beras Liter;5;8000;0;40000;37500;2500;
2021-08-26 23:14:53;8999909982000;SAMPOERNA 12 FILTER;1;18000;0;18000;16600;1400;
2021-08-26 23:14:53;ROTI;ROTI 2000;6;2000;0;12000;10800;1200;
2021-08-26 23:14:53;8997018720469;TISSUE SE-KA;1;10000;0;10000;9300;700;
2021-08-26 23:17:19;8992775311998;GERY CHOCOLATOS;1;17000;0;17000;15483;1517;
2021-08-26 23:19:54;8992775312452;gery salut;1;500;0;500;400;100;
2021-08-26 23:20:37;KIKO;KIKO;1;1000;0;1000;500;500;
2021-08-26 23:21:06;TORT;TORTILA;3;1000;0;3000;3000;0;
2021-08-26 23:21:25;8992761139018;ADES 600ML;1;3500;0;3500;2292;1208;
2021-08-26 23:22:01;8992761111519;COCA COLA SLIM CAM 250ML;3;5000;0;15000;11250;3750;
2021-08-26 23:22:45;8992761145019;COCA COLA PET 250ML;1;3500;0;3500;2417;1083;
2021-08-26 23:23:21;8998866803694;SOKLIN SOFTERGENT PURPLE BAG 770 & PIRING;1;18000;0;18000;16680;1320;
2021-08-26 23:23:59;Gula gula tusuk;gula gula tusuk;2;500;0;1000;800;200;
2021-08-26 23:24:27;KIKO;KIKO;1;1000;0;1000;500;500;
2021-08-27 09:45:14;8850507001152;MOTU ATV;1;10000;0;10000;8000;2000;
2021-08-27 09:45:14;8991002307209;COFFE CANDY;1;6000;0;6000;5000;1000;
2021-08-27 09:45:50;8991002307209;COFFE CANDY;1;6000;0;6000;5000;1000;
2021-08-27 09:45:50;8997003910684;2CS;2;3000;0;6000;3000;3000;
2021-08-27 10:27:59;9556001004673;MILO NESTLE MALAYSIA ACTIVE GO;1;85000;0;85000;80000;5000;
2021-08-27 10:33:09;8998866601429;POWDET DAIA BUNGA BAG 290GR;1;5000;0;5000;4450;550;
2021-08-27 10:38:10;8998866101998;ZINC REFRESHING COOL 70ML;1;8500;0;8500;7550;950;
2021-08-27 11:11:44;8998866200301;MIE SEDAAP GORENG;1;2700;0;2700;2413;287;
2021-08-27 11:11:44;089686043204;INDOMIE MIE ACEH;1;2700;0;2700;2452;248;
2021-08-27 11:11:44;ROTI;ROTI 2000;1;2000;0;2000;1800;200;
2021-08-27 11:11:44;8997028590014;ARGUS 220ML;5;500;0;2500;1510;990;
2021-08-27 11:53:13;8997027300089;NOMOS;1;4000;0;4000;2963;1037;
2021-08-27 11:53:13;8992761111540;FANTA STRAWBERY SLIM CAM 250ML;1;5000;0;5000;3750;1250;
2021-08-27 12:17:04;8999801700054;SUSU FOYU 1 KG;2;22000;0;44000;39582;4418;
2021-08-27 12:55:59;8991002121065;GOOD DAY AVOCADO DELIGHT;1;6000;0;6000;4295;1705;
2021-08-27 12:56:40;Gula gula kaki;gula gula kaki;2;500;0;1000;800;200;
2021-08-27 12:57:18;089686611519;QTELA SINGKONG;2;5000;0;10000;8532;1468;
2021-08-27 12:57:59;ROTI;ROTI 2000;8;2000;0;16000;14400;1600;
2021-08-27 12:58:50;Gula gula kopiko;gula gula kopiko;6;350;0;2100;1500;600;
2021-08-27 13:02:38;8992761164546;NUTRIBOOST STRAWBERRY 300ML;1;6500;0;6500;5300;1200;
2021-08-27 13:03:10;8999999050009;SUNLIGHT LIME NEW POUCH 95ML;1;2000;0;2000;1600;400;
2021-08-27 13:03:37;8992775312452;gery salut;1;500;0;500;400;100;
2021-08-27 13:07:02;8993989311699;CLAS MILD 16 FILTER;1;23000;0;23000;21700;1300;
2021-08-27 13:08:35;8993989311699;CLAS MILD 16 FILTER;1;23000;0;23000;21700;1300;
2021-08-27 13:18:29;089686611519;QTELA SINGKONG;1;5000;0;5000;4266;734;
2021-08-27 13:18:29;8993470672858;SAKU-SAKU RASA BALADO;1;2000;0;2000;1530;470;
2021-08-27 13:19:31;6907992825076;JD WATERMELON APPLE;1;2000;0;2000;1700;300;
2021-08-27 13:25:33;ROTI;ROTI 2000;2;2000;0;4000;3600;400;
2021-08-27 13:25:33;8992775310212;GERY PASTA COKELAT;1;18000;0;18000;16029;1971;
2021-08-27 13:25:33;8992388101085;NU GREEN TEA ORIGINAL 330ML;1;3500;0;3500;2854;646;
2021-08-27 13:25:33;8992696523067;MILO ACTVGO UHT 180ML;1;4500;0;4500;3515;985;
2021-08-27 13:54:58;8991102300421;WFR TANGO COKLAT 176GR;2;10000;0;20000;17388;2612;
2021-08-27 13:54:58;8992775214008;Garuda Kacang Atom;1;1000;0;1000;810;190;
2021-08-27 15:06:05;8996001410042;TB TORA MOKA;5;1500;0;7500;4350;3150;
2021-08-27 16:20:06;8991102385060;TANGO WAFFLE CHOX;1;9000;0;9000;8498;502;
2021-08-27 16:45:37;ARD;SENDAL ARDILES;1;15000;0;15000;13500;1500;
2021-08-27 16:52:23;089686611878;QTELA TEMPE;1;6000;0;6000;5370;630;
2021-08-27 16:52:23;8998866201452;POTABEE REGULER BBQ BEEF 35GR;1;5000;0;5000;4150;850;
2021-08-27 16:52:23;089686611618;QTELA BARBEQUE;1;5000;0;5000;4266;734;
2021-08-27 16:52:23;8991102714679;TANGO TETRA STRAW;2;5000;0;10000;9090;910;
2021-08-27 17:21:45;8997231980039;O`JELLY KONYAKU (MAXI APPLE STRAWBERRY);1;5500;0;5500;4620;880;
2021-08-27 17:21:45;089686611519;QTELA SINGKONG;1;5000;0;5000;4266;734;
2021-08-27 17:23:03;8992775002582;DILAN CHOCO;2;2000;0;4000;3006;994;
2021-08-27 17:26:12;8992775002582;DILAN CHOCO;3;2000;0;6000;4509;1491;
2021-08-27 17:30:06;8991001242013;Top;1;1000;0;1000;500;500;
2021-08-27 17:40:08;8886013213208;FRENCH FREIS 2000;1;5000;0;5000;3750;1250;
2021-08-27 17:40:08;ROTI;ROTI 2000;2;2000;0;4000;3600;400;
2021-08-27 17:40:08;8992775310212;GERY PASTA COKELAT;1;18000;0;18000;16029;1971;
2021-08-27 17:40:08;8992388101085;NU GREEN TEA ORIGINAL 330ML;1;3500;0;3500;2854;646;
2021-08-27 17:40:08;8992696523067;MILO ACTVGO UHT 180ML;2;4500;0;9000;7030;1970;
2021-08-27 17:40:08;KIKO;KIKO;1;1000;0;1000;500;500;
2021-08-27 17:40:08;8999999519124;LUX MAGICAL ORCHID 3PC 110G;1;11200;0;11200;10160;1040;
2021-08-27 17:40:08;8999999033217;LIFEBUOY SHP ANTI KETEMBE 170ML;1;16500;0;16500;14950;1550;
2021-08-27 17:40:08;8998866202343;MIE SEDAAP KOREAN SPICY;1;2700;0;2700;2413;287;
2021-08-27 17:40:08;8991001503107;CHACHA PEANUT 35GR;1;5500;0;5500;4900;600;
2021-08-27 17:40:08;8991002121065;GOOD DAY AVOCADO DELIGHT;1;6000;0;6000;4295;1705;
2021-08-27 17:49:03;8991004011906;KOPI BORONG;1;10000;0;10000;8333;1667;
2021-08-27 17:49:03;8996001355756;BENG-BENG MAXX SCT;4;2500;0;10000;8164;1836;
2021-08-27 17:49:03;ROTI;ROTI 2000;4;2000;0;8000;7200;800;
2021-08-27 17:49:03;089686060027;POP MIE AYAM JUMBO;1;4500;0;4500;3833;667;
2021-08-27 17:49:03;8991102384841;WFR TANGO LONG CKLT 130G;1;5000;0;5000;4345;655;
2021-08-27 17:49:03;8992761002022;SPRITE PET 390ML;1;5500;0;5500;4300;1200;
2021-08-27 17:49:03;8997028590014;ARGUS 220ML;2;500;0;1000;604;396;
2021-08-27 17:49:03;8992761139018;ADES 600ML;2;3500;0;7000;4584;2416;
2021-08-27 17:49:03;089686611519;QTELA SINGKONG;2;5000;0;10000;8532;1468;
2021-08-27 17:49:03;8998866201841;GOLDA DOLCE LATTE 200ML;1;3000;0;3000;2500;500;
2021-08-27 17:50:03;8995333032113;TERIGU GATOT KACA 1 KG;1;9000;0;9000;8572;428;
2021-08-27 18:01:34;9556001004673;MILO NESTLE MALAYSIA ACTIVE GO;1;85000;0;85000;80000;5000;
2021-08-27 18:01:34;089686611519;QTELA SINGKONG;2;5000;0;10000;8532;1468;
2021-08-27 18:01:34;8998009040023;TEH KOTAK;2;5000;0;10000;5654;4346;
2021-08-27 18:01:34;ROTI;ROTI 2000;5;2000;0;10000;9000;1000;
2021-08-27 18:01:34;8992761164539;NUTRIBOOST ORANGE 300ML;1;6500;0;6500;5300;1200;
2021-08-27 18:01:34;Pulpen;pulpen;1;1000;0;1000;750;250;
2021-08-27 18:01:34;8997003910684;2CS;1;3000;0;3000;1500;1500;
2021-08-27 18:01:34;8992761139018;ADES 600ML;1;3500;0;3500;2292;1208;
2021-08-27 18:01:34;6907992823843;JD MOCHA CRISPY;1;5000;0;5000;4400;600;
2021-08-27 18:03:38;8998866607315;SOKLIN SOFTERGENT SAKURA 770G & PIRING;1;18000;0;18000;16680;1320;
2021-08-27 18:03:38;8992959953181;SWEETY BRONZE L30+2;1;55000;0;55000;53410;1590;
2021-08-27 18:03:38;8993470671752;JOGER STICK DUO KACANG;2;1000;0;2000;1700;300;
2021-08-27 18:06:47;Gula gula pulpen;gula gula pulpen;3;2000;0;6000;5250;750;
2021-08-27 18:06:47;Gula gula tusuk;gula gula tusuk;4;500;0;2000;1600;400;
2021-08-27 18:09:45;GL;GULA 1 LITER;1;11500;0;11500;10500;1000;
2021-08-27 18:15:16;8994834006128;TICTIC PEDAS;2;2000;0;4000;3400;600;
2021-08-27 18:15:16;8991102281416;PERMEN MINTZ PPMINT;1;5000;0;5000;4000;1000;
2021-08-27 18:33:41;MARS;MARSHMELLOW;2;500;0;1000;866;134;
2021-08-27 18:51:02;Gula gula pulpen;gula gula pulpen;1;2000;0;2000;1750;250;
2021-08-27 18:55:42;8996001600399;LE MINERAL 1500ML;1;5000;0;5000;4042;958;
2021-08-27 19:11:00;ff;FULLO BLASTO;3;1000;0;3000;2985;15;
2021-08-27 19:45:42;8991102384841;WFR TANGO LONG CKLT 130G;2;5000;0;10000;8690;1310;
2021-08-27 19:49:24;8992775214008;Garuda Kacang Atom;1;1000;0;1000;810;190;
2021-08-27 19:49:24;089686611878;QTELA TEMPE;1;6000;0;6000;5370;630;
2021-08-27 19:49:24;089686611519;QTELA SINGKONG;1;5000;0;5000;4266;734;
2021-08-27 19:49:24;8991102987639;WFR TANGO LONG VNL 130G;2;5000;0;10000;7546;2454;
2021-08-27 19:49:24;8998866201452;POTABEE REGULER BBQ BEEF 35GR;1;5000;0;5000;4150;850;
2021-08-27 20:38:48;krupuk k;Krupuk Kentang;2;5000;0;10000;9000;1000;
2021-08-27 21:11:27;8997003910684;2CS;1;3000;0;3000;1500;1500;
2021-08-27 21:36:35;8992775001783;GERY SALUT MALKIST KELAPA;1;6500;0;6500;5516;984;
2021-08-27 21:36:35;8992775315095;GERY MALKIST SWEET CHEESE;1;6500;0;6500;5516;984;
2021-08-27 21:36:35;8991102989381;TANGO LONG BUBBLEGUM 130G;1;5000;0;5000;4345;655;
2021-08-27 21:55:44;8998866202343;MIE SEDAAP KOREAN SPICY;5;2700;0;13500;12065;1435;
2021-08-27 21:55:44;8998866612173;SOKLIN SOFTERGENT PINK 770G & PIRING;1;18000;0;18000;16055;1945;
2021-08-27 21:55:44;8999999531515;MOLTO WHITE MUSK SC 10ML;1;5500;0;5500;4800;700;
2021-08-27 21:55:44;gula;GULA;2;11500;0;23000;20000;3000;
2021-08-27 21:55:44;8850507001152;MOTU ATV;1;10000;0;10000;8000;2000;
2021-08-27 21:59:49;8998866202312;NOODLE SEDAAP TASTY BAKMI AYAM 129 GR;1;5000;0;5000;4167;833;
2021-08-27 21:59:49;8992959117583;SFX DS REG FLOW WING 20;1;5000;0;5000;4288;712;
2021-08-27 22:18:59;jagung marning;jagung marning;1;5000;0;5000;4500;500;
2021-08-27 22:20:47;ICE CREAM 3.500;ICE CREAM 3.500;1;3500;0;3500;3000;500;
2021-08-27 22:23:34;8999999514495;RINSO MOLTO ROSE FRESH 215ML;1;5000;0;5000;4250;750;
2021-08-27 22:28:40;8998866201889;KRISBEE PILLOW STRAWBERRY ICE CREAM 120GR;1;8000;0;8000;7250;750;
2021-08-27 22:33:24;8992959930748;CONFI PANTS L10;4;5000;0;20000;17032;2968;
2021-08-27 22:34:48;8997003910684;2CS;2;3000;0;6000;3000;3000;
2021-08-27 22:35:52;jagung marning;jagung marning;2;5000;0;10000;9000;1000;
2021-08-27 22:40:23;8992775312452;gery salut;3;500;0;1500;1200;300;
2021-08-27 22:44:08;silet;silet;1;1000;0;1000;800;200;
2021-08-27 22:47:04;8992775312452;gery salut;2;500;0;1000;800;200;
2021-08-27 22:48:09;YOUTOP;YOUTOP;1;1000;0;1000;875;125;
2021-08-27 22:50:03;KIKO;KIKO;1;1000;0;1000;500;500;
2021-08-27 22:52:39;8999999045616;MOLTO AIO PINK SCH;5;1000;0;5000;4000;1000;
2021-08-27 22:54:08;KRP;KERUPUK BAWANG SINJAI;1;6000;0;6000;5000;1000;
2021-08-27 22:55:28;8998866202244;EKOMIE BUMBU KALDU AYAM;2;1000;0;2000;1596;404;
2021-08-27 22:56:52;TORT;TORTILA;1;1000;0;1000;1000;0;
2021-08-27 22:58:35;8999999195649;SARI WANGI 25X1.86G;1;6000;0;6000;5050;950;
2021-08-27 23:09:34;8993007001557;INDOMILK SKM 37G;1;1500;0;1500;1081;419;
2021-08-27 23:30:45;0105312686040047;yakult;1;2000;0;2000;1500;500;
2021-08-27 23:31:32;0105312686040047;yakult;3;2000;0;6000;4500;1500;
2021-08-27 23:32:24;8992775214008;Garuda Kacang Atom;1;1000;0;1000;810;190;
2021-08-27 23:33:25;8998866500708;FLORIDINA ORANGE;1;3000;0;3000;2500;500;
2021-08-27 23:37:01;8994834006128;TICTIC PEDAS;2;2000;0;4000;3400;600;
2021-08-27 23:46:16;8998989110167;SURYA GUDANG GARAM 16 FILTER;1;25000;0;25000;23700;1300;
2021-08-28 12:09:27;ROTI;ROTI 2000;5;2000;0;10000;9000;1000;
2021-08-28 12:09:27;8998989110167;SURYA GUDANG GARAM 16 FILTER;2;25000;0;50000;47400;2600;
2021-08-28 12:12:21;ROTI;ROTI 2000;4;2000;0;8000;7200;800;
2021-08-28 12:39:52;8999909096004;SAMPOERNA 16 FILTER;2;24000;0;48000;46200;1800;
2021-08-28 12:39:52;8996001355237;SUPER STAR;1;11000;0;11000;9900;1100;
2021-08-28 13:01:10;8993989311699;CLAS MILD 16 FILTER;1;23000;0;23000;21700;1300;
2021-08-28 13:01:10;8994935000070;MINYAK DUNIA 450 ML;1;7500;0;7500;6779;721;
2021-08-28 13:19:15;8996001355978;BENG-BENG SHARE IT 9.5G;1;10000;0;10000;8700;1300;
2021-08-28 13:21:32;8992775214008;Garuda Kacang Atom;1;1000;0;1000;810;190;
2021-08-28 13:21:32;8993274532105;BOLU;1;1000;0;1000;833;167;
2021-08-28 13:23:01;ROTI;ROTI 2000;3;2000;0;6000;5400;600;
2021-08-28 13:28:33;8850507001176;HERO RACING;1;12000;0;12000;10600;1400;
2021-08-28 13:28:33;8998866612173;SOKLIN SOFTERGENT PINK 770G & PIRING;1;18000;0;18000;16055;1945;
2021-08-28 14:30:06;8999909010567;234 DJI SAM SOE 16;1;22000;0;22000;21500;500;
2021-08-28 14:31:22;KIKO;KIKO;1;1000;0;1000;500;500;
2021-08-28 15:20:06;Gula gula pulpen;gula gula pulpen;1;2000;0;2000;1750;250;
2021-08-28 15:31:47;KIKO;KIKO;3;1000;0;3000;1500;1500;
2021-08-28 15:31:47;6907992825076;JD WATERMELON APPLE;1;2000;0;2000;1700;300;
2021-08-28 16:19:40;8991102384841;WFR TANGO LONG CKLT 130G;2;5000;0;10000;8690;1310;
2021-08-28 16:19:40;8999909002821;MARLBORO BLACK 16;1;22000;0;22000;20850;1150;
2021-08-28 16:19:40;8994867007161;ROKOK PENA GOLD 20;1;17000;0;17000;15500;1500;
2021-08-28 16:19:40;TORT;TORTILA;1;1000;0;1000;1000;0;
2021-08-28 16:19:40;8886013213208;FRENCH FREIS 2000;1;5000;0;5000;3750;1250;
2021-08-28 16:19:40;KIKO;KIKO;1;1000;0;1000;500;500;
2021-08-28 16:19:40;8998989300261;GUDANG GARAM SURYA 12 FILTER;1;19000;0;19000;17700;1300;
2021-08-28 17:11:37;8998989500166;GUDANG GARAM MERAH BESAR 16KS;1;18000;0;18000;17000;1000;
2021-08-28 17:14:11;8993007000680;INDOMILK 1L;1;16500;0;16500;14792;1708;
2021-08-28 17:14:11;6907992823874;JD CRUNCHY CHOCO BLUEBERRY;1;5500;0;5500;4700;800;
2021-08-28 17:16:13;8991002103931;GOOD DAY CARREBIAN NUT;10;1300;0;13000;8900;4100;
2021-08-28 17:18:05;6907992823652;JD CHOCOLATE MILKSHAKE;1;6000;0;6000;5200;800;
2021-08-28 17:18:05;6907992824963;JD MILKY CHOCOLATE;1;3000;0;3000;2600;400;
2021-08-28 18:04:47;8991102022460;FORMULA DIAMOND;1;3000;0;3000;2500;500;
2021-08-28 18:05:28;8999999049416;REXONA MEN RO QUANTUM 45 ML;1;15000;0;15000;13550;1450;
2021-08-28 18:27:10;8999099920691;SGM 1+ MADU 1000G;1;85000;0;85000;78510;6490;
2021-08-28 18:28:07;8998866200301;MIE SEDAAP GORENG;1;2700;0;2700;2413;287;
2021-08-28 18:28:07;8998866202732;MILKU STROBERI 200ML;1;3000;0;3000;2375;625;
2021-08-29 12:09:52;8993226365522;GARAM MEJA GYURI 200GR;1;2000;0;2000;1700;300;
2021-08-29 12:09:52;VTM;VITAMIN CIMIN;6;500;0;3000;2550;450;
2021-08-29 12:09:52;8998989110167;SURYA GUDANG GARAM 16 FILTER;1;25000;0;25000;23700;1300;
2021-08-29 12:09:52;8999099920691;SGM 1+ MADU 1000G;1;85000;0;85000;78510;6490;
2021-08-29 12:09:52;ARG;ARGUS 220ML;2;14500;0;29000;26600;2400;
2021-08-29 12:09:52;8886001038011;BENG-BENG SCT;2;4000;0;8000;2900;5100;
2021-08-29 12:09:52;8998989500166;GUDANG GARAM MERAH BESAR 16KS;1;18000;0;18000;17000;1000;
2021-08-29 12:09:52;711844120419;SAMBAL ABC 275 ML;1;12000;0;12000;10800;1200;
2021-08-29 12:09:52;8999909096004;SAMPOERNA 16 FILTER;1;24000;0;24000;23100;900;
2021-08-29 12:09:52;GL;GULA 1 LITER;1;11500;0;11500;10500;1000;
2021-08-29 12:09:52;8998989300261;GUDANG GARAM SURYA 12 FILTER;1;19000;0;19000;17700;1300;
2021-08-29 12:09:52;8996001304020;SLAI OLAI NANAS;1;8500;0;8500;7700;800;
2021-08-29 13:04:09;8998989300261;GUDANG GARAM SURYA 12 FILTER;1;19000;0;19000;17700;1300;
2021-08-29 13:04:09;089686611519;QTELA SINGKONG;1;5000;0;5000;4266;734;
2021-08-29 13:04:09;8992959953105;SWEETY BRONZE XXL6;1;16000;0;16000;15230;770;
2021-08-29 13:04:09;8999999529734;CLEAR IC MTHL 160ML;1;23700;0;23700;21400;2300;
2021-08-29 13:04:09;8999999390198;SUNLIGHT LIME NEW POUCH 755ML;1;17000;0;17000;15400;1600;
2021-08-29 13:04:09;8997027300089;NOMOS;1;4000;0;4000;2963;1037;
2021-08-29 13:04:09;8999999007768;FAIR&LOVELY MULTIVITAMIN  CREAM 9 ML;2;4500;0;9000;6400;2600;
2021-08-29 13:04:09;8998866610278;DAIA VIOLET GUSSET 565G;1;10000;0;10000;8700;1300;
2021-08-29 13:04:09;8998866200301;MIE SEDAAP GORENG;2;2700;0;5400;4826;574;
2021-08-29 13:04:09;8993989311699;CLAS MILD 16 FILTER;2;23000;0;46000;43400;2600;
2021-08-29 13:04:09;8994834006128;TICTIC PEDAS;1;1000;0;1000;1700;-700;
2021-08-29 13:04:09;8886013213208;FRENCH FREIS 2000;1;5000;0;5000;3750;1250;
2021-08-29 13:04:09;GL;GULA 1 LITER;5;11500;0;57500;52500;5000;
2021-08-29 13:07:20;089686041705;INDOMIE GORENG JUMBO;1;3500;0;3500;3143;357;
2021-08-29 13:07:20;8998898830125;KKB ENER-G ANGGUR;1;5500;0;5500;4824;676;
2021-08-29 13:07:20;8992761139018;ADES 600ML;1;3000;0;3000;2292;708;
2021-08-29 13:07:20;8996001355756;BENG-BENG MAXX SCT;1;2500;0;2500;2041;459;
2021-08-29 13:07:20;8994867000162;ROKOK PUNDIMAS KRETEK16;1;10000;0;10000;8600;1400;
2021-08-29 13:07:20;8999909000711;MAGNUM MILD 16;1;21000;0;21000;19350;1650;
2021-08-29 13:07:20;8992761145033;FANTA STRAW PET 250ML;1;3500;0;3500;2417;1083;
2021-08-29 13:35:07;8996001600399;LE MINERAL 1500ML;1;5000;0;5000;4042;958;
2021-08-29 13:39:45;8995333000822;TERIGU KOMPAS SOFT 500GR;3;5500;0;16500;14901;1599;
2021-08-29 13:39:45;8999999524722;SUNLIGHT LIME NEW PCH 435ML;1;10000;0;10000;9100;900;
2021-08-29 13:46:26;089686043051;INDOMIE COTO MAKASSAR;1;2800;0;2800;2525;275;
2021-08-29 13:46:26;8991102384841;WFR TANGO LONG CKLT 130G;1;5000;0;5000;4345;655;
2021-08-29 13:49:54;8998866501026;MINYAK GORENG SEDAAP POUCH 1 L;1;15000;0;15000;14110;890;
2021-08-29 13:49:54;8996001355756;BENG-BENG MAXX SCT;1;2500;0;2500;2041;459;
2021-08-29 13:49:54;8992775312452;gery salut;1;500;0;500;400;100;
2021-08-29 13:49:54;8992775000076;GERY SNACK RING CKLT;1;2000;0;2000;1712;288;
2021-08-29 13:57:24;8998989300261;GUDANG GARAM SURYA 12 FILTER;1;19000;0;19000;17700;1300;
2021-08-29 13:57:24;8998866202671;NOODLE SEDAAP MIE KOREAN SPICY SOUP CUP;1;2700;0;2700;4002;-1302;
2021-08-29 15:53:11;TBR;TEPUNG BERAS ROSE BRAND;1;8000;0;8000;5800;2200;
2021-08-29 15:53:11;8998866200844;NOODLE SEDAAP MIE KARI SPESIAL CUP 81 GR;1;4500;0;4500;3650;850;
2021-08-29 15:53:11;SFX;SOFTEX DAUN SIRIH 1;1;5000;0;5000;413;4587;
2021-08-29 15:53:11;KIKO;KIKO;1;1000;0;1000;500;500;
2021-08-29 15:53:11;MILKITA;MILKITA;4;250;0;1000;800;200;
2021-08-29 15:53:11;8999909010567;234 DJI SAM SOE 16;1;22000;0;22000;21500;500;
2021-08-29 15:53:11;8999909000971;MAGNUM MILD 20;1;24000;0;24000;22750;1250;
2021-08-29 16:01:19;8999999559854;AXE BLACK POCKET FRAG 17ML;1;10000;0;10000;8000;2000;
2021-08-29 16:27:18;8997210107877;VORTEX SMART 3;1;4000;0;4000;4750;-750;
2021-08-29 17:19:09;6907992823850;JD CHOCO CIRLE;1;5500;0;5500;4700;800;
2021-08-29 17:19:09;6907992823652;JD CHOCOLATE MILKSHAKE;2;6000;0;12000;10400;1600;
2021-08-29 17:19:09;8992628022156;BIMOLI KLASIK TOUCH 1 LT;1;16000;0;16000;14350;1650;
2021-08-29 17:19:09;KIKO;KIKO;1;1000;0;1000;500;500;
2021-08-29 17:19:09;ff;FULLO BLASTO;1;1000;0;1000;995;5;
2021-08-29 17:19:09;8886001038011;BENG-BENG SCT;3;1500;0;4500;4350;150;
2021-08-29 17:20:31;COKLAT;COKLAT COIN;2;500;0;1000;850;150;
2021-08-29 18:10:32;8997210107877;VORTEX SMART 3;1;5000;0;5000;4750;250;
2021-08-29 18:13:56;8998989110167;SURYA GUDANG GARAM 16 FILTER;1;25000;0;25000;23700;1300;
2021-08-29 18:28:33;8999909096004;SAMPOERNA 16 FILTER;2;24000;0;48000;46200;1800;
2021-08-29 18:33:37;8999801700054;SUSU FOYU 1 KG;1;22000;0;22000;19791;2209;
2021-08-29 18:47:17;8997011700123;BIHUN JAGUNG 300GR;5;6000;0;30000;24895;5105;
2021-08-29 18:51:34;KP;KERIPIK PISANG;1;5000;0;5000;5000;0;
2021-08-29 18:55:30;8992628022156;BIMOLI KLASIK TOUCH 1 LT;1;16000;0;16000;14350;1650;
2021-08-29 18:56:17;ICE CREAM 6;ICE CREAM 6.000;2;6000;0;12000;10400;1600;
2021-08-29 19:12:06;8998866601429;POWDET DAIA BUNGA BAG 290GR;1;5000;0;5000;4450;550;
2021-08-29 19:12:06;8999999036607;LUX TS SOFT ROSE 75G;1;3500;0;3500;2800;700;
2021-08-29 19:12:06;8999999050009;SUNLIGHT LIME NEW POUCH 95ML;1;2000;0;2000;1600;400;
2021-08-29 19:29:44;KIKO;KIKO;1;1000;0;1000;500;500;
2021-08-29 19:32:09;8993470672858;SAKU-SAKU RASA BALADO;1;2000;0;2000;1530;470;
2021-08-29 20:47:41;8994867007161;ROKOK PENA GOLD 20;1;17000;0;17000;15500;1500;
2021-08-29 20:47:41;8994867006997;ROKOK PENA BOLD 20BTG;1;17000;0;17000;15000;2000;
2021-08-29 20:49:36;8991909101016;URBAN MILD 16;1;17000;0;17000;15800;1200;
2021-08-29 21:16:50;8998989110167;SURYA GUDANG GARAM 16 FILTER;2;25000;0;50000;47400;2600;
2021-08-29 21:23:42;8996001375372;CHOKI CHOKI;1;1000;0;1000;910;90;
2021-08-29 22:11:47;089686014280;SUPERMI AYAM BAWANG;2;2500;0;5000;4624;376;
2021-08-30 17:00:46;8997025911058;HATARI SHP KELAPA;1;6000;0;6000;4911;1089;
2021-08-30 17:00:46;8996001318430;BETTER 1000;10;1000;0;10000;8200;1800;
2021-08-30 17:00:46;8998866202435;JAPOTA UMAMI JAPANESE SEAWEED 35GR;1;5000;0;5000;4150;850;
2021-08-30 17:09:49;8994867000179;ROKOK PENA MILD 16;1;14500;0;14500;13500;1000;
2021-08-30 17:25:01;8998989110167;SURYA GUDANG GARAM 16 FILTER;1;25000;0;25000;23700;1300;
2021-08-30 20:06:03;8993379241858;SABUN HARMONY LEMON 70G;1;2000;0;2000;1652;348;
2021-08-30 20:06:03;8993379200862;harmony;1;2000;0;2000;1700;300;
2021-08-30 20:34:36;8999999006006;RINSO ANTI NODA CLASSISC 750ML;2;15000;0;30000;25014;4986;
2021-08-30 20:34:36;8998866202732;MILKU STROBERI 200ML;2;3000;0;6000;4750;1250;
2021-08-30 20:34:36;8992388133017;NU MILK TEA ORI 330ML;1;6000;0;6000;5125;875;
2021-08-30 20:34:36;8992775002735;CHOCOLATOS SUSU COKELAT;2;4000;0;8000;7040;960;
2021-08-30 20:34:36;8998866609487;SOKLIN SOFTERGEN 280G;1;5000;0;5000;4425;575;
2021-08-30 20:34:36;8995333032113;TERIGU GATOT KACA 1 KG;1;9000;0;9000;8572;428;
2021-08-30 20:34:36;8993093115008;tepun beras;1;8000;0;8000;7000;1000;
2021-08-30 20:46:07;8998866610087;JAVANA ORIGINAL 350ML;1;3000;0;3000;2150;850;
2021-08-30 20:46:39;TORT;TORTILA;3;1000;0;3000;3000;0;
2021-08-30 20:51:47;RT 1000;ROTI 1000;4;1000;0;4000;3200;800;
2021-08-30 20:51:47;8997028590014;ARGUS 220ML;4;500;0;2000;1208;792;
2021-08-30 20:51:47;jagung marning;jagung marning;1;5000;0;5000;4500;500;
2021-08-30 20:52:30;8999909002821;MARLBORO BLACK 16;1;22000;0;22000;20850;1150;
2021-08-30 20:52:30;8994867007161;ROKOK PENA GOLD 20;1;17000;0;17000;15500;1500;
2021-08-30 21:00:32;8992775318201;GERY SNACK BANTAL COKLAT;1;2000;0;2000;1712;288;
2021-08-30 21:00:32;RT 1000;ROTI 1000;2;1000;0;2000;1600;400;
2021-08-30 21:00:32;8997003910684;2CS;1;3000;0;3000;1500;1500;
2021-08-30 21:00:32;jagung marning;jagung marning;2;5000;0;10000;9000;1000;
2021-08-30 21:00:32;RT;ROTI;2;9000;0;18000;16000;2000;
2021-08-30 21:00:32;8997211400038;SANTAN COCONUT CREAM;2;4000;0;8000;6000;2000;
2021-08-30 21:00:32;089686021219;INTER MIE GORENG;4;1000;0;4000;3540;460;
2021-08-30 21:00:32;8997012030748;MADU ENAK;1;1000;0;1000;900;100;
2021-08-30 21:02:27;8998866200301;MIE SEDAAP GORENG;3;2700;0;8100;7239;861;
2021-08-30 21:04:05;089686010107;INDOMIE KALDU AYAM;4;2500;0;10000;8600;1400;
2021-08-30 21:05:07;Gula gula tusuk;gula gula tusuk;2;500;0;1000;800;200;
2021-08-30 21:08:08;8998866201889;KRISBEE PILLOW STRAWBERRY ICE CREAM 120GR;1;8000;0;8000;7250;750;
2021-08-30 21:10:47;8991102714846;MILKIDO CKLT;2;3000;0;6000;4306;1694;
2021-08-30 21:10:47;ICE CREAM 5.000;ICE CREAM 5.000;1;5000;0;5000;4700;300;
2021-08-30 21:10:47;8992761139018;ADES 600ML;1;3500;0;3500;2292;1208;
2021-08-30 21:10:47;089686611519;QTELA SINGKONG;1;5000;0;5000;4266;734;
2021-08-30 21:18:04;8998866200301;MIE SEDAAP GORENG;2;2700;0;5400;4826;574;
2021-08-30 21:19:26;PUL;PULPEN;1;1500;0;1500;833;667;
2021-08-30 21:20:12;PUL;PULPEN;2;1500;0;3000;1666;1334;
2021-08-30 21:24:49;JL;JELLY;4;500;0;2000;1600;400;
2021-08-30 21:25:40;GGK;PLAYGUM PERMEN KARET;4;500;0;2000;1600;400;
2021-08-30 21:26:17;8991001503107;CHACHA PEANUT 35GR;1;5500;0;5500;4900;600;
2021-08-30 21:27:05;Gula gula pulpen;gula gula pulpen;3;2000;0;6000;5250;750;
2021-08-30 21:27:49;Gula gula pulpen;gula gula pulpen;2;2000;0;4000;3500;500;
2021-08-30 21:28:17;Gula gula pulpen;gula gula pulpen;1;2000;0;2000;1750;250;
2021-08-30 21:28:53;8997012030748;MADU ENAK;1;1000;0;1000;900;100;
2021-08-30 21:34:50;8992775311509;gery garuda;1;1000;0;1000;700;300;
2021-08-30 21:35:25;8992775311509;gery garuda;2;1000;0;2000;1400;600;
2021-08-30 21:36:43;8992775110157;GARUDA KACANG KULIT;2;5000;0;10000;7850;2150;
2021-08-30 21:38:32;MARS;MARSHMELLOW;2;500;0;1000;866;134;
2021-08-30 21:39:51;ARG;ARGUS 220ML;2;14500;0;29000;26600;2400;
2021-08-30 21:41:00;8999999059781;SUNLIGHT LIME NEW POUCH 210ML;1;5000;0;5000;4300;700;
2021-08-30 21:41:52;8992775311509;gery garuda;3;1000;0;3000;2100;900;
2021-08-30 21:42:27;krupuk k;Krupuk Kentang;1;5000;0;5000;4500;500;
2021-08-30 21:44:23;711844110113;KECAP ABC 135 ML;1;7000;0;7000;6400;600;
2021-08-30 21:45:13;8994420107789;SARDEN SAUS TOMAT;1;7000;0;7000;5833;1167;
2021-08-30 21:46:31;8993274532105;BOLU;2;1000;0;2000;1666;334;
2021-08-30 21:47:07;RT 1000;ROTI 1000;2;1000;0;2000;1600;400;
2021-08-30 21:47:39;Masako;Masako Gantung;1;6000;0;6000;5000;1000;
2021-08-30 21:48:29;8999909982000;SAMPOERNA 12 FILTER;1;18000;0;18000;16600;1400;
2021-08-30 21:52:01;8998989110167;SURYA GUDANG GARAM 16 FILTER;1;25000;0;25000;23700;1300;
2021-08-30 21:52:01;8992959020012;SWEETY SILVER PANTS XL 34;1;78000;0;78000;73637;4363;
2021-08-30 21:56:56;8992775001783;GERY SALUT MALKIST KELAPA;1;6500;0;6500;5516;984;
2021-08-30 21:56:56;8993274532105;BOLU;5;1000;0;5000;4165;835;
2021-08-30 21:57:26;jagung marning;jagung marning;1;5000;0;5000;4500;500;
2021-08-30 21:57:45;8998989300261;GUDANG GARAM SURYA 12 FILTER;1;19000;0;19000;17700;1300;
2021-08-30 22:01:12;8992959117583;SFX DS REG FLOW WING 20;1;5000;0;5000;4288;712;
2021-08-30 22:02:20;KIKO;KIKO;2;1000;0;2000;1000;1000;
2021-08-30 22:02:20;ICE CREAM 3;ICE CREAM 3000;1;3000;0;3000;2600;400;
2021-08-30 22:02:49;8993989311699;CLAS MILD 16 FILTER;1;23000;0;23000;21700;1300;
2021-08-30 22:06:34;8992628020152;BIMOLI POUCH 2L;1;31000;0;31000;29800;1200;
2021-08-30 22:10:03;8886022830243;BATEREI ABC;1;9000;0;9000;7000;2000;
2021-08-30 22:11:14;8995555121244;SOSIS KIMBO;7;1000;0;7000;4550;2450;
2021-08-30 22:17:36;8993007000024;INDOMILK UHT VANILA;2;5000;0;10000;6940;3060;
2021-08-30 22:17:36;8997012030748;MADU ENAK;2;1000;0;2000;1800;200;
2021-08-30 22:18:11;YP;YUPI;2;250;0;500;416;84;
2021-08-30 22:18:39;MARS;MARSHMELLOW;2;500;0;1000;866;134;
2021-08-30 22:19:20;JL;JELLY;2;500;0;1000;800;200;
2021-08-30 22:19:46;ARG;ARGUS 220ML;4;14500;0;58000;53200;4800;
2021-08-30 22:25:04;8998898337440;TOLAK ANGIN CARE 10ML;1;10000;0;10000;7893;2107;
2021-08-30 22:25:58;8999999706081;PEPSODENT WHITE 75G;1;5000;0;5000;3850;1150;
2021-08-30 22:26:48;8996001375372;CHOKI CHOKI;1;1000;0;1000;910;90;
2021-08-30 22:27:26;telur;telur;2;2000;0;4000;2468;1532;
2021-08-30 22:30:50;8996001370063;CHOKI-CHOKI;1;18200;0;18200;16500;1700;
2021-08-30 22:38:03;8991111101255;JB SHAMPOO GOLD 50ML;1;5000;0;5000;4500;500;
2021-08-30 22:39:20;KIKO;KIKO;3;1000;0;3000;1500;1500;
2021-08-30 22:39:53;KIKO;KIKO;1;1000;0;1000;500;500;
2021-08-30 22:40:58;8998866608305;GIV BENGKOANG KOTAK 76G;3;2000;0;6000;5460;540;
2021-08-30 22:42:05;ROTI;ROTI 2000;1;2000;0;2000;1800;200;
2021-08-30 22:42:38;089686386011;BUMBU RACIK NASI GORENG;1;2000;0;2000;1450;550;
2021-08-30 22:49:17;8993989311699;CLAS MILD 16 FILTER;2;23000;0;46000;43400;2600;
2021-08-30 22:49:17;8998866610278;DAIA VIOLET GUSSET 565G;1;10000;0;10000;8700;1300;
2021-08-30 22:50:14;ICE CREAM 5;ICE CREAM 5000;1;5000;0;5000;4400;600;
2021-08-31 14:34:28;Beras;Beras Liter;5;8000;0;40000;37500;2500;
2021-08-31 14:36:55;123124;KOREK BIASA;1;2000;0;2000;1300;700;
2021-08-31 14:44:07;8993379200886;SABUN HARMONY ORANGE 70G;1;2000;0;2000;1652;348;
2021-08-31 14:44:49;telur;telur;6;2000;0;12000;7404;4596;
2021-08-31 14:45:35;telur;telur;6;2000;0;12000;7404;4596;
2021-08-31 14:57:38;JL;JELLY;1;500;0;500;400;100;
2021-08-31 14:59:43;123124;KOREK BIASA;1;2000;0;2000;1300;700;
2021-08-31 15:18:18;8998989300261;GUDANG GARAM SURYA 12 FILTER;1;19000;0;19000;17700;1300;
2021-08-31 15:48:56;8996001375372;CHOKI CHOKI;1;1000;0;1000;910;90;
2021-08-31 15:48:56;KIKO;KIKO;5;1000;0;5000;2500;2500;
2021-08-31 15:51:12;8998866501026;MINYAK GORENG SEDAAP POUCH 1 L;1;15000;0;15000;14110;890;
2021-08-31 15:51:12;6907992823829;JD MILKY MILK;1;3000;0;3000;2600;400;
2021-08-31 16:03:41;KIKO;KIKO;2;1000;0;2000;1000;1000;
2021-08-31 16:03:41;8996001355756;BENG-BENG MAXX SCT;1;2500;0;2500;2041;459;
2021-08-31 16:03:41;8992775312452;gery salut;1;500;0;500;400;100;
2021-08-31 16:05:30;089686060362;POP MIE SOTO AYAM JUMBO;1;4500;0;4500;3833;667;
2021-08-31 16:05:30;089686060027;POP MIE AYAM JUMBO;1;4500;0;4500;3833;667;
2021-08-31 16:05:30;089686060102;POP MIE PEDE GLEDEEK;1;5000;0;5000;4450;550;
2021-08-31 16:08:16;8992959850015;CONFIDENCE M5+1;1;43000;0;43000;39550;3450;
2021-08-31 16:28:24;089686611670;QTELA BALADO;1;5000;0;5000;4266;734;
2021-08-31 16:53:34;KP;KERIPIK PISANG;2;5000;0;10000;10000;0;
2021-08-31 16:53:34;8886013213208;FRENCH FREIS 2000;1;5000;0;5000;3750;1250;
2021-08-31 16:53:34;milkita;milkita;1;500;0;500;370;130;
2021-08-31 16:53:34;balon air;balon air;1;2000;0;2000;1700;300;
2021-08-31 16:53:34;8992775312452;gery salut;1;500;0;500;400;100;
2021-08-31 16:53:34;8996001355756;BENG-BENG MAXX SCT;1;2500;0;2500;2041;459;
2021-08-31 16:53:34;8996001375372;CHOKI CHOKI;1;1000;0;1000;910;90;
2021-08-31 16:53:34;8996001318911;BETTER ISI 4;1;2000;0;2000;1700;300;
2021-08-31 18:29:45;RT ISI 6;ROTI ISI 6;1;6000;0;6000;5000;1000;
2021-08-31 18:29:45;8992761139018;ADES 600ML;1;3500;0;3500;2292;1208;
2021-08-31 18:29:45;8992959955024;SWEETY BABY WIPES 36X50;1;17000;0;17000;14293;2707;
2021-08-31 18:49:13;ARG;ARGUS 220ML;1;14500;0;14500;13300;1200;
2021-08-31 18:49:51;Gula gula tusuk;gula gula tusuk;1;500;0;500;400;100;
2021-08-31 19:06:50;089686043051;INDOMIE COTO MAKASSAR;1;2800;0;2800;2525;275;
2021-08-31 19:06:50;089686010343;INDOMIE SOTO MIE;2;2600;0;5200;4734;466;
2021-08-31 19:06:50;8992761111533;SPRITE SLIM CAM250ML;3;5000;0;15000;11250;3750;
2021-08-31 19:19:37;8998989300261;GUDANG GARAM SURYA 12 FILTER;1;19000;0;19000;17700;1300;
2021-08-31 19:28:42;8998866610070;SOKLIN SOFTERGEN 280G PURPLE;1;5000;0;5000;4425;575;
2021-08-31 19:28:42;089686010107;INDOMIE KALDU AYAM;2;2500;0;5000;4300;700;
2021-08-31 19:28:42;8998866200301;MIE SEDAAP GORENG;1;2700;0;2700;2413;287;
2021-08-31 19:28:42;8998866202619;MIE SEDAAP KOREAN SPICY SOUP;1;2700;0;2700;2322;378;
2021-08-31 19:44:47;8997218380135;ICHITAN GREEN TEA;1;8000;0;8000;6583;1417;
2021-08-31 19:47:08;896867700494;AIR CLUB 1500ML;2;5000;0;10000;5974;4026;
2021-08-31 19:48:00;8998898853100;SUSU JAHE;2;1500;0;3000;2360;640;
2021-08-31 19:48:00;8993989311699;CLAS MILD 16 FILTER;1;23000;0;23000;21700;1300;
2021-08-31 19:50:00;8996001355756;BENG-BENG MAXX SCT;1;2500;0;2500;2041;459;
2021-08-31 19:50:00;8991001242013;Top;1;1000;0;1000;500;500;
2021-08-31 19:50:00;8996001375372;CHOKI CHOKI;1;1000;0;1000;910;90;
2021-08-31 19:54:03;8992222050609;GATSBY ANTI KETOMBE 28ML;1;5500;0;5500;4000;1500;
2021-08-31 20:11:15;8998866501026;MINYAK GORENG SEDAAP POUCH 1 L;2;15000;0;30000;28220;1780;
2021-08-31 20:26:50;8992959020005;SWEETY SILVER PANTS XXL 5;1;16800;0;16800;15228;1572;
2021-08-31 20:36:01;8992775311486;CHOCOLATOS DARK 16G;1;18000;0;18000;15173;2827;
2021-08-31 20:36:01;089686043273;INDOMIE SAMBAL RICA;2;2700;0;5400;4904;496;
2021-08-31 20:36:01;8992775001691;GARUDA ROSTA WAGYU BEEF;2;8000;0;16000;14644;1356;
2021-08-31 20:36:56;8999909096004;SAMPOERNA 16 FILTER;2;24000;0;48000;46200;1800;
2021-08-31 21:10:16;8993989311699;CLAS MILD 16 FILTER;1;23000;0;23000;21700;1300;
2021-08-31 22:19:25;8995333060703;TERIGU KOMPAS 1KG;1;10500;0;10500;9816;684;
2021-08-31 22:19:25;8995333000822;TERIGU KOMPAS SOFT 500GR;3;5500;0;16500;14901;1599;
2021-08-31 22:19:25;8999999192150;ROYCO FDS CHICKEN 100GR;2;5000;0;10000;8600;1400;
2021-08-31 22:25:49;8994867000179;ROKOK PENA MILD 16;1;14500;0;14500;13500;1000;
2021-08-31 23:19:16;8998866200301;MIE SEDAAP GORENG;2;2700;0;5400;4826;574;
2021-08-31 23:23:09;8997231980039;O`JELLY KONYAKU (MAXI APPLE STRAWBERRY);1;5500;0;5500;4620;880;
2021-08-31 23:25:17;telur;telur;5;2000;0;10000;6170;3830;
2021-09-01 09:35:55;PUL;PULPEN;1;1500;0;1500;833;667;
2021-09-01 11:42:29;8998009040023;TEH KOTAK;2;5000;0;10000;5654;4346;
2021-09-01 11:42:29;8998866202626;Top Kopi Gula Aren 22gr;1;1000;0;1000;830;170;
2021-09-01 11:42:29;8998866200325;MIE SEDAAP SOTO;5;2700;0;13500;11655;1845;
2021-09-01 11:42:29;AMPLOP;AMPLOP;4;250;0;1000;560;440;
2021-09-01 11:42:29;8996001600399;LE MINERAL 1500ML;1;5000;0;5000;4042;958;
2021-09-01 11:42:29;8992775312452;gery salut;2;500;0;1000;800;200;
2021-09-01 11:42:29;8996001318430;BETTER 1000;2;1000;0;2000;1640;360;
2021-09-01 11:42:29;8992775311509;gery garuda;3;1000;0;3000;2100;900;
2021-09-01 11:44:39;8997025914059;HATARI SEE HONG;1;6000;0;6000;4911;1089;
2021-09-01 11:44:39;8992775001998 pcs;Gery Salut sandiwich pcs;4;1000;0;4000;3260;740;
2021-09-01 11:56:06;6907992825045;JD CRUNCHY MATCHA CHEESE;1;8000;0;8000;7000;1000;
2021-09-01 11:56:06;8992388133017;NU MILK TEA ORI 330ML;1;6000;0;6000;5125;875;
2021-09-01 11:58:41;8998866202626;Top Kopi Gula Aren 22gr;10;800;0;8000;8300;-300;
2021-09-01 12:05:40;8998866202237;NOODLE SEDAAP TASTY AYAM GEPREK 124 GR;1;5000;0;5000;4167;833;
2021-09-01 12:48:31;8995102703534;TERASI DUO 6 GR;1;4000;0;4000;3720;280;
2021-09-01 12:50:19;8998989300261;GUDANG GARAM SURYA 12 FILTER;1;19000;0;19000;17700;1300;
2021-09-01 12:52:33;8999999516208;ROYCO FDS CHICKEN NEW 230G;1;10000;0;10000;9000;1000;
2021-09-01 14:52:05;8992696425316;NESCAFE BLACK;1;5000;0;5000;4099;901;
2021-09-01 14:52:05;8996001600610;TORA MILKY LATTE 180ML;1;3500;0;3500;2750;750;
2021-09-01 15:06:50;8998989121163;SURYA PRO MERAH;1;20000;0;20000;18600;1400;
2021-09-01 16:31:48;8999909003439;MARLBORO CRAFTED 12;1;8000;0;8000;7250;750;
2021-09-01 16:31:48;8995555171225;KIMBO SOSIS;1;1000;0;1000;900;100;
2021-09-01 16:31:48;Vita Jelly;Vita Jelly;2;1000;0;2000;1532;468;
2021-09-01 16:31:48;8996001375372;CHOKI CHOKI;2;1000;0;2000;1820;180;
2021-09-01 16:33:02;JL;JELLY;2;500;0;1000;800;200;
2021-09-01 16:59:15;8992753100101;BKM FULL CREAM GOLD 370;2;15000;0;30000;28000;2000;
2021-09-01 17:05:40;8993989311699;CLAS MILD 16 FILTER;2;23000;0;46000;43400;2600;
2021-09-01 17:34:19;8992959953167;SWEETY BRONZE S36+2;1;48000;0;48000;45682;2318;
2021-09-01 17:34:19;8992959508862;SWEETY SILVER PANTS M 8;1;16800;0;16800;15229;1571;
2021-09-01 17:34:19;8999999032128;ZWITSAL BATH NAT HAIR&BODY 100ML;1;12100;0;12100;10835;1265;
2021-09-01 17:38:48;8993989311699;CLAS MILD 16 FILTER;1;23000;0;23000;21700;1300;
2021-09-01 17:48:31;8997028590014;ARGUS 220ML;1;500;0;500;302;198;
2021-09-01 18:00:37;8991002105409;KOPI KAPAL API;1;20000;0;20000;18888;1112;
2021-09-01 18:00:37;8886013213208;FRENCH FREIS 2000;1;5000;0;5000;3750;1250;
2021-09-01 18:00:37;8998866200561;EKOMIE SUPER 600GR;1;10000;0;10000;8615;1385;
2021-09-01 18:00:37;8995555121244;SOSIS KIMBO;2;1000;0;2000;1300;700;
2021-09-01 18:24:30;8999801700054;SUSU FOYU 1 KG;1;22000;0;22000;19791;2209;
2021-09-01 18:24:30;ROYCO;ROYCO RASA AYAM;2;500;0;1000;750;250;
2021-09-01 18:24:50;Pulpen;pulpen;1;1000;0;1000;750;250;
2021-09-01 18:28:37;8999999516208;ROYCO FDS CHICKEN NEW 230G;1;10000;0;10000;9000;1000;
2021-09-01 18:48:06;8999909010567;234 DJI SAM SOE 16;1;22000;0;22000;21500;500;
2021-09-01 19:12:19;8992696523067;MILO ACTVGO UHT 180ML;1;4500;0;4500;3515;985;
2021-09-01 19:12:19;8992775001042;PILUS GARUDA MI GORENG;1;5000;0;5000;4810;190;
2021-09-01 19:12:19;8992775311325;GERY SNACK&SEREAL 100G;1;7000;0;7000;6012;988;
2021-09-01 19:12:19;8850507002197;TOK TAK FRUIT CANDY;2;7500;0;15000;12500;2500;
2021-09-01 19:12:19;Vita Jelly;Vita Jelly;1;1000;0;1000;766;234;
2021-09-01 19:12:19;8999909096004;SAMPOERNA 16 FILTER;1;24000;0;24000;23100;900;
2021-09-01 19:13:44;123124;KOREK BIASA;1;2000;0;2000;1300;700;
2021-09-01 19:27:02;089686043051;INDOMIE COTO MAKASSAR;1;2800;0;2800;2525;275;
2021-09-01 19:27:02;089686043204;INDOMIE MIE ACEH;1;2700;0;2700;2452;248;
2021-09-01 19:27:02;KOPIKO;KOPIKO;2;250;0;500;350;150;
2021-09-01 19:33:26;8997204370126;Siko;5;10000;0;50000;41665;8335;
2021-09-01 19:36:29;8999909002821;MARLBORO BLACK 16;1;22000;0;22000;20850;1150;
2021-09-01 19:38:53;8998989110167;SURYA GUDANG GARAM 16 FILTER;2;25000;0;50000;47400;2600;
2021-09-01 19:38:53;ARG;ARGUS 220ML;1;14500;0;14500;13300;1200;
2021-09-01 19:38:53;8996001600399;LE MINERAL 1500ML;2;5000;0;10000;8084;1916;
2021-09-01 19:38:53;KOPIKO;KOPIKO;2;250;0;500;350;150;
2021-09-01 19:58:11;8998866202237;NOODLE SEDAAP TASTY AYAM GEPREK 124 GR;1;5000;0;5000;4167;833;
2021-09-01 19:58:11;8998866200301;MIE SEDAAP GORENG;2;2700;0;5400;4826;574;
2021-09-01 19:58:11;089686010107;INDOMIE KALDU AYAM;1;2500;0;2500;2150;350;
2021-09-01 19:58:11;8998866202244;EKOMIE BUMBU KALDU AYAM;2;1000;0;2000;1596;404;
2021-09-01 20:02:06;8994867000179;ROKOK PENA MILD 16;2;14500;0;29000;27000;2000;
2021-09-01 20:14:27;8998989110167;SURYA GUDANG GARAM 16 FILTER;1;25000;0;25000;23700;1300;
2021-09-01 20:14:27;123124;KOREK BIASA;1;2000;0;2000;1300;700;
2021-09-01 20:16:30;6907992823942;JD JUJUBE;1;4500;0;4500;3800;700;
2021-09-01 20:16:30;YP;YUPI;4;250;0;1000;832;168;
2021-09-01 20:16:30;JL;JELLY;1;500;0;500;400;100;
2021-09-01 20:23:34;ARG;ARGUS 220ML;1;14500;0;14500;13300;1200;
2021-09-01 20:23:34;8991909101016;URBAN MILD 16;1;17000;0;17000;15800;1200;
2021-09-01 20:25:09;8998989300261;GUDANG GARAM SURYA 12 FILTER;1;19000;0;19000;17700;1300;
2021-09-01 20:29:19;8992761164478;FRESTEA MILK TEA;2;8000;0;16000;13150;2850;
2021-09-01 20:29:19;8991102281430;PERMEN MINTZ DUOMINT;1;5000;0;5000;4000;1000;
2021-09-01 20:29:19;0105312686040047;yakult;5;2000;0;10000;7500;2500;
2021-09-01 20:30:02;9556001025272;NESCAFE LATTE 240ML;1;8500;0;8500;7834;666;
2021-09-01 21:20:32;896867700494;AIR CLUB 1500ML;4;5000;0;20000;11948;8052;
2021-09-01 21:20:32;8992761145033;FANTA STRAW PET 250ML;1;3500;0;3500;2417;1083;
2021-09-01 21:20:32;089686611618;QTELA BARBEQUE;1;5000;0;5000;4266;734;
2021-09-01 21:48:48;089686021219;INTER MIE GORENG;1;1000;0;1000;885;115;
2021-09-01 21:48:48;089686021127;INTER MIE KALDU;1;1000;0;1000;813;187;
2021-09-01 21:53:15;8994867000162;ROKOK PUNDIMAS KRETEK16;1;10000;0;10000;8600;1400;
2021-09-01 21:53:15;8992959508954;SWEETY SILVER PANTS S 66;1;92000;0;92000;88788;3212;
2021-09-01 21:53:15;GL;GULA 1 LITER;2;11500;0;23000;21000;2000;
2021-09-01 22:02:45;8992696422650;NESCAFE FRENCH VANILLA;1;5000;0;5000;4099;901;
2021-09-01 22:21:58;8999999514648;LUX BWSAKURA BLOOM LD REFF 450 ML;1;25000;0;25000;22110;2890;
2021-09-01 22:21:58;8998866618298;DAIA CLEAN&FRESH HJB 320GR;1;5000;0;5000;4450;550;
2021-09-01 22:21:58;8991002105430;KAPAL API 65G;2;5000;0;10000;8290;1710;
2021-09-01 22:25:02;8998866202619;MIE SEDAAP KOREAN SPICY SOUP;3;2700;0;8100;6966;1134;
2021-09-01 22:25:02;8992979120013;TOTAL BUNGA SOFTENER;1;13000;0;13000;11532;1468;
2021-09-01 22:25:02;8998866201377;KRISBEE FRIES KENTANG GORENG 68 GR;2;5500;0;11000;9240;1760;
2021-09-01 22:58:52;8992761145033;FANTA STRAW PET 250ML;1;3500;0;3500;2417;1083;
2021-09-01 22:58:52;8992761145026;SPRITE PET 250ML;1;3500;0;3500;2417;1083;
2021-09-01 22:58:52;8992775610367;Garuda Koro paggang;1;1000;0;1000;828;172;
2021-09-01 23:14:09;8999909004221;SAMPOERNA ULTRAMILD 16;1;22000;0;22000;20350;1650;
2021-09-01 23:15:20;8992388133345;NU MILK TEA TEH TARIK 330ML;1;6000;0;6000;5125;875;
2021-09-01 23:33:28;8995899210185;Mi Boncabe;1;3500;0;3500;3000;500;
2021-09-02 08:57:29;8995102703534;TERASI DUO 6 GR;1;4000;0;4000;3720;280;
2021-09-02 08:57:29;8998866202626;Top Kopi Gula Aren 22gr;11;1000;0;11000;9130;1870;
2021-09-02 08:57:29;8992696419742;NESCAFE COFFE CREAM;1;5000;0;5000;4099;901;
2021-09-02 08:57:29;089686611519;QTELA SINGKONG;1;5000;0;5000;4266;734;
2021-09-02 08:57:29;AMPLOP;AMPLOP;4;250;0;1000;560;440;
2021-09-02 08:57:29;8992775001615;CHOCOLATOS SWEET CHEESE;1;18000;0;18000;15483;2517;
2021-09-02 08:57:29;8992775311615;CHOCOLATOS;1;12000;0;12000;9983;2017;
2021-09-02 08:57:29;8996001600399;LE MINERAL 1500ML;1;5000;0;5000;4042;958;
2021-09-02 08:57:29;8999909982000;SAMPOERNA 12 FILTER;1;18000;0;18000;16600;1400;
2021-09-02 08:57:29;8992761139018;ADES 600ML;2;3500;0;7000;4584;2416;
2021-09-02 08:57:29;JL;JELLY;2;500;0;1000;800;200;
2021-09-02 08:57:29;8992761111533;SPRITE SLIM CAM250ML;1;5000;0;5000;3750;1250;
2021-09-02 08:57:29;8993007000024;INDOMILK UHT VANILA;1;5000;0;5000;3470;1530;
2021-09-02 08:57:29;8992696523067;MILO ACTVGO UHT 180ML;1;4500;0;4500;3515;985;
2021-09-02 08:57:29;8991002105430;KAPAL API 65G;1;5000;0;5000;4145;855;
2021-09-02 09:17:37;8991102022460;FORMULA DIAMOND;1;3000;0;3000;2500;500;
2021-09-02 09:17:37;8999999552473;PEPSODENT ACTION123 SIWAK 65G;1;6200;0;6200;5600;600;
2021-09-02 09:17:37;8992946512223;SHINZUI;1;4000;0;4000;2500;1500;
2021-09-02 09:17:37;8998666001924;TB TORA CAFE CHOCO LATTE;2;1000;0;2000;1560;440;
2021-09-02 09:17:37;8934868015024;REXONA DEO LOTION FREE SPIRIT 9G;1;2500;0;2500;2000;500;
2021-09-02 09:17:37;8991002114067;PIKOPI;2;1000;0;2000;1090;910;
2021-09-02 09:17:37;KOPIKO;KOPIKO;1;250;0;250;175;75;
2021-09-02 09:19:21;8996001600399;LE MINERAL 1500ML;1;5000;0;5000;4042;958;
2021-09-02 09:19:21;8997028590014;ARGUS 220ML;1;500;0;500;302;198;
2021-09-02 09:48:33;8992761164539;NUTRIBOOST ORANGE 300ML;1;6500;0;6500;5300;1200;
2021-09-02 10:01:14;TBR;TEPUNG BERAS ROSE BRAND;1;8000;0;8000;5800;2200;
2021-09-02 10:03:09;8997003910684;2CS;1;3000;0;3000;1500;1500;
2021-09-02 10:03:09;RT 1000;ROTI 1000;1;1000;0;1000;800;200;
2021-09-02 10:03:09;ff;FULLO BLASTO;1;1000;0;1000;995;5;
2021-09-02 10:03:09;8991102320184;TANGO CHOCO JAVAMOCCA;1;5000;0;5000;4330;670;
2021-09-02 10:16:24;8997218380135;ICHITAN GREEN TEA;1;8000;0;8000;6583;1417;
2021-09-02 10:16:24;8992775001660;WAFER CREAM COKLAT TABUR KEJU;1;19000;0;19000;17721;1279;
2021-09-02 10:37:05;PUL;PULPEN;1;1500;0;1500;833;667;
2021-09-02 10:37:05;6907992823669;JD MILKY STRAW;1;3000;0;3000;2600;400;
2021-09-02 10:43:51;ARG;ARGUS 220ML;1;14500;0;14500;13300;1200;
2021-09-02 10:43:51;8991188943536;SASA SANTAN KELAPA 65ML;1;3000;0;3000;2437;563;
2021-09-02 10:56:27;8992696425316;NESCAFE BLACK;1;5000;0;5000;4099;901;
2021-09-02 10:56:27;RT 1000;ROTI 1000;1;1000;0;1000;800;200;
2021-09-02 10:56:27;8991909101016;URBAN MILD 16;2;17000;0;34000;31600;2400;
2021-09-02 11:08:58;8999909000377;SAMPOERNA AVOLUTION;1;31000;0;31000;28450;2550;
2021-09-02 11:08:58;8997218380074;ICHITAN MILK TEA;1;8000;0;8000;6583;1417;
2021-09-02 11:08:58;8992388133017;NU MILK TEA ORI 330ML;1;6000;0;6000;5125;875;
2021-09-02 11:14:34;POTO;KERUPUK PANJANG;1;5000;0;5000;4000;1000;
2021-09-02 11:14:34;8998866202664;POTABEE WAGYU BEEF STEAK 68 GR;1;8000;0;8000;7200;800;
2021-09-02 11:14:34;8992761164539;NUTRIBOOST ORANGE 300ML;1;6500;0;6500;5300;1200;
2021-09-02 11:14:34;6907992823874;JD CRUNCHY CHOCO BLUEBERRY;2;5500;0;11000;9400;1600;
2021-09-02 11:15:25;8997003910684;2CS;1;3000;0;3000;1500;1500;
2021-09-02 12:27:14;8999999526894;RINSO ROYAL GOLD 40ML;6;1000;0;6000;4830;1170;
2021-09-02 12:45:15;8992775305034;Geri Salut Malkist Bungkus;1;18000;0;18000;16250;1750;
2021-09-02 13:55:42;8992993524477;COLATTA FINEZA COMPOUND DARK 250G;1;18500;0;18500;17179;1321;
2021-09-02 14:09:38;8999999542191;LUX BW SANDALWOOD MUSK 250ML;1;22000;0;22000;19800;2200;
2021-09-02 14:09:38;8999999559861;AXE DARK POCKET FRAG 17ML;1;10000;0;10000;8000;2000;
2021-09-02 14:09:38;JD VM;JD VANILLA MILKSHAKE;1;5000;0;5000;4300;700;
2021-09-02 14:09:38;8997009510123;ORANGE WATER;1;7000;0;7000;6089;911;
2021-09-02 14:09:59;LT;LIPSTIK HANASUI;1;27000;0;27000;27000;0;
2021-09-02 14:10:37;8991002121010;GOOD DAY FANTASTIC MOCACINNO;1;6000;0;6000;4295;1705;
2021-09-02 14:21:07;8992775110157;GARUDA KACANG KULIT;1;5000;0;5000;3925;1075;
2021-09-02 14:21:07;8992761145033;FANTA STRAW PET 250ML;1;3500;0;3500;2417;1083;
2021-09-02 14:21:07;KP;KERIPIK PISANG;1;5000;0;5000;5000;0;
2021-09-02 14:26:49;8998866200813;NOODLE SEDAAP MIE GORENG CUP 85 GR;2;5000;0;10000;7834;2166;
2021-09-02 14:26:49;089686060027;POP MIE AYAM JUMBO;1;4500;0;4500;3833;667;
2021-09-02 14:26:49;089686060126;POP MIE BASO JUMBO;1;4500;0;4500;3833;667;
2021-09-02 14:26:49;089686017748;SARIMIE GORENG ISI 2;2;3500;0;7000;6240;760;
2021-09-02 14:26:49;089686048704;SARIMIE GORENG AYAM KCP ISI 2;2;3500;0;7000;6240;760;
2021-09-02 16:21:53;8998989110167;SURYA GUDANG GARAM 16 FILTER;1;25000;0;25000;23700;1300;
2021-09-02 16:24:24;8999909003439;MARLBORO CRAFTED 12;1;8000;0;8000;7250;750;
2021-09-02 16:24:24;8998866610377;ISOPLUS;1;3000;0;3000;2350;650;
2021-09-02 17:18:27;8998866106535;EMERON LOVELY NAT GREEN 200ML;1;6000;0;6000;5075;925;
2021-09-02 17:18:27;8999999534677;REXONA WMN RO GLOWING WHITE 45 ML;1;13500;0;13500;12030;1470;
2021-09-02 17:18:27;KOPIKO;KOPIKO;2;250;0;500;350;150;
2021-09-02 17:27:38;8992702000018;INDOMILK PUTIH 370G;1;10000;0;10000;9020;980;
2021-09-02 17:27:38;8999999048303;SUNSILK HJV RFR HF SOL 170ML;1;22000;0;22000;20020;1980;
2021-09-02 18:15:49;8991111111971;C&C FACIAL WASH 100ML;1;17500;0;17500;16070;1430;
2021-09-02 18:42:12;8995555171225;KIMBO SOSIS;3;1000;0;3000;2700;300;
2021-09-02 19:50:44;8994867000179;ROKOK PENA MILD 16;1;14500;0;14500;13500;1000;
2021-09-02 19:50:54;8998989300261;GUDANG GARAM SURYA 12 FILTER;1;19000;0;19000;18150;850;
2021-09-02 20:15:31;KPS;KAPAS MEI QIAN;1;5000;0;5000;4750;250;
2021-09-02 20:15:31;8999908284907;MY BABY MINYAK TELON 90ML;1;25000;0;25000;22700;2300;
2021-09-02 20:33:08;8997027300089;NOMOS;1;4000;0;4000;2963;1037;
2021-09-02 20:33:08;8998866202244;EKOMIE BUMBU KALDU AYAM;3;1000;0;3000;2394;606;
2021-09-02 20:33:08;HT;HOT-HOT;2;500;0;1000;700;300;
2021-09-02 20:33:08;KIKO;KIKO;2;1000;0;2000;1000;1000;
2021-09-02 20:34:45;8992959508879;SWEETY SILVER PANTS L 7;1;16800;0;16800;15228;1572;
2021-09-02 20:34:45;KOPIKO;KOPIKO;1;250;0;250;175;75;
2021-09-02 21:37:03;6907992823669;JD MILKY STRAW;1;3000;0;3000;2600;400;
2021-09-02 21:37:03;RT 1000;ROTI 1000;2;1000;0;2000;1600;400;
2021-09-02 21:46:15;8992775001691;GARUDA ROSTA WAGYU BEEF;1;8000;0;8000;7322;678;
2021-09-02 21:46:58;8999999707774;PEPSODENT ACTION 123 PLUS WHITENING 75G;1;8000;0;8000;7200;800;
2021-09-02 21:46:58;8991102022460;FORMULA DIAMOND;1;3000;0;3000;2500;500;
2021-09-02 21:46:58;ARG;ARGUS 220ML;1;14500;0;14500;13300;1200;
2021-09-02 22:23:37;8998866200882;SUKSESMIE GORENG AYAM KRMS 133GR;2;3500;0;7000;6094;906;
2021-09-02 22:23:37;8992775110157;GARUDA KACANG KULIT;1;5000;0;5000;3925;1075;
2021-09-02 22:23:37;8997028900837;SABUN PAPAYA;1;10000;0;10000;9375;625;
2021-09-02 22:23:37;8992979120013;TOTAL BUNGA SOFTENER;1;13000;0;13000;11532;1468;
2021-09-02 22:23:37;9556001025272;NESCAFE LATTE 240ML;1;8500;0;8500;7834;666;
2021-09-02 22:23:37;8996001600399;LE MINERAL 1500ML;1;5000;0;5000;4042;958;
2021-09-02 22:29:58;8998989300261;GUDANG GARAM SURYA 12 FILTER;1;19000;0;19000;18150;850;
2021-09-02 22:36:00;8886057883665;KRATING DAENG;2;6000;0;12000;8572;3428;
2021-09-02 22:38:48;8998866202466;JAPOTA HAPPY HONEY BUTTER;1;5000;0;5000;4150;850;
2021-09-02 22:38:48;8998866202619;MIE SEDAAP KOREAN SPICY SOUP;2;2700;0;5400;4644;756;
2021-09-02 22:38:48;089686010107;INDOMIE KALDU AYAM;1;2500;0;2500;2150;350;
2021-09-02 22:38:48;8998866610377;ISOPLUS;1;3000;0;3000;2350;650;
2021-09-02 22:48:02;8998989110167;SURYA GUDANG GARAM 16 FILTER;1;25000;0;25000;23700;1300;
2021-09-02 22:48:02;8996001600399;LE MINERAL 1500ML;1;5000;0;5000;4042;958;
2021-09-02 22:51:06;8998009010569;ULTRA CHO 200;1;5000;0;5000;3830;1170;
2021-09-02 22:51:06;9556001025272;NESCAFE LATTE 240ML;1;8500;0;8500;7834;666;
2021-09-02 22:51:06;6907992823904;JD CRUNCHY CHOCOLATE VAN;1;8000;0;8000;6800;1200;
2021-09-03 09:35:19;8992979190986;TOTAL PUTIH SOFTENER;1;13000;0;13000;11532;1468;
2021-09-03 09:35:19;8998866619035;Royale Sweet Floral 13 ml;1;5000;0;5000;4452;548;
2021-09-03 09:35:20;8996001355756;BENG-BENG MAXX SCT;2;2500;0;5000;4082;918;
2021-09-03 09:35:20;RT 1000;ROTI 1000;2;1000;0;2000;1600;400;
2021-09-03 09:35:20;8992702000063;INDOMILK COKLAT 370G;1;10000;0;10000;9020;980;
2021-09-03 09:35:20;8991102714860;MILKIDO STRAW;1;3000;0;3000;2153;847;
2021-09-03 09:35:20;8997012321204;MAXX BUMBU BALADO;1;5000;0;5000;4100;900;
2021-09-03 09:35:20;8995333060772;TERIGU GATOT KACA 500GR;1;5000;0;5000;4346;654;
2021-09-03 09:35:20;8993989311699;CLAS MILD 16 FILTER;1;23000;0;23000;21700;1300;
2021-09-03 09:35:20;8997025914042;ATB MARIE SUSU 185G;1;7000;0;7000;4554;2446;
2021-09-03 09:46:01;ROTI;ROTI 2000;1;2000;0;2000;1800;200;
2021-09-03 09:46:01;HT;HOT-HOT;2;500;0;1000;700;300;
2021-09-03 09:46:01;8998989300261;GUDANG GARAM SURYA 12 FILTER;1;19000;0;19000;18150;850;
2021-09-03 10:32:50;711844120419;SAMBAL ABC 275 ML;1;12000;0;12000;10800;1200;
2021-09-03 10:32:50;711844110083;KECAP ABC 275 ML;1;15000;0;15000;14000;1000;
2021-09-03 10:58:07;8998866200325;MIE SEDAAP SOTO;4;2700;0;10800;9324;1476;
2021-09-03 10:58:07;8991102714594;TANGO DRINK BLCK VNL;1;5000;0;5000;3818;1182;
2021-09-03 10:58:07;8992775001042;PILUS GARUDA MI GORENG;1;5000;0;5000;4810;190;
2021-09-03 11:21:20;BAYFLAST;BAYPLAST;1;500;0;500;350;150;
2021-09-03 11:21:46;8999999524722;SUNLIGHT LIME NEW PCH 435ML;1;10000;0;10000;9100;900;
2021-09-03 11:21:46;8998866200325;MIE SEDAAP SOTO;2;2700;0;5400;4662;738;
2021-09-03 11:23:08;BAYFLAST;BAYPLAST;1;500;0;500;350;150;
2021-09-03 12:47:11;KIKO;KIKO;4;1000;0;4000;2000;2000;
2021-09-03 13:02:58;8993989311699;CLAS MILD 16 FILTER;1;23000;0;23000;21700;1300;
2021-09-03 13:10:29;8998866200301;MIE SEDAAP GORENG;1;2700;0;2700;2413;287;
2021-09-03 13:10:29;8999999558062;RINSO ANTI NODA CLASSIC PWD 44G;1;5000;0;5000;4830;170;
2021-09-03 13:30:41;8992775000014;CHOCOLATOS HAZELNUT;1;18000;0;18000;15483;2517;
2021-09-03 13:30:41;8996001304136;SLAI OLAI BLUEBERRY;1;12000;0;12000;9900;2100;
2021-09-03 13:30:41;8992761145026;SPRITE PET 250ML;1;3500;0;3500;2417;1083;
2021-09-03 13:30:41;8992761145019;COCA COLA PET 250ML;1;3500;0;3500;2417;1083;
2021-09-03 13:30:41;0105312686040047;yakult;5;2000;0;10000;7500;2500;
2021-09-03 14:34:30;8998989300261;GUDANG GARAM SURYA 12 FILTER;1;19000;0;19000;18150;850;
2021-09-03 14:44:19;9556040040038;SUSU F&N;2;33000;0;66000;60000;6000;
2021-09-03 15:32:56;GL;GULA 1 LITER;1;11500;0;11500;10500;1000;
2021-09-03 15:32:56;8992628022156;BIMOLI KLASIK TOUCH 1 LT;1;16000;0;16000;14350;1650;
2021-09-03 15:32:56;8999999195649;SARI WANGI 25X1.86G;1;6000;0;6000;5050;950;
2021-09-03 16:12:31;8999999539603;ZWITSAL NATURAL BASIC PACK;1;39000;0;39000;35420;3580;
2021-09-03 16:52:04;RB;RED BOLD;1;20000;0;20000;18800;1200;
2021-09-03 17:06:49;8992959954034;SWEETY BRONZE NB 24;1;29000;0;29000;26762;2238;
2021-09-03 17:06:49;8996001600399;LE MINERAL 1500ML;1;5000;0;5000;4042;958;
2021-09-03 17:06:57;8998009010569;ULTRA CHO 200;1;5000;0;5000;3830;1170;
2021-09-03 17:21:33;GL;GULA 1 LITER;1;11500;0;11500;10500;1000;
2021-09-03 17:21:33;8999801700054;SUSU FOYU 1 KG;1;22000;0;22000;19791;2209;
2021-09-03 17:21:57;8998989110167;SURYA GUDANG GARAM 16 FILTER;1;25000;0;25000;23700;1300;
2021-09-03 17:27:22;6907992823645;JD COCONUT BLISS;1;4000;0;4000;3500;500;
2021-09-03 17:27:22;8996001305119;ARDEN 30G;1;2000;0;2000;1650;350;
2021-09-03 18:02:29;ROTI;ROTI 2000;2;2000;0;4000;3600;400;
2021-09-03 18:02:29;8991188943536;SASA SANTAN KELAPA 65ML;1;3000;0;3000;2437;563;
2021-09-03 18:02:29;8996001314005;ROMA KELAPA CREAM CKLT;1;8000;0;8000;6642;1358;
2021-09-03 18:11:46;MARS;MARSHMELLOW;2;500;0;1000;866;134;
2021-09-03 18:30:27;8992761002015;COCA COLA PET 390ML;1;5500;0;5500;4333;1167;
2021-09-03 18:30:27;8996001600610;TORA MILKY LATTE 180ML;1;3500;0;3500;2750;750;
2021-09-03 18:53:44;ROTI;ROTI 2000;2;2000;0;4000;3600;400;
2021-09-03 19:08:09;8999099920714;SGM 1+ VANILA 1000G;1;85000;0;85000;78510;6490;
2021-09-03 19:58:03;8996001600399;LE MINERAL 1500ML;1;5000;0;5000;4042;958;
2021-09-03 20:17:59;8999909002821;MARLBORO BLACK 16;1;22000;0;22000;20850;1150;
2021-09-03 20:36:08;9556001025272;NESCAFE LATTE 240ML;1;8500;0;8500;7834;666;
2021-09-03 20:36:08;JGR SHN;JOGER SHINY SACHET;1;500;0;500;437;63;
2021-09-03 21:02:42;8992696419742;NESCAFE COFFE CREAM;2;5000;0;10000;8198;1802;
2021-09-03 21:22:59;8992761111533;SPRITE SLIM CAM250ML;2;5000;0;10000;7500;2500;
2021-09-03 21:31:21;8996001410042;TB TORA MOKA;3;1500;0;4500;2610;1890;
2021-09-03 21:31:21;8998866202626;Top Kopi Gula Aren 22gr;2;1000;0;2000;1660;340;
2021-09-03 21:34:31;8997011700123;BIHUN JAGUNG 300GR;1;6000;0;6000;4979;1021;
2021-09-03 22:01:00;8996001600597;KOPIKO LUCKY DAY;1;5000;0;5000;4283;717;
2021-09-03 22:09:17;8999909003873;MARLBORO 12;1;17000;0;17000;15750;1250;
2021-09-03 22:09:17;76239878;MARLBORO GOLD;1;30000;0;30000;27700;2300;
2021-09-03 22:12:18;123124;KOREK BIASA;2;2000;0;4000;2600;1400;
2021-09-03 22:13:32;8991111111995;C&C TONER 100ML;1;14000;0;14000;12900;1100;
2021-09-03 22:13:32;8991102320184;TANGO CHOCO JAVAMOCCA;1;5000;0;5000;4330;670;
2021-09-03 22:13:32;8886013213208;FRENCH FREIS 2000;1;5000;0;5000;3750;1250;
2021-09-03 22:27:42;GL;GULA 1 LITER;5;11500;0;57500;52500;5000;
2021-09-03 22:27:42;ARG 330;ARGUS 330ML;1;35000;0;35000;31000;4000;
2021-09-03 22:27:43;ROTI;ROTI 2000;3;2000;0;6000;5400;600;
2021-09-04 08:26:30;8996001305119;ARDEN 30G;1;2000;0;2000;1650;350;
2021-09-04 08:26:30;089686021219;INTER MIE GORENG;2;1000;0;2000;1770;230;
2021-09-04 08:30:47;ROTI;ROTI 2000;1;2000;0;2000;1800;200;
2021-09-04 11:32:40;8993989311699;CLAS MILD 16 FILTER;1;23000;0;23000;21700;1300;
2021-09-04 11:37:11;8998866202244;EKOMIE BUMBU KALDU AYAM;6;1000;0;6000;4788;1212;
2021-09-04 11:37:11;089686021127;INTER MIE KALDU;3;1000;0;3000;2439;561;
2021-09-04 11:37:11;089686043051;INDOMIE COTO MAKASSAR;1;2800;0;2800;2525;275;
2021-09-04 11:42:50;8991909101016;URBAN MILD 16;1;17000;0;17000;15800;1200;
2021-09-04 11:42:50;TUSTEL;TUSUK TELINGA;1;1000;0;1000;833;167;
2021-09-04 11:42:50;ROTI;ROTI 2000;2;2000;0;4000;3600;400;
2021-09-04 11:42:50;8993083140041;BISKITOP CHOCOLATE;1;27000;0;27000;25200;1800;
2021-09-04 11:42:50;8998989500166;GUDANG GARAM MERAH BESAR 16KS;2;18000;0;36000;34000;2000;
2021-09-04 11:42:50;8994867007161;ROKOK PENA GOLD 20;1;18000;0;18000;16800;1200;
2021-09-04 11:42:50;8998866202244;EKOMIE BUMBU KALDU AYAM;6;1000;0;6000;4788;1212;
2021-09-04 11:42:50;089686021127;INTER MIE KALDU;3;1000;0;3000;2439;561;
2021-09-04 11:42:50;089686043051;INDOMIE COTO MAKASSAR;1;2800;0;2800;2525;275;
2021-09-04 11:42:50;8996001375372;CHOKI CHOKI;1;1000;0;1000;910;90;
2021-09-04 12:32:38;ROTI;ROTI 2000;1;2000;0;2000;1800;200;
2021-09-04 12:33:57;8995333060703;TERIGU KOMPAS 1KG;10;10500;0;105000;98160;6840;
2021-09-04 12:52:13;8992770033178;Masako;12;500;0;6000;5400;600;
2021-09-04 12:52:13;8992979190986;TOTAL PUTIH SOFTENER;1;13000;0;13000;11532;1468;
2021-09-04 12:52:13;8996001305119;ARDEN 30G;2;2000;0;4000;3300;700;
2021-09-04 12:52:13;GL;GULA 1 LITER;2;11500;0;23000;21000;2000;
2021-09-04 13:05:03;ROTI;ROTI 2000;3;2000;0;6000;5400;600;
2021-09-04 13:05:03;8998989300261;GUDANG GARAM SURYA 12 FILTER;1;19000;0;19000;18150;850;
2021-09-04 13:29:50;8992775001844;Chocolatos original taste;1;1000;0;1000;829;171;
2021-09-04 13:29:50;ff;FULLO BLASTO;2;1000;0;2000;1990;10;
2021-09-04 13:39:09;8999999528942;CITRA HBL PEARLY WHITE UV 120ML;1;12000;0;12000;10082;1918;
2021-09-04 13:40:21;ARG;ARGUS 220ML;1;14500;0;14500;13300;1200;
2021-09-04 13:44:55;8992628020152;BIMOLI POUCH 2L;1;31000;0;31000;29800;1200;
2021-09-04 13:44:55;089686017748;SARIMIE GORENG ISI 2;1;3500;0;3500;3120;380;
2021-09-04 13:57:29;8992775001844;Chocolatos original taste;2;1000;0;2000;1658;342;
2021-09-04 13:57:29;089686611670;QTELA BALADO;1;5000;0;5000;4266;734;
2021-09-04 14:21:33;8992775913000;CHOCOLATOS CKLT 28G;2;2000;0;4000;3114;886;
2021-09-04 14:21:33;8992696405417;DNCO INSTANT 27G;5;3500;0;17500;15000;2500;
2021-09-04 14:21:33;8994023000050;MEGKEJU SERBAGUNA 165G;1;12000;0;12000;10339;1661;
2021-09-04 14:21:33;TELUR RAK;TELUR RAK;1;38000;0;38000;36000;2000;
2021-09-04 14:35:06;8998866201377;KRISBEE FRIES KENTANG GORENG 68 GR;1;5500;0;5500;4620;880;
2021-09-04 14:35:06;8998866201469;POTABEE REGULER BBQ BEEF 68 GR;1;8000;0;8000;7200;800;
2021-09-04 14:35:57;YP;YUPI;10;250;0;2500;2080;420;
2021-09-04 14:40:07;TELUR RAK;TELUR RAK;1;39000;0;39000;36000;3000;
2021-09-04 14:40:07;8997028590052;ARGUS 600ML;1;3000;0;3000;1458;1542;
2021-09-04 14:40:07;8997009510123;ORANGE WATER;1;7000;0;7000;6089;911;
2021-09-04 15:05:36;8998898337440;TOLAK ANGIN CARE 10ML;1;10000;0;10000;7893;2107;
2021-09-04 15:16:45;8998866501026;MINYAK GORENG SEDAAP POUCH 1 L;1;15000;0;15000;14110;890;
2021-09-04 16:05:12;089686535044;SUN BERAS MERAH;1;8500;0;8500;7410;1090;
2021-09-04 16:39:07;8998898830125;KKB ENER-G ANGGUR;1;5500;0;5500;4824;676;
2021-09-04 17:25:30;8996001305119;ARDEN 30G;1;2000;0;2000;1650;350;
2021-09-04 17:25:30;8993274532105;BOLU;2;1000;0;2000;1666;334;
2021-09-04 17:25:30;8991102308892;BLASTO;1;1000;0;1000;995;5;
2021-09-04 17:27:36;8998989300261;GUDANG GARAM SURYA 12 FILTER;1;19000;0;19000;18150;850;
2021-09-04 17:31:39;8995555121244;SOSIS KIMBO;1;1000;0;1000;650;350;
2021-09-04 17:35:46;8991102303309;WFR TANGO SBJ 176G;1;10000;0;10000;8694;1306;
2021-09-04 17:46:18;8998989110167;SURYA GUDANG GARAM 16 FILTER;1;25000;0;25000;23700;1300;
2021-09-04 19:12:35;8992959509005;SWEETY SILVER PANTS XL26;1;61500;0;61500;55910;5590;
2021-09-04 19:49:26;ARG 330;ARGUS 330ML;1;35000;0;35000;31000;4000;
2021-09-04 19:49:26;ARG;ARGUS 220ML;1;14500;0;14500;13300;1200;
2021-09-04 19:49:26;8999999195649;SARI WANGI 25X1.86G;1;6000;0;6000;5050;950;
2021-09-04 19:49:26;8991002105409;KOPI KAPAL API;1;20000;0;20000;18888;1112;
2021-09-04 19:51:27;8996001600375;LE MINERAL 330ML;24;2000;0;48000;34008;13992;
2021-09-04 20:06:47;8999999049478;REXONA WMN RO NATURALS BIO 45 ML;1;16500;0;16500;14900;1600;
2021-09-04 20:06:47;8999999049669;REXONA MEN RO INVISIBLE DRY 45 ML;1;15000;0;15000;13550;1450;
2021-09-04 20:06:47;8999999033200;LIFEBUOY SHP ANTI KETOMBE 70+21 ML;1;8000;0;8000;7260;740;
2021-09-04 20:06:47;8997009510123;ORANGE WATER;1;7000;0;7000;6089;911;
2021-09-04 20:59:00;8999999534677;REXONA WMN RO GLOWING WHITE 45 ML;2;13500;0;27000;24060;2940;
2021-09-04 20:59:00;8992959971093;SFX COMFORT SLIME 6;1;8500;0;8500;7798;702;
2021-09-04 20:59:00;8998866107457;POSH SUMMER LOVE 150ML;1;19500;0;19500;17500;2000;
2021-09-04 20:59:00;Vita Jelly;Vita Jelly;5;1000;0;5000;3830;1170;
2021-09-04 21:11:39;8996001305119;ARDEN 30G;2;2000;0;4000;3300;700;
2021-09-04 21:33:34;8998866201490;POTABEE REGULER GRILLED SEAWED 68 GR;1;8000;0;8000;7200;800;
2021-09-04 21:34:42;8992761111540;FANTA STRAWBERY SLIM CAM 250ML;2;5000;0;10000;7500;2500;
2021-09-04 21:34:42;8992761111533;SPRITE SLIM CAM250ML;1;5000;0;5000;3750;1250;
2021-09-04 21:52:59;8992761166052;FRESTEA MELATI 350ML;1;4500;0;4500;3000;1500;
2021-09-04 22:36:45;8997013180046;Tissu Tessi B;1;10000;0;10000;9800;200;
2021-09-04 22:36:45;8992775110157;GARUDA KACANG KULIT;1;5000;0;5000;3925;1075;
2021-09-04 22:36:45;8994834005923;SPIX 1000;5;1000;0;5000;4250;750;
2021-09-04 22:49:01;8998989300261;GUDANG GARAM SURYA 12 FILTER;1;19000;0;19000;18150;850;
2021-09-04 22:54:21;8999909000377;SAMPOERNA AVOLUTION;1;31000;0;31000;29450;1550;
2021-09-04 22:59:21;8998989110167;SURYA GUDANG GARAM 16 FILTER;1;25000;0;25000;23700;1300;
2021-09-04 23:12:04;8993007000086;INDOMILK CKLT 1L;1;16500;0;16500;14791;1709;
2021-09-04 23:12:04;8998866200301;MIE SEDAAP GORENG;2;2700;0;5400;4826;574;
2021-09-04 23:12:04;ARG;ARGUS 220ML;1;14500;0;14500;13300;1200;
2021-09-04 23:12:04;8886013213208;FRENCH FREIS 2000;1;5000;0;5000;3750;1250;
2021-09-04 23:13:29;8994834006128;TICTIC PEDAS;1;2000;0;2000;1700;300;
2021-09-04 23:13:29;ROTI;ROTI 2000;2;2000;0;4000;3600;400;
2021-09-04 23:15:06;Garuda pilus pcs;Garuda pilus Rasa Mi Goreng pcs;1;1000;0;1000;808;192;
2021-09-04 23:15:06;8886001038011;BENG-BENG SCT;1;1500;0;1500;1450;50;
2021-09-04 23:15:06;089686043051;INDOMIE COTO MAKASSAR;1;2800;0;2800;2525;275;
2021-09-04 23:15:06;8992775001998 pcs;Gery Salut sandiwich pcs;1;1000;0;1000;815;185;
2021-09-04 23:21:37;8991102100823;Formula Acttion Protector 190 gr;1;10000;0;10000;9000;1000;
2021-09-04 23:21:37;8993379200886;SABUN HARMONY ORANGE 70G;2;2000;0;4000;3304;696;
2021-09-04 23:21:37;8999999525811;MOLTO AIO BLUE PCH 720;1;26800;0;26800;23900;2900;
2021-09-04 23:21:37;8998866200325;MIE SEDAAP SOTO;2;2700;0;5400;4662;738;
2021-09-04 23:21:37;8998866200301;MIE SEDAAP GORENG;3;2700;0;8100;7239;861;
2021-09-04 23:21:37;8999999536244;SUNSILK SHP THICK N LONG170ML;1;20000;0;20000;18150;1850;
2021-09-05 09:24:03;8992628022156;BIMOLI KLASIK TOUCH 1 LT;1;16000;0;16000;14350;1650;
2021-09-05 09:24:03;8992775002582;DILAN CHOCO;1;2000;0;2000;1503;497;
2021-09-05 09:24:03;8998866202602;KRISBEE FRENCH FRIES 18GR;1;2000;0;2000;1500;500;
2021-09-05 09:24:03;GL;GULA 1 LITER;1;11500;0;11500;10500;1000;
2021-09-05 09:24:03;TELUR;TELUR;3;1800;0;5400;3600;1800;
2021-09-05 09:26:22;8992761145033;FANTA STRAW PET 250ML;1;3500;0;3500;2417;1083;
2021-09-05 09:34:00;8997009510123;ORANGE WATER;1;7000;0;7000;6089;911;
2021-09-05 09:34:00;8998866808729;ROYALE SOFT WHITE;1;5000;0;5000;4500;500;
2021-09-05 09:34:00;8998866803694;SOKLIN SOFTERGENT PURPLE BAG 770 & PIRING;1;18000;0;18000;16680;1320;
2021-09-05 09:34:00;8991188943536;SASA SANTAN KELAPA 65ML;1;3000;0;3000;2437;563;
2021-09-05 09:34:00;089686440133;BUMBU KARE;1;5000;0;5000;4500;500;
2021-09-05 09:34:00;8991102385060;TANGO WAFFLE CHOX;1;9000;0;9000;8498;502;
2021-09-05 09:34:00;8992775913000;CHOCOLATOS CKLT 28G;10;2000;0;20000;15570;4430;
2021-09-05 09:34:00;8998866200301;MIE SEDAAP GORENG;1;2700;0;2700;2413;287;
2021-09-05 11:37:02;8992761139018;ADES 600ML;1;3500;0;3500;2166;1334;
2021-09-05 11:37:02;8992761166038;MMP ORANGE 300ML;1;5000;0;5000;3750;1250;
2021-09-05 11:43:02;8991102714846;MILKIDO CKLT;1;3000;0;3000;2153;847;
2021-09-05 11:43:02;8998866202466;JAPOTA HAPPY HONEY BUTTER;1;5000;0;5000;4150;850;
2021-09-05 11:43:02;AMPLOP;AMPLOP;4;250;0;1000;560;440;
2021-09-05 11:43:02;Vita Jelly;Vita Jelly;1;1000;0;1000;766;234;
2021-09-05 11:53:50;8996001305119;ARDEN 30G;1;2000;0;2000;1650;350;
2021-09-05 11:53:50;ROTI;ROTI 2000;1;2000;0;2000;1800;200;
2021-09-05 12:59:04;089686535044;SUN BERAS MERAH;1;8500;0;8500;7410;1090;
2021-09-05 12:59:04;8991102022347;SIKAT GIGI FORMULA RIPPLE;1;5000;0;5000;4583;417;
2021-09-05 13:02:35;8998989110167;SURYA GUDANG GARAM 16 FILTER;3;25000;0;75000;71100;3900;
2021-09-05 13:02:35;089686611618;QTELA BARBEQUE;1;5000;0;5000;4266;734;
2021-09-05 13:02:35;8886013213208;FRENCH FREIS 2000;1;5000;0;5000;3750;1250;
2021-09-05 13:02:35;8991102308823;KLOP COCONUT ORI;1;6000;0;6000;4969;1031;
2021-09-05 13:09:46;8998866608046;KECAP MANIS SEDAAP POUCH 225ML;1;8500;0;8500;7744;756;
2021-09-05 16:06:50;8992959117583;SFX DS REG FLOW WING 20;1;5000;0;5000;4288;712;
2021-09-05 16:12:41;8999909096004;SAMPOERNA 16 FILTER;1;24000;0;24000;23100;900;
2021-09-05 16:13:47;8992959117583;SFX DS REG FLOW WING 20;1;5000;0;5000;4288;712;
2021-09-05 16:16:09;8998866202619;MIE SEDAAP KOREAN SPICY SOUP;2;2700;0;5400;4644;756;
2021-09-05 16:18:19;089686611519;QTELA SINGKONG;1;5000;0;5000;4266;734;
2021-09-05 16:18:55;8992628022156;BIMOLI KLASIK TOUCH 1 LT;1;16000;0;16000;14350;1650;
2021-09-05 16:19:26;8998866605144;CLING KUNING POUCH 425ML;1;4000;0;4000;3250;750;
2021-09-05 16:20:41;089686043051;INDOMIE COTO MAKASSAR;1;2800;0;2800;2525;275;
2021-09-05 16:24:25;Garuda pilus;Garuda Pilus Pedas Pcs;2;500;0;1000;816;184;
2021-09-05 16:24:59;8993470672827;SAKU-SAKU SAPI PANGGANG;1;2000;0;2000;1530;470;
2021-09-05 16:25:36;Garuda pilus pcs;Garuda pilus Rasa Mi Goreng pcs;1;1000;0;1000;808;192;
2021-09-05 16:26:09;KOPIKO;KOPIKO;2;250;0;500;350;150;
2021-09-05 16:28:24;8998866200882;SUKSESMIE GORENG AYAM KRMS 133GR;1;3500;0;3500;3047;453;
2021-09-05 16:30:35;JL;JELLY;3;500;0;1500;1200;300;
2021-09-05 16:31:04;JL;JELLY;4;500;0;2000;1600;400;
2021-09-05 16:32:16;8998866200646;KOPI TOP MURNI;1;11000;0;11000;9600;1400;
2021-09-05 16:33:26;ROTI;ROTI 2000;2;2000;0;4000;3600;400;
2021-09-05 16:35:11;8993989311699;CLAS MILD 16 FILTER;1;23000;0;23000;21700;1300;
2021-09-05 16:38:37;8992775002933;GERY MALKIST DOUBLE ABON;1;6500;0;6500;5516;984;
2021-09-05 16:38:37;8998989300261;GUDANG GARAM SURYA 12 FILTER;1;19000;0;19000;18150;850;
2021-09-05 16:40:33;8998989500166;GUDANG GARAM MERAH BESAR 16KS;1;18000;0;18000;17000;1000;
2021-09-05 16:41:47;ARG;ARGUS 220ML;1;14500;0;14500;13300;1200;
2021-09-05 16:42:11;ROTI;ROTI 2000;1;2000;0;2000;1800;200;
2021-09-05 16:43:29;8995555171225;KIMBO SOSIS;1;1000;0;1000;900;100;
2021-09-05 16:43:57;8995555171225;KIMBO SOSIS;2;1000;0;2000;1800;200;
2021-09-05 16:45:06;8992775305126 pcs;Gery Salut malkist Kelapa pcs;1;1000;0;1000;812;188;
2021-09-05 16:45:44;8992761166052;FRESTEA MELATI 350ML;1;4500;0;4500;3000;1500;
2021-09-05 16:46:53;8998989300261;GUDANG GARAM SURYA 12 FILTER;1;19000;0;19000;18150;850;
2021-09-05 16:47:43;8992775203422;GARUDA ROSTA OVEN 100G;2;8000;0;16000;14644;1356;
2021-09-05 16:49:34;8994834005923;SPIX 1000;2;1000;0;2000;1700;300;
2021-09-05 16:50:18;8992696425316;NESCAFE BLACK;1;5000;0;5000;4099;901;
2021-09-05 16:51:22;8886013257400;TWISTKO;1;1000;0;1000;900;100;
2021-09-05 16:52:17;SURYA;SURYA;2;500;0;1000;1000;0;
2021-09-05 16:57:18;8992979130012;TOTAL LEMON SOFTENER;1;13000;0;13000;11532;1468;
2021-09-05 16:59:54;8992775311509;gery garuda;2;1000;0;2000;1400;600;
2021-09-05 19:04:14;8996001600399;LE MINERAL 1500ML;1;5000;0;5000;4042;958;
2021-09-05 19:04:30;8994834005923;SPIX 1000;3;1000;0;3000;2550;450;
2021-09-05 19:06:00;089686043051;INDOMIE COTO MAKASSAR;1;2800;0;2800;2525;275;
2021-09-05 19:08:41;8992775002933;GERY MALKIST DOUBLE ABON;1;6500;0;6500;5516;984;
2021-09-05 19:57:52;8995555121244;SOSIS KIMBO;1;1000;0;1000;650;350;
2021-09-05 19:59:55;8992775311509;gery garuda;1;1000;0;1000;700;300;
2021-09-05 20:00:27;8992775311509;gery garuda;1;1000;0;1000;700;300;
2021-09-05 20:01:23;8998989300261;GUDANG GARAM SURYA 12 FILTER;1;19000;0;19000;18150;850;
2021-09-05 20:16:53;GGK;PLAYGUM PERMEN KARET;2;500;0;1000;800;200;
2021-09-05 21:07:31;8998866200578;MIE SEDAAP KARI KENTAL;1;2700;0;2700;2331;369;
2021-09-05 21:15:18;8992775211434;PILUS GARUDA SAPI PANGGANG;1;5000;0;5000;4810;190;
2021-09-05 21:15:18;8998866200325;MIE SEDAAP SOTO;3;2700;0;8100;6993;1107;
2021-09-05 21:25:26;8998866200578;MIE SEDAAP KARI KENTAL;1;2700;0;2700;2331;369;
2021-09-05 21:25:26;8992761166052;FRESTEA MELATI 350ML;1;4500;0;4500;3000;1500;
2021-09-06 08:19:55;ROTI;ROTI 2000;1;2000;0;2000;1800;200;
2021-09-06 08:55:15;8995333000822;TERIGU KOMPAS SOFT 500GR;2;5500;0;11000;9934;1066;
2021-09-06 08:57:35;8998866601429;POWDET DAIA BUNGA BAG 290GR;1;5000;0;5000;4450;550;
2021-09-06 08:57:35;8999999059309;LIFEBUOY TS TOTAL 10 DG 75G;2;3000;0;6000;5280;720;
2021-09-06 08:57:35;8998866602556;NUVO FAMILY MERAH 76G;1;2000;0;2000;1820;180;
2021-09-06 12:37:51;ARG;ARGUS 220ML;2;14500;0;29000;26600;2400;
2021-09-06 12:37:51;8998989300391;SURYA PRO PUTIH;1;22000;0;22000;20100;1900;
2021-09-06 12:37:51;8998866601429;POWDET DAIA BUNGA BAG 290GR;1;5000;0;5000;4450;550;
2021-09-06 12:37:51;8998866602549;NUVO FAMILY BIRU 76G;3;2000;0;6000;5460;540;
2021-09-06 12:37:51;8999999529703;CLEAR MEN COOL SPORT MTHL 80ML;1;11000;0;11000;10000;1000;
2021-09-06 12:37:51;8992730002992;HAI CANDY;7;7000;0;49000;42000;7000;
2021-09-06 12:37:51;8991004011906;KOPI BORONG;1;10000;0;10000;8333;1667;
2021-09-06 12:37:51;gula;GULA;1;11500;0;11500;10000;1500;
2021-09-06 12:37:51;8994867007161;ROKOK PENA GOLD 20;1;18000;0;18000;16800;1200;
2021-09-06 12:37:51;GL;GULA 1 LITER;1;11500;0;11500;10500;1000;
2021-09-06 12:37:51;Gula gula pulpen;gula gula pulpen;1;2000;0;2000;1750;250;
2021-09-06 12:37:51;MOBIL;GULA GULA HP;1;2000;0;2000;1700;300;
2021-09-06 12:39:03;ROTI;ROTI 2000;1;2000;0;2000;1800;200;
2021-09-06 16:05:08;8992730002992;HAI CANDY;2;7000;0;14000;12000;2000;
2021-09-06 16:05:30;8991004011906;KOPI BORONG;1;10000;0;10000;8333;1667;
2021-09-06 16:05:57;GL;GULA 1 LITER;1;11500;0;11500;10500;1000;
2021-09-06 16:06:23;8994867007161;ROKOK PENA GOLD 20;1;18000;0;18000;16800;1200;
2021-09-06 16:08:52;8997003910684;2CS;1;3000;0;3000;1500;1500;
2021-09-06 16:48:11;ARG;ARGUS 220ML;1;14500;0;14500;13300;1200;
2021-09-06 16:49:41;8998989300261;GUDANG GARAM SURYA 12 FILTER;1;19000;0;19000;18150;850;
2021-09-06 16:50:55;ABC;BATERAI ABC BIRU;1;9000;0;9000;7712;1288;
2021-09-06 16:51:36;GL;GULA 1 LITER;1;11500;0;11500;10500;1000;
2021-09-06 16:52:06;8995333032113;TERIGU GATOT KACA 1 KG;1;9000;0;9000;8572;428;
2021-09-06 16:52:26;8995333060703;TERIGU KOMPAS 1KG;1;10500;0;10500;9816;684;
2021-09-06 16:53:29;8998866501026;MINYAK GORENG SEDAAP POUCH 1 L;2;15000;0;30000;28220;1780;
2021-09-06 16:56:16;8993083929837;BISKITOP BLACK COOKIES;1;27000;0;27000;23700;3300;
2021-09-06 16:57:38;8997210107877;VORTEX SMART 3;1;5000;0;5000;4750;250;
2021-09-06 17:39:04;8996001305119;ARDEN 30G;1;2000;0;2000;1650;350;
2021-09-06 17:54:32;8999999524807;SUNLIGHT HABBATUSSAUDA POUCH 755ML;1;17000;0;17000;15400;1600;
2021-09-06 17:54:32;8998866106979;CIPTADENT TB CHARCOAL PROTEC;1;6000;0;6000;5250;750;
2021-09-06 17:54:32;8992628020152;BIMOLI POUCH 2L;1;31000;0;31000;29800;1200;
2021-09-06 18:53:03;8992761111533;SPRITE SLIM CAM250ML;2;5000;0;10000;7500;2500;
2021-09-06 18:54:16;8997025911058;HATARI SHP KELAPA;1;6000;0;6000;4911;1089;
2021-09-06 18:58:35;8997003910684;2CS;1;3000;0;3000;1500;1500;
2021-09-06 18:59:09;8886001038011;BENG-BENG SCT;2;1500;0;3000;2900;100;
2021-09-06 18:59:27;8997003910684;2CS;1;3000;0;3000;1500;1500;
2021-09-06 19:04:22;8999999053291;LIFEBUOY LEMONFRESH 110G;2;15000;0;30000;28490;1510;
2021-09-06 20:07:51;8991001121400;SILVERQUEEN ALMOND 65G;1;15000;0;15000;13200;1800;
2021-09-06 20:17:22;089686010343;INDOMIE SOTO MIE;1;2600;0;2600;2367;233;
2021-09-06 20:17:22;8998866609487;SOKLIN SOFTERGEN 280G;1;5000;0;5000;4425;575;
2021-09-06 20:44:52;089686010343;INDOMIE SOTO MIE;3;2600;0;7800;7101;699;
2021-09-06 20:47:13;ARG;ARGUS 220ML;1;14500;0;14500;13300;1200;
2021-09-06 20:47:13;8992761002022;SPRITE PET 390ML;1;5500;0;5500;4333;1167;
2021-09-06 20:47:13;KIKO;KIKO;1;1000;0;1000;500;500;
2021-09-06 20:55:26;8999909982000;SAMPOERNA 12 FILTER;1;18000;0;18000;16600;1400;
2021-09-06 21:41:02;Gula gula tusuk;gula gula tusuk;2;500;0;1000;800;200;
2021-09-06 21:42:03;089686017748;SARIMIE GORENG ISI 2;1;3500;0;3500;3120;380;
2021-09-06 21:49:58;BALON;BALON CABUT;2;1000;0;2000;1800;200;
2021-09-06 21:49:58;GGK;PLAYGUM PERMEN KARET;6;500;0;3000;2400;600;
2021-09-06 21:49:58;8992761139018;ADES 600ML;1;3500;0;3500;2166;1334;
2021-09-07 09:11:44;8993379200886;SABUN HARMONY ORANGE 70G;2;2000;0;4000;3304;696;
2021-09-07 09:15:45;8992775311509;gery garuda;1;1000;0;1000;700;300;
2021-09-07 09:16:05;8996001305119;ARDEN 30G;1;2000;0;2000;1650;350;
2021-09-07 09:18:34;8991001242013;Top;1;1000;0;1000;500;500;
2021-09-07 09:19:06;ROTI;ROTI 2000;1;2000;0;2000;1800;200;
2021-09-07 09:19:49;8998866679596;SOKLIN LANTAI BIRU 780ML;1;12000;0;12000;10020;1980;
2021-09-07 09:20:23;8996001305119;ARDEN 30G;1;2000;0;2000;1650;350;
2021-09-07 09:20:56;RT 1000;ROTI 1000;1;1000;0;1000;800;200;
2021-09-07 09:21:22;ROTI;ROTI 2000;1;2000;0;2000;1800;200;
2021-09-07 09:24:18;8992959953020;SWEETY BRONZE M1;1;3000;0;3000;2671;329;
2021-09-07 09:24:40;gula;GULA;1;11500;0;11500;10000;1500;
2021-09-07 09:53:48;8992957220186;COKLAT RUSA;1;2000;0;2000;1700;300;
2021-09-07 09:53:48;8886001038011;BENG-BENG SCT;1;1500;0;1500;1450;50;
2021-09-07 09:53:48;089686535044;SUN BERAS MERAH;1;8500;0;8500;7410;1090;
2021-09-07 11:12:51;GL;GULA 1 LITER;1;11500;0;11500;10500;1000;
2021-09-07 11:40:55;089686611670;QTELA BALADO;2;5000;0;10000;8532;1468;
2021-09-07 11:45:47;TORT;TORTILA;2;1000;0;2000;2000;0;
2021-09-07 12:20:06;RB;RED BOLD;1;20000;0;20000;18800;1200;
2021-09-07 12:20:41;KIKO;KIKO;2;1000;0;2000;1000;1000;
2021-09-07 12:20:41;TORT;TORTILA;2;1000;0;2000;2000;0;
2021-09-07 12:33:47;8992775310212;GERY PASTA COKELAT;1;18000;0;18000;16029;1971;
2021-09-07 12:39:09;ARG;ARGUS 220ML;2;14500;0;29000;26600;2400;
2021-09-07 14:03:36;8992775001844;Chocolatos original taste;2;1000;0;2000;1658;342;
2021-09-07 14:31:31;8997218380135;ICHITAN GREEN TEA;1;8000;0;8000;6583;1417;
2021-09-07 14:37:09;8994935000049;MINYAK GORENG DAMAI 5L;1;75000;0;75000;73780;1220;
2021-09-07 14:37:09;8998866501026;MINYAK GORENG SEDAAP POUCH 1 L;1;15000;0;15000;14110;890;
2021-09-07 15:32:36;8999999559533;LIFEBUOY BW TOTAL 10 90ML;1;5000;0;5000;4000;1000;
2021-09-07 15:32:36;8997210107877;VORTEX SMART 3;1;5000;0;5000;4750;250;
2021-09-07 15:46:14;ARG;ARGUS 220ML;3;14500;0;43500;39900;3600;
2021-09-07 16:25:34;ICE CREAM 5;ICE CREAM 5000;1;5000;0;5000;4400;600;
2021-09-07 16:29:38;8997009510055;YOU C1000;1;15000;0;15000;13000;2000;
2021-09-07 16:31:40;8997009510055;YOU C1000;3;15000;0;45000;39000;6000;
2021-09-07 16:48:21;8999988778846;LASEGAR;1;6500;0;6500;5700;800;
2021-09-07 16:59:42;8992628020152;BIMOLI POUCH 2L;1;31000;0;31000;29800;1200;
2021-09-07 16:59:42;8995333000822;TERIGU KOMPAS SOFT 500GR;3;5500;0;16500;14901;1599;
2021-09-07 16:59:42;8992775312469;GERY SALUT COKELAT;1;11000;0;11000;9983;1017;
2021-09-07 17:00:49;8999999001124;LIFEBUOY MILD CARE REF 250ML;1;15000;0;15000;13550;1450;
2021-09-07 17:02:16;8992959953136;SWEETY BRONZE L20;1;40000;0;40000;36770;3230;
2021-09-07 17:02:16;8993007003063;ENAAK 500G;1;11000;0;11000;9625;1375;
2021-09-07 17:19:55;8999909002821;MARLBORO BLACK 16;1;22000;0;22000;20850;1150;
2021-09-07 17:23:57;8999909096004;SAMPOERNA 16 FILTER;1;25000;0;25000;23100;1900;
2021-09-07 17:27:22;8993989311699;CLAS MILD 16 FILTER;1;24000;0;24000;21700;2300;
2021-09-07 17:28:59;8998989300261;GUDANG GARAM SURYA 12 FILTER;1;20000;0;20000;18150;1850;
2021-09-07 17:30:50;8999909010567;234 DJI SAM SOE 16;1;22500;0;22500;21500;1000;
2021-09-07 17:39:30;8998866603676;FRES&NATURAL SOAP GREEN 65G;1;1800;0;1800;1425;375;
2021-09-07 17:39:30;8998866604512;FRES&NATURAL SOAP VIOLET 65G;1;1800;0;1800;1425;375;
2021-09-07 17:39:30;089686535242;SUN PISANG SUSU;1;8500;0;8500;7410;1090;
2021-09-07 17:39:30;6907992823874;JD CRUNCHY CHOCO BLUEBERRY;1;5500;0;5500;4700;800;
2021-09-07 17:41:38;Garuda pilus;Garuda Pilus Pedas Pcs;1;500;0;500;408;92;
2021-09-07 17:44:07;8999801700054;SUSU FOYU 1 KG;1;22000;0;22000;19791;2209;
2021-09-07 17:51:19;8996001600146;TEH PUCUK HARUM 350ML;1;3000;0;3000;2314;686;
2021-09-07 17:52:30;RT 1000;ROTI 1000;1;1000;0;1000;800;200;
2021-09-07 21:09:01;8996001305119;ARDEN 30G;1;2000;0;2000;1650;350;
2021-09-07 21:09:01;8997012030748;MADU ENAK;1;1000;0;1000;900;100;
2021-09-07 21:17:11;KIKO;KIKO;1;1000;0;1000;500;500;
2021-09-07 21:17:11;8996001600146;TEH PUCUK HARUM 350ML;2;3000;0;6000;4628;1372;
2021-09-07 21:17:11;YP;YUPI;2;250;0;500;416;84;
2021-09-07 21:17:11;GL;GULA 1 LITER;4;11500;0;46000;42000;4000;
2021-09-07 21:17:11;8996001318980;BETTER 120G;1;6000;0;6000;5100;900;
2021-09-07 21:17:11;8996001305119;ARDEN 30G;1;2000;0;2000;1650;350;
2021-09-07 21:17:11;123124;KOREK BIASA;1;2000;0;2000;1300;700;
2021-09-07 21:17:11;0105312686040047;yakult;1;2000;0;2000;1500;500;
2021-09-07 22:18:04;8998866501033;MINYAK GORENG SEDAAP POUCH 2L;1;32000;0;32000;31414;586;
2021-09-07 22:19:22;8993379152017;SABUN CUCI SURYA 200G;1;3000;0;3000;2281;719;
2021-09-07 22:24:19;8992775001806 pcs;Gery salut malkist chocolate coconut pcs;1;1000;0;1000;812;188;
2021-09-07 22:26:50;8993989311699;CLAS MILD 16 FILTER;1;24000;0;24000;21700;2300;
2021-09-07 22:32:32;8998989300261;GUDANG GARAM SURYA 12 FILTER;1;20000;0;20000;18150;1850;
2021-09-07 22:37:59;kri;kripik pisang;1;5000;0;5000;4000;1000;
2021-09-07 22:42:40;kentang;kripik kentang;4;1000;0;4000;3600;400;
2021-09-07 22:43:18;8996001600146;TEH PUCUK HARUM 350ML;1;3000;0;3000;2314;686;
2021-09-07 22:44:15;Gula gula kaki;gula gula kaki;4;500;0;2000;1600;400;
2021-09-07 22:45:14;TORT;TORTILA;1;1000;0;1000;1000;0;
2021-09-07 22:47:06;8992775001806 pcs;Gery salut malkist chocolate coconut pcs;1;1000;0;1000;812;188;
2021-09-07 22:48:22;8998866201452;POTABEE REGULER BBQ BEEF 35GR;1;5000;0;5000;4150;850;
2021-09-07 22:49:24;ROTI;ROTI 2000;7;2000;0;14000;12600;1400;
2021-09-07 22:53:27;8997027300089;NOMOS;1;4000;0;4000;2963;1037;
2021-09-07 23:09:43;8993072254018;MELROSE COTTON BUDS BSR;1;5000;0;5000;4050;950;
2021-09-07 23:38:25;8993379152017;SABUN CUCI SURYA 200G;1;3000;0;3000;2281;719;
2021-09-07 23:41:11;8992931006256;tessa;2;1000;0;2000;1800;200;
2021-09-08 00:01:04;8992761166205;FRESTEA GREEN HONEY 350ML;1;4500;0;4500;3000;1500;
2021-09-08 00:01:04;8991102320184;TANGO CHOCO JAVAMOCCA;1;5000;0;5000;4330;670;
2021-09-08 00:01:04;089686043273;INDOMIE SAMBAL RICA;1;2700;0;2700;2452;248;
2021-09-08 00:01:04;8992775913000;CHOCOLATOS CKLT 28G;10;2000;0;20000;15570;4430;
2021-09-08 00:01:04;ROTI;ROTI 2000;1;2000;0;2000;1800;200;
2021-09-08 09:13:13;8997003910684;2CS;4;3000;0;12000;6000;6000;
2021-09-08 09:13:13;8992761164539;NUTRIBOOST ORANGE 300ML;1;6500;0;6500;5300;1200;
2021-09-08 09:14:06;8995555171225;KIMBO SOSIS;1;1000;0;1000;900;100;
2021-09-08 09:15:19;6907992823829;JD MILKY MILK;1;3000;0;3000;2600;400;
2021-09-08 09:15:35;8992775311509;gery garuda;1;1000;0;1000;700;300;
2021-09-08 09:16:03;8992696523081;MILO UHT 110ML;1;2500;0;2500;1962;538;
2021-09-08 09:16:39;8992775001998 pcs;Gery Salut sandiwich pcs;1;1000;0;1000;815;185;
2021-09-08 09:16:56;089686535044;SUN BERAS MERAH;1;8500;0;8500;7410;1090;
2021-09-08 09:17:14;8992628020152;BIMOLI POUCH 2L;1;31000;0;31000;29800;1200;
2021-09-08 09:17:58;PRG;PARAGO;2;500;0;1000;800;200;
2021-09-08 09:30:08;8992761139018;ADES 600ML;1;3500;0;3500;2166;1334;
2021-09-08 09:30:08;ROTI;ROTI 2000;1;2000;0;2000;1800;200;
2021-09-08 09:31:22;ROTI;ROTI 2000;2;2000;0;4000;3600;400;
2021-09-08 09:46:51;8992761166038;MMP ORANGE 300ML;1;5000;0;5000;3750;1250;
2021-09-08 09:46:51;8997028590045;ARGUS 330ML;2;2000;0;4000;2582;1418;
2021-09-08 09:47:46;ROTI;ROTI 2000;2;2000;0;4000;3600;400;
2021-09-08 09:50:40;8886013213208;FRENCH FREIS 2000;2;5000;0;10000;7500;2500;
2021-09-08 09:50:40;089686611878;QTELA TEMPE;1;6000;0;6000;5370;630;
2021-09-08 09:51:58;8998898101409;TOLAK ANGIN SIDOMUNCUL;2;3500;0;7000;5416;1584;
2021-09-08 09:51:58;8997028590052;ARGUS 600ML;2;3000;0;6000;2916;3084;
2021-09-08 09:51:58;8997025914059;HATARI SEE HONG;1;6000;0;6000;4911;1089;
2021-09-08 09:52:21;8992724892844;Coklat mede;7;1000;0;7000;5600;1400;
2021-09-08 09:53:34;8997025914059;HATARI SEE HONG;1;6000;0;6000;4911;1089;
2021-09-08 09:54:31;8997028590052;ARGUS 600ML;2;3000;0;6000;2916;3084;
2021-09-08 09:59:29;8998866202664;POTABEE WAGYU BEEF STEAK 68 GR;1;8000;0;8000;7200;800;
2021-09-08 10:14:58;8998866608718;DAIA SOFTENER PINK;1;5000;0;5000;4450;550;
2021-09-08 10:28:41;8997003910684;2CS;1;3000;0;3000;1500;1500;
2021-09-08 10:44:08;ROTI;ROTI 2000;1;2000;0;2000;1800;200;
2021-09-08 10:53:52;PULPEN SNOWMAN;PULPEN SNOWMAN;2;2500;0;5000;4000;1000;
2021-09-08 10:55:09;PULPEN SNOWMAN;PULPEN SNOWMAN;2;2500;0;5000;4000;1000;
2021-09-08 10:56:12;PULPEN SNOWMAN;PULPEN SNOWMAN;1;2500;0;2500;2000;500;
2021-09-08 11:01:55;PULPEN SNOWMAN;PULPEN SNOWMAN;1;2500;0;2500;2000;500;
2021-09-08 11:02:15;8992696521629;DNCO COKLT UHT 180ML;1;5000;0;5000;3533;1467;
2021-09-08 11:02:29;ARG;ARGUS 220ML;1;14500;0;14500;13300;1200;
2021-09-08 11:05:02;PULPEN SNOWMAN;PULPEN SNOWMAN;1;2500;0;2500;2000;500;
2021-09-08 11:11:56;8992761166038;MMP ORANGE 300ML;1;5000;0;5000;3750;1250;
2021-09-08 11:11:56;0105312686040047;yakult;1;2000;0;2000;1500;500;
2021-09-08 11:18:48;8994935000285;MINYAK GORENG DUNIA 4500ML;1;70000;0;70000;66433;3567;
2021-09-08 11:18:48;8995333060703;TERIGU KOMPAS 1KG;1;10500;0;10500;9816;684;
2021-09-08 11:18:48;ROTI;ROTI 2000;1;2000;0;2000;1800;200;
2021-09-08 11:18:48;8997009510055;YOU C1000;1;15000;0;15000;13000;2000;
2021-09-08 11:19:37;8998989300261;GUDANG GARAM SURYA 12 FILTER;1;20000;0;20000;18150;1850;
2021-09-08 11:25:45;ROTI;ROTI 2000;1;2000;0;2000;1800;200;
2021-09-08 11:28:34;8991102320184;TANGO CHOCO JAVAMOCCA;1;5000;0;5000;4330;670;
2021-09-08 11:40:10;8997003910684;2CS;6;3000;0;18000;9000;9000;
2021-09-08 11:46:36;8999999050009;SUNLIGHT LIME NEW POUCH 95ML;1;2000;0;2000;1600;400;
2021-09-08 11:46:36;8999999057640;MOLTO EDP BLK PURPLE 20ML;1;1000;0;1000;800;200;
2021-09-08 11:46:36;8999999042592;RINSO MOLTO PERFUME ESSENSE LIQ 4OML;1;1000;0;1000;802;198;
2021-09-08 11:46:36;8999999534752;PEPSODENT ACTION123 CHARCOAL 65G;1;7400;0;7400;6710;690;
2021-09-08 11:46:36;8996001600399;LE MINERAL 1500ML;1;5000;0;5000;4042;958;
2021-09-08 11:53:51;8992761164539;NUTRIBOOST ORANGE 300ML;1;6500;0;6500;5300;1200;
2021-09-08 11:59:00;8996001600641;TORA CAPPUCINO;1;3500;0;3500;2750;750;
2021-09-08 12:22:08;8997028590052;ARGUS 600ML;1;3000;0;3000;1458;1542;
2021-09-08 12:22:08;711844120419;SAMBAL ABC 275 ML;1;12000;0;12000;10800;1200;
2021-09-08 12:23:37;8998866201469;POTABEE REGULER BBQ BEEF 68 GR;1;8000;0;8000;7200;800;
2021-09-08 12:23:37;8991102300421;WFR TANGO COKLAT 176GR;1;10000;0;10000;8694;1306;
2021-09-08 12:23:37;8886013257400;TWISTKO;4;1000;0;4000;3600;400;
2021-09-08 12:24:01;TBR;TEPUNG BERAS ROSE BRAND;1;8000;0;8000;5800;2200;
2021-09-08 12:24:21;8991102281430;PERMEN MINTZ DUOMINT;2;5000;0;10000;8000;2000;
2021-09-08 12:54:19;ROTI;ROTI 2000;2;2000;0;4000;3600;400;
2021-09-08 12:56:44;8993470411433;JOGER CLASSIC;2;1000;0;2000;1700;300;
2021-09-08 13:15:35;ARG;ARGUS 220ML;2;14500;0;29000;26600;2400;
2021-09-08 13:17:33;8995333060703;TERIGU KOMPAS 1KG;2;10500;0;21000;19632;1368;
2021-09-08 13:25:15;089686010107;INDOMIE KALDU AYAM;2;2500;0;5000;4300;700;
2021-09-08 13:31:06;8999909002821;MARLBORO BLACK 16;1;22000;0;22000;20850;1150;
2021-09-08 14:20:24;089686021141;INTER MIE SOTO;1;1000;0;1000;854;146;
2021-09-08 14:59:59;8992761166212;FRESTEA APPLE 350ML;5;4500;0;22500;15000;7500;
2021-09-08 15:01:22;8992775002933;GERY MALKIST DOUBLE ABON;1;6500;0;6500;5516;984;
2021-09-08 15:01:56;RT 1000;ROTI 1000;6;1000;0;6000;4800;1200;
2021-09-08 15:02:40;8999909002821;MARLBORO BLACK 16;1;22000;0;22000;20850;1150;
2021-09-08 16:46:54;8991002105409;KOPI KAPAL API;1;20000;0;20000;18888;1112;
2021-09-08 16:47:48;089686044249;SUPERMI NUTRIMI STEAK AYAM;2;3500;0;7000;5600;1400;
2021-09-08 16:49:26;089686021141;INTER MIE SOTO;5;1000;0;5000;4270;730;
2021-09-08 16:50:38;8998866202664;POTABEE WAGYU BEEF STEAK 68 GR;1;8000;0;8000;7200;800;
2021-09-08 16:52:31;8998866202060;POTABEE AYAM BAKAR PEDAS 35 GR;1;5000;0;5000;4150;850;
2021-09-08 16:53:11;8999999024475;CITRA BW PEARLY WHITE LD 400ML;1;21000;0;21000;19000;2000;
2021-09-08 16:53:37;8997028590052;ARGUS 600ML;1;3000;0;3000;1458;1542;
2021-09-08 16:54:10;8999909003873;MARLBORO 12;1;17000;0;17000;15750;1250;
2021-09-08 16:54:35;KIKO;KIKO;5;1000;0;5000;2500;2500;
2021-09-08 17:01:10;6907992823942;JD JUJUBE;1;4500;0;4500;3800;700;
2021-09-08 17:02:37;6907992825069;JD FRUITY;1;5000;0;5000;4400;600;
2021-09-08 17:03:08;JD VM;JD VANILLA MILKSHAKE;1;5000;0;5000;4300;700;
2021-09-08 17:03:32;8997028590045;ARGUS 330ML;1;2000;0;2000;1291;709;
2021-09-08 17:03:50;8991909101016;URBAN MILD 16;1;17000;0;17000;15800;1200;
2021-09-08 17:04:10;8994867007161;ROKOK PENA GOLD 20;1;18000;0;18000;16800;1200;
2021-09-08 17:04:33;ARG;ARGUS 220ML;4;14500;0;58000;53200;4800;
2021-09-08 17:04:52;ARG 330;ARGUS 330ML;1;35000;0;35000;31000;4000;
2021-09-08 17:05:11;0105312686040047;yakult;2;2000;0;4000;3000;1000;
2021-09-08 17:05:23;8992628510158;SIMAS PALMIA;1;6000;0;6000;4832;1168;
2021-09-08 17:05:33;0105312686040047;yakult;1;2000;0;2000;1500;500;
2021-09-08 17:05:49;8998989110167;SURYA GUDANG GARAM 16 FILTER;1;26000;0;26000;23700;2300;
2021-09-08 17:06:06;8992761164539;NUTRIBOOST ORANGE 300ML;1;6500;0;6500;5300;1200;
2021-09-08 17:07:58;8991111101415;JB POWDER 100G;1;7000;0;7000;6000;1000;
2021-09-08 17:09:51;8997028590014;ARGUS 220ML;2;500;0;1000;604;396;
2021-09-08 17:10:20;TG;TEH GELAS;3;1000;0;3000;2187;813;
2021-09-08 17:11:08;KOPIKO;KOPIKO;12;250;0;3000;2100;900;
2021-09-08 17:51:46;8992696523067;MILO ACTVGO UHT 180ML;1;4500;0;4500;3515;985;
2021-09-08 18:10:51;8993989311699;CLAS MILD 16 FILTER;2;24000;0;48000;43400;4600;
2021-09-08 18:17:32;TELUR;TELUR;1;1800;0;1800;1200;600;
2021-09-08 18:23:10;8998989300261;GUDANG GARAM SURYA 12 FILTER;1;20000;0;20000;18150;1850;
2021-09-08 19:53:49;089686043051;INDOMIE COTO MAKASSAR;1;2800;0;2800;2525;275;
2021-09-08 19:54:29;ARG;ARGUS 220ML;1;14500;0;14500;13300;1200;
2021-09-08 19:55:18;ARG 330;ARGUS 330ML;1;35000;0;35000;31000;4000;
2021-09-08 19:55:50;8998989300261;GUDANG GARAM SURYA 12 FILTER;1;20000;0;20000;18150;1850;
2021-09-08 19:58:54;Gula gula tusuk;gula gula tusuk;6;500;0;3000;2400;600;
2021-09-08 20:03:30;6907992823645;JD COCONUT BLISS;1;4000;0;4000;3500;500;
2021-09-08 20:10:09;8996001305041;ROMA SANDWICH CKLT;2;7000;0;14000;11856;2144;
2021-09-08 20:10:09;8995333060703;TERIGU KOMPAS 1KG;1;10500;0;10500;9816;684;
2021-09-08 20:10:09;089686043051;INDOMIE COTO MAKASSAR;4;2800;0;11200;10100;1100;
2021-09-08 20:10:09;8992628022156;BIMOLI KLASIK TOUCH 1 LT;1;16000;0;16000;14350;1650;
2021-09-08 20:10:09;8992979190986;TOTAL PUTIH SOFTENER;1;13000;0;13000;11532;1468;
2021-09-08 20:10:09;8992979130012;TOTAL LEMON SOFTENER;1;13000;0;13000;11532;1468;
2021-09-08 20:10:09;8998866671736;CREAM EKONOMI 455G;1;5500;0;5500;4750;750;
2021-09-08 20:10:09;8999999707859;CLOSEUP GREEN 160G;1;15000;0;15000;13600;1400;
2021-09-08 20:10:09;8999999548698;LUXTS VALVET JASMINE 4X60G;1;8500;0;8500;7650;850;
2021-09-08 20:10:09;8992761111519;COCA COLA SLIM CAM 250ML;1;5000;0;5000;3750;1250;
2021-09-08 20:10:54;8999999059903;PONDS AGE MIRACLE DAY CREAM 10G;1;28500;0;28500;25850;2650;
2021-09-08 20:13:00;8996001318980;BETTER 120G;1;6000;0;6000;5100;900;
2021-09-08 20:13:00;8995555121244;SOSIS KIMBO;1;1000;0;1000;650;350;
2021-09-08 20:41:11;8997018250218;JAHE MERAH;9;1000;0;9000;7497;1503;
2021-09-08 20:41:11;9311931024036;COFFEEMIX SCT;1;1500;0;1500;1200;300;
2021-09-08 20:41:11;8996001440001;TB JAHE SUSU;5;1500;0;7500;4350;3150;
2021-09-08 20:41:11;8998666001306;TB CREAMY LATTE;8;1500;0;12000;7920;4080;
2021-09-08 20:45:16;089686021141;INTER MIE SOTO;1;1000;0;1000;854;146;
2021-09-08 20:45:16;089686021219;INTER MIE GORENG;1;1000;0;1000;885;115;
2021-09-08 20:45:16;Vita Jelly;Vita Jelly;1;1000;0;1000;766;234;
2021-09-08 20:52:33;TELUR;TELUR;3;1800;0;5400;3600;1800;
2021-09-08 20:53:10;kentang;kripik kentang;5;1000;0;5000;4500;500;
2021-09-08 21:00:54;TS;TISSUE TESSY;1;5000;0;5000;4200;800;
2021-09-08 21:02:22;8997028590045;ARGUS 330ML;1;2000;0;2000;1291;709;
2021-09-08 21:02:22;8999909010567;234 DJI SAM SOE 16;1;22500;0;22500;21500;1000;
2021-09-08 21:12:32;8992696521797;MILO 22G;2;2500;0;5000;3144;1856;
2021-09-08 22:21:33;8998866202237;NOODLE SEDAAP TASTY AYAM GEPREK 124 GR;1;5000;0;5000;4167;833;
2021-09-08 22:52:05;8991102213189;BLASTER UNGU;1;5000;0;5000;3106;1894;
2021-09-08 22:52:05;8991102281430;PERMEN MINTZ DUOMINT;1;5000;0;5000;4000;1000;
2021-09-08 22:56:05;kentang;kripik kentang;5;1000;0;5000;4500;500;
2021-09-08 23:00:42;Gula gula kaki;gula gula kaki;4;500;0;2000;1600;400;
2021-09-08 23:11:39;gg;gula-gula koin;2;500;0;1000;800;200;
2021-09-08 23:15:41;gula gula;gula-gula karet;2;500;0;1000;800;200;
2021-09-08 23:17:01;gula gula;gula-gula karet;2;500;0;1000;800;200;
2021-09-08 23:17:25;jagung marning;jagung marning;1;5000;0;5000;4500;500;
2021-09-08 23:17:55;gg;gula-gula koin;2;500;0;1000;800;200;
2021-09-08 23:19:39;TORT;TORTILA;1;1000;0;1000;1000;0;
2021-09-08 23:20:16;8996001301562;MALKIST TABUR KELAPA;1;1000;0;1000;820;180;
2021-09-08 23:21:29;8996001305119;ARDEN 30G;1;2000;0;2000;1650;350;
2021-09-08 23:22:19;8996001305119;ARDEN 30G;2;2000;0;4000;3300;700;
2021-09-08 23:25:21;8991001121400;SILVERQUEEN ALMOND 65G;1;15000;0;15000;13200;1800;
2021-09-08 23:25:54;8993470672858;SAKU-SAKU RASA BALADO;1;2000;0;2000;1530;470;
2021-09-08 23:28:00;8996001355978;BENG-BENG SHARE IT 9.5G;1;10000;0;10000;8700;1300;
2021-09-08 23:29:01;8991111112114;C&C ACNE CLEARING CLEANSER 100G;1;21500;0;21500;19900;1600;
2021-09-08 23:31:13;8997013790108;BIMURA KACANG TELUR 25G;3;1000;0;3000;2625;375;
2021-09-08 23:36:48;8998866202343;MIE SEDAAP KOREAN SPICY;2;2700;0;5400;4826;574;
2021-09-08 23:37:17;Telur 7 Biji;Telur 7 Biji;1;10000;0;10000;8400;1600;
2021-09-08 23:39:19;8992628020152;BIMOLI POUCH 2L;1;31000;0;31000;29800;1200;
2021-09-08 23:42:24;8999909096004;SAMPOERNA 16 FILTER;1;25000;0;25000;23100;1900;
2021-09-08 23:42:46;8997028590052;ARGUS 600ML;2;3000;0;6000;2916;3084;
2021-09-08 23:49:10;8999999037765;pepsodent 225 gr;1;12000;0;12000;10500;1500;
2021-09-08 23:49:10;8999999531515;MOLTO WHITE MUSK SC 10ML;1;5500;0;5500;4800;700;
2021-09-08 23:49:10;8998866610278;DAIA VIOLET GUSSET 565G;1;10000;0;10000;8700;1300;
2021-09-08 23:52:36;8999999192198;Royco;1;5000;0;5000;4000;1000;
2021-09-09 00:00:15;MRC;MERICA LADA;1;1000;0;1000;889;111;
2021-09-09 09:12:05;8991002307209;COFFE CANDY;2;6000;0;12000;10000;2000;
2021-09-09 09:25:41;8998866605144;CLING KUNING POUCH 425ML;1;4000;0;4000;3250;750;
2021-09-09 09:26:47;8992959971109;SFX COMFORT SLIM 36CM 12+1;1;17000;0;17000;15152;1848;
2021-09-09 09:27:08;8992696523081;MILO UHT 110ML;1;2500;0;2500;1962;538;
2021-09-09 09:28:31;8999999042639;RINSO ANTI NODA CLS LIQ 40ML;2;1000;0;2000;1610;390;
2021-09-09 09:29:13;8996001301562;MALKIST TABUR KELAPA;2;1000;0;2000;1640;360;
2021-09-09 09:30:01;8999999531508;MOLTO HYGIENE SC 10ML;4;500;0;2000;1920;80;
2021-09-09 09:30:21;8997025914059;HATARI SEE HONG;1;6000;0;6000;4911;1089;
2021-09-09 09:30:41;8996001305041;ROMA SANDWICH CKLT;1;7000;0;7000;5928;1072;
2021-09-09 10:45:39;8998866202244;EKOMIE BUMBU KALDU AYAM;5;1000;0;5000;3990;1010;
2021-09-09 10:58:41;8997013180046;Tissu Tessi B;1;11000;0;11000;9800;1200;
2021-09-09 10:59:15;8998989500166;GUDANG GARAM MERAH BESAR 16KS;1;18000;0;18000;17000;1000;
2021-09-09 11:30:16;8992959117583;SFX DS REG FLOW WING 20;1;5000;0;5000;4288;712;
2021-09-09 11:30:16;8996001375372;CHOKI CHOKI;1;1000;0;1000;910;90;
2021-09-09 11:40:30;8994867007161;ROKOK PENA GOLD 20;1;18000;0;18000;16800;1200;
2021-09-09 11:40:42;8998989110167;SURYA GUDANG GARAM 16 FILTER;1;26000;0;26000;23700;2300;
2021-09-09 11:47:07;089686611670;QTELA BALADO;1;5000;0;5000;4266;734;
2021-09-09 11:47:26;8992775110140;GARUDA KACANG KULIT 160G;1;12000;0;12000;10012;1988;
2021-09-09 12:16:15;089686067002;POP MIE PDS DOWER RS AYAM;2;5000;0;10000;8900;1100;
2021-09-09 12:16:15;089686060126;POP MIE BASO JUMBO;1;4500;0;4500;3833;667;
2021-09-09 12:16:15;8998866200844;NOODLE SEDAAP MIE KARI SPESIAL CUP 81 GR;1;4500;0;4500;3650;850;
2021-09-09 12:23:53;roti;roti 2000;1;2000;0;2000;1800;200;
2021-09-09 12:37:46;8992959107515;SFX NON WING 23CM 8;1;4000;0;4000;3288;712;
2021-09-09 12:37:46;8997013180053;Tissu Tessy;1;5000;0;5000;4000;1000;
2021-09-09 12:37:46;8999999192150;ROYCO FDS CHICKEN 100GR;1;5000;0;5000;4300;700;
2021-09-09 12:37:46;8997021110028;Garam;1;2500;0;2500;1500;1000;
2021-09-09 12:37:46;8993379254469;SABUN LERVIA 90G;1;5000;0;5000;3077;1923;
2021-09-09 12:37:46;6907992823829;JD MILKY MILK;1;3000;0;3000;2600;400;
2021-09-09 12:37:46;089686048704;SARIMIE GORENG AYAM KCP ISI 2;1;3500;0;3500;3120;380;
2021-09-09 12:37:46;8992775001998 pcs;Gery Salut sandiwich pcs;2;1000;0;2000;1630;370;
2021-09-09 13:05:34;8992696523081;MILO UHT 110ML;1;2500;0;2500;1962;538;
2021-09-09 13:06:15;8992696523081;MILO UHT 110ML;1;2500;0;2500;1962;538;
2021-09-09 13:08:21;TUSTEL;TUSUK TELINGA;1;1000;0;1000;833;167;
2021-09-09 13:12:07;8993989311699;CLAS MILD 16 FILTER;1;24000;0;24000;21700;2300;
2021-09-09 13:13:26;8993989311699;CLAS MILD 16 FILTER;2;24000;0;48000;43400;4600;
2021-09-09 13:43:01;Telur 3 Biji;Telur 3 Biji;1;5000;0;5000;3600;1400;
2021-09-09 15:43:00;8998989500166;GUDANG GARAM MERAH BESAR 16KS;1;18000;0;18000;17000;1000;
2021-09-09 15:43:00;8999909002821;MARLBORO BLACK 16;1;22000;0;22000;20850;1150;
2021-09-09 16:28:23;8996001600146;TEH PUCUK HARUM 350ML;1;3000;0;3000;2314;686;
2021-09-09 16:28:23;8992775311509;gery garuda;2;1000;0;2000;1400;600;
2021-09-09 16:50:21;8991102213189;BLASTER UNGU;1;5000;0;5000;3106;1894;
2021-09-09 16:50:21;8993989311699;CLAS MILD 16 FILTER;1;24000;0;24000;21700;2300;
2021-09-09 16:50:21;roti;roti 2000;4;2000;0;8000;7200;800;
2021-09-09 17:19:43;GL;GULA 1 LITER;1;11500;0;11500;10500;1000;
2021-09-09 17:20:31;JL;JELLY;2;500;0;1000;800;200;
2021-09-09 17:20:57;Gula gula tusuk;gula gula tusuk;2;500;0;1000;800;200;
2021-09-09 17:21:27;8999999059781;SUNLIGHT LIME NEW POUCH 210ML;1;5000;0;5000;4300;700;
2021-09-09 17:23:33;8997012030748;MADU ENAK;2;1000;0;2000;1800;200;
2021-09-09 18:14:51;8996001305119;ARDEN 30G;1;2000;0;2000;1650;350;
2021-09-09 18:23:01;8998866200301;MIE SEDAAP GORENG;1;2700;0;2700;2413;287;
2021-09-09 19:22:03;6907992823843;JD MOCHA CRISPY;1;5000;0;5000;4400;600;
2021-09-09 19:22:47;ARG;ARGUS 220ML;1;14500;0;14500;13300;1200;
2021-09-09 19:23:24;TBR;TEPUNG BERAS ROSE BRAND;1;8000;0;8000;5800;2200;
2021-09-09 19:24:16;YP;YUPI;6;250;0;1500;1248;252;
2021-09-09 19:24:37;8998009010231;ULTRA CHO 250;1;6000;0;6000;4784;1216;
2021-09-09 19:25:05;089686067002;POP MIE PDS DOWER RS AYAM;1;5000;0;5000;4450;550;
2021-09-09 19:30:24;8994834006128;TICTIC PEDAS;3;2000;0;6000;5100;900;
2021-09-09 19:30:24;8997028590045;ARGUS 330ML;2;2000;0;4000;2582;1418;
2021-09-09 19:46:05;gula gula;gula-gula karet;8;500;0;4000;3200;800;
2021-09-09 19:50:38;896867700494;AIR CLUB 1500ML;1;5000;0;5000;2987;2013;
2021-09-09 19:50:38;8998866202770;MIE SEDAAP SALERO PADANG;1;2500;0;2500;2362;138;
2021-09-09 19:50:38;089686043617;INDOMIE MIEGHETTI;1;2700;0;2700;2452;248;
2021-09-09 19:50:38;089686043051;INDOMIE COTO MAKASSAR;1;2800;0;2800;2525;275;
2021-09-09 19:50:38;8999999526894;RINSO ROYAL GOLD 40ML;2;1000;0;2000;1610;390;
2021-09-09 19:50:38;8992775211434;PILUS GARUDA SAPI PANGGANG;1;5000;0;5000;4810;190;
2021-09-09 19:50:38;Gula gula tusuk;gula gula tusuk;1;500;0;500;400;100;
2021-09-09 19:50:38;Gula gula kaki;gula gula kaki;1;500;0;500;400;100;
2021-09-09 19:53:44;roti;roti 2000;3;2000;0;6000;5400;600;
2021-09-09 19:54:02;8992775310212;GERY PASTA COKELAT;1;18000;0;18000;16029;1971;
2021-09-09 19:56:13;8999909002876;SAMPOERNA ULTRAMILD 12;1;17000;0;17000;14600;2400;
2021-09-09 20:00:37;089686021219;INTER MIE GORENG;5;1000;0;5000;4425;575;
2021-09-09 20:00:37;8999999059309;LIFEBUOY TS TOTAL 10 DG 75G;1;3000;0;3000;2640;360;
2021-09-09 20:00:37;8998898830125;KKB ENER-G ANGGUR;1;5500;0;5500;4824;676;
2021-09-09 20:00:37;8999909010567;234 DJI SAM SOE 16;1;22500;0;22500;21500;1000;
2021-09-09 20:44:05;8992775001806 pcs;Gery salut malkist chocolate coconut pcs;3;1000;0;3000;2436;564;
2021-09-09 20:44:57;8992775305188 pcs;Gery Salut Grentea pcs;1;1000;0;1000;812;188;
2021-09-09 20:45:47;kentang;kripik kentang;3;1000;0;3000;2700;300;
2021-09-09 20:46:19;jagung marning;jagung marning;1;5000;0;5000;4500;500;
2021-09-09 20:49:06;8998866605137;CLING BIRU POUCH 425ML;1;4000;0;4000;3250;750;
2021-09-09 20:49:45;Gula gula tusuk;gula gula tusuk;2;500;0;1000;800;200;
2021-09-09 20:53:03;roti;roti 2000;3;2000;0;6000;5400;600;
2021-09-09 20:53:59;8992761111540;FANTA STRAWBERY SLIM CAM 250ML;1;5000;0;5000;3750;1250;
2021-09-09 20:54:56;8992696521797;MILO 22G;1;2500;0;2500;1572;928;
2021-09-09 20:56:24;8992724892844;Coklat mede;1;1000;0;1000;800;200;
2021-09-09 20:57:11;8992775305188 pcs;Gery Salut Grentea pcs;1;1000;0;1000;812;188;
2021-09-09 21:02:41;8996001305119;ARDEN 30G;1;2000;0;2000;1650;350;
2021-09-09 21:02:41;8991102380805;FULLO  CKL PCK 8G;1;10000;0;10000;9000;1000;
2021-09-09 21:02:41;711844610095;LARISSA UDANG 500 GR;1;11000;0;11000;9790;1210;
2021-09-09 21:02:41;8991102987875;WFR TANGO POUCH CKL 115G;1;8000;0;8000;6786;1214;
2021-09-09 21:02:41;089686021219;INTER MIE GORENG;5;1000;0;5000;4425;575;
2021-09-09 21:07:23;8994834006128;TICTIC PEDAS;1;2000;0;2000;1700;300;
2021-09-09 21:07:23;8999999001117;Lifebuoy;1;15000;0;15000;14000;1000;
2021-09-09 21:07:23;8992761145033;FANTA STRAW PET 250ML;1;3500;0;3500;2417;1083;
2021-09-09 21:10:50;8995899210185;Mi Boncabe;2;3500;0;7000;6000;1000;
2021-09-09 21:14:03;8993093115008;tepun beras;1;8000;0;8000;7000;1000;
2021-09-09 21:16:09;8998866201377;KRISBEE FRIES KENTANG GORENG 68 GR;1;5500;0;5500;4620;880;
2021-09-09 21:16:09;8992959117583;SFX DS REG FLOW WING 20;4;5000;0;20000;17152;2848;
2021-09-09 21:17:18;kentang;kripik kentang;1;1000;0;1000;900;100;
2021-09-09 21:18:21;8992628020152;BIMOLI POUCH 2L;1;31000;0;31000;29800;1200;
2021-09-09 21:18:45;ARG;ARGUS 220ML;1;14500;0;14500;13300;1200;
2021-09-09 21:19:49;KIKO;KIKO;1;1000;0;1000;500;500;
2021-09-09 21:21:37;8992761111533;SPRITE SLIM CAM250ML;1;5000;0;5000;3750;1250;
2021-09-09 21:22:28;8999999007768;FAIR&LOVELY MULTIVITAMIN  CREAM 9 ML;1;4500;0;4500;3200;1300;
2021-09-09 21:24:28;8999999549480;SUNLIGHT LIME CRM SCH 270G;1;5000;0;5000;4500;500;
2021-09-09 21:27:59;8992959953037;SWEETY BRONZE L1;2;2500;0;5000;3638;1362;
2021-09-09 21:36:15;8997878004327;gula-gula milkita;4;250;0;1000;800;200;
2021-09-09 21:37:01;8997878004327;gula-gula milkita;4;250;0;1000;800;200;
2021-09-09 21:41:34;kentang;kripik kentang;2;1000;0;2000;1800;200;
2021-09-09 21:43:20;8997009510055;YOU C1000;1;15000;0;15000;13000;2000;
2021-09-09 21:44:19;8997009510055;YOU C1000;1;15000;0;15000;13000;2000;
2021-09-09 21:45:50;8997211400038;SANTAN COCONUT CREAM;1;4000;0;4000;3000;1000;
2021-09-09 21:46:53;8992959953037;SWEETY BRONZE L1;2;2500;0;5000;3638;1362;
2021-09-09 21:54:34;8998866601429;POWDET DAIA BUNGA BAG 290GR;2;5000;0;10000;8900;1100;
2021-09-09 21:55:34;MARS;MARSHMELLOW;8;500;0;4000;3464;536;
2021-09-09 21:56:41;Vita Jelly;Vita Jelly;2;1000;0;2000;1532;468;
2021-09-09 21:57:46;8998866201889;KRISBEE PILLOW STRAWBERRY ICE CREAM 120GR;1;8000;0;8000;7250;750;
2021-09-09 21:58:15;Telur 7 Biji;Telur 7 Biji;1;10000;0;10000;8400;1600;
2021-09-09 21:58:49;8997009510055;YOU C1000;1;15000;0;15000;13000;2000;
2021-09-09 21:59:34;kri;kripik pisang;1;5000;0;5000;4000;1000;
2021-09-09 22:00:33;kri;kripik pisang;1;5000;0;5000;4000;1000;
2021-09-09 22:01:36;8998866201889;KRISBEE PILLOW STRAWBERRY ICE CREAM 120GR;1;8000;0;8000;7250;750;
2021-09-09 22:02:50;8997231980039;O`JELLY KONYAKU (MAXI APPLE STRAWBERRY);2;5500;0;11000;9240;1760;
2021-09-09 22:05:01;8998989500166;GUDANG GARAM MERAH BESAR 16KS;2;18000;0;36000;34000;2000;
2021-09-09 22:06:01;8994867007161;ROKOK PENA GOLD 20;1;18000;0;18000;16800;1200;
2021-09-09 22:06:29;ROTI;ROTI 2000;2;2000;0;4000;3600;400;
2021-09-09 22:09:15;8992959953044;SWEETY BRONZE XL1;6;3000;0;18000;13866;4134;
2021-09-09 22:09:49;MARS;MARSHMELLOW;1;500;0;500;433;67;
2021-09-09 22:12:38;8995899210185;Mi Boncabe;2;3500;0;7000;6000;1000;
2021-09-09 22:13:29;8995899210185;Mi Boncabe;1;3500;0;3500;3000;500;
2021-09-09 22:22:38;8997009510055;YOU C1000;1;15000;0;15000;13000;2000;
2021-09-09 22:24:33;8991909101016;URBAN MILD 16;1;17000;0;17000;15800;1200;
2021-09-09 22:30:06;8998989110167;SURYA GUDANG GARAM 16 FILTER;1;26000;0;26000;23700;2300;
2021-09-10 09:49:58;8998989300261;GUDANG GARAM SURYA 12 FILTER;1;20000;0;20000;18150;1850;
2021-09-10 09:50:18;8996001305119;ARDEN 30G;1;2000;0;2000;1650;350;
2021-09-10 09:50:33;8992775311509;gery garuda;1;1000;0;1000;700;300;
2021-09-10 09:50:55;8995555121244;SOSIS KIMBO;1;1000;0;1000;650;350;
2021-09-10 09:51:18;8991001242013;Top;1;1000;0;1000;500;500;
2021-09-10 09:52:36;8992959509005;SWEETY SILVER PANTS XL26;1;61500;0;61500;55910;5590;
2021-09-10 09:52:57;8992717900310;KARA SUN;2;2500;0;5000;4000;1000;
2021-09-10 09:53:31;8998866202244;EKOMIE BUMBU KALDU AYAM;3;1000;0;3000;2394;606;
2021-09-10 09:54:15;089686386127;BUMBU RACIK NASI GORENG SOSIS;2;2000;0;4000;3240;760;
2021-09-10 09:54:31;roti;roti 2000;1;2000;0;2000;1800;200;
2021-09-10 09:56:19;CC;NICE FACIAL KILOAN 900 GR DUO;1;34500;0;34500;31325;3175;
2021-09-10 09:57:10;roti;roti 2000;2;2000;0;4000;3600;400;
2021-09-10 09:57:31;gula;GULA;1;11500;0;11500;10000;1500;
2021-09-10 09:58:30;8998866619035;Royale Sweet Floral 13 ml;1;5000;0;5000;4452;548;
2021-09-10 09:59:23;8992696430860;KOKO KRUNCH 80G;1;9000;0;9000;8063;937;
2021-09-10 09:59:42;089686060102;POP MIE PEDE GLEDEEK;1;5000;0;5000;4450;550;
2021-09-10 10:00:04;8998866200301;MIE SEDAAP GORENG;2;2700;0;5400;4826;574;
2021-09-10 11:01:58;11222;LEM KOREA;1;10000;0;10000;8000;2000;
2021-09-10 11:03:13;089686060102;POP MIE PEDE GLEDEEK;1;5000;0;5000;4450;550;
2021-09-10 11:03:49;8996001312698;MALKIST KOREAN;1;6500;0;6500;5500;1000;
2021-09-10 11:52:45;089686386011;BUMBU RACIK NASI GORENG;1;2000;0;2000;1450;550;
2021-09-10 11:52:45;Telur 7 Biji;Telur 7 Biji;1;10000;0;10000;8400;1600;
2021-09-10 11:54:22;8995555121244;SOSIS KIMBO;1;1000;0;1000;650;350;
2021-09-10 13:09:36;Gula gula tusuk;gula gula tusuk;1;500;0;500;400;100;
2021-09-10 13:10:17;JD VM;JD VANILLA MILKSHAKE;1;5000;0;5000;4300;700;
2021-09-10 13:11:20;6907992823829;JD MILKY MILK;1;3000;0;3000;2600;400;
2021-09-10 13:15:12;8999999045913;LIFEBUOY MILDCARE 110GR;1;15000;0;15000;14245;755;
2021-09-10 13:16:25;8999999195649;SARI WANGI 25X1.86G;1;6000;0;6000;5050;950;
2021-09-10 13:16:46;8997025911058;HATARI SHP KELAPA;1;6000;0;6000;4911;1089;
2021-09-10 13:17:26;8999909010567;234 DJI SAM SOE 16;1;22500;0;22500;21500;1000;
2021-09-10 13:17:40;8998989110167;SURYA GUDANG GARAM 16 FILTER;1;26000;0;26000;23700;2300;
2021-09-10 13:18:06;8997210107877;VORTEX SMART 3;1;5000;0;5000;4750;250;
2021-09-10 13:21:05;8992775110157;GARUDA KACANG KULIT;1;5000;0;5000;3925;1075;
2021-09-10 13:23:43;8995077609985;Tortilla;1;1000;0;1000;900;100;
2021-09-10 13:24:53;roti;roti 2000;1;2000;0;2000;1800;200;
2021-09-10 15:36:56;8998866200882;SUKSESMIE GORENG AYAM KRMS 133GR;2;3500;0;7000;6094;906;
2021-09-10 15:37:26;089686043051;INDOMIE COTO MAKASSAR;1;2800;0;2800;2525;275;
2021-09-10 15:37:55;8999909002821;MARLBORO BLACK 16;1;22000;0;22000;20850;1150;
2021-09-10 15:39:17;8999999706081;PEPSODENT WHITE 75G;1;5000;0;5000;3850;1150;
2021-09-10 15:40:17;8991102022460;FORMULA DIAMOND;1;3000;0;3000;2500;500;
2021-09-10 15:40:49;Garuda pilus;Garuda Pilus Pedas Pcs;1;500;0;500;408;92;
2021-09-10 15:42:14;8994075230870;momogi;1;500;0;500;450;50;
2021-09-10 16:14:06;MATERAI;MATERAI;6;15000;0;90000;60000;30000;
2021-09-10 17:00:47;8999999049669;REXONA MEN RO INVISIBLE DRY 45 ML;1;15000;0;15000;13550;1450;
2021-09-10 17:12:30;roti;roti 2000;5;2000;0;10000;9000;1000;
2021-09-10 17:40:17;8992979130012;TOTAL LEMON SOFTENER;1;13000;0;13000;11532;1468;
2021-09-10 17:40:17;8998866611718;EKONOMI PENCUCI PIRING  LIQ 780ML;1;12000;0;12000;10900;1100;
2021-09-10 17:40:17;8999999059309;LIFEBUOY TS TOTAL 10 DG 75G;3;3000;0;9000;7920;1080;
2021-09-10 17:40:35;8998989500166;GUDANG GARAM MERAH BESAR 16KS;2;18000;0;36000;34000;2000;
2021-09-10 17:42:46;8998866619035;Royale Sweet Floral 13 ml;1;5000;0;5000;4452;548;
2021-09-10 17:42:46;8998866202244;EKOMIE BUMBU KALDU AYAM;5;1000;0;5000;3990;1010;
2021-09-10 17:43:27;8997003910684;2CS;1;3000;0;3000;1500;1500;
2021-09-10 17:43:27;roti;roti 2000;1;2000;0;2000;1800;200;
2021-09-10 17:46:05;089686043204;INDOMIE MIE ACEH;1;2700;0;2700;2452;248;
2021-09-10 17:46:05;Garuda Pilus;Garuda Pilus Rasa Abon Pcs;2;500;0;1000;802;198;
2021-09-10 17:46:22;roti;roti 2000;1;2000;0;2000;1800;200;
2021-09-10 17:47:40;8998866600521;SOKLIN FLOORCLENER KUNING 400ML;1;6000;0;6000;5025;975;
2021-09-10 17:58:17;8996001600641;TORA CAPPUCINO;1;3500;0;3500;2750;750;
2021-09-10 17:58:17;roti;roti 2000;2;2000;0;4000;3600;400;
2021-09-10 17:58:17;8997878004327;gula-gula milkita;2;250;0;500;400;100;
2021-09-10 18:01:18;711844110083;KECAP ABC 275 ML;1;15000;0;15000;14000;1000;
2021-09-10 18:09:24;roti;roti 2000;1;2000;0;2000;1800;200;
2021-09-10 19:21:08;089686043204;INDOMIE MIE ACEH;1;2700;0;2700;2452;248;
2021-09-10 19:22:38;8998866200578;MIE SEDAAP KARI KENTAL;2;2700;0;5400;4662;738;
2021-09-10 19:23:07;8998866200325;MIE SEDAAP SOTO;2;2700;0;5400;4662;738;
2021-09-10 19:23:21;896867700494;AIR CLUB 1500ML;1;5000;0;5000;2987;2013;
2021-09-10 19:28:18;9556001004673;MILO NESTLE MALAYSIA ACTIVE GO;1;85000;0;85000;80000;5000;
2021-09-10 21:03:46;8997218380074;ICHITAN MILK TEA;1;8000;0;8000;6583;1417;
2021-09-10 21:05:06;8998989110167;SURYA GUDANG GARAM 16 FILTER;1;26000;0;26000;23700;2300;
2021-09-10 21:06:42;089686021219;INTER MIE GORENG;5;1000;0;5000;4425;575;
2021-09-10 21:10:35;8995333000822;TERIGU KOMPAS SOFT 500GR;3;5500;0;16500;14901;1599;
2021-09-10 21:12:11;089686021219;INTER MIE GORENG;5;1000;0;5000;4425;575;
2021-09-10 21:13:57;8992761145033;FANTA STRAW PET 250ML;1;3500;0;3500;2417;1083;
2021-09-10 21:13:57;8999999007782;FAIR&LOVELY MULTIVITAMIN CREAM 25 MG;1;16500;0;16500;14905;1595;
2021-09-10 21:13:57;8993470411433;JOGER CLASSIC;1;1000;0;1000;850;150;
2021-09-10 21:13:57;8994834005923;SPIX 1000;1;1000;0;1000;850;150;
2021-09-10 21:15:02;8993470411433;JOGER CLASSIC;1;1000;0;1000;850;150;
2021-09-10 21:20:41;8997025914059;HATARI SEE HONG;1;6000;0;6000;4911;1089;
2021-09-10 21:20:41;8999999520878;WIPOL 240ML;1;5000;0;5000;4250;750;
2021-09-10 21:20:41;8992736925134;SASA TEPUNG BUMBU SERBAGUNA;1;5500;0;5500;4700;800;
2021-09-10 21:20:41;8991002103764;GOOD DAY CAPPUCINO 10X25G;5;1500;0;7500;6975;525;
2021-09-10 21:20:41;8999999192150;ROYCO FDS CHICKEN 100GR;1;5000;0;5000;4300;700;
2021-09-10 21:20:41;8992696521797;MILO 22G;9;2500;0;22500;14148;8352;
2021-09-10 21:21:49;089686043273;INDOMIE SAMBAL RICA;1;2700;0;2700;2452;248;
2021-09-10 21:25:19;8996001318980;BETTER 120G;1;6000;0;6000;5100;900;
2021-09-10 21:25:19;8997028590052;ARGUS 600ML;1;3000;0;3000;1458;1542;
2021-09-10 21:25:19;9556001047175;NESCAFE ORI 240ML;1;8500;0;8500;7834;666;
2021-09-10 21:31:53;8992696521797;MILO 22G;2;2500;0;5000;3144;1856;
2021-09-10 21:42:49;8996001305041;ROMA SANDWICH CKLT;2;7000;0;14000;11856;2144;
2021-09-10 22:21:42;8996001305119;ARDEN 30G;1;2000;0;2000;1650;350;
2021-09-11 09:30:49;089686535044;SUN BERAS MERAH;1;8500;0;8500;7410;1090;
2021-09-11 10:11:15;roti;roti 2000;2;2000;0;4000;3600;400;
2021-09-11 10:11:15;8995555121244;SOSIS KIMBO;1;1000;0;1000;650;350;
2021-09-11 10:11:15;8992775001998 pcs;Gery Salut sandiwich pcs;1;1000;0;1000;815;185;
2021-09-11 10:27:04;roti;roti 2000;2;2000;0;4000;3600;400;
2021-09-11 10:30:29;roti;roti 2000;1;2000;0;2000;1800;200;
2021-09-11 10:38:18;8999909010567;234 DJI SAM SOE 16;4;22500;0;90000;86000;4000;
2021-09-11 11:00:46;8999999023997;CITRA BW FRESH WHITE 220ML;1;12000;0;12000;10700;1300;
2021-09-11 11:00:46;8998866608404;Softener;1;5000;0;5000;4560;440;
2021-09-11 11:07:35;8998866201469;POTABEE REGULER BBQ BEEF 68 GR;1;8000;0;8000;7200;800;
2021-09-11 11:07:35;089686041705;INDOMIE GORENG JUMBO;1;3500;0;3500;3143;357;
2021-09-11 11:07:35;8996001600146;TEH PUCUK HARUM 350ML;1;3000;0;3000;2314;686;
2021-09-11 11:08:46;8991001121615;SILVERQUEEN NUT;1;15000;0;15000;13200;1800;
2021-09-11 11:09:46;8998866605151;CLING HIJAU POUCH 425ML;1;4000;0;4000;3250;750;
2021-09-11 11:21:23;8997878002088;Kiko;1;1000;0;1000;450;550;
2021-09-11 11:26:30;8998989121163;SURYA PRO MERAH;1;22000;0;22000;20100;1900;
2021-09-11 11:28:42;8999909982000;SAMPOERNA 12 FILTER;1;19000;0;19000;16600;2400;
2021-09-11 11:54:06;8999909002821;MARLBORO BLACK 16;1;22000;0;22000;20850;1150;
2021-09-11 11:55:22;MILKITA;MILKITA;4;250;0;1000;800;200;
2021-09-11 11:59:26;8998009040023;TEH KOTAK;1;5000;0;5000;2827;2173;
2021-09-11 12:21:23;8992775311615;CHOCOLATOS;1;12000;0;12000;9983;2017;
2021-09-11 12:23:55;8992775311615;CHOCOLATOS;1;12000;0;12000;9983;2017;
2021-09-11 12:23:55;8998866500517;BABY HAPPY PANTS L PCS;2;2000;0;4000;2860;1140;
2021-09-11 12:31:31;8998866202602;KRISBEE FRENCH FRIES 18GR;4;2000;0;8000;6000;2000;
2021-09-11 12:33:51;8992761139018;ADES 600ML;1;3500;0;3500;2166;1334;
2021-09-11 12:33:51;YP;YUPI;6;250;0;1500;1248;252;
2021-09-11 12:50:16;8998989300261;GUDANG GARAM SURYA 12 FILTER;1;20000;0;20000;18150;1850;
2021-09-11 13:00:31;ARG;ARGUS 220ML;2;14500;0;29000;26600;2400;
2021-09-11 13:00:54;8998989300261;GUDANG GARAM SURYA 12 FILTER;1;20000;0;20000;18150;1850;
2021-09-11 13:06:54;PRG;PARAGO;4;500;0;2000;1600;400;
2021-09-11 13:20:14;8999999030179;PEPSODENT ACTION 123 COMPLETE 75G;1;6700;0;6700;5170;1530;
2021-09-11 13:20:14;8999999045913;LIFEBUOY MILDCARE 110GR;1;15000;0;15000;14245;755;
2021-09-11 15:17:16;8995333000822;TERIGU KOMPAS SOFT 500GR;3;5500;0;16500;14901;1599;
2021-09-11 15:18:33;8999909004221;SAMPOERNA ULTRAMILD 16;1;22000;0;22000;20350;1650;
2021-09-11 15:35:59;8995555121244;SOSIS KIMBO;1;1000;0;1000;650;350;
2021-09-11 16:08:27;8991001242013;Top;2;1000;0;2000;1000;1000;
2021-09-11 16:08:51;8996001375372;CHOKI CHOKI;2;1000;0;2000;1820;180;
2021-09-11 16:09:04;kentang;kripik kentang;1;1000;0;1000;900;100;
2021-09-11 16:09:52;kentang;kripik kentang;1;1000;0;1000;900;100;
2021-09-11 16:17:00;8995555121244;SOSIS KIMBO;1;1000;0;1000;650;350;
2021-09-11 16:19:22;roti;roti 2000;1;2000;0;2000;1800;200;
2021-09-11 16:43:10;8997878004327;gula-gula milkita;2;250;0;500;400;100;
2021-09-11 17:24:23;8997003910684;2CS;1;3000;0;3000;1500;1500;
2021-09-11 17:24:23;kentang;kripik kentang;2;1000;0;2000;1800;200;
2021-09-11 17:31:09;8992775001998 pcs;Gery Salut sandiwich pcs;1;1000;0;1000;815;185;
2021-09-11 17:54:46;8996001305119;ARDEN 30G;2;2000;0;4000;3300;700;
2021-09-11 17:54:46;kentang;kripik kentang;1;1000;0;1000;900;100;
2021-09-11 17:54:46;Vita Jelly;Vita Jelly;1;1000;0;1000;766;234;
2021-09-11 17:54:46;8994834006128;TICTIC PEDAS;1;2000;0;2000;1700;300;
2021-09-11 18:04:58;8998866200646;KOPI TOP MURNI;1;11000;0;11000;9600;1400;
2021-09-11 18:06:11;Vita Jelly;Vita Jelly;1;1000;0;1000;766;234;
2021-09-11 18:06:11;gg;gula-gula koin;2;500;0;1000;800;200;
2021-09-11 18:20:21;089686041705;INDOMIE GORENG JUMBO;1;3500;0;3500;3143;357;
2021-09-11 20:19:46;8999999524807;SUNLIGHT HABBATUSSAUDA POUCH 755ML;1;17000;0;17000;15400;1600;
2021-09-11 20:20:04;8998989110167;SURYA GUDANG GARAM 16 FILTER;1;26000;0;26000;23700;2300;
2021-09-11 20:21:14;8998866200578;MIE SEDAAP KARI KENTAL;2;2700;0;5400;4662;738;
2021-09-11 20:21:14;8998866202343;MIE SEDAAP KOREAN SPICY;2;2700;0;5400;4826;574;
2021-09-11 20:22:12;TBR;TEPUNG BERAS ROSE BRAND;1;8000;0;8000;5800;2200;
2021-09-11 20:25:14;8992959071205;HN PANTS M20;1;32000;0;32000;29091;2909;
2021-09-11 20:26:18;8934868015031;REXONA DEO LOTION ICE COOL;1;4500;0;4500;3900;600;
2021-09-11 20:26:51;8992959117613;SFX DAUN SIRIH 1 WP;3;500;0;1500;1239;261;
2021-09-11 20:27:16;Vita Jelly;Vita Jelly;2;1000;0;2000;1532;468;
2021-09-11 20:28:28;8993470411433;JOGER CLASSIC;2;1000;0;2000;1700;300;
2021-09-11 20:30:04;8998866202602;KRISBEE FRENCH FRIES 18GR;2;2000;0;4000;3000;1000;
2021-09-11 20:30:26;CK;COOKIEZ;1;1000;0;1000;725;275;
2021-09-11 20:35:56;8999908059802;MY BABY POWDER KUNING;1;5000;0;5000;3276;1724;
2021-09-11 20:36:47;8998866105484;EMERON LOVELY MOISTURE&BRIGHT;1;4300;0;4300;3800;500;
2021-09-11 20:40:55;8997240540019;tepun tapioka;1;11000;0;11000;9900;1100;
2021-09-11 20:41:52;8992959953020;SWEETY BRONZE M1;1;3000;0;3000;2671;329;
2021-09-11 20:42:21;gg;gula-gula koin;4;500;0;2000;1600;400;
2021-09-11 21:07:58;8991102281416;PERMEN MINTZ PPMINT;1;5000;0;5000;4000;1000;
2021-09-11 21:07:58;8991002330504;RELAXA MANGO MINT;1;5000;0;5000;4500;500;
2021-09-11 21:07:58;8991102230308;BLASTER PINK;1;5000;0;5000;3106;1894;
2021-09-11 21:22:46;8996001305119;ARDEN 30G;1;2000;0;2000;1650;350;
2021-09-12 16:23:42;8995333060703;TERIGU KOMPAS 1KG;1;10500;0;10500;9816;684;
2021-09-12 16:23:42;8998866501026;MINYAK GORENG SEDAAP POUCH 1 L;1;15000;0;15000;14110;890;
2021-09-12 16:49:47;8998989300261;GUDANG GARAM SURYA 12 FILTER;1;20000;0;20000;18150;1850;
2021-09-12 16:49:47;8991002103337;GOOD DAY VANILLA;2;1500;0;3000;1780;1220;
2021-09-12 17:19:15;8998989110167;SURYA GUDANG GARAM 16 FILTER;1;26000;0;26000;23700;2300;
2021-09-12 17:25:56;8999909096004;SAMPOERNA 16 FILTER;1;25000;0;25000;23100;1900;
2021-09-12 17:27:17;8997009510055;YOU C1000;1;15000;0;15000;13000;2000;
2021-09-12 17:39:05;8999999401238;RINSO ANTI NODA 770G;1;21200;0;21200;19338;1862;
2021-09-12 17:43:19;8993083140041;BISKITOP CHOCOLATE;1;27000;0;27000;25200;1800;
2021-09-12 17:43:19;KLOP;KLOP SALUTO;2;16000;0;32000;29090;2910;
2021-09-12 17:44:52;8991102308823;KLOP COCONUT ORI;2;6000;0;12000;9938;2062;
2021-09-12 17:44:52;8993083140041;BISKITOP CHOCOLATE;2;27000;0;54000;50400;3600;
2021-09-12 18:06:57;8992628020152;BIMOLI POUCH 2L;1;31000;0;31000;29800;1200;
2021-09-12 18:06:57;GL;GULA 1 LITER;1;11500;0;11500;10500;1000;
2021-09-12 18:06:57;ARG;ARGUS 220ML;1;14500;0;14500;13300;1200;
2021-09-12 18:06:57;ROTI;ROTI 2000;1;2000;0;2000;1800;200;
2021-09-12 18:06:57;8886001038011;BENG-BENG SCT;2;1500;0;3000;2900;100;
2021-09-12 18:06:57;JL;JELLY;2;500;0;1000;800;200;
2021-09-12 18:06:57;8993470411433;JOGER CLASSIC;1;1000;0;1000;850;150;
2021-09-12 18:06:57;8996001600146;TEH PUCUK HARUM 350ML;1;3000;0;3000;2314;686;
2021-09-12 18:12:00;8995899210185;Mi Boncabe;1;3000;0;3000;3000;0;
2021-09-12 18:12:00;8992761139018;ADES 600ML;1;3500;0;3500;2166;1334;
2021-09-12 18:12:00;8998866202053;POTABEE AYAM BAKAR PEDAS 68GR;1;8000;0;8000;7200;800;
2021-09-12 18:12:00;8886013213208;FRENCH FREIS 2000;1;5000;0;5000;3750;1250;
2021-09-12 18:12:00;8996001375372;CHOKI CHOKI;2;1000;0;2000;1820;180;
2021-09-12 18:12:00;8998866200325;MIE SEDAAP SOTO;1;2700;0;2700;2331;369;
2021-09-12 18:12:00;8886001038011;BENG-BENG SCT;1;1500;0;1500;1450;50;
2021-09-12 18:12:00;YP;YUPI;3;250;0;750;624;126;
2021-09-12 18:12:00;8996001600146;TEH PUCUK HARUM 350ML;2;3000;0;6000;4628;1372;
2021-09-12 18:18:08;8992696523081;MILO UHT 110ML;1;2500;0;2500;1962;538;
2021-09-12 18:18:08;PRG;PARAGO;1;500;0;500;400;100;
2021-09-12 18:18:08;roti;roti 2000;3;2000;0;6000;5400;600;
2021-09-12 18:18:08;8998866200561;EKOMIE SUPER 600GR;1;10000;0;10000;8615;1385;
2021-09-12 18:18:08;8998866202435;JAPOTA UMAMI JAPANESE SEAWEED 35GR;1;5000;0;5000;4150;850;
2021-09-12 18:18:08;8995899210185;Mi Boncabe;1;3000;0;3000;3000;0;
2021-09-12 18:18:08;jagung marning;jagung marning;1;5000;0;5000;4500;500;
2021-09-12 18:18:08;ARG;ARGUS 220ML;1;14500;0;14500;13300;1200;
2021-09-12 18:21:32;8992761111540;FANTA STRAWBERY SLIM CAM 250ML;1;5000;0;5000;3750;1250;
2021-09-12 18:21:32;roti;roti 2000;1;2000;0;2000;1800;200;
2021-09-12 18:48:19;8994867007161;ROKOK PENA GOLD 20;1;18000;0;18000;16800;1200;
2021-09-12 19:04:11;8991909101016;URBAN MILD 16;1;17000;0;17000;15800;1200;
2021-09-12 19:15:23;krupuk k;Krupuk Kentang;1;5000;0;5000;4500;500;
2021-09-12 19:15:23;kentang;kripik kentang;1;1000;0;1000;900;100;
2021-09-12 19:23:47;Vita Jelly;Vita Jelly;2;1000;0;2000;1532;468;
2021-09-12 19:23:47;8996001305119;ARDEN 30G;2;2000;0;4000;3300;700;
2021-09-12 19:31:35;8993989311699;CLAS MILD 16 FILTER;1;24000;0;24000;21700;2300;
2021-09-12 19:31:35;6907992824963;JD MILKY CHOCOLATE;2;3000;0;6000;5200;800;
2021-09-12 19:52:55;GL;GULA 1 LITER;1;11500;0;11500;10500;1000;
2021-09-12 19:52:55;8997204370126;Siko;1;10000;0;10000;8333;1667;
2021-09-12 20:10:22;GL;GULA 1 LITER;4;11500;0;46000;42000;4000;
2021-09-12 20:28:13;8995150101696;M+SUSU ORIGINAL;1;5000;0;5000;4000;1000;
2021-09-12 20:33:44;GGK;PLAYGUM PERMEN KARET;2;500;0;1000;800;200;
2021-09-12 20:33:44;lolipop;lolipop;4;1000;0;4000;3400;600;
2021-09-12 20:40:01;TELUR;TELUR;7;1428;0;9996;8400;1596;
2021-09-12 21:41:07;8999909010567;234 DJI SAM SOE 16;1;22500;0;22500;21500;1000;
2021-09-12 21:41:07;8997028590052;ARGUS 600ML;1;3000;0;3000;1458;1542;
2021-09-12 21:41:07;089686021219;INTER MIE GORENG;5;1000;0;5000;4425;575;
2021-09-12 21:43:11;ARG;ARGUS 220ML;1;14500;0;14500;13300;1200;
2021-09-12 21:43:11;TELUR;TELUR;7;1428;0;9996;8400;1596;
2021-09-12 21:43:11;8992761002022;SPRITE PET 390ML;1;5500;0;5500;4333;1167;
2021-09-12 22:03:38;8992959953037;SWEETY BRONZE L1;2;2500;0;5000;3638;1362;
2021-09-12 22:30:05;8992696521797;MILO 22G;2;2500;0;5000;3144;1856;
2021-09-13 14:24:25;8992717900310;KARA SUN;2;2500;0;5000;4000;1000;
2021-09-13 14:24:25;6907992823829;JD MILKY MILK;1;3000;0;3000;2600;400;
2021-09-13 14:24:33;8996001600146;TEH PUCUK HARUM 350ML;1;3000;0;3000;2314;686;
2021-09-13 14:47:41;ARG;ARGUS 220ML;2;14500;0;29000;26600;2400;
2021-09-13 14:47:41;8997028590052;ARGUS 600ML;4;3000;0;12000;5832;6168;
2021-09-13 14:47:41;8991102281416;PERMEN MINTZ PPMINT;1;5000;0;5000;4000;1000;
2021-09-13 14:47:41;8996001314005;ROMA KELAPA CREAM CKLT;1;8000;0;8000;6642;1358;
2021-09-13 14:47:41;8992775001844;Chocolatos original taste;3;1000;0;3000;2487;513;
2021-09-13 14:47:41;8991102714846;MILKIDO CKLT;1;3000;0;3000;2153;847;
2021-09-13 15:12:21;8998866605151;CLING HIJAU POUCH 425ML;1;4000;0;4000;3250;750;
2021-09-13 15:12:21;9556001047175;NESCAFE ORI 240ML;1;8500;0;8500;7834;666;
2021-09-13 15:12:21;8995555121244;SOSIS KIMBO;5;1000;0;5000;3250;1750;
2021-09-13 15:12:21;8997027300089;NOMOS;1;4000;0;4000;2963;1037;
2021-09-13 15:12:21;Vita Jelly;Vita Jelly;1;1000;0;1000;766;234;
2021-09-13 15:12:21;8998866610438;SOKLIN SOFTERGENT RED BAG 770G & PIRING;1;18000;0;18000;16680;1320;
2021-09-13 15:12:21;089686386127;BUMBU RACIK NASI GORENG SOSIS;1;2000;0;2000;1620;380;
2021-09-13 15:12:21;8998866108003;EMERON HJB CLEANFRESH 10ML;1;5000;0;5000;4185;815;
2021-09-13 15:12:21;8997003910684;2CS;2;3000;0;6000;3000;3000;
2021-09-13 15:12:21;8992222050609;GATSBY ANTI KETOMBE 28ML;1;5500;0;5500;4000;1500;
2021-09-13 15:12:21;8998866608459;POWDET DAIA PUTIH BAG 290GR;1;5000;0;5000;4450;550;
2021-09-13 15:12:21;8994935000070;MINYAK GORENG DUNIA 450 ML;1;7500;0;7500;6779;721;
2021-09-13 15:12:21;ROTI;ROTI 2000;3;2000;0;6000;5400;600;
2021-09-13 15:12:21;8991002103238;GOOD DAY MOCACINNO;4;1500;0;6000;3560;2440;
2021-09-13 15:12:21;8999999524807;SUNLIGHT HABBATUSSAUDA POUCH 755ML;1;17000;0;17000;15400;1600;
2021-09-13 15:12:21;GL;GULA 1 LITER;1;11500;0;11500;10500;1000;
2021-09-13 15:12:21;8997013790108;BIMURA KACANG TELUR 25G;3;1000;0;3000;2625;375;
2021-09-13 15:12:21;8996001600146;TEH PUCUK HARUM 350ML;9;3000;0;27000;20826;6174;
2021-09-13 15:12:21;8999999049461;REXONA WMN ROINVISIBLE DRY 45 ML;1;15000;0;15000;13550;1450;
2021-09-13 15:12:21;8991909101016;URBAN MILD 16;1;17000;0;17000;15800;1200;
2021-09-13 15:12:21;6907992823867;JD CRUNCHY CHOCOLATE MALT;1;5500;0;5500;4700;800;
2021-09-13 15:12:21;6907992823843;JD MOCHA CRISPY;1;5000;0;5000;4400;600;
2021-09-13 15:12:21;8993989311699;CLAS MILD 16 FILTER;1;24000;0;24000;21700;2300;
2021-09-13 15:12:21;8998989300261;GUDANG GARAM SURYA 12 FILTER;1;20000;0;20000;18150;1850;
2021-09-13 15:12:21;089686041705;INDOMIE GORENG JUMBO;2;3500;0;7000;6286;714;
2021-09-13 15:12:21;8998866200578;MIE SEDAAP KARI KENTAL;2;2700;0;5400;4662;738;
2021-09-13 15:57:07;8996001600146;TEH PUCUK HARUM 350ML;1;3000;0;3000;2314;686;
2021-09-13 16:33:46;8992761166038;MMP ORANGE 300ML;1;5000;0;5000;3750;1250;
2021-09-13 17:14:01;8998866200325;MIE SEDAAP SOTO;3;2700;0;8100;6993;1107;
2021-09-13 17:43:13;BAYFLAST;BAYPLAST;1;500;0;500;350;150;
2021-09-13 17:43:13;KIKO;KIKO;1;1000;0;1000;500;500;
2021-09-13 17:43:13;6907992825076;JD WATERMELON APPLE;1;2000;0;2000;1700;300;
2021-09-13 17:43:13;8996001600146;TEH PUCUK HARUM 350ML;1;3000;0;3000;2314;686;
2021-09-13 18:28:17;ROTI;ROTI 2000;3;2000;0;6000;5400;600;
2021-09-13 18:28:17;8997003910684;2CS;1;3000;0;3000;1500;1500;
2021-09-13 20:02:07;8999999524807;SUNLIGHT HABBATUSSAUDA POUCH 755ML;1;17000;0;17000;15400;1600;
2021-09-13 20:02:35;GL;GULA 1 LITER;1;11500;0;11500;10500;1000;
2021-09-13 20:04:30;8991002121089;GOOD DAY ORI CAPPUCINO;1;6000;0;6000;4295;1705;
2021-09-13 20:05:26;8996001600146;TEH PUCUK HARUM 350ML;2;3000;0;6000;4628;1372;
2021-09-13 20:06:09;8999999047108;REXONA WMN RO ANTIBACTERIAL DEFENSE 45 ML;1;16500;0;16500;14900;1600;
2021-09-13 20:07:00;8991909101016;URBAN MILD 16;1;17000;0;17000;15800;1200;
2021-09-13 20:07:48;8993989311699;CLAS MILD 16 FILTER;1;24000;0;24000;21700;2300;
2021-09-13 20:08:28;ARG;ARGUS 220ML;1;14500;0;14500;13300;1200;
2021-09-13 20:10:21;Gula gula tusuk;gula gula tusuk;3;500;0;1500;1200;300;
2021-09-13 20:11:08;8991102103091;Formula Proteksi;1;3500;0;3500;2650;850;
2021-09-13 20:12:35;gula gula;gula-gula karet;2;500;0;1000;800;200;
2021-09-13 20:13:11;8999999533717;CITRA TS FRESH WHITE 70G;1;2200;0;2200;1900;300;
2021-09-13 20:13:39;8991102103091;Formula Proteksi;1;3500;0;3500;2650;850;
2021-09-13 20:16:09;8997021290348;Teh Gunung Tengah;1;6000;0;6000;5000;1000;
2021-09-13 20:27:54;8998866501026;MINYAK GORENG SEDAAP POUCH 1 L;1;15000;0;15000;14110;890;
2021-09-13 20:27:54;8998866107068;Mama lemon 230 ml;1;4000;0;4000;3500;500;
2021-09-13 20:27:54;8991002105430;KAPAL API 65G;1;5000;0;5000;4145;855;
2021-09-13 20:27:54;8992770154026;SAJIKU SAYUR SOP;1;2500;0;2500;2000;500;
2021-09-13 20:27:54;8994907000428;KECAP SACHET ABC;12;600;0;7200;6000;1200;
2021-09-13 20:27:54;089686021219;INTER MIE GORENG;2;1000;0;2000;1770;230;
2021-09-13 20:27:54;089686021127;INTER MIE KALDU;5;1000;0;5000;4065;935;
2021-09-13 20:32:02;8995899210185;Mi Boncabe;1;3000;0;3000;3000;0;
2021-09-13 20:32:02;089686014280;SUPERMI AYAM BAWANG;1;2500;0;2500;2312;188;
2021-09-13 20:38:12;8998866200325;MIE SEDAAP SOTO;2;2700;0;5400;4662;738;
2021-09-13 20:38:12;089686041705;INDOMIE GORENG JUMBO;2;3500;0;7000;6286;714;
2021-09-13 20:38:31;TG;TEH GELAS;1;1000;0;1000;729;271;
2021-09-13 20:42:03;8998989300261;GUDANG GARAM SURYA 12 FILTER;1;20000;0;20000;18150;1850;
2021-09-13 20:52:10;8991102714846;MILKIDO CKLT;1;3000;0;3000;2153;847;
2021-09-13 20:52:41;ROTI;ROTI 2000;1;2000;0;2000;1800;200;
2021-09-13 20:53:37;8992775000663;GERY SNACK KEJU;1;2000;0;2000;1712;288;
2021-09-13 20:54:26;8998866605144;CLING KUNING POUCH 425ML;1;4000;0;4000;3250;750;
2021-09-13 20:55:12;9556001047175;NESCAFE ORI 240ML;1;8500;0;8500;7834;666;
2021-09-13 20:55:56;8995555121244;SOSIS KIMBO;3;1000;0;3000;1950;1050;
2021-09-13 20:56:52;8997027300089;NOMOS;1;4000;0;4000;2963;1037;
2021-09-13 20:57:27;Vita Jelly;Vita Jelly;1;1000;0;1000;766;234;
2021-09-13 20:58:10;8998866608558;SOKLIN SOFTERGENT BIRU 770G & PIRING;1;18000;0;18000;16055;1945;
2021-09-13 20:58:44;roti;roti 2000;1;2000;0;2000;1800;200;
2021-09-13 21:00:45;TG;TEH GELAS;1;1000;0;1000;729;271;
2021-09-13 21:00:45;Garuda pilus pcs;Garuda pilus Rasa Mi Goreng pcs;1;1000;0;1000;808;192;
2021-09-13 21:00:45;8992959117538;SFX COMFORT SLIM WING 20;1;12000;0;12000;10947;1053;
2021-09-13 21:13:31;8992959508879;SWEETY SILVER PANTS L 7;1;16800;0;16800;15228;1572;
2021-09-13 21:14:33;Telur 7 Biji;Telur 7 Biji;1;10000;0;10000;8400;1600;
2021-09-14 10:46:01;8998866200646;KOPI TOP MURNI;1;11000;0;11000;9600;1400;
2021-09-14 10:51:21;8992628020152;MINYAK GOREG BIMOLI POUCH 2L;2;32000;0;64000;59600;4400;
2021-09-14 11:11:09;089686043204;INDOMIE MIE ACEH;1;2700;0;2700;2452;248;
2021-09-14 11:11:09;8998866202770;MIE SEDAAP SALERO PADANG;1;2500;0;2500;2362;138;
2021-09-14 12:00:28;8886467100017;pringles original;1;9000;0;9000;6333;2667;
2021-09-14 12:00:57;8991002121089;GOOD DAY ORI CAPPUCINO;1;6000;0;6000;4295;1705;
2021-09-14 12:00:57;8991001111883;SILVERQUEEN CHUNKYBAR 33G;1;8000;0;8000;7150;850;
2021-09-14 12:15:10;089686060102;POP MIE PEDE GLEDEEK;1;5000;0;5000;4450;550;
2021-09-14 12:15:10;8998866200844;NOODLE SEDAAP MIE KARI SPESIAL CUP 81 GR;3;4500;0;13500;10950;2550;
2021-09-14 12:15:10;8995555121244;SOSIS KIMBO;4;1000;0;4000;2600;1400;
2021-09-14 13:02:46;8992959953020;SWEETY BRONZE M1;2;3000;0;6000;5342;658;
2021-09-14 13:14:38;8992775311615;CHOCOLATOS;1;12000;0;12000;9983;2017;
2021-09-14 13:58:42;8998009040023;TEH KOTAK;1;5000;0;5000;2827;2173;
2021-09-14 13:58:42;8998989300261;GUDANG GARAM SURYA 12 FILTER;1;20000;0;20000;18150;1850;
2021-09-14 13:58:42;KIKO;KIKO;3;1000;0;3000;1500;1500;
2021-09-14 15:32:53;8999999529840;CLEAR SHP SPR FRSH APPLE 9 AML;1;10500;0;10500;9300;1200;
2021-09-14 15:32:53;8991001111883;SILVERQUEEN CHUNKYBAR 33G;1;8000;0;8000;7150;850;
2021-09-14 16:04:10;8991102281416;PERMEN MINTZ PPMINT;1;5000;0;5000;4000;1000;
2021-09-14 16:27:41;8992696523081;MILO UHT 110ML;4;2500;0;10000;7848;2152;
2021-09-14 16:30:48;ARG;ARGUS 220ML;1;14500;0;14500;13300;1200;
2021-09-14 16:30:48;8997013180053;Tissu Tessy;3;5000;0;15000;12000;3000;
2021-09-14 16:30:48;8999999050009;SUNLIGHT LIME NEW POUCH 95ML;1;2000;0;2000;1600;400;
2021-09-14 16:31:26;8997018250058;SUSU JAHE;8;1000;0;8000;6400;1600;
2021-09-14 16:50:11;8998989500166;GUDANG GARAM MERAH BESAR 16KS;2;18000;0;36000;34000;2000;
2021-09-14 16:50:11;089686010107;INDOMIE KALDU AYAM;4;2700;0;10800;8600;2200;
2021-09-14 16:50:11;123124;KOREK BIASA;1;2000;0;2000;1300;700;
2021-09-14 17:10:01;8993989311699;CLAS MILD 16 FILTER;1;24000;0;24000;21700;2300;
2021-09-14 17:17:54;6907992823850;JD CHOCO CIRLE;1;5500;0;5500;4700;800;
2021-09-14 17:17:54;8999908204202;MY BABY MINYAK TELON 60ML;1;18000;0;18000;16900;1100;
2021-09-14 17:29:42;JGR SHN;JOGER SHINY SACHET;2;500;0;1000;874;126;
2021-09-14 17:29:42;8997009510055;YOU C1000;1;15000;0;15000;13000;2000;
2021-09-14 17:33:59;8999801700054;SUSU FOYU 1 KG;1;22000;0;22000;19791;2209;
2021-09-14 17:44:05;711844110083;KECAP ABC 275 ML;1;15000;0;15000;14000;1000;
2021-09-14 18:11:23;8992761139018;ADES 600ML;3;3500;0;10500;6498;4002;
2021-09-14 18:11:23;8992775001691;GARUDA ROSTA WAGYU BEEF;1;8000;0;8000;7322;678;
2021-09-14 18:11:23;8991102989381;TANGO LONG BUBBLEGUM 130G;1;5000;0;5000;4345;655;
2021-09-14 18:11:23;8886013213208;FRENCH FREIS 2000;2;5000;0;10000;7500;2500;
2021-09-14 18:16:28;ROTI;ROTI 2000;2;2000;0;4000;3600;400;
2021-09-14 18:20:47;8992761166038;MMP ORANGE 300ML;1;5000;0;5000;3750;1250;
2021-09-14 18:20:47;8992761139018;ADES 600ML;1;3500;0;3500;2166;1334;
2021-09-14 18:22:46;8992702000063;INDOMILK COKLAT 370G;1;10000;0;10000;9020;980;
2021-09-14 18:51:11;8994867007161;ROKOK PENA GOLD 20;1;18000;0;18000;16800;1200;
2021-09-14 19:13:00;8995333032113;TERIGU GATOT KACA 1 KG;4;9000;0;36000;34288;1712;
2021-09-14 19:21:59;8998866200578;MIE SEDAAP KARI KENTAL;1;2700;0;2700;2331;369;
2021-09-14 19:21:59;8998866202343;MIE SEDAAP KOREAN SPICY;2;2700;0;5400;4826;574;
2021-09-14 19:21:59;KIKO;KIKO;1;1000;0;1000;500;500;
2021-09-14 19:28:16;089686048704;SARIMIE GORENG AYAM KCP ISI 2;2;3500;0;7000;6240;760;
2021-09-14 19:28:16;089686043273;INDOMIE SAMBAL RICA;2;2700;0;5400;4904;496;
2021-09-14 19:28:16;8992761139018;ADES 600ML;1;3500;0;3500;2166;1334;
2021-09-14 19:29:13;BAYFLAST;BAYPLAST;8;500;0;4000;2800;1200;
2021-09-14 21:04:37;089686010343;INDOMIE SOTO MIE;2;2600;0;5200;4734;466;
2021-09-14 21:04:37;8998866200882;SUKSESMIE GORENG AYAM KRMS 133GR;1;3500;0;3500;3047;453;
2021-09-14 22:33:29;8992761111533;SPRITE SLIM CAM250ML;2;5000;0;10000;7500;2500;
2021-09-14 22:33:29;8998866619004;ROYALE SUNNY DAY;1;5000;0;5000;4560;440;
2021-09-14 22:33:29;089686386127;BUMBU RACIK NASI GORENG SOSIS;1;2000;0;2000;1620;380;
2021-09-14 22:33:29;8995102703138;bumbu sop;1;500;0;500;450;50;
2021-09-14 22:33:29;8997028590052;ARGUS 600ML;1;3000;0;3000;1458;1542;
2021-09-14 22:33:29;ROTI;ROTI 2000;1;2000;0;2000;1800;200;
2021-09-14 22:33:29;8994075230870;momogi;2;500;0;1000;900;100;
2021-09-14 22:33:29;Vita Jelly;Vita Jelly;2;1000;0;2000;1532;468;
2021-09-14 22:33:29;8999999195649;SARI WANGI 25X1.86G;1;6000;0;6000;5050;950;
2021-09-14 22:33:29;SURYA;SURYA;3;500;0;1500;1500;0;
2021-09-14 22:33:29;milkita;milkita;1;500;0;500;370;130;
2021-09-14 22:33:29;8998866604963;POWDET DAIA LEMON 290GR;1;5000;0;5000;4450;550;
2021-09-14 22:33:29;8998989500166;GUDANG GARAM MERAH BESAR 16KS;1;18000;0;18000;17000;1000;
2021-09-14 22:33:29;8995555171225;KIMBO SOSIS;1;1000;0;1000;900;100;
2021-09-14 22:33:29;0105312686040047;yakult;2;2000;0;4000;3000;1000;
2021-09-14 22:33:29;8998866202602;KRISBEE FRENCH FRIES 18GR;2;2000;0;4000;3000;1000;
2021-09-14 22:33:29;6907992825069;JD FRUITY;1;5000;0;5000;4400;600;
2021-09-14 22:33:29;8992959117583;SFX DS REG FLOW WING 20;1;5000;0;5000;4288;712;
2021-09-14 22:33:29;8993989311699;CLAS MILD 16 FILTER;1;24000;0;24000;21700;2300;
2021-09-14 22:33:29;8995102703534;TERASI DUO 6 GR;1;4000;0;4000;3720;280;
2021-09-14 22:33:29;6907992825076;JD WATERMELON APPLE;3;2000;0;6000;5100;900;
2021-09-15 09:43:55;PULPEN SNOWMAN;PULPEN SNOWMAN;1;2500;0;2500;2000;500;
2021-09-15 09:43:55;8999988778846;LASEGAR;1;6500;0;6500;5700;800;
2021-09-15 09:43:55;8996001600146;TEH PUCUK HARUM 350ML;1;3000;0;3000;2314;686;
2021-09-15 09:43:55;6907992823973;JD PINEAPPLE;1;5000;0;5000;4300;700;
2021-09-15 09:43:55;8998866105651;EMERON LOVELY NOUR&BRIGHT 200ML;1;7500;0;7500;6475;1025;
2021-09-15 09:44:44;8997028590014;ARGUS 220ML;2;500;0;1000;604;396;
2021-09-15 09:49:04;PULPEN SNOWMAN;PULPEN SNOWMAN;1;2500;0;2500;2000;500;
2021-09-15 09:54:27;PULPEN SNOWMAN;PULPEN SNOWMAN;1;2500;0;2500;2000;500;
2021-09-15 10:00:35;PULPEN SNOWMAN;PULPEN SNOWMAN;2;2500;0;5000;4000;1000;
2021-09-15 10:01:30;8997028590014;ARGUS 220ML;2;500;0;1000;604;396;
2021-09-15 10:01:30;8992775311325;GERY SNACK&SEREAL 100G;1;7000;0;7000;6012;988;
2021-09-15 10:05:47;BAYFLAST;BAYPLAST;2;500;0;1000;700;300;
2021-09-15 10:05:47;VTM;VITAMIN CIMIN;2;500;0;1000;850;150;
2021-09-15 10:06:48;8998866601429;POWDET DAIA BUNGA BAG 290GR;1;5000;0;5000;4450;550;
2021-09-15 10:15:41;8991102987875;WFR TANGO POUCH CKL 115G;1;8000;0;8000;6786;1214;
2021-09-15 10:15:41;8992761166038;MMP ORANGE 300ML;2;5000;0;10000;7500;2500;
2021-09-15 10:31:12;GL;GULA 1 LITER;4;11500;0;46000;42000;4000;
2021-09-15 10:41:53;8998989300261;GUDANG GARAM SURYA 12 FILTER;1;20000;0;20000;18150;1850;
2021-09-15 10:45:48;8992761166038;MMP ORANGE 300ML;1;5000;0;5000;3750;1250;
2021-09-15 11:04:54;8997028590045;ARGUS 330ML;1;2000;0;2000;1291;709;
2021-09-15 11:04:54;8999909096004;SAMPOERNA 16 FILTER;1;25000;0;25000;23100;1900;
2021-09-15 11:29:39;kri;kripik pisang;1;5000;0;5000;4000;1000;
2021-09-15 11:32:31;8993007000024;INDOMILK UHT VANILA;1;5000;0;5000;3470;1530;
2021-09-15 11:32:31;BALON;BALON CABUT;1;1000;0;1000;900;100;
2021-09-15 11:32:31;Gula gula tusuk;gula gula tusuk;1;500;0;500;400;100;
2021-09-15 11:32:31;KOPIKO;KOPIKO;12;250;0;3000;2100;900;
2021-09-15 11:32:31;YP;YUPI;2;250;0;500;416;84;
2021-09-15 12:14:40;123124;KOREK BIASA;1;2000;0;2000;1300;700;
2021-09-15 12:14:40;8991909101016;URBAN MILD 16;1;17000;0;17000;15800;1200;
2021-09-15 12:14:40;KOPIKO;KOPIKO;4;250;0;1000;700;300;
2021-09-15 12:24:29;8992761002039;FANTA STRAWBERRY PET 390 ML;1;5500;0;5500;4333;1167;
2021-09-15 12:28:34;8991102228053;TEH GELAS BOTOL;1;3000;0;3000;1695;1305;
2021-09-15 12:28:34;ARG;ARGUS 220ML;1;14500;0;14500;13300;1200;
2021-09-15 12:38:14;ARG;ARGUS 220ML;1;14500;0;14500;13300;1200;
2021-09-15 12:44:43;8993989311699;CLAS MILD 16 FILTER;1;24000;0;24000;21700;2300;
2021-09-15 12:44:43;6907992823904;JD CRUNCHY CHOCOLATE VAN;1;8000;0;8000;6800;1200;
2021-09-15 12:44:43;6907992823911;JD CRUNCHY HONEYDEW MELON;1;8000;0;8000;6800;1200;
2021-09-15 12:44:43;8995555121244;SOSIS KIMBO;3;1000;0;3000;1950;1050;
2021-09-15 12:51:38;8991102300544;WFR TANGO VNL 176G;1;10000;0;10000;8694;1306;
2021-09-15 12:51:38;8997028590045;ARGUS 330ML;3;2000;0;6000;3873;2127;
2021-09-15 13:10:55;8997028590014;ARGUS 220ML;1;500;0;500;302;198;
2021-09-15 13:25:35;8997009510055;YOU C1000;2;15000;0;30000;26000;4000;
2021-09-15 13:25:35;8998009010569;ULTRA CHO 200;2;5000;0;10000;7660;2340;
2021-09-15 13:25:35;8997003910684;2CS;2;3000;0;6000;3000;3000;
2021-09-15 13:25:35;8999909096004;SAMPOERNA 16 FILTER;1;25000;0;25000;23100;1900;
2021-09-15 13:25:35;123124;KOREK BIASA;1;2000;0;2000;1300;700;
2021-09-15 13:26:52;8999909001909;MAGNUM REVAMP BLACK 12;1;18000;0;18000;16300;1700;
2021-09-15 13:32:29;8993470672858;SAKU-SAKU RASA BALADO;2;2000;0;4000;3060;940;
2021-09-15 13:32:29;8997028590045;ARGUS 330ML;1;2000;0;2000;1291;709;
2021-09-15 13:39:55;8998866202060;POTABEE AYAM BAKAR PEDAS 35 GR;1;5000;0;5000;4150;850;
2021-09-15 13:39:55;8991001502933;CHACHA TUBE;1;7500;0;7500;6400;1100;
2021-09-15 14:46:26;8997028590052;ARGUS 600ML;2;3000;0;6000;2916;3084;
2021-09-15 15:02:37;8998989300261;GUDANG GARAM SURYA 12 FILTER;1;20000;0;20000;18150;1850;
2021-09-15 15:18:53;8997028590045;ARGUS 330ML;1;2000;0;2000;1291;709;
2021-09-15 15:18:53;8997028590052;ARGUS 600ML;1;3000;0;3000;1458;1542;
2021-09-15 15:18:53;9556001025272;NESCAFE LATTE 240ML;1;8500;0;8500;7834;666;
2021-09-15 15:18:53;8998866200851;NOODLE SEDAAP MIE BAKSO SPESIAL CUP 77 GR;1;4500;0;4500;3738;762;
2021-09-15 15:18:53;8886013213208;FRENCH FREIS 2000;1;5000;0;5000;3750;1250;
2021-09-15 15:34:28;8992761122331;FRESTEA APPEL 500ML;1;6500;0;6500;4791;1709;
2021-09-15 17:32:38;TORT;TORTILA;1;1000;0;1000;1000;0;
2021-09-15 19:23:04;8997028590045;ARGUS 330ML;1;2000;0;2000;1291;709;
2021-09-15 19:23:04;8997028590014;ARGUS 220ML;4;500;0;2000;1208;792;
2021-09-15 19:23:04;8996001318980;BETTER 120G;1;6000;0;6000;5100;900;
2021-09-15 19:23:04;8992957220087;COKLAT SINGA;1;2000;0;2000;1700;300;
2021-09-15 19:23:04;GGK;PLAYGUM PERMEN KARET;4;500;0;2000;1600;400;
2021-09-15 19:23:04;JGR SHN;JOGER SHINY SACHET;4;500;0;2000;1748;252;
2021-09-15 19:23:04;8992957220063;COKLAT BANGO;1;2000;0;2000;1700;300;
2021-09-15 19:24:14;8998898101409;TOLAK ANGIN SIDOMUNCUL;2;3500;0;7000;5416;1584;
2021-09-15 19:24:14;8997009510055;YOU C1000;1;15000;0;15000;13000;2000;
2021-09-15 19:24:14;KP;KERIPIK PISANG;1;5000;0;5000;5000;0;
2021-09-15 19:24:14;ROTI;ROTI 2000;1;2000;0;2000;1800;200;
2021-09-15 19:47:33;8998989300261;GUDANG GARAM SURYA 12 FILTER;1;20000;0;20000;18150;1850;
2021-09-15 19:47:33;8994867000162;ROKOK PUNDIMAS KRETEK16;1;10000;0;10000;8600;1400;
2021-09-15 19:53:40;8992775110157;GARUDA KACANG KULIT;2;5000;0;10000;7850;2150;
2021-09-15 19:56:08;ROTI;ROTI 2000;2;2000;0;4000;3600;400;
2021-09-15 20:19:45;9556001047175;NESCAFE ORI 240ML;1;8500;0;8500;7834;666;
2021-09-15 20:19:45;9556001025272;NESCAFE LATTE 240ML;1;8500;0;8500;7834;666;
2021-09-15 20:19:45;8998009040023;TEH KOTAK;1;5000;0;5000;2827;2173;
2021-09-15 20:19:45;TG;TEH GELAS;4;1000;0;4000;2916;1084;
2021-09-15 20:59:11;8999909001909;MAGNUM REVAMP BLACK 12;1;18000;0;18000;16300;1700;
2021-09-15 20:59:11;Gula gula tusuk;gula gula tusuk;2;500;0;1000;800;200;
2021-09-15 20:59:11;8999909002821;MARLBORO BLACK 16;1;22000;0;22000;20850;1150;
2021-09-15 21:00:15;8998866605779;RAPIKA BIANG BIRU 250MLBTL;1;8500;0;8500;7650;850;
2021-09-15 22:03:29;8992761166205;FRESTEA GREEN HONEY 350ML;1;4500;0;4500;3000;1500;
2021-09-15 22:10:38;8992696521797;MILO 22G;2;2500;0;5000;3144;1856;
2021-09-15 22:14:10;089686021219;INTER MIE GORENG;2;1000;0;2000;1770;230;
2021-09-15 22:47:47;8992775318201;GERY SNACK BANTAL COKLAT;1;2000;0;2000;1712;288;
2021-09-15 22:47:47;8995555171225;KIMBO SOSIS;1;1000;0;1000;900;100;
2021-09-15 22:47:47;8999999706081;PEPSODENT WHITE 75G;1;5000;0;5000;3850;1150;
2021-09-15 22:47:47;8999999533731;CITRA TS NATURE WHITE 70G;1;2200;0;2200;1900;300;
2021-09-15 22:47:47;8998866200325;MIE SEDAAP SOTO;1;2700;0;2700;2331;369;
2021-09-15 22:47:47;ROTI;ROTI 2000;4;2000;0;8000;7200;800;
2021-09-15 22:47:47;8997028590045;ARGUS 330ML;4;2000;0;8000;5164;2836;
2021-09-15 22:47:47;jagung marning;jagung marning;1;5000;0;5000;4500;500;
2021-09-15 22:47:47;8997028590052;ARGUS 600ML;2;3000;0;6000;2916;3084;
2021-09-15 22:47:47;8996001305041;ROMA SANDWICH CKLT;2;7000;0;14000;11856;2144;
2021-09-15 22:47:47;8997025914059;HATARI SEE HONG;1;6000;0;6000;4911;1089;
2021-09-15 22:47:47;8999999037765;pepsodent 225 gr;1;12000;0;12000;10500;1500;
2021-09-15 22:47:47;8999999707859;CLOSEUP GREEN 160G;1;15000;0;15000;13600;1400;
2021-09-15 22:47:47;8999999533717;CITRA TS FRESH WHITE 70G;2;2200;0;4400;3800;600;
2021-09-15 22:47:47;8999999529840;CLEAR SHP SPR FRSH APPLE 9 AML;1;10500;0;10500;9300;1200;
2021-09-15 22:47:47;8992761111533;SPRITE SLIM CAM250ML;2;5000;0;10000;7500;2500;
2021-09-15 22:47:47;8991102281430;PERMEN MINTZ DUOMINT;1;5000;0;5000;4000;1000;
2021-09-15 22:47:47;TUSTEL;TUSUK TELINGA;1;1000;0;1000;833;167;
2021-09-15 22:47:47;8996001440001;TB JAHE SUSU;10;1500;0;15000;8700;6300;
2021-09-15 22:47:47;8992696523067;MILO ACTVGO UHT 180ML;2;5000;0;10000;7030;2970;
2021-09-15 22:47:47;8992775214008;Garuda Kacang Atom;2;1000;0;2000;1620;380;
2021-09-15 22:47:47;8992761166038;MMP ORANGE 300ML;1;5000;0;5000;3750;1250;
2021-09-15 22:47:47;6907992823911;JD CRUNCHY HONEYDEW MELON;1;8000;0;8000;6800;1200;
2021-09-15 22:47:47;6907992823829;JD MILKY MILK;1;3000;0;3000;2600;400;
2021-09-15 22:47:47;8991102320184;TANGO CHOCO JAVAMOCCA;1;5000;0;5000;4330;670;
2021-09-15 22:47:47;8992730002992;HAI CANDY;1;7000;0;7000;6000;1000;
2021-09-15 22:47:47;6907992823652;JD CHOCOLATE MILKSHAKE;1;6000;0;6000;5200;800;
2021-09-15 22:47:47;6907992823669;JD MILKY STRAW;1;3000;0;3000;2600;400;
2021-09-15 22:47:47;8995555121244;SOSIS KIMBO;1;1000;0;1000;650;350;
2021-09-15 22:47:47;ARG;ARGUS 220ML;1;14500;0;14500;13300;1200;
2021-09-15 22:47:47;896867700494;AIR CLUB 1500ML;1;5000;0;5000;2987;2013;
2021-09-15 22:47:47;8991909101016;URBAN MILD 16;1;17000;0;17000;15800;1200;
2021-09-15 22:47:47;123124;KOREK BIASA;1;2000;0;2000;1300;700;
2021-09-15 22:47:47;Gula gula tusuk;gula gula tusuk;2;500;0;1000;800;200;
2021-09-16 11:16:30;8996001305119;ARDEN 30G;1;2000;0;2000;1650;350;
2021-09-16 11:16:30;8995555121244;SOSIS KIMBO;3;1000;0;3000;1950;1050;
2021-09-16 11:16:30;8992775318201;GERY SNACK BANTAL COKLAT;1;2000;0;2000;1712;288;
2021-09-16 11:16:30;ROTI;ROTI 2000;1;2000;0;2000;1800;200;
2021-09-16 11:16:30;8991001503336;chacha minis hat;1;7500;0;7500;6400;1100;
2021-09-16 11:16:30;8992775511206;LEO 10GR;2;1000;0;2000;1696;304;
2021-09-16 11:16:30;089686017748;SARIMIE GORENG ISI 2;1;3500;0;3500;3120;380;
2021-09-16 11:16:30;8997009510123;ORANGE WATER;1;11000;0;11000;10416;584;
2021-09-16 11:16:30;8997028590052;ARGUS 600ML;1;3000;0;3000;1458;1542;
2021-09-16 11:16:30;8999988778846;LASEGAR;1;6500;0;6500;5700;800;
2021-09-16 11:16:30;8997028590045;ARGUS 330ML;1;2000;0;2000;1291;709;
2021-09-16 11:16:30;8993274532105;BOLU;1;1000;0;1000;833;167;
2021-09-16 11:16:30;8995333060703;TERIGU KOMPAS 1KG;1;10500;0;10500;9816;684;
2021-09-16 11:16:30;8999801700054;SUSU FOYU 1 KG;1;22000;0;22000;19791;2209;
2021-09-16 11:16:30;ARG;ARGUS 220ML;1;14500;0;14500;13300;1200;
2021-09-16 11:16:30;0105312686040047;yakult;1;2000;0;2000;1500;500;
2021-09-16 11:43:12;8992716109172;BISKUAT BOLU SCT;1;2000;0;2000;1641;359;
2021-09-16 11:43:12;7622300335809;OREO SOFT CAKE;1;2000;0;2000;1641;359;
2021-09-16 11:43:12;ROTI;ROTI 2000;1;2000;0;2000;1800;200;
2021-09-16 11:43:12;8995077609985;Tortilla;1;1000;0;1000;850;150;
2021-09-16 11:43:12;8997028590052;ARGUS BTL 600ML;1;3000;0;3000;1458;1542;
2021-09-16 11:46:05;8998866606158;NUVO ACTIVE COOL 110G;1;3000;0;3000;2600;400;
2021-09-16 11:46:05;8998866602563;NUVO FAMILY HIJAU 76G;1;2000;0;2000;1820;180;
2021-09-16 11:46:05;8991102020305;FORMULA TRIPLE ACTION;1;3000;0;3000;2500;500;
2021-09-16 12:15:44;8995333000822;TERIGU KOMPAS SOFT 500GR;1;5500;0;5500;4967;533;
2021-09-16 12:15:44;8996001305119;ARDEN 30G;2;2000;0;4000;3300;700;
2021-09-16 12:21:58;8992628020152;MINYAK GOREG BIMOLI POUCH 2L;1;32000;0;32000;29800;2200;
2021-09-16 12:21:58;8999999049447;REXONA WMN RO ADVANCED WHITE 45 ML;1;16500;0;16500;14900;1600;
2021-09-16 12:21:58;8999999053031;PONDS WHITE BEAUTY FACIAL FOAM100G;1;26000;0;26000;23700;2300;
2021-09-16 12:22:54;8995333060703;TERIGU KOMPAS 1KG;2;10500;0;21000;19632;1368;
2021-09-16 12:23:49;8999999003074;VASELINE ALOE SOOTHE;1;13200;0;13200;11805;1395;
2021-09-16 12:30:32;Telur 3 Biji;Telur 3 Biji;1;5000;0;5000;3600;1400;
2021-09-16 12:30:32;089686021141;INTER MIE SOTO;2;1000;0;2000;1708;292;
2021-09-16 12:31:04;BAYFLAST;BAYPLAST;2;500;0;1000;700;300;
2021-09-16 13:19:46;RB;RED BOLD;1;20000;0;20000;18800;1200;
2021-09-16 13:23:01;8998989300261;GUDANG GARAM SURYA 12 FILTER;1;20000;0;20000;18150;1850;
2021-09-16 13:50:00;8991002105430;KAPAL API 65G;1;5000;0;5000;4145;855;
2021-09-16 14:08:39;8992761139018;ADES 600ML;1;3500;0;3500;2166;1334;
2021-09-16 14:08:39;8995555171225;KIMBO SOSIS;1;1000;0;1000;900;100;
2021-09-16 14:08:39;MILKITA;MILKITA;2;250;0;500;400;100;
2021-09-16 14:21:18;8992628020152;MINYAK GOREG BIMOLI POUCH 2L;1;32000;0;32000;29800;2200;
2021-09-16 14:21:18;8999999516208;ROYCO FDS CHICKEN NEW 230G;1;10000;0;10000;9000;1000;
2021-09-16 14:21:18;8992696405417;DNCO INSTANT 27G;4;3500;0;14000;12000;2000;
2021-09-16 14:34:31;8992761139018;ADES 600ML;2;3500;0;7000;4332;2668;
2021-09-16 14:34:31;TG;TEH GELAS;5;1000;0;5000;3645;1355;
2021-09-16 14:34:31;8997028590014;ARGUS 220ML;6;500;0;3000;1812;1188;
2021-09-16 16:04:25;089686727081;DORITOS 55G;1;7000;0;7000;5950;1050;
2021-09-16 16:04:25;8992957220025;GOLDEN CITY MINI;1;3000;0;3000;2500;500;
2021-09-16 16:04:25;8997218380135;ICHITAN GREEN TEA;1;8000;0;8000;6583;1417;
2021-09-16 16:05:19;8992388133017;NU MILK TEA ORI 330ML;1;6000;0;6000;5125;875;
2021-09-16 16:05:19;8992775311325;GERY SNACK&SEREAL 100G;1;7000;0;7000;6012;988;
2021-09-16 16:05:19;YP;YUPI;8;250;0;2000;1664;336;
2021-09-16 16:06:20;089686727081;DORITOS 55G;1;7000;0;7000;5950;1050;
2021-09-16 16:06:20;8992957220025;GOLDEN CITY MINI;1;3000;0;3000;2500;500;
2021-09-16 16:06:20;089686611618;QTELA BARBEQUE;1;5000;0;5000;4266;734;
2021-09-16 16:06:20;8991102714495;TANGO DRINK COKLAT;1;5000;0;5000;3818;1182;
2021-09-16 16:06:20;9556001047175;NESCAFE ORI 240ML;1;8500;0;8500;7834;666;
2021-09-16 16:07:21;8999999559861;AXE DARK POCKET FRAG 17ML;1;10000;0;10000;8000;2000;
2021-09-16 16:08:57;Telur 3 Biji;Telur 3 Biji;1;5000;0;5000;3600;1400;
2021-09-16 16:08:57;089686010343;INDOMIE SOTO MIE;1;2600;0;2600;2367;233;
2021-09-16 16:15:44;8999909096004;SAMPOERNA 16 FILTER;1;25000;0;25000;23100;1900;
2021-09-16 16:53:22;8998989300261;GUDANG GARAM SURYA 12 FILTER;1;20000;0;20000;18150;1850;
2021-09-16 16:55:53;8999999706180;PEPSODENT WHITE 190GR;1;10000;0;10000;9350;650;
2021-09-16 16:55:53;8998866602570;NUVO FAMILY KUNING 76G;1;2000;0;2000;1820;180;
2021-09-16 16:55:53;8998866618144;NUVO FAMILY UNGU 76G;1;2000;0;2000;1880;120;
2021-09-16 16:55:53;8998866618199;NUVO FAMILY TOSKA 76G;1;2000;0;2000;1880;120;
2021-09-16 17:24:01;8998866201728;POTABEE SELECTION SALTED EGG 68G;1;8000;0;8000;7200;800;
2021-09-16 17:24:25;8886013257400;TWISTKO;1;1000;0;1000;900;100;
2021-09-16 17:24:25;Vita Jelly;Vita Jelly;2;1000;0;2000;1532;468;
2021-09-16 17:40:23;8999909010567;234 DJI SAM SOE 16;2;22500;0;45000;43000;2000;
2021-09-16 17:46:32;8995150101696;M+SUSU ORIGINAL;1;5000;0;5000;4000;1000;
2021-09-16 17:48:17;8991102024099;FORMULA CURVE;1;5000;0;5000;3000;2000;
2021-09-16 17:48:17;8999999525590;PEPSODENT TB KIDS;1;12900;0;12900;11700;1200;
2021-09-16 17:48:17;8999999710873;PEPSODENT ACTION123 HERBAL 120G;1;11400;0;11400;10400;1000;
2021-09-16 17:48:17;8997028590052;ARGUS BTL 600ML;2;3000;0;6000;2916;3084;
2021-09-16 17:48:17;ROTI;ROTI 2000;5;2000;0;10000;9000;1000;
2021-09-16 18:00:09;ARG 330;ARGUS DOS 330ML;1;35000;0;35000;31000;4000;
2021-09-16 18:36:58;ARG;ARGUS DOS 220ML;1;14500;0;14500;13300;1200;
2021-09-16 18:36:58;089686611670;QTELA BALADO;1;5000;0;5000;4266;734;
2021-09-16 18:36:58;8992959953310;SWEETY BRONZE M58;1;85000;0;85000;80304;4696;
2021-09-16 19:17:56;896867700494;AIR CLUB 1500ML;3;5000;0;15000;8961;6039;
2021-09-16 19:21:24;KIKO;KIKO;1;1000;0;1000;500;500;
2021-09-16 19:23:19;MARS;MARSHMELLOW;2;500;0;1000;866;134;
2021-09-16 19:24:51;896867700494;AIR CLUB 1500ML;3;5000;0;15000;8961;6039;
2021-09-16 19:24:51;8998989110167;SURYA GUDANG GARAM 16 FILTER;1;26000;0;26000;23700;2300;
2021-09-16 19:31:39;8995333060703;TERIGU KOMPAS 1KG;1;10500;0;10500;9816;684;
2021-09-16 19:31:39;KOPIKO;KOPIKO;2;250;0;500;350;150;
2021-09-16 20:33:28;8994867007161;ROKOK PENA GOLD 20;1;18000;0;18000;16800;1200;
2021-09-16 20:40:04;8992696521797;MILO 22G;1;2500;0;2500;1572;928;
2021-09-16 20:40:04;8997025911058;HATARI SHP KELAPA;1;6000;0;6000;4911;1089;
2021-09-16 20:44:21;SMBL;SAMBAL ABC BLINK 335 ML;1;14000;0;14000;12550;1450;
2021-09-16 20:44:21;0105312686040047;yakult;2;2000;0;4000;3000;1000;
2021-09-16 20:44:21;COKLAT;COKLAT COIN;2;500;0;1000;850;150;
2021-09-16 20:59:34;ROTI;ROTI 2000;1;2000;0;2000;1800;200;
2021-09-16 20:59:34;8998866202602;KRISBEE FRENCH FRIES 18GR;1;2000;0;2000;1500;500;
2021-09-16 21:00:14;MILKITA;MILKITA;2;250;0;500;400;100;
2021-09-16 21:00:28;TELUR RAK;TELUR RAK;1;39000;0;39000;36000;3000;
2021-09-16 21:03:23;8991909101016;URBAN MILD 16;1;17000;0;17000;15800;1200;
2021-09-16 21:03:23;8999909002821;MARLBORO BLACK 16;1;22000;0;22000;20850;1150;
2021-09-16 21:10:54;8996001318980;BETTER 120G;1;6000;0;6000;5100;900;
2021-09-16 21:19:16;ROTI;ROTI 2000;1;2000;0;2000;1800;200;
2021-09-16 21:19:16;8992716109172;BISKUAT BOLU SCT;1;2000;0;2000;1641;359;
2021-09-16 21:19:16;8886001038011;BENG-BENG SCT;1;1500;0;1500;1450;50;
2021-09-16 21:47:24;089686821086;ICHI OCHA MELATI;1;3000;0;3000;2250;750;
2021-09-16 22:17:56;8998989500166;GUDANG GARAM MERAH BESAR 16KS;2;18000;0;36000;34000;2000;
2021-09-17 10:15:56;8995555121244;SOSIS KIMBO;1;1000;0;1000;650;350;
2021-09-17 10:15:56;OJELLY;O'JELLY;4;500;0;2000;1540;460;
2021-09-17 10:15:56;8998989300261;GUDANG GARAM SURYA 12 FILTER;2;20000;0;40000;36300;3700;
2021-09-17 10:15:56;8996001318980;BETTER 120G;1;6000;0;6000;5100;900;
2021-09-17 10:15:56;8997028590045;ARGUS BTL 330ML;1;2000;0;2000;1291;709;
2021-09-17 10:15:56;ROTI;ROTI 2000;1;2000;0;2000;1800;200;
2021-09-17 10:15:56;8992761139018;ADES 600ML;2;3500;0;7000;4332;2668;
2021-09-17 10:57:51;ARG;ARGUS DOS 220ML;1;14500;0;14500;13300;1200;
2021-09-17 11:06:20;8997011700123;BIHUN JAGUNG 300GR;1;6000;0;6000;4979;1021;
2021-09-17 11:06:20;ARG;ARGUS DOS 220ML;1;14500;0;14500;13300;1200;
2021-09-17 11:06:20;Gula gula tusuk;gula gula tusuk;1;500;0;500;400;100;
2021-09-17 11:18:09;8997003910684;2CS;2;3000;0;6000;3000;3000;
2021-09-17 11:18:09;8997028590052;ARGUS BTL 600ML;1;3000;0;3000;1458;1542;
2021-09-17 11:18:09;8997028590045;ARGUS BTL 330ML;1;2000;0;2000;1291;709;
2021-09-17 11:18:09;8998866610087;JAVANA ORIGINAL 350ML;1;3000;0;3000;2150;850;
2021-09-17 11:24:15;8991002121089;GOOD DAY ORI CAPPUCINO;1;6000;0;6000;4295;1705;
2021-09-17 11:38:23;8997009510123;ORANGE WATER;1;11000;0;11000;10416;584;
2021-09-17 11:38:23;8998866200301;MIE SEDAAP GORENG;1;2700;0;2700;2363;337;
2021-09-17 11:38:23;8998866200844;NOODLE SEDAAP MIE KARI SPESIAL CUP 81 GR;2;4500;0;9000;7300;1700;
2021-09-17 11:38:23;8997013790092;BIMURA KERUPUK BAWANG 25G;2;1000;0;2000;1748;252;
2021-09-17 11:43:35;KIKO;KIKO;4;1000;0;4000;2000;2000;
2021-09-17 12:14:31;8998866200578;MIE SEDAAP KARI KENTAL;2;2700;0;5400;4662;738;
2021-09-17 12:14:31;8998866200301;MIE SEDAAP GORENG;2;2700;0;5400;4726;674;
2021-09-17 12:14:31;8991102228053;TEH GELAS BOTOL;1;3000;0;3000;1695;1305;
2021-09-17 12:39:16;ROTI;ROTI 2000;2;2000;0;4000;3600;400;
2021-09-17 12:51:13;8993496107549;MINYAK SIIP 1800 ML;1;28000;0;28000;25399;2601;
2021-09-17 12:51:13;8996001318980;BETTER 120G;1;6000;0;6000;5100;900;
2021-09-17 12:51:13;YP;YUPI;4;250;0;1000;832;168;
2021-09-17 13:15:43;8998866202923;FLORIDINA COCO;1;3000;0;3000;2500;500;
2021-09-17 13:15:43;8992761166038;MMP ORANGE 300ML;1;5000;0;5000;3750;1250;
2021-09-17 13:15:43;8999999519872;DOVE DEO WMN RO POMEGRANATE 40 ML;1;16500;0;16500;15000;1500;
2021-09-17 14:01:39;8992761122331;FRESTEA APPEL 500ML;1;6500;0;6500;4791;1709;
2021-09-17 14:12:18;6907992825076;JD WATERMELON APPLE;2;2000;0;4000;3400;600;
2021-09-17 14:28:02;8998866501026;MINYAK GORENG SEDAAP POUCH 1 L;2;15500;0;31000;28220;2780;
2021-09-17 14:28:02;8998989110167;SURYA GUDANG GARAM 16 FILTER;1;26000;0;26000;23700;2300;
2021-09-17 15:16:54;8999908059802;MY BABY POWDER KUNING;1;5000;0;5000;3276;1724;
2021-09-17 16:05:26;8991102022460;FORMULA DIAMOND;1;3000;0;3000;2500;500;
2021-09-17 16:35:41;8994867000179;ROKOK PENA MILD 16;2;14500;0;29000;27000;2000;
2021-09-17 17:15:26;8998866200578;MIE SEDAAP KARI KENTAL;2;2700;0;5400;4662;738;
2021-09-17 17:15:26;8991102228053;TEH GELAS BOTOL;1;3000;0;3000;1695;1305;
2021-09-17 17:15:26;6907992823843;JD MOCHA CRISPY;1;5000;0;5000;4400;600;
2021-09-17 17:15:26;6907992824963;JD MILKY CHOCOLATE;1;3000;0;3000;2600;400;
2021-09-17 17:15:26;8991001111883;SILVERQUEEN CHUNKYBAR 33G;1;8000;0;8000;7150;850;
2021-09-17 17:15:26;ROTI;ROTI 2000;2;2000;0;4000;3600;400;
2021-09-17 17:25:05;6907992823966;JD BLUEBERRY;2;3500;0;7000;6000;1000;
2021-09-17 17:28:36;KIKO;KIKO;2;1000;0;2000;1000;1000;
2021-09-17 17:28:36;GGK;PLAYGUM PERMEN KARET;4;500;0;2000;1600;400;
2021-09-17 17:30:45;8999999195656;SARIWANGI 50X1.85;1;10000;0;10000;9405;595;
2021-09-17 17:34:14;8999999524838;SUNLIGHT MINT POUCH 755ML;1;18000;0;18000;15950;2050;
2021-09-17 17:44:41;8993989311279;CLAS MILD 12;1;18000;0;18000;15800;2200;
2021-09-17 18:06:50;8992696404441;BEAR BRAND 189ML;1;13000;0;13000;11000;2000;
2021-09-17 18:23:58;8991102022460;FORMULA DIAMOND;1;3000;0;3000;2500;500;
2021-09-17 19:20:16;8992761111540;FANTA STRAWBERY SLIM CAM 250ML;2;5000;0;10000;7500;2500;
2021-09-17 19:20:16;8998989300261;GUDANG GARAM SURYA 12 FILTER;1;20000;0;20000;18150;1850;
2021-09-17 19:20:16;8999909000377;SAMPOERNA AVOLUTION;1;31000;0;31000;29450;1550;
2021-09-17 19:20:16;8997028590052;ARGUS BTL 600ML;1;3000;0;3000;1458;1542;
2021-09-17 19:22:41;896867700494;AIR CLUB 1500ML;1;5000;0;5000;2987;2013;
2021-09-17 19:22:41;8992775318201;GERY SNACK BANTAL COKLAT;1;2000;0;2000;1712;288;
2021-09-17 19:22:41;8991002121003;GOOD DAY TIRAMISU BLISS;1;6000;0;6000;4295;1705;
2021-09-17 19:22:41;7622300405588;KEJUCAKE 16G;1;2000;0;2000;1641;359;
2021-09-17 20:37:05;8992959953037;SWEETY BRONZE L1;2;2500;0;5000;3638;1362;
2021-09-17 20:42:55;8999999516208;ROYCO FDS CHICKEN NEW 230G;2;10000;0;20000;18000;2000;
2021-09-17 20:44:15;ROTI;ROTI 2000;1;2000;0;2000;1800;200;
2021-09-17 20:44:55;089686386127;BUMBU RACIK NASI GORENG SOSIS;1;2000;0;2000;1620;380;
2021-09-17 20:45:32;8997028590052;ARGUS BTL 600ML;1;3000;0;3000;1458;1542;
2021-09-17 20:46:01;8998866202244;EKOMIE BUMBU KALDU AYAM;1;1000;0;1000;798;202;
2021-09-17 20:46:32;ROTI;ROTI 2000;1;2000;0;2000;1800;200;
2021-09-17 20:47:30;8991102026383;AIR CRYSTALINE 1.5 L;1;5000;0;5000;3471;1529;
2021-09-17 20:47:56;8994075230870;momogi;2;500;0;1000;900;100;
2021-09-17 20:48:30;Vita Jelly;Vita Jelly;2;1000;0;2000;1532;468;
2021-09-17 20:51:05;8999999195649;SARIWANGI 25X1.86G;1;6000;0;6000;5202;798;
2021-09-17 20:51:40;SURYA;SURYA;3;500;0;1500;1500;0;
2021-09-17 20:52:05;Gula gula tusuk;gula gula tusuk;1;500;0;500;400;100;
2021-09-17 20:53:52;8998989500166;GUDANG GARAM MERAH BESAR 16KS;1;18000;0;18000;17000;1000;
2021-09-17 20:54:16;8995555171225;KIMBO SOSIS;1;1000;0;1000;900;100;
2021-09-17 20:54:53;8992775305003 pcs;Gery Salut Coklat pcs;1;1000;0;1000;812;188;
2021-09-17 20:55:29;0105312686040047;yakult;2;2000;0;4000;3000;1000;
2021-09-17 20:56:06;8998866202602;KRISBEE FRENCH FRIES 18GR;2;2000;0;4000;3000;1000;
2021-09-17 20:56:53;ICE CREAM 5.000;ICE CREAM 5.000;1;5000;0;5000;4700;300;
2021-09-17 20:58:09;089686021219;INTER MIE GORENG;1;1000;0;1000;885;115;
2021-09-17 20:58:36;Vita Jelly;Vita Jelly;1;1000;0;1000;766;234;
2021-09-17 21:15:06;ICE CREAM 5;ICE CREAM 5000;1;5000;0;5000;4400;600;
2021-09-17 21:20:12;8991102020305;FORMULA TRIPLE ACTION;1;3000;0;3000;2500;500;
2021-09-17 21:26:00;089686535044;SUN BERAS MERAH;1;8500;0;8500;7410;1090;
2021-09-17 21:26:00;8997027300089;NOMOS;1;4000;0;4000;2963;1037;
2021-09-17 21:26:00;JGR SHN;JOGER SHINY SACHET;2;500;0;1000;874;126;
2021-09-17 21:26:00;8999909002821;MARLBORO BLACK 16;1;22000;0;22000;20850;1150;
2021-09-17 21:26:00;8995555121244;SOSIS KIMBO;3;1000;0;3000;1950;1050;
2021-09-17 21:42:41;8998866100717;MAMALIME POUCH 780ML;1;15500;0;15500;13850;1650;
2021-09-17 21:42:41;8992979130012;TOTAL LEMON SOFTENER;1;13000;0;13000;11532;1468;
2021-09-17 21:42:41;8992696404441;BEAR BRAND 189ML;1;13000;0;13000;11000;2000;
2021-09-17 21:42:41;8997009510055;YOU C1000;1;15000;0;15000;13000;2000;
2021-09-17 22:02:07;8992759218046;JOLLY KLNR FCL CR LUNAK EMBOSS 10 ROLL;2;9000;0;18000;16150;1850;
2021-09-17 22:02:07;GL;GULA 1 LITER;4;11500;0;46000;42000;4000;
2021-09-17 22:06:53;8991102026383;AIR CRYSTALINE 1.5 L;1;5000;0;5000;3471;1529;
2021-09-17 22:11:37;JGR SHN;JOGER SHINY SACHET;1;500;0;500;437;63;
2021-09-17 22:14:13;8998989110167;SURYA GUDANG GARAM 16 FILTER;1;26000;0;26000;23700;2300;
2021-09-17 22:40:57;OJELLY;O'JELLY;1;500;0;500;385;115;
2021-09-17 22:40:57;ROTI;ROTI 2000;1;2000;0;2000;1800;200;
2021-09-17 22:40:57;JGR SHN;JOGER SHINY SACHET;2;500;0;1000;874;126;
2021-09-17 22:40:57;8997218380135;ICHITAN GREEN TEA;1;8000;0;8000;6583;1417;
2021-09-18 11:22:20;8991102987875;WFR TANGO POUCH CKL 115G;2;8000;0;16000;13572;2428;
2021-09-18 11:22:20;8991102320184;TANGO CHOCO JAVAMOCCA;3;5000;0;15000;12990;2010;
2021-09-18 11:22:20;8991102994422;TANGO WALUT CHOCOBNN 18G;1;9000;0;9000;8661;339;
2021-09-18 11:29:36;TBR;TEPUNG BERAS ROSE BRAND;1;8000;0;8000;5800;2200;
2021-09-18 11:29:36;089686048704;SARIMIE GORENG AYAM KCP ISI 2;1;3500;0;3500;3120;380;
2021-09-18 11:29:36;8992705025124;AGAR-AGAR SATELIT MERAH;1;3500;0;3500;2604;896;
2021-09-18 11:29:36;8992705035123;AGAR-AGAR SATELIT COKLAT;1;3500;0;3500;2604;896;
2021-09-18 11:29:36;8992705045122;AGAR-AGAR SATELIT HIJAU;2;3500;0;7000;5208;1792;
2021-09-18 11:29:36;RT;ROTI;1;9000;0;9000;8000;1000;
2021-09-18 11:29:36;8997025914042;ATB MARIE SUSU 185G;1;7000;0;7000;4554;2446;
2021-09-18 11:29:36;8997028590052;ARGUS BTL 600ML;3;3000;0;9000;4374;4626;
2021-09-18 11:29:36;8999909096004;SAMPOERNA 16 FILTER;3;25000;0;75000;69300;5700;
2021-09-18 11:29:36;8992775203422;GARUDA ROSTA OVEN BAWANG 100G;1;8000;0;8000;7322;678;
2021-09-18 11:29:36;7622300335809;OREO SOFT CAKE;1;2000;0;2000;1641;359;
2021-09-18 11:29:36;8992761139018;ADES 600ML;1;3500;0;3500;2166;1334;
2021-09-18 11:29:36;8997028590014;ARGUS 220ML;2;500;0;1000;604;396;
2021-09-18 11:29:36;8998866610223;DAIA VIOLET BAG 850G & PIRING;1;18000;0;18000;15627;2373;
2021-09-18 11:29:36;ROTI;ROTI 2000;2;2000;0;4000;3600;400;
2021-09-18 11:29:36;8997009510055;YOU C1000;3;15000;0;45000;39000;6000;
2021-09-18 11:29:36;8992696404441;BEAR BRAND 189ML;1;13000;0;13000;11000;2000;
2021-09-18 11:29:36;8997028590045;ARGUS BTL 330ML;1;2000;0;2000;1291;709;
2021-09-18 11:29:36;8992775318201;GERY SNACK BANTAL COKLAT;1;2000;0;2000;1712;288;
2021-09-18 11:29:36;8991001242013;Top;1;1000;0;1000;500;500;
2021-09-18 11:29:36;8992696523067;MILO ACTVGO UHT 180ML;1;4500;0;4500;3515;985;
2021-09-18 11:29:36;8992959117613;SFX DAUN SIRIH 1 WP;4;500;0;2000;1652;348;
2021-09-18 11:29:36;8991001502926;Chaca Peanut;1;1000;0;1000;800;200;
2021-09-18 11:29:36;KIKO;KIKO;1;1000;0;1000;500;500;
2021-09-18 11:34:52;ABC;BATERAI ABC BIRU;1;9000;0;9000;7712;1288;
2021-09-18 11:44:19;8993989311279;CLAS MILD 12;1;18000;0;18000;15800;2200;
2021-09-18 12:02:14;8998989300261;GUDANG GARAM SURYA 12 FILTER;1;20000;0;20000;18150;1850;
2021-09-18 13:41:24;6907992823942;JD JUJUBE;1;4500;0;4500;3800;700;
2021-09-18 13:41:24;8991001111883;SILVERQUEEN CHUNKYBAR 33G;1;8000;0;8000;7150;850;
2021-09-18 13:41:24;8999999516208;ROYCO FDS CHICKEN NEW 230G;1;10000;0;10000;9000;1000;
2021-09-18 13:41:24;OJELLY;O'JELLY;1;500;0;500;385;115;
2021-09-18 13:41:24;8991001502926;Chaca Peanut;1;1000;0;1000;800;200;
2021-09-18 14:04:19;8850507001152;MOTU ATV;1;10000;0;10000;8000;2000;
2021-09-18 14:04:19;7622201430184;OREO ORIGINAL 38G;2;2000;0;4000;3282;718;
2021-09-18 14:18:31;089686611670;QTELA BALADO;1;5000;0;5000;4266;734;
2021-09-18 14:18:31;8997003910684;2CS;1;3000;0;3000;1500;1500;
2021-09-18 14:18:31;8991102987875;WFR TANGO POUCH CKL 115G;1;8000;0;8000;6786;1214;
2021-09-18 14:18:31;8999988778846;LASEGAR;1;6500;0;6500;5700;800;
2021-09-18 14:18:31;8998866201490;POTABEE REGULER GRILLED SEAWED 68 GR;1;8000;0;8000;7200;800;
2021-09-18 14:18:31;8996001318980;BETTER 120G;1;6000;0;6000;5100;900;
2021-09-18 14:53:45;8992761166212;FRESTEA APPLE 350ML;3;4500;0;13500;9000;4500;
2021-09-18 14:53:45;8992761145026;SPRITE PET 250ML;5;3500;0;17500;12085;5415;
2021-09-18 15:23:23;8992761145026;SPRITE PET 250ML;2;3500;0;7000;4834;2166;
2021-09-18 15:39:14;8991111101507;JB POWDER BLOSSOM 50G;1;3500;0;3500;3000;500;
2021-09-18 15:39:14;8998866603546;SOKLIN FLOORCLENER UNGU 450ML;1;7000;0;7000;6385;615;
2021-09-18 15:48:15;8998989110167;SURYA GUDANG GARAM 16 FILTER;1;26000;0;26000;23700;2300;
2021-09-18 15:48:15;123124;KOREK BIASA;1;2000;0;2000;1300;700;
2021-09-18 15:48:15;Gula gula tusuk;gula gula tusuk;4;500;0;2000;1600;400;
2021-09-18 15:56:01;8992959071205;HN PANTS M20;1;32000;0;32000;29091;2909;
2021-09-18 15:59:20;8998009010569;ULTRA CHO 200;1;5000;0;5000;3830;1170;
2021-09-18 16:05:36;18992628503171;SIMAS 5KG;1;95000;0;95000;89000;6000;
2021-09-18 16:05:36;8995333060703;TERIGU KOMPAS 1KG;20;10500;0;210000;196320;13680;
2021-09-18 16:05:36;GLK;GULATA 50KG;1;620000;0;620000;592000;28000;
2021-09-18 16:44:32;8886022971298;BATERAI ALKALINE 06;1;12000;0;12000;10557;1443;
2021-09-18 17:18:39;8994867007161;ROKOK PENA GOLD 20;1;18000;0;18000;16800;1200;
2021-09-18 17:45:43;8992959953198;SWEETY BRONZE XL 26+2;1;60000;0;60000;54091;5909;
2021-09-18 17:45:43;8998009010569;ULTRA CHO 200;1;5000;0;5000;3830;1170;
2021-09-18 17:51:28;8999999559533;LIFEBUOY BW TOTAL 10 90ML;1;5000;0;5000;4000;1000;
2021-09-18 17:57:09;8999999036546;LUX BW WHITE VELVET 250ML;1;20000;0;20000;17900;2100;
2021-09-18 17:57:09;711844110113;KECAP ABC 135 ML;1;7000;0;7000;6400;600;
2021-09-18 17:57:09;8992870311091;SALONPAS;1;6000;0;6000;4806;1194;
2021-09-18 17:57:09;Pulpen;pulpen;1;1000;0;1000;750;250;
2021-09-18 18:35:43;089686043617;INDOMIE MIEGHETTI;2;2700;0;5400;4904;496;
2021-09-18 18:35:43;089686010343;INDOMIE SOTO MIE;1;2600;0;2600;2367;233;
2021-09-18 19:04:31;8997028590014;ARGUS 220ML;10;500;0;5000;3020;1980;
2021-09-18 19:08:45;6907992825069;JD FRUITY;2;5000;0;10000;8800;1200;
2021-09-18 19:35:36;6907992823942;JD JUJUBE;1;4500;0;4500;3800;700;
2021-09-18 19:35:36;8992775318201;GERY SNACK BANTAL COKLAT;2;2000;0;4000;3424;576;
2021-09-18 19:35:36;KIKO;KIKO;2;1000;0;2000;1000;1000;
2021-09-18 19:44:39;8993226365522;GARAM MEJA GYURI 200GR;1;2000;0;2000;1700;300;
2021-09-18 19:44:39;8997021110028;Garam;1;2500;0;2500;1500;1000;
2021-09-18 20:23:36;0105312686040047;yakult;1;2000;0;2000;1500;500;
2021-09-18 20:23:36;8992957220025;GOLDEN CITY MINI;1;3000;0;3000;2500;500;
2021-09-18 20:27:50;8999909002821;MARLBORO BLACK 16;1;22000;0;22000;20850;1150;
2021-09-18 20:47:20;8999988778846;LASEGAR;1;6500;0;6500;5700;800;
2021-09-18 20:47:20;8998989300261;GUDANG GARAM SURYA 12 FILTER;1;20000;0;20000;18150;1850;
2021-09-18 20:48:26;8991909101016;URBAN MILD 16;1;17000;0;17000;15800;1200;
2021-09-18 20:48:26;8998866202602;KRISBEE FRENCH FRIES 18GR;6;2000;0;12000;9000;3000;
2021-09-18 20:50:46;8999988778846;LASEGAR;1;6500;0;6500;5700;800;
2021-09-18 20:50:46;8993007000024;INDOMILK UHT VANILA;1;5000;0;5000;3470;1530;
2021-09-18 20:50:46;8992388133345;NU MILK TEA TEH TARIK 330ML;1;6000;0;6000;5125;875;
2021-09-18 20:50:46;ROTI;ROTI 2000;1;2000;0;2000;1800;200;
2021-09-18 20:50:46;MARS;MARSHMELLOW;1;500;0;500;433;67;
2021-09-18 20:51:04;8998989500166;GUDANG GARAM MERAH BESAR 16KS;2;18000;0;36000;34000;2000;
2021-09-18 20:57:33;8994867000179;ROKOK PENA MILD 16;1;14500;0;14500;13500;1000;
2021-09-18 21:00:36;8999909028234;234 DJI SAM SOE 12;1;17500;0;17500;15850;1650;
2021-09-18 21:06:51;8992959953037;SWEETY BRONZE L1;2;2500;0;5000;3638;1362;
2021-09-18 21:11:04;OJELLY;O'JELLY;1;500;0;500;385;115;
2021-09-18 21:12:16;8992696523081;MILO UHT 110ML;2;2500;0;5000;3924;1076;
2021-09-18 21:18:32;8998866200646;KOPI TOP MURNI;1;11000;0;11000;9600;1400;
2021-09-18 21:20:39;ARG;ARGUS DOS 220ML;1;14500;0;14500;13300;1200;
2021-09-19 11:01:54;8999999558086;RINSO MOLTO FERFUME ESSENSE PWD 44G;1;1000;0;1000;805;195;
2021-09-19 11:01:54;8999909982000;SAMPOERNA 12 FILTER;1;19000;0;19000;16600;2400;
2021-09-19 11:01:54;8995555121244;SOSIS KIMBO;3;1000;0;3000;1950;1050;
2021-09-19 11:01:54;VTM;VITAMIN CIMIN;7;500;0;3500;2975;525;
2021-09-19 11:01:54;GGK;PLAYGUM PERMEN KARET;1;500;0;500;400;100;
2021-09-19 11:01:54;ROTI;ROTI 2000;2;2000;0;4000;3600;400;
2021-09-19 11:01:54;8997025911058;HATARI SHP KELAPA;1;6000;0;6000;4911;1089;
2021-09-19 11:01:54;8992628020152;MINYAK GOREG BIMOLI POUCH 2L;1;32000;0;32000;29800;2200;
2021-09-19 11:01:54;8993007001359;INDOMILK KM SCT 37G;2;1500;0;3000;2166;834;
2021-09-19 11:01:54;8998866200325;MIE SEDAAP SOTO;2;2700;0;5400;4564;836;
2021-09-19 11:01:54;Telur 3 Biji;Telur 3 Biji;1;5000;0;5000;3600;1400;
2021-09-19 11:01:54;8999999533717;CITRA TS FRESH WHITE 70G;1;2200;0;2200;1900;300;
2021-09-19 11:01:54;8992694247163;ZWITSAL SOAP RICH N HON 70G;1;4000;0;4000;3410;590;
2021-09-19 11:01:54;8998866100717;MAMALIME POUCH 780ML;1;15500;0;15500;13850;1650;
2021-09-19 11:01:54;GL;GULA 1 LITER;1;11500;0;11500;10500;1000;
2021-09-19 11:24:58;KIKO;KIKO;4;1000;0;4000;2000;2000;
2021-09-19 12:09:19;8998989300261;GUDANG GARAM SURYA 12 FILTER;1;20000;0;20000;18150;1850;
2021-09-19 12:30:02;8993007001694;INDOMILK SKM 37G;1;7500;0;7500;6500;1000;
2021-09-19 12:30:02;8998898830125;KKB ENER-G ANGGUR;1;5500;0;5500;4824;676;
2021-09-19 12:33:57;8998866608459;POWDET DAIA PUTIH BAG 290GR;1;5000;0;5000;4450;550;
2021-09-19 12:34:47;8991102022460;FORMULA DIAMOND;1;3000;0;3000;2500;500;
2021-09-19 12:34:47;8998866609043;DAIA SOFTENER GUSSET 565G;1;10000;0;10000;8700;1300;
2021-09-19 13:19:49;089686043273;INDOMIE SAMBAL RICA;1;2700;0;2700;2452;248;
2021-09-19 13:19:49;Telur 3 Biji;Telur 3 Biji;1;5000;0;5000;3600;1400;
2021-09-19 13:44:58;ROTI;ROTI 2000;1;2000;0;2000;1800;200;
2021-09-19 14:18:21;8994867000179;ROKOK PENA MILD 16;2;14500;0;29000;27000;2000;
2021-09-19 14:23:03;8998866200325;MIE SEDAAP SOTO;2;2700;0;5400;4564;836;
2021-09-19 14:23:03;8998866200578;MIE SEDAAP KARI KENTAL;1;2700;0;2700;2331;369;
2021-09-19 14:23:03;8998866200301;MIE SEDAAP GORENG;2;2700;0;5400;4726;674;
2021-09-19 14:29:19;089686021219;INTER MIE GORENG;2;1000;0;2000;1770;230;
2021-09-19 14:38:57;8994867000162;ROKOK PUNDIMAS KRETEK16;2;10000;0;20000;17200;2800;
2021-09-19 14:38:57;6907992823829;JD MILKY MILK;1;3000;0;3000;2600;400;
2021-09-19 14:38:57;6907992825076;JD WATERMELON APPLE;1;2000;0;2000;1700;300;
2021-09-19 14:49:14;8995555171225;KIMBO SOSIS;1;1000;0;1000;900;100;
2021-09-19 14:49:14;OJELLY;O'JELLY;2;500;0;1000;770;230;
2021-09-19 14:50:27;8995555171225;KIMBO SOSIS;3;1000;0;3000;2700;300;
2021-09-19 14:50:27;8997028590014;ARGUS 220ML;2;500;0;1000;604;396;
2021-09-19 14:58:11;8991001503336;chacha minis hat;1;7500;0;7500;6400;1100;
2021-09-19 15:03:59;8994834006128;TICTIC PEDAS;2;2000;0;4000;3400;600;
2021-09-19 15:03:59;8991002103238;GOOD DAY MOCACINNO;4;1500;0;6000;3560;2440;
2021-09-19 15:03:59;089686021127;INTER MIE KALDU;1;1000;0;1000;813;187;
2021-09-19 15:03:59;8992770033178;Masako;2;500;0;1000;900;100;
2021-09-19 15:09:04;8995555121244;SOSIS KIMBO;3;1000;0;3000;1950;1050;
2021-09-19 15:09:04;Gula gula tusuk;gula gula tusuk;2;500;0;1000;800;200;
2021-09-19 16:12:37;8992696404441;BEAR BRAND 189ML;1;15000;0;15000;11000;4000;
2021-09-19 16:20:44;6907992825076;JD WATERMELON APPLE;1;2000;0;2000;1700;300;
2021-09-19 16:20:44;8999909085114;SAMPOERNA KRETEK HIJAU 12;1;13000;0;13000;11650;1350;
2021-09-19 16:40:03;8992696405417;DNCO INSTANT 27G;3;3500;0;10500;9000;1500;
2021-09-19 17:36:40;Vita Jelly;Vita Jelly;1;1000;0;1000;766;234;
2021-09-19 17:45:25;089686060362;POP MIE SOTO AYAM JUMBO;3;4500;0;13500;11499;2001;
2021-09-19 17:45:25;8999999059781;SUNLIGHT LIME NEW POUCH 210ML;1;5000;0;5000;4520;480;
2021-09-19 18:13:41;76164217;MARLBORO MERAH;2;30000;0;60000;55400;4600;
2021-09-19 18:13:41;8992696404441;BEAR BRAND 189ML;2;15000;0;30000;22000;8000;
2021-09-19 18:13:41;8997009510055;YOU C1000;2;15000;0;30000;26000;4000;
2021-09-19 18:18:55;8999909002821;MARLBORO BLACK 16;1;22000;0;22000;20850;1150;
2021-09-19 18:33:49;JGR SHN;JOGER SHINY SACHET;2;500;0;1000;874;126;
2021-09-19 18:33:49;8997009510123;ORANGE WATER;1;11000;0;11000;10416;584;
2021-09-19 18:38:48;8992696404441;BEAR BRAND 189ML;1;15000;0;15000;11000;4000;
2021-09-19 18:40:47;8997028590052;ARGUS BTL 600ML;2;3000;0;6000;2916;3084;
2021-09-19 18:40:47;8992761166212;FRESTEA APPLE 350ML;1;4500;0;4500;3000;1500;
2021-09-19 18:40:47;8992696523067;MILO ACTVGO UHT 180ML;1;4500;0;4500;3515;985;
2021-09-19 18:40:47;8995555121244;SOSIS KIMBO;1;1000;0;1000;650;350;
2021-09-19 18:40:47;8992775000076;GERY SNACK RING CKLT;1;2000;0;2000;1712;288;
2021-09-19 19:17:39;ROTI;ROTI 2000;1;2000;0;2000;1800;200;
2021-09-19 19:17:39;8999909028234;234 DJI SAM SOE 12;1;17500;0;17500;15850;1650;
2021-09-19 19:21:08;8998989110167;SURYA GUDANG GARAM 16 FILTER;1;26000;0;26000;23700;2300;
2021-09-19 19:21:08;089686060027;POP MIE AYAM JUMBO;1;4500;0;4500;3833;667;
2021-09-19 19:21:08;8998009010569;ULTRA CHO 200;1;5000;0;5000;3830;1170;
2021-09-19 19:21:08;KIKO;KIKO;1;1000;0;1000;500;500;
2021-09-19 19:21:08;ARG;ARGUS DOS 220ML;1;14500;0;14500;13300;1200;
2021-09-19 19:21:08;ROTI;ROTI 2000;2;2000;0;4000;3600;400;
2021-09-19 19:21:08;8998866202602;KRISBEE FRENCH FRIES 18GR;1;2000;0;2000;1500;500;
2021-09-19 19:34:56;8992222050418;GATSBY NORMAL 38GR;1;5000;0;5000;3850;1150;
2021-09-19 20:03:27;8999999048174;SUNSILK  BLK SHINE 70+21ML;1;9600;0;9600;8525;1075;
2021-09-19 20:04:31;8998989300261;GUDANG GARAM SURYA 12 FILTER;1;20000;0;20000;18150;1850;
2021-09-19 20:04:31;ROTI;ROTI 2000;2;2000;0;4000;3600;400;
2021-09-19 20:30:18;8997027300089;NOMOS;1;4000;0;4000;2963;1037;
2021-09-19 20:32:16;8998866608718;DAIA SOFTENER PINK;1;5000;0;5000;4450;550;
2021-09-19 20:32:16;SKT;SIKAT CUCI;1;6000;0;6000;5000;1000;
2021-09-19 20:32:16;RB;RED BOLD;1;20000;0;20000;18800;1200;
2021-09-19 20:34:57;ARG;ARGUS DOS 220ML;3;14500;0;43500;39900;3600;
2021-09-19 20:42:38;6907992825076;JD WATERMELON APPLE;1;2000;0;2000;1700;300;
2021-09-19 20:42:38;Vita Jelly;Vita Jelly;1;1000;0;1000;766;234;
2021-09-19 20:45:33;JGR SHN;JOGER SHINY SACHET;6;500;0;3000;2622;378;
2021-09-19 20:45:33;8991909101016;URBAN MILD 16;1;17000;0;17000;15800;1200;
2021-09-19 21:16:09;8998866608725;DAIA SOFTENER BAG 850G;1;18000;0;18000;15627;2373;
2021-09-19 21:16:09;8999999525675;MOLTO HYGIENE 720ML;1;28000;0;28000;25150;2850;
2021-09-19 21:45:40;Vita Jelly;Vita Jelly;1;1000;0;1000;766;234;
2021-09-19 22:11:17;8997027300089;NOMOS;1;4000;0;4000;2963;1037;
2021-09-19 22:11:17;8993470672827;SAKU-SAKU SAPI PANGGANG;1;2000;0;2000;1530;470;
2021-09-19 22:11:17;8997013790108;BIMURA KACANG TELUR 25G;1;1000;0;1000;875;125;
2021-09-19 22:25:52;8999999001162;LIFEBUOY BW MILDCARE BTL 300ML;1;24000;0;24000;21550;2450;
2021-09-19 22:25:52;8999999049669;REXONA MEN RO INVISIBLE DRY 45 ML;1;15000;0;15000;13550;1450;
2021-09-19 22:40:39;8997009510055;YOU C1000;3;15000;0;45000;39000;6000;
2021-09-19 22:40:39;8992696404441;BEAR BRAND 189ML;3;15000;0;45000;33000;12000;
2021-09-19 22:40:39;4902430553636;HEAD & shoulders;1;25000;0;25000;18900;6100;
2021-09-19 22:40:39;TUSTEL;TUSUK TELINGA;1;1000;0;1000;833;167;
2021-09-19 22:40:39;8995555171225;KIMBO SOSIS;1;1000;0;1000;900;100;
2021-09-19 22:43:48;7992912508305;SWEETY SILVER PANTS L1;2;2500;0;5000;3764;1236;
2021-09-19 22:43:48;8992959117613;SFX DAUN SIRIH 1 WP;4;500;0;2000;1652;348;
2021-09-19 22:43:48;8992696521797;MILO 22G;2;2500;0;5000;3144;1856;
2021-09-19 22:43:48;8991102228053;TEH GELAS BOTOL;1;3000;0;3000;1695;1305;
2021-09-20 10:39:56;8998009010569;ULTRA CHO 200;1;5000;0;5000;3830;1170;
2021-09-20 10:39:56;8998866200301;MIE SEDAAP GORENG;3;2700;0;8100;7089;1011;
2021-09-20 10:39:56;8993110071126;SONICE SOSIS SAPI;1;24000;0;24000;23500;500;
2021-09-20 10:39:56;8995555171225;KIMBO SOSIS;2;1000;0;2000;1800;200;
2021-09-20 10:39:56;8997003910684;2CS;2;3000;0;6000;3000;3000;
2021-09-20 10:39:56;8999999059316;LIFEBUOY TS MILDCARE 75G;1;3000;0;3000;2640;360;
2021-09-20 10:56:15;8992696523067;MILO ACTVGO UHT 180ML;2;4500;0;9000;7030;1970;
2021-09-20 10:56:15;8993470279651;JOGER CHOCKY BAR;1;1000;0;1000;867;133;
2021-09-20 12:15:22;8998866107099;WET WIPES KODOMO BABY 50SHT CLSSC;1;20000;0;20000;14150;5850;
2021-09-20 15:37:58;8994867000162;ROKOK PUNDIMAS KRETEK16;1;10000;0;10000;8600;1400;
2021-09-20 16:09:03;8999988778846;LASEGAR;1;6500;0;6500;5700;800;
2021-09-20 16:09:03;8998989300261;GUDANG GARAM SURYA 12 FILTER;1;20000;0;20000;18150;1850;
2021-09-20 16:17:34;8991002103337;GOOD DAY VANILLA;2;1500;0;3000;1780;1220;
2021-09-20 16:17:34;8991102320184;TANGO CHOCO JAVAMOCCA;1;5000;0;5000;4330;670;
2021-09-20 16:24:30;ARG;ARGUS DOS 220ML;1;14500;0;14500;13300;1200;
2021-09-20 16:30:04;8992761145019;COCA COLA PET 250ML;1;3500;0;3500;2417;1083;
2021-09-20 16:43:54;8994867007161;ROKOK PENA GOLD 20;1;18000;0;18000;16800;1200;
2021-09-20 17:13:02;8996001301579;MALKIST CKLT KELAPA PACK;1;6500;0;6500;5400;1100;
2021-09-20 17:13:02;8996001305058;ROMA SANDWICH KACANG;1;7000;0;7000;5928;1072;
2021-09-20 17:13:02;8991102023115;Sikat Gigi Formula;1;11000;0;11000;10000;1000;
2021-09-20 17:19:11;KIKO;KIKO;6;1000;0;6000;3000;3000;
2021-09-20 17:19:11;OJELLY;O'JELLY;2;500;0;1000;770;230;
2021-09-20 17:19:11;8997028590014;ARGUS 220ML;10;500;0;5000;3020;1980;
2021-09-20 17:40:28;8991002103337;GOOD DAY VANILLA;1;1500;0;1500;890;610;
2021-09-20 17:40:28;8991002103832;GOOD DAY CHOCOCINNO;1;1500;0;1500;890;610;
2021-09-20 17:40:28;GL;GULA 1 LITER;1;11500;0;11500;10500;1000;
2021-09-20 17:40:28;OJELLY;O'JELLY;1;500;0;500;385;115;
2021-09-20 17:41:28;8992870311091;SALONPAS;1;6000;0;6000;4806;1194;
2021-09-20 17:52:22;8994935000070;MINYAK GORENG DUNIA 450 ML;1;7500;0;7500;6779;721;
2021-09-20 17:52:22;8996001314005;ROMA KELAPA CREAM CKLT;1;8000;0;8000;6642;1358;
2021-09-20 18:20:07;089686041705;INDOMIE GORENG JUMBO;1;3500;0;3500;3143;357;
2021-09-20 18:22:09;8998866200301;MIE SEDAAP GORENG;2;2700;0;5400;4726;674;
2021-09-20 18:22:09;8995555121244;SOSIS KIMBO;2;1000;0;2000;1300;700;
2021-09-20 18:22:09;8997028590052;ARGUS BTL 600ML;1;3000;0;3000;1458;1542;
2021-09-20 18:59:58;8991102026383;AIR CRYSTALINE 1.5 L;1;5000;0;5000;3471;1529;
2021-09-20 19:01:51;8997009510055;YOU C1000;1;15000;0;15000;13000;2000;
2021-09-20 19:01:51;8992696404441;BEAR BRAND 189ML;1;15000;0;15000;11000;4000;
2021-09-20 19:10:25;8998866604963;POWDET DAIA LEMON 290GR;1;5000;0;5000;4450;550;
2021-09-20 19:10:25;8991002105430;KAPAL API 65G;1;5000;0;5000;4145;855;
2021-09-20 19:10:25;8992775511206;LEO 10GR;1;1000;0;1000;848;152;
2021-09-20 19:10:25;8996001305119;ARDEN 30G;1;2000;0;2000;1650;350;
2021-09-20 19:10:25;8998866202602;KRISBEE FRENCH FRIES 18GR;1;2000;0;2000;1500;500;
2021-09-20 19:32:00;8992696404441;BEAR BRAND 189ML;1;15000;0;15000;11000;4000;
2021-09-20 19:35:59;8998989500166;GUDANG GARAM MERAH BESAR 16KS;1;18000;0;18000;17000;1000;
2021-09-20 19:51:20;8998989300261;GUDANG GARAM SURYA 12 FILTER;1;20000;0;20000;18150;1850;
2021-09-20 19:52:10;Vita Jelly;Vita Jelly;1;1000;0;1000;766;234;
2021-09-20 20:21:49;OJELLY;O'JELLY;3;500;0;1500;1155;345;
2021-09-20 20:26:04;ROTI;ROTI 2000;1;2000;0;2000;1800;200;
2021-09-20 20:32:25;8993989311699;CLAS MILD 16 FILTER;1;24000;0;24000;21700;2300;
2021-09-20 20:40:36;7992912508305;SWEETY SILVER PANTS L1;2;2500;0;5000;3764;1236;
2021-09-20 20:43:02;8999999516208;ROYCO FDS CHICKEN NEW 230G;1;10000;0;10000;9000;1000;
2021-09-20 22:20:40;7622300761349;OREO MINI CKLT;1;7500;0;7500;6500;1000;
2021-09-21 10:53:45;8991001503336;chacha minis hat;1;7500;0;7500;6400;1100;
2021-09-21 10:53:45;8998989300261;GUDANG GARAM SURYA 12 FILTER;1;20000;0;20000;18150;1850;
2021-09-21 11:06:42;8996001305119;ARDEN 30G;1;2000;0;2000;1650;350;
2021-09-21 11:06:42;8992775511206;LEO 10GR;3;1000;0;3000;2544;456;
2021-09-21 11:06:42;8992959850046;CONFI PANTS M10;1;80000;0;80000;75120;4880;
2021-09-21 11:06:42;8999999059781;SUNLIGHT LIME NEW POUCH 210ML;1;5000;0;5000;4520;480;
2021-09-21 11:06:42;8999999571887;MOLTO EDP PURPLE 10ML;1;5000;0;5000;4800;200;
2021-09-21 11:06:42;8992775318201;GERY SNACK BANTAL COKLAT;1;2000;0;2000;1712;288;
2021-09-21 11:06:42;8995555171225;KIMBO SOSIS;1;1000;0;1000;900;100;
2021-09-21 11:06:42;8997204370126;Siko;1;10000;0;10000;8333;1667;
2021-09-21 11:06:42;8997025911058;HATARI SHP KELAPA;1;6000;0;6000;4911;1089;
2021-09-21 11:06:42;GL;GULA 1 LITER;2;11500;0;23000;21000;2000;
2021-09-21 11:06:42;WC;WAFER COKELAT MADE;1;1000;0;1000;800;200;
2021-09-21 11:06:42;8993470279651;JOGER CHOCKY BAR;1;1000;0;1000;867;133;
2021-09-21 11:06:42;8992959508930;SWEETY SILVER PANTS L 54;1;108000;0;108000;99697;8303;
2021-09-21 11:06:42;ROTI;ROTI 2000;2;2000;0;4000;3600;400;
2021-09-21 11:06:42;8991188943062;SASA 250G;1;10000;0;10000;8500;1500;
2021-09-21 11:06:42;jagung marning;jagung marning;1;5000;0;5000;4500;500;
2021-09-21 11:06:42;8997028590052;ARGUS BTL 600ML;1;3000;0;3000;1458;1542;
2021-09-21 11:06:42;8992959117583;SFX DS REG FLOW WING 20;1;5000;0;5000;4288;712;
2021-09-21 11:09:07;Telur 3 Biji;Telur 3 Biji;1;5000;0;5000;3600;1400;
2021-09-21 11:09:07;8998866200301;MIE SEDAAP GORENG;1;2700;0;2700;2363;337;
2021-09-21 11:09:07;KERUPUK 1000;KERUPUK BALADO;2;1000;0;2000;1800;200;
2021-09-21 11:09:07;KOPIKO;KOPIKO;1;250;0;250;175;75;
2021-09-21 11:26:27;8996001301579;MALKIST CKLT KELAPA PACK;1;6500;0;6500;5400;1100;
2021-09-21 11:26:27;ROTI;ROTI 2000;1;2000;0;2000;1800;200;
2021-09-21 11:41:42;8994867007161;ROKOK PENA GOLD 20;1;18000;0;18000;16800;1200;
2021-09-21 11:59:26;8991102300544;WFR TANGO VNL 176G;1;10000;0;10000;8694;1306;
2021-09-21 11:59:26;8991102300421;WFR TANGO COKLAT 176GR;1;10000;0;10000;8694;1306;
2021-09-21 14:52:32;8998866200882;SUKSESMIE GORENG AYAM KRMS 133GR;1;3500;0;3500;3047;453;
2021-09-21 14:54:06;6907992825076;JD WATERMELON APPLE;1;2000;0;2000;1700;300;
2021-09-21 14:54:06;6907992823942;JD JUJUBE;1;4500;0;4500;3800;700;
2021-09-21 14:54:06;lolipop;lolipop;1;1000;0;1000;850;150;
2021-09-21 15:05:13;8995899210185;Mi Boncabe;1;3000;0;3000;3000;0;
2021-09-21 15:05:13;8995555171225;KIMBO SOSIS;1;1000;0;1000;900;100;
2021-09-21 15:08:52;8998989300261;GUDANG GARAM SURYA 12 FILTER;1;20000;0;20000;18150;1850;
2021-09-21 15:08:52;8997218380135;ICHITAN GREEN TEA;2;8000;0;16000;13166;2834;
2021-09-21 15:08:52;8997218380074;ICHITAN MILK TEA;1;8000;0;8000;6583;1417;
2021-09-21 15:08:52;8992761139018;ADES 600ML;1;3500;0;3500;2166;1334;
2021-09-21 15:08:52;8992730002992;HAI CANDY;1;7000;0;7000;6000;1000;
2021-09-21 15:08:52;8991001503336;chacha minis hat;1;7500;0;7500;6400;1100;
2021-09-21 16:33:00;8991102024099;FORMULA CURVE;1;5000;0;5000;3000;2000;
2021-09-21 16:33:00;8998866610711;NOVO ACTIVE CLEAN 110G;2;3000;0;6000;5200;800;
2021-09-21 16:33:00;089686010343;INDOMIE SOTO MIE;2;2600;0;5200;4734;466;
2021-09-21 16:33:00;KERUPUK 5000;KERUPUK BALADO;1;5000;0;5000;4000;1000;
2021-09-21 16:33:00;8991002121089;GOOD DAY ORI CAPPUCINO;1;6000;0;6000;4295;1705;
2021-09-21 16:41:26;8999909096004;SAMPOERNA 16 FILTER;1;25000;0;25000;23100;1900;
2021-09-21 17:43:12;Vita Jelly;Vita Jelly;1;1000;0;1000;766;234;
2021-09-21 17:45:13;8991002105409;KOPI KAPAL API;1;20000;0;20000;18888;1112;
2021-09-21 17:45:13;8998989300261;GUDANG GARAM SURYA 12 FILTER;1;20000;0;20000;18150;1850;
2021-09-21 18:25:40;089686021141;INTER MIE SOTO;2;1000;0;2000;1708;292;
2021-09-21 18:31:55;TG;TEH GELAS;1;1000;0;1000;729;271;
2021-09-21 18:31:55;KERUPUK 5000;KERUPUK BALADO;1;5000;0;5000;4000;1000;
2021-09-21 19:13:03;8998866202664;POTABEE WAGYU BEEF STEAK 68 GR;2;8000;0;16000;14400;1600;
2021-09-21 19:13:03;ROTI;ROTI 2000;5;2000;0;10000;9000;1000;
2021-09-21 19:15:40;8997028590014;ARGUS 220ML;8;500;0;4000;2416;1584;
2021-09-21 19:54:39;JL;JELLY;2;500;0;1000;800;200;
2021-09-21 20:55:21;TG APEL;TEH GELAS APEL;1;2000;0;2000;1178;822;
2021-09-21 20:55:21;TG MARKISA;TEH GELAS MARKISA;2;2000;0;4000;2356;1644;
2021-09-21 20:55:21;TG;TEH GELAS;2;1000;0;2000;1458;542;
2021-09-21 20:55:21;Vita Jelly;Vita Jelly;5;1000;0;5000;3830;1170;
2021-09-21 20:55:21;8997028590014;ARGUS 220ML;2;500;0;1000;604;396;
2021-09-21 21:18:11;8997027300089;NOMOS;1;4000;0;4000;2963;1037;
2021-09-21 21:53:03;089686041705;INDOMIE GORENG JUMBO;1;3500;0;3500;3143;357;
2021-09-21 21:53:03;8997028590045;ARGUS BTL 330ML;1;2000;0;2000;1291;709;
2021-09-21 21:58:37;GL;GULA 1 LITER;4;11500;0;46000;42000;4000;
2021-09-21 22:06:06;8992979130012;TOTAL LEMON SOFTENER;1;15000;0;15000;13524;1476;
2021-09-21 22:06:06;8998866200646;KOPI TOP MURNI;1;11000;0;11000;9600;1400;
2021-09-21 22:09:25;7992912508305;SWEETY SILVER PANTS L1;2;2500;0;5000;3764;1236;
2021-09-22 08:52:55;8999999525590;PEPSODENT TB KIDS;1;12900;0;12900;11700;1200;
2021-09-22 09:00:17;8998866605113;CLING KUNING BTL 440ML;1;8500;0;8500;7600;900;
2021-09-22 09:02:40;RB;RED BOLD;1;20000;0;20000;18800;1200;
2021-09-22 09:14:14;8998989300261;GUDANG GARAM SURYA 12 FILTER;1;20000;0;20000;18150;1850;
2021-09-22 09:14:14;8991102320184;TANGO CHOCO JAVAMOCCA;1;5000;0;5000;4330;670;
2021-09-22 10:21:58;PULPEN SNOWMAN;PULPEN SNOWMAN;3;2500;0;7500;6000;1500;
2021-09-22 10:21:58;Pulpen;pulpen;1;1000;0;1000;750;250;
2021-09-22 10:23:36;8994834006128;TICTIC PEDAS;2;2000;0;4000;3400;600;
2021-09-22 10:23:36;8991102714594;TANGO DRINK BLCK VNL;1;5000;0;5000;3818;1182;
2021-09-22 10:23:36;8996001600641;TORA CAPPUCINO;1;3500;0;3500;2750;750;
2021-09-22 10:23:47;JGR SHN;JOGER SHINY SACHET;1;500;0;500;437;63;
2021-09-22 10:34:02;089686611618;QTELA BARBEQUE;1;5000;0;5000;4266;734;
2021-09-22 10:38:19;8998866201490;POTABEE REGULER GRILLED SEAWED 68 GR;1;8000;0;8000;7200;800;
2021-09-22 10:40:25;8991102714860;MILKIDO STRAW;2;3000;0;6000;4306;1694;
2021-09-22 10:40:25;089686727074;DORITOS 160G;1;12000;0;12000;10700;1300;
2021-09-22 10:47:26;089686611670;QTELA BALADO;1;5000;0;5000;4266;734;
2021-09-22 10:47:26;ROTI;ROTI 2000;1;2000;0;2000;1800;200;
2021-09-22 10:56:45;8992761166212;FRESTEA APPLE 350ML;4;4500;0;18000;12000;6000;
2021-09-22 10:56:45;8999999033170;LIFEBUOY SHP  KUAT&BERKILAU 170ML;1;16500;0;16500;14950;1550;
2021-09-22 10:57:06;PRG;PARAGO;1;500;0;500;400;100;
2021-09-22 10:58:20;8992761145026;SPRITE PET 250ML;1;3500;0;3500;2417;1083;
2021-09-22 11:13:43;JGR SHN;JOGER SHINY SACHET;2;500;0;1000;874;126;
2021-09-22 11:13:43;8997028590045;ARGUS BTL 330ML;1;2000;0;2000;1291;709;
2021-09-22 11:17:31;ROTI;ROTI 2000;3;2000;0;6000;5400;600;
2021-09-22 11:20:42;ROTI;ROTI 2000;1;2000;0;2000;1800;200;
2021-09-22 11:36:57;8997028590014;ARGUS 220ML;6;500;0;3000;1812;1188;
2021-09-22 11:36:57;OJELLY;O'JELLY;5;500;0;2500;1925;575;
2021-09-22 12:30:25;8998866608725;DAIA SOFTENER BAG 850G;1;18000;0;18000;15627;2373;
2021-09-22 12:50:25;8997028590014;ARGUS 220ML;6;500;0;3000;1812;1188;
2021-09-22 13:09:01;8991102026383;AIR CRYSTALINE 1.5 L;1;5000;0;5000;3471;1529;
2021-09-22 13:12:34;Vita Jelly;Vita Jelly;2;1000;0;2000;1532;468;
2021-09-22 13:15:46;ARG;ARGUS DOS 220ML;3;14500;0;43500;39900;3600;
2021-09-22 13:44:20;8996001305119;ARDEN 30G;1;2000;0;2000;1650;350;
2021-09-22 13:50:59;8998866201377;KRISBEE FRIES KENTANG GORENG 68 GR;1;5500;0;5500;4620;880;
2021-09-22 13:50:59;8997028590045;ARGUS BTL 330ML;1;2000;0;2000;1291;709;
2021-09-22 13:50:59;8992759120264;LARISST 220;1;10000;0;10000;9200;800;
2021-09-22 13:50:59;6901668053121;OREO ORIGINAL 66.5 G;1;4000;0;4000;3200;800;
2021-09-22 13:50:59;8992775318201;GERY SNACK BANTAL COKLAT;1;2000;0;2000;1712;288;
2021-09-22 13:54:23;8992775318201;GERY SNACK BANTAL COKLAT;2;2000;0;4000;3424;576;
2021-09-22 14:15:34;8991102308861;FULLO BLASTO;1;16000;0;16000;14545;1455;
2021-09-22 14:40:36;8998989300261;GUDANG GARAM SURYA 12 FILTER;1;20000;0;20000;18150;1850;
2021-09-22 15:47:21;GL;GULA 1 LITER;4;11500;0;46000;42000;4000;
2021-09-22 16:24:05;ROTI;ROTI 2000;2;2000;0;4000;3600;400;
2021-09-22 16:24:05;6901668053121;OREO ORIGINAL 66.5 G;1;4000;0;4000;3200;800;
2021-09-22 16:24:05;KIKO;KIKO;2;1000;0;2000;1000;1000;
2021-09-22 17:50:00;8998866202312;NOODLE SEDAAP TASTY BAKMI AYAM 129 GR;1;5000;0;5000;4167;833;
2021-09-22 17:50:00;8998866200325;MIE SEDAAP SOTO;1;2700;0;2700;2282;418;
2021-09-22 22:06:48;8999999195656;SARIWANGI 50X1.85;1;10000;0;10000;9405;595;
2021-09-22 22:06:48;8998989500166;GUDANG GARAM MERAH BESAR 16KS;1;18000;0;18000;17000;1000;
2021-09-22 22:06:48;8991102026383;AIR CRYSTALINE 1.5 L;1;5000;0;5000;3471;1529;
2021-09-22 22:10:14;8998989110167;SURYA GUDANG GARAM 16 FILTER;1;26000;0;26000;23700;2300;
2021-09-22 22:18:41;JGR SHN;JOGER SHINY SACHET;2;500;0;1000;874;126;
2021-09-22 22:26:32;MTR;MOTOR;1;5000;0;5000;3500;1500;
2021-09-23 21:19:38;ICE CREAM 3;ICE CREAM 3000;5;3000;0;15000;13000;2000;
2021-09-23 21:20:43;8998009010569;ULTRA CHO 200;1;5000;0;5000;3830;1170;
2021-09-23 21:28:49;8998009010231;ULTRA CHO 250;1;6000;0;6000;4784;1216;
2021-09-23 21:30:09;8998989110167;SURYA GUDANG GARAM 16 FILTER;1;26000;0;26000;23700;2300;
2021-09-23 21:32:01;AMPLOP;AMPLOP;2;250;0;500;280;220;
2021-09-23 21:37:36;8992775511206;LEO 10GR;3;1000;0;3000;2544;456;
2021-09-23 21:38:15;8997028590052;ARGUS BTL 600ML;1;3000;0;3000;1458;1542;
2021-09-23 21:39:01;7992912508305;SWEETY SILVER PANTS L1;2;2500;0;5000;3764;1236;
2021-09-23 21:41:23;8991111112213;C&C DEEP ACTION CLEANSER 100G;1;22000;0;22000;19900;2100;
2021-09-23 21:44:20;8991102281430;PERMEN MINTZ DUOMINT;1;5000;0;5000;4000;1000;
2021-09-23 21:44:20;8997028590052;ARGUS BTL 600ML;1;3000;0;3000;1458;1542;
2021-09-23 21:44:20;8997218380074;ICHITAN MILK TEA;1;8000;0;8000;6583;1417;
2021-09-23 21:44:35;8997028590052;ARGUS BTL 600ML;1;3000;0;3000;1458;1542;
2021-09-23 21:59:44;8991102989381;TANGO LONG BUBBLEGUM 130G;1;5000;0;5000;4345;655;
2021-09-23 22:02:28;KOPIKO;KOPIKO;4;250;0;1000;700;300;
2021-09-23 22:02:47;8998989500166;GUDANG GARAM MERAH BESAR 16KS;1;18000;0;18000;17000;1000;
2021-09-24 10:13:38;8999999027056;LIFEBUOY ANTI KETOMBE 9ML;2;5000;0;10000;9000;1000;
2021-09-24 10:13:38;8997231980022;O'JELLY MINI STRAWBERRY;1;3000;0;3000;2250;750;
2021-09-24 10:13:38;8997009510055;YOU C1000;3;15000;0;45000;39000;6000;
2021-09-24 10:13:38;8998989110167;SURYA GUDANG GARAM 16 FILTER;1;26000;0;26000;23700;2300;
2021-09-24 10:14:44;8998866202626;Top Kopi Gula Aren 22gr;3;666;0;1998;1659;339;
2021-09-24 10:50:31;8994935000070;MINYAK GORENG DUNIA 450 ML;1;7500;0;7500;6779;721;
2021-09-24 10:50:31;089686021219;INTER MIE GORENG;1;1000;0;1000;885;115;
2021-09-24 10:50:31;089686021141;INTER MIE SOTO;1;1000;0;1000;854;146;
2021-09-24 10:50:31;YP;YUPI;2;250;0;500;416;84;
2021-09-24 12:18:38;8992761145026;SPRITE PET 250ML;4;3500;0;14000;9668;4332;
2021-09-24 12:18:38;8991102385091;WFR TANGO CKLT 7G;1;8300;0;8300;7455;845;
2021-09-24 12:18:38;8992775203422;GARUDA ROSTA OVEN BAWANG 100G;1;8000;0;8000;7322;678;
2021-09-24 12:18:38;8992959953150;SWEETY BRONZE XXL 18;1;45000;0;45000;42330;2670;
2021-09-24 12:18:38;4902430400947;PANTENE ANTI DANDRUFF 130ML;1;20000;0;20000;17860;2140;
2021-09-24 12:24:03;8992775001691;GARUDA ROSTA WAGYU BEEF 100G;2;8000;0;16000;14644;1356;
2021-09-24 12:24:03;089686727081;DORITOS 55G;1;7000;0;7000;5950;1050;
2021-09-24 12:24:03;8886013213208;FRENCH FREIS 2000;1;5000;0;5000;3750;1250;
2021-09-24 12:24:03;8886467100048;pringles bbq;1;9000;0;9000;6333;2667;
2021-09-24 12:25:51;8886467100017;pringles original;1;9000;0;9000;6333;2667;
2021-09-24 12:25:51;8886013213208;FRENCH FREIS 2000;1;5000;0;5000;3750;1250;
2021-09-24 12:25:51;8992775001691;GARUDA ROSTA WAGYU BEEF 100G;1;8000;0;8000;7322;678;
2021-09-24 12:25:51;8992775110157;GARUDA KACANG KULIT;1;5000;0;5000;3925;1075;
2021-09-24 12:41:25;8998898337440;TOLAK ANGIN CARE 10ML;1;10000;0;10000;7893;2107;
2021-09-24 12:58:25;8998989300261;GUDANG GARAM SURYA 12 FILTER;1;20000;0;20000;18150;1850;
2021-09-24 12:58:25;8991909101016;URBAN MILD 16;1;17000;0;17000;15800;1200;
2021-09-24 12:58:25;123124;KOREK BIASA;1;2000;0;2000;1300;700;
2021-09-24 12:58:25;Gula gula tusuk;gula gula tusuk;4;500;0;2000;1600;400;
2021-09-24 13:00:59;8998866201483;POTABEE REGULER GRILLED SEAWEED 35GR;1;5000;0;5000;4150;850;
2021-09-24 13:00:59;TG;TEH GELAS;2;1000;0;2000;1458;542;
2021-09-24 13:03:04;8998866200578;MIE SEDAAP KARI KENTAL;2;2700;0;5400;4662;738;
2021-09-24 13:03:04;8998866200301;MIE SEDAAP GORENG;2;2700;0;5400;4726;674;
2021-09-24 13:03:04;ROTI;ROTI 2000;2;2000;0;4000;3600;400;
2021-09-24 13:03:04;KOPIKO;KOPIKO;1;250;0;250;175;75;
2021-09-24 13:10:42;8998866202770;MIE SEDAAP SALERO PADANG;2;2500;0;5000;4724;276;
2021-09-24 13:12:46;8886001038011;BENG-BENG SCT;1;1500;0;1500;1450;50;
2021-09-24 13:12:46;COKLAT;COKLAT COIN;1;500;0;500;425;75;
2021-09-24 14:14:14;6907992823843;JD MOCHA CRISPY;1;5000;0;5000;4400;600;
2021-09-24 14:16:08;RB;RED BOLD;1;20000;0;20000;18800;1200;
2021-09-24 15:12:39;8999909000773;MARLBORO FILTER BLACK 12;1;17000;0;17000;15950;1050;
2021-09-24 15:31:18;8998866501026;MINYAK GORENG SEDAAP POUCH 1 L;1;15000;0;15000;14110;890;
2021-09-24 15:31:18;089686535044;SUN BERAS MERAH;1;8500;0;8500;7410;1090;
2021-09-24 15:34:27;8998989300261;GUDANG GARAM SURYA 12 FILTER;1;20000;0;20000;18150;1850;
2021-09-24 15:34:27;8850507001152;MOTU ATV;1;10000;0;10000;8000;2000;
2021-09-24 15:34:27;6907992823652;JD CHOCOLATE MILKSHAKE;1;6000;0;6000;5200;800;
2021-09-24 16:13:51;8992761164539;NUTRIBOOST ORANGE 300ML;1;6500;0;6500;5300;1200;
2021-09-24 16:13:51;8991001111883;SILVERQUEEN CHUNKYBAR 33G;1;8000;0;8000;7150;850;
2021-09-24 16:44:06;GGK;PLAYGUM PERMEN KARET;4;500;0;2000;1600;400;
2021-09-24 16:45:10;8992775214008;Garuda Kacang Atom;6;1000;0;6000;4860;1140;
2021-09-24 17:01:50;Gula gula tusuk;gula gula tusuk;2;500;0;1000;800;200;
2021-09-24 17:01:50;lolipop;lolipop;2;1000;0;2000;1700;300;
2021-09-24 17:01:50;8995555121244;SOSIS KIMBO;2;1000;0;2000;1300;700;
2021-09-24 17:05:46;8992761166212;FRESTEA APPLE 350ML;1;4500;0;4500;3000;1500;
2021-09-24 17:05:46;PD;PENDEKAR;3;500;0;1500;1050;450;
2021-09-24 17:36:00;8997218380074;ICHITAN MILK TEA;1;8000;0;8000;6583;1417;
2021-09-24 17:36:00;8998009010231;ULTRA CHO 250;1;6000;0;6000;4784;1216;
2021-09-24 17:36:00;7622201430184;OREO ORIGINAL 38G;1;2000;0;2000;1641;359;
2021-09-24 17:36:00;7622201430153;OREO CHOCOLATE 38G;1;2000;0;2000;1641;359;
2021-09-24 17:43:53;8998989500166;GUDANG GARAM MERAH BESAR 16KS;1;18000;0;18000;17000;1000;
2021-09-24 17:49:43;8992761145026;SPRITE PET 250ML;1;3500;0;3500;2417;1083;
2021-09-24 17:49:43;8997009510055;YOU C1000;1;15000;0;15000;13000;2000;
2021-09-24 17:49:43;8992761164539;NUTRIBOOST ORANGE 300ML;1;6500;0;6500;5300;1200;
2021-09-24 17:49:43;8992775318201;GERY SNACK BANTAL COKLAT;1;2000;0;2000;1712;288;
2021-09-24 17:49:43;8992696523067;MILO ACTVGO UHT 180ML;1;4500;0;4500;3515;985;
2021-09-24 18:23:19;8998989110167;SURYA GUDANG GARAM 16 FILTER;1;26000;0;26000;23700;2300;
2021-09-24 19:10:34;JD VM;JD VANILLA MILKSHAKE;1;5000;0;5000;4300;700;
2021-09-24 19:31:18;8992694242502;ZWITZAL SOAP CALSSIC 70G;1;3800;0;3800;3410;390;
2021-09-24 19:31:18;8999999053307;LIFEBUOY LEMONFRESH 60G;4;2500;0;10000;7644;2356;
2021-09-24 19:31:18;8999999529833;CLEAR SHP ICM UNISEX 9 ML;1;10000;0;10000;9300;700;
2021-09-24 19:31:18;8999999524722;SUNLIGHT LIME NEW PCH 435ML;1;10000;0;10000;9100;900;
2021-09-24 19:31:18;8998866607315;SOKLIN SOFTERGENT SAKURA 770G & PIRING;1;18000;0;18000;16680;1320;
2021-09-24 19:31:18;8991102385091;WFR TANGO CKLT 7G;1;8300;0;8300;7455;845;
2021-09-24 19:31:18;8992959953334;SWEETY BRONZE XL42;1;80000;0;80000;75455;4545;
2021-09-24 19:31:18;8992959020012;SWEETY SILVER PANTS XL34;1;78000;0;78000;73637;4363;
2021-09-24 19:31:18;8992761111533;SPRITE SLIM CAM250ML;1;5000;0;5000;3750;1250;
2021-09-24 19:48:32;8992775318201;GERY SNACK BANTAL COKLAT;1;2000;0;2000;1712;288;
2021-09-24 19:48:32;TG;TEH GELAS;2;1000;0;2000;1458;542;
2021-09-24 19:48:32;8992775315095;GERY MALKIST SWEET CHEESE;1;6500;0;6500;5516;984;
2021-09-24 19:49:45;Gula gula kaki;gula gula kaki;2;500;0;1000;800;200;
2021-09-24 19:49:45;ICE CREAM 3;ICE CREAM 3000;1;3000;0;3000;2600;400;
2021-09-24 19:54:12;8994867000162;ROKOK PUNDIMAS KRETEK16;1;10000;0;10000;8600;1400;
2021-09-24 20:03:45;8998866609494;SOKLIN SOFTERGEN 280G BIRU;1;5000;0;5000;4425;575;
2021-09-24 20:03:45;8999999046996;LIFEBUOY TOTAL10 60G;1;3000;0;3000;1800;1200;
2021-09-24 20:03:45;8992761166052;FRESTEA MELATI 350ML;1;4500;0;4500;3000;1500;
2021-09-24 20:10:17;7992912508305;SWEETY SILVER PANTS L1;1;2500;0;2500;1882;618;
2021-09-24 20:18:03;8992959971109;SFX COMFORT SLIM 36CM 12+1;1;17000;0;17000;15152;1848;
2021-09-24 20:19:08;TUSTEL;TUSUK TELINGA;1;1000;0;1000;833;167;
2021-09-24 20:26:58;Gula gula tusuk;gula gula tusuk;4;500;0;2000;1600;400;
2021-09-24 20:40:51;8998866610087;JAVANA ORIGINAL 350ML;1;3000;0;3000;2150;850;
2021-09-24 20:52:07;8994867007161;ROKOK PENA GOLD 20;1;18000;0;18000;16800;1200;
2021-09-24 21:09:52;8992775001998 pcs;Gery Salut sandiwich pcs;1;1000;0;1000;815;185;
2021-09-24 21:09:52;Vita Jelly;Vita Jelly;2;1000;0;2000;1532;468;
2021-09-24 21:33:14;6907992825069;JD FRUITY;2;5000;0;10000;8800;1200;
2021-09-24 22:03:58;8991102320184;TANGO CHOCO JAVAMOCCA;1;5000;0;5000;4330;670;
2021-09-24 22:03:58;COKLAT;COKLAT COIN;5;500;0;2500;2125;375;
2021-09-24 22:03:58;8992724892844;Coklat mede;3;1000;0;3000;2400;600;
2021-09-24 22:11:43;8992959020005;SWEETY SILVER PANTS XXL5;1;16800;0;16800;15228;1572;
2021-09-24 22:11:43;8992957220025;GOLDEN CITY MINI;1;3000;0;3000;2500;500;
2021-09-24 22:20:43;ARG 330;ARGUS DOS 330ML;1;35000;0;35000;31000;4000;
2021-09-25 11:57:55;6907992823935;JD SWEETCORN;1;3500;0;3500;3000;500;
2021-09-25 11:57:55;6907992825069;JD FRUITY;1;5000;0;5000;4400;600;
2021-09-25 11:57:55;8991102385091;WFR TANGO CKLT 7G;1;8300;0;8300;7455;845;
2021-09-25 15:46:41;8998866610087;JAVANA ORIGINAL 350ML;1;3000;0;3000;2150;850;
2021-09-25 15:48:42;089686535242;SUN PISANG SUSU;1;8500;0;8500;7410;1090;
2021-09-25 15:48:42;COKLAT;COKLAT COIN;1;500;0;500;425;75;
2021-09-25 15:51:13;COKLAT;COKLAT COIN;1;500;0;500;425;75;
2021-09-25 15:51:13;MILKITA;MILKITA;2;250;0;500;400;100;
2021-09-25 15:51:13;8991909101016;URBAN MILD 16;1;17000;0;17000;15800;1200;
2021-09-25 16:13:29;KERUPUK 1000;KERUPUK BALADO;2;1000;0;2000;1800;200;
2021-09-25 16:13:29;ABC;BATERAI ABC BIRU;2;2500;0;5000;3856;1144;
2021-09-25 16:17:12;8998989110129;SURYA KECIL MERAH 12KS;1;20000;0;20000;18450;1550;
2021-09-25 16:18:53;8998989300261;GUDANG GARAM SURYA 12 FILTER;1;20000;0;20000;18150;1850;
2021-09-25 16:18:53;8998989500166;GUDANG GARAM MERAH BESAR 16KS;1;18000;0;18000;17000;1000;
2021-09-25 16:19:25;8991909101016;URBAN MILD 16;1;17000;0;17000;15800;1200;
2021-09-25 16:19:25;GL;GULA 1 LITER;4;11500;0;46000;42000;4000;
2021-09-25 16:20:55;GGK;PLAYGUM PERMEN KARET;6;500;0;3000;2400;600;
2021-09-25 16:41:11;7622300335809;OREO SOFT CAKE;2;2000;0;4000;3282;718;
2021-09-25 17:27:40;8997028590014;ARGUS 220ML;3;500;0;1500;906;594;
2021-09-25 17:27:40;PD;PENDEKAR;2;500;0;1000;700;300;
2021-09-25 17:27:40;KERUPUK;KERUPUK BALADO;1;1000;0;1000;900;100;
2021-09-25 18:44:44;KIKO;KIKO;3;1000;0;3000;1500;1500;
2021-09-25 18:44:44;8992959117613;SFX DAUN SIRIH 1 WP;2;500;0;1000;826;174;
2021-09-25 19:04:10;RB;RED BOLD;1;20000;0;20000;18800;1200;
2021-09-25 19:36:46;8998898337440;TOLAK ANGIN CARE 10ML;1;10000;0;10000;7893;2107;
2021-09-25 19:36:46;8992775913000;CHOCOLATOS CKLT 28G;2;2000;0;4000;3114;886;
2021-09-25 19:47:48;8991002103832;GOOD DAY CHOCOCINNO;1;1500;0;1500;890;610;
2021-09-25 19:47:48;JGR SHN;JOGER SHINY SACHET;1;500;0;500;437;63;
2021-09-25 20:20:41;8996001375372;CHOKI CHOKI;1;1000;0;1000;910;90;
2021-09-25 20:20:59;YP;YUPI;12;250;0;3000;2496;504;
2021-09-25 20:26:44;8992775305102;GERY MALKIST COCONUT;2;6500;0;13000;11032;1968;
2021-09-25 20:26:44;8999999049669;REXONA MEN RO INVISIBLE DRY 45 ML;1;15000;0;15000;13550;1450;
2021-09-25 20:57:27;8993989311699;CLAS MILD 16 FILTER;1;24000;0;24000;21700;2300;
2021-09-25 20:57:27;8999909085114;SAMPOERNA KRETEK HIJAU 12;1;13000;0;13000;11650;1350;
2021-09-25 20:57:27;8998009010231;ULTRA CHO 250;1;6000;0;6000;4784;1216;
2021-09-25 20:57:27;8992696404441;BEAR BRAND 189ML;1;15000;0;15000;11000;4000;
2021-09-25 20:57:27;123124;KOREK BIASA;1;2000;0;2000;1300;700;
2021-09-25 20:57:27;8991102300544;WFR TANGO VNL 176G;1;10000;0;10000;8694;1306;
2021-09-25 21:22:48;8994867007161;ROKOK PENA GOLD 20;1;18000;0;18000;16800;1200;
2021-09-25 21:22:48;8999999031930;PEPSODENT TB TRIPLE CLEAN;1;3500;0;3500;2850;650;
2021-09-25 22:14:53;089686021219;INTER MIE GORENG;4;1000;0;4000;3540;460;
2021-09-25 22:14:53;Telur 3 Biji;Telur 3 Biji;1;5000;0;5000;3600;1400;
2021-09-25 22:14:53;8992959508305;SWEETY;2;2500;0;5000;4000;1000;
2021-09-25 22:14:53;kentang;kripik kentang;1;1000;0;1000;900;100;
2021-09-25 22:17:50;BMO;BERAS MERAH ORGANIK;1;25000;0;25000;23500;1500;
2021-09-25 22:42:42;8992979190986;TOTAL PUTIH SOFTENER;1;15000;0;15000;13524;1476;
2021-09-25 22:50:16;8992761166052;FRESTEA MELATI 350ML;1;4500;0;4500;3000;1500;
2021-09-25 22:50:16;7622300405588;KEJUCAKE 16G;1;2000;0;2000;1641;359;
2021-09-25 22:51:13;8996001314005;ROMA KELAPA CREAM CKLT;1;8000;0;8000;6642;1358;
2021-09-25 22:51:13;089686727081;DORITOS 55G;1;7000;0;7000;5950;1050;
2021-09-25 22:51:13;8998898337440;TOLAK ANGIN CARE 10ML;1;10000;0;10000;7893;2107;
2021-09-25 22:51:13;8992696404441;BEAR BRAND 189ML;1;15000;0;15000;11000;4000;
2021-09-26 13:45:31;8998989110167;SURYA GUDANG GARAM 16 FILTER;1;26000;0;26000;23700;2300;
2021-09-26 14:02:16;Vita Jelly;Vita Jelly;3;1000;0;3000;2298;702;
2021-09-26 14:02:16;8992775001806 pcs;Gery salut malkist chocolate coconut pcs;3;1000;0;3000;2436;564;
2021-09-26 15:09:04;ICE CREAM 3;ICE CREAM 3000;3;3000;0;9000;7800;1200;
2021-09-26 15:16:44;PULPEN SNOWMAN;PULPEN SNOWMAN;1;2500;0;2500;2000;500;
2021-09-26 15:16:44;PUL;PULPEN;1;1500;0;1500;833;667;
2021-09-26 16:31:52;ARG 330;ARGUS DOS 330ML;1;35000;0;35000;31000;4000;
2021-09-26 17:04:33;8999908284907;MY BABY MINYAK TELON 90ML;1;25000;0;25000;22700;2300;
2021-09-26 17:04:33;8998866200325;MIE SEDAAP SOTO;1;2700;0;2700;2282;418;
2021-09-26 17:04:33;8998866200882;SUKSESMIE GORENG AYAM KRMS 133GR;1;3500;0;3500;3047;453;
2021-09-26 17:22:04;8999999059781;SUNLIGHT LIME NEW POUCH 210ML;1;5000;0;5000;4520;480;
2021-09-26 17:24:36;6907992825045;JD CRUNCHY MATCHA CHEESE;1;8000;0;8000;7000;1000;
2021-09-26 17:24:36;8999999024475;CITRA BW PEARLY WHITE LD 400ML;1;21000;0;21000;19000;2000;
2021-09-26 17:24:36;8997218380074;ICHITAN MILK TEA;1;8000;0;8000;6583;1417;
2021-09-26 17:24:54;8999999036607;LUX TS SOFT ROSE 75G;1;3500;0;3500;2800;700;
2021-09-26 17:24:54;8992702000018;INDOMILK PUTIH 370G;1;10000;0;10000;9020;980;
2021-09-26 17:35:21;8997009510055;YOU C1000;2;15000;0;30000;26000;4000;
2021-09-26 17:35:21;8886013213208;FRENCH FREIS 2000;1;5000;0;5000;3750;1250;
2021-09-26 17:41:31;8934868015024;REXONA DEO LOTION FREE SPIRIT 9G;2;2500;0;5000;4000;1000;
2021-09-26 17:43:04;8992761111533;SPRITE SLIM CAM250ML;1;5000;0;5000;3750;1250;
2021-09-26 18:16:07;8991102714860;MILKIDO STRAW;1;3000;0;3000;2153;847;
2021-09-26 18:42:00;8991102026383;AIR CRYSTALINE 1.5 L;1;5000;0;5000;3471;1529;
2021-09-26 18:42:00;8998866603676;FRES&NATURAL SOAP GREEN 65G;1;1800;0;1800;1425;375;
2021-09-26 18:42:00;8998866603669;FRES&NATURAL SOAP WHITE 65G;1;1800;0;1800;1425;375;
2021-09-26 18:50:46;Gula gula tusuk;gula gula tusuk;2;500;0;1000;800;200;
2021-09-26 19:06:48;089686044249;SUPERMI NUTRIMI STEAK AYAM;2;3500;0;7000;5600;1400;
2021-09-26 19:27:16;8993989311279;CLAS MILD 12;1;18000;0;18000;15800;2200;
2021-09-26 19:28:47;8997009510017;YOU C1000 LEMON;1;10000;0;10000;9166;834;
2021-09-26 19:34:24;ARG;ARGUS DOS 220ML;1;14500;0;14500;13300;1200;
2021-09-26 19:34:24;8997027300089;NOMOS;1;4000;0;4000;2963;1037;
2021-09-26 19:34:24;6907992823645;JD COCONUT BLISS;1;4000;0;4000;3500;500;
2021-09-26 19:51:56;Vita Jelly;Vita Jelly;2;1000;0;2000;1532;468;
2021-09-26 19:51:56;KIKO;KIKO;1;1000;0;1000;500;500;
2021-09-26 20:03:49;8992959930748;CONFI PANTS L10;2;5000;0;10000;8516;1484;
2021-09-26 20:03:49;8992959930762;CONFI CLASS DAY XL1;4;6500;0;26000;22728;3272;
2021-09-26 20:03:49;ICE CREAM 3;ICE CREAM 3000;1;3000;0;3000;2600;400;
2021-09-26 20:04:54;8991909101016;URBAN MILD 16;1;17000;0;17000;15800;1200;
2021-09-26 20:25:33;8999801700054;SUSU FOYU 1 KG;1;22000;0;22000;19791;2209;
2021-09-26 20:28:39;8997028590014;ARGUS 220ML;2;500;0;1000;604;396;
2021-09-26 20:28:39;8995555171225;KIMBO SOSIS;2;1000;0;2000;1800;200;
2021-09-26 20:36:16;8991102989381;TANGO LONG BUBBLEGUM 130G;1;5000;0;5000;4345;655;
2021-09-26 20:36:16;8992696521797;MILO 22G;1;2500;0;2500;1572;928;
2021-09-26 20:36:16;COKLAT;COKLAT COIN;5;500;0;2500;2125;375;
2021-09-26 20:42:00;8997013180046;Tissu Tessi B;1;11000;0;11000;9800;1200;
2021-09-26 21:06:13;MOBIL;GULA GULA HP;1;2000;0;2000;1700;300;
2021-09-26 21:06:46;8995555171225;KIMBO SOSIS;1;1000;0;1000;900;100;
2021-09-26 21:15:42;8998866202244;EKOMIE BUMBU KALDU AYAM;2;1000;0;2000;1596;404;
2021-09-26 21:15:42;8992775315057;GERY SALUT MALKIST COKLAT;1;6500;0;6500;5516;984;
2021-09-26 21:15:42;8998866202602;KRISBEE FRENCH FRIES 18GR;2;2000;0;4000;3000;1000;
2021-09-26 22:11:45;089686611670;QTELA BALADO;1;5000;0;5000;4266;734;
2021-09-26 22:11:45;089686727074;DORITOS 160G;1;12000;0;12000;10700;1300;
2021-09-26 22:11:45;8992761166205;FRESTEA GREEN HONEY 350ML;1;4500;0;4500;3000;1500;
2021-09-26 22:11:45;8998866201490;POTABEE REGULER GRILLED SEAWED 68 GR;1;8000;0;8000;7200;800;
2021-09-26 22:11:45;8992760221028;OREO ORIGINAL 133G;1;8000;0;8000;6300;1700;
2021-09-26 22:12:51;089686727074;DORITOS 160G;2;12000;0;24000;21400;2600;
2021-09-26 22:13:35;8992761122331;FRESTEA APPEL 500ML;1;6500;0;6500;4791;1709;
2021-09-26 22:14:45;8991001503336;chacha minis hat;1;7500;0;7500;6400;1100;
2021-09-26 22:18:29;8991102026383;AIR CRYSTALINE 1.5 L;2;5000;0;10000;6942;3058;
2021-09-26 22:18:29;COKLAT;COKLAT COIN;2;500;0;1000;850;150;
2021-09-26 22:19:15;9556001025272;NESCAFE LATTE 240ML;1;8500;0;8500;7834;666;
2021-09-26 22:19:15;8997009510055;YOU C1000;1;15000;0;15000;13000;2000;
2021-09-26 22:19:15;8992696404441;BEAR BRAND 189ML;1;15000;0;15000;11000;4000;
2021-09-26 22:19:15;8998866610377;ISOPLUS;1;3000;0;3000;2350;650;
2021-09-26 22:19:15;6907992823904;JD CRUNCHY CHOCOLATE VAN;1;8000;0;8000;6800;1200;
2021-09-27 08:44:55;8998866608558;SOKLIN SOFTERGENT BIRU 770G & PIRING;2;18000;0;36000;32110;3890;
2021-09-27 08:44:55;8998866619004;ROYALE SUNNY DAY;2;5000;0;10000;9120;880;
2021-09-27 08:44:55;8992696523067;MILO ACTVGO UHT 180ML;2;4500;0;9000;7030;1970;
2021-09-27 08:44:55;8995555121244;SOSIS KIMBO;5;1000;0;5000;3250;1750;
2021-09-27 08:44:55;8992388133345;NU MILK TEA TEH TARIK 330ML;1;6000;0;6000;5125;875;
2021-09-27 08:44:55;089686611670;QTELA BALADO;1;5000;0;5000;4266;734;
2021-09-27 08:44:55;8996001312278;MALKIST KEJU MANIS;1;6500;0;6500;5400;1100;
2021-09-27 08:48:50;8996001355237;SUPER STAR;1;11000;0;11000;9900;1100;
2021-09-27 08:48:50;8991002307209;COFFE CANDY;1;6000;0;6000;5000;1000;
2021-09-27 08:48:50;8998866200325;MIE SEDAAP SOTO;1;2700;0;2700;2282;418;
2021-09-27 08:58:59;8998866612173;SOKLIN SOFTERGENT PINK 770G & PIRING;1;18000;0;18000;16055;1945;
2021-09-27 08:58:59;8992959117583;SFX DS REG FLOW WING 20;1;5000;0;5000;4288;712;
2021-09-27 08:58:59;089686386127;BUMBU RACIK NASI GORENG SOSIS;2;2000;0;4000;3240;760;
2021-09-27 08:58:59;TUSTEL;TUSUK TELINGA;1;1000;0;1000;833;167;
2021-09-27 08:58:59;8886001038011;BENG-BENG SCT;1;1500;0;1500;1450;50;
2021-09-27 08:58:59;COKLAT;COKLAT COIN;4;500;0;2000;1700;300;
2021-09-27 08:58:59;8993072254018;MELROSE COTTON BUDS BSR;1;5000;0;5000;4050;950;
2021-09-27 08:58:59;8998898847109;KOPI JAHE;1;1500;0;1500;1180;320;
2021-09-27 08:58:59;Telur 3 Biji;Telur 3 Biji;1;5000;0;5000;3600;1400;
2021-09-27 08:58:59;KERUPUK 1000;KERUPUK BALADO;2;1000;0;2000;1800;200;
2021-09-27 08:58:59;089686021141;INTER MIE SOTO;1;1000;0;1000;854;146;
2021-09-27 08:58:59;8991002103535;GOOD DAY ORIGINAL;2;1500;0;3000;1780;1220;
2021-09-27 08:58:59;8991102987875;WFR TANGO POUCH CKL 115G;1;8000;0;8000;6786;1214;
2021-09-27 08:58:59;8992775001783;GERY SALUT MALKIST KELAPA;1;6500;0;6500;5516;984;
2021-09-27 08:58:59;8991102387286;TANGO LONG CKLT 47G;1;2000;0;2000;1551;449;
2021-09-27 08:58:59;8998866610087;JAVANA ORIGINAL 350ML;1;3000;0;3000;2150;850;
2021-09-27 08:58:59;4902430745703;DOWNY SUNRISE FRESH 10ML;4;500;0;2000;1572;428;
2021-09-27 08:58:59;8997003910684;2CS;1;3000;0;3000;1500;1500;
2021-09-27 08:58:59;Vita Jelly;Vita Jelly;1;1000;0;1000;766;234;
2021-09-27 08:58:59;7622201430153;OREO CHOCOLATE 38G;1;2000;0;2000;1641;359;
2021-09-27 08:58:59;8998866202602;KRISBEE FRENCH FRIES 18GR;1;2000;0;2000;1500;500;
2021-09-27 08:58:59;8992696521797;MILO 22G;1;2500;0;2500;1572;928;
2021-09-27 08:58:59;8999909982000;SAMPOERNA 12 FILTER;1;19000;0;19000;16600;2400;
2021-09-27 08:58:59;8992759120264;LARISST 220;1;10000;0;10000;9200;800;
2021-09-27 08:58:59;YP;YUPI;6;250;0;1500;1248;252;
2021-09-27 09:37:57;8993072254018;MELROSE COTTON BUDS BSR;1;5000;0;5000;4050;950;
2021-09-27 09:37:57;8992806145417;SCOTCH BRITE;1;3500;0;3500;2407;1093;
2021-09-27 09:37:57;JGR SHN;JOGER SHINY SACHET;1;500;0;500;437;63;
2021-09-27 09:38:52;8992957220025;GOLDEN CITY MINI;1;3000;0;3000;2500;500;
2021-09-27 09:38:52;SURYA;SURYA;2;500;0;1000;1000;0;
2021-09-27 09:38:52;Garuda Pilus;Garuda Pilus Rasa Abon Pcs;2;500;0;1000;802;198;
2021-09-27 09:57:16;8998866605113;CLING KUNING BTL 440ML;1;8500;0;8500;7600;900;
2021-09-27 09:57:16;089686043273;INDOMIE SAMBAL RICA;1;2700;0;2700;2452;248;
2021-09-27 09:57:16;8992957220025;GOLDEN CITY MINI;1;3000;0;3000;2500;500;
2021-09-27 10:30:36;8998866619035;Royale Sweet Floral 13 ml;1;5000;0;5000;4452;548;
2021-09-27 10:30:36;8999999520885;WIPOL 500 ML;1;10000;0;10000;8600;1400;
2021-09-27 10:30:36;8998866808248;SOKLIN LAVENDER 490 GRAM;1;18000;0;18000;17000;1000;
2021-09-27 10:30:36;9556001004673;MILO NESTLE MALAYSIA ACTIVE GO;1;85000;0;85000;80000;5000;
2021-09-27 10:30:36;089686611618;QTELA BARBEQUE;3;5000;0;15000;12798;2202;
2021-09-27 10:30:36;089686611878;QTELA TEMPE;1;6000;0;6000;5370;630;
2021-09-27 10:30:36;8999999706180;PEPSODENT WHITE 190GR;1;10000;0;10000;9350;650;
2021-09-27 10:30:36;8998866606158;NUVO ACTIVE COOL 110G;1;3000;0;3000;2600;400;
2021-09-27 10:30:36;8999999525590;PEPSODENT TB KIDS;1;12900;0;12900;11700;1200;
2021-09-27 10:30:36;8999999390198;SUNLIGHT LIME NEW POUCH 755ML;3;18000;0;54000;47850;6150;
2021-09-27 10:30:36;8992696405417;DNCO INSTANT 27G;3;3500;0;10500;9000;1500;
2021-09-27 10:30:36;8992696523067;MILO ACTVGO UHT 180ML;2;4500;0;9000;7030;1970;
2021-09-27 10:30:36;8997011700123;BIHUN JAGUNG 300GR;1;6000;0;6000;4979;1021;
2021-09-27 10:30:36;8886020033431;KAPUR AJAIB ANTI KECOA DAN NYAMUK;1;3000;0;3000;2700;300;
2021-09-27 10:30:36;TBR;TEPUNG BERAS ROSE BRAND;2;8000;0;16000;11600;4400;
2021-09-27 10:30:36;8992702000018;INDOMILK PUTIH 370G;1;10000;0;10000;9020;980;
2021-09-27 10:30:36;8994023000050;MEGKEJU SERBAGUNA 165G;1;13000;0;13000;12000;1000;
2021-09-27 10:30:36;8992628510158;SIMAS PALMIA;1;6000;0;6000;4832;1168;
2021-09-27 10:30:36;8997213204900;INLITE 30W;2;110000;0;220000;210000;10000;
2021-09-27 10:30:36;8997213204887;INLITE 20W;1;68000;0;68000;65000;3000;
2021-09-27 10:30:36;711844110113;KECAP ABC 135 ML;1;7000;0;7000;6400;600;
2021-09-27 10:30:36;8991689668006;SWALLOW;6;3500;0;21000;21000;0;
2021-09-27 10:30:36;8991002105409;KOPI KAPAL API;1;20000;0;20000;18888;1112;
2021-09-27 10:30:36;8998866107112;WET WIPES KODOMO  BABY 50SHT;1;20000;0;20000;14150;5850;
2021-09-27 10:30:36;TELUR RAK;TELUR RAK;1;38000;0;38000;35000;3000;
2021-09-27 10:30:36;8992696404441;BEAR BRAND 189ML;1;15000;0;15000;11000;4000;
2021-09-27 10:31:36;089686611670;QTELA BALADO;1;5000;0;5000;4266;734;
2021-09-27 11:19:31;089686021127;INTER MIE KALDU;1;1000;0;1000;813;187;
2021-09-27 11:19:31;8999999046996;LIFEBUOY TOTAL10 60G;1;3000;0;3000;1800;1200;
2021-09-27 13:08:17;8991102022460;FORMULA DIAMOND;1;3000;0;3000;2500;500;
2021-09-27 13:08:17;8997028590045;ARGUS BTL 330ML;1;2000;0;2000;1291;709;
2021-09-27 13:08:17;8998989300261;GUDANG GARAM SURYA 12 FILTER;1;20000;0;20000;18150;1850;
2021-09-27 13:08:22;RB;RED BOLD;1;20000;0;20000;18800;1200;
2021-09-27 14:18:28;8994867000179;ROKOK PENA MILD 16;1;14500;0;14500;13500;1000;
2021-09-27 15:30:02;8992775311509;gery garuda;2;1000;0;2000;1400;600;
2021-09-27 15:30:02;8992775001844;Chocolatos original taste;3;1000;0;3000;2487;513;
2021-09-27 16:26:14;089686386127;BUMBU RACIK NASI GORENG SOSIS;1;2000;0;2000;1620;380;
2021-09-27 16:38:21;8999909000971;MAGNUM MILD 20;1;24000;0;24000;22750;1250;
2021-09-27 16:46:46;6907992823867;JD CRUNCHY CHOCOLATE MALT;1;5500;0;5500;4700;800;
2021-09-27 16:46:46;8999999037765;pepsodent 225 gr;1;12000;0;12000;10500;1500;
2021-09-27 16:46:46;8991909101016;URBAN MILD 16;1;17000;0;17000;15800;1200;
2021-09-27 17:04:40;8991102026383;AIR CRYSTALINE 1.5 L;1;5000;0;5000;3471;1529;
2021-09-27 17:32:23;GL;GULA 1 LITER;3;11500;0;34500;31500;3000;
2021-09-27 17:32:23;8997231980022;O'JELLY MINI STRAWBERRY;1;3000;0;3000;2250;750;
2021-09-27 17:32:23;JGR SHN;JOGER SHINY SACHET;5;500;0;2500;2185;315;
2021-09-27 18:10:03;8991001503107;CHACHA PEANUT 35GR;1;5500;0;5500;4900;600;
2021-09-27 18:10:03;OJELLY;O'JELLY;1;500;0;500;385;115;
2021-09-27 18:10:03;8999909002821;MARLBORO BLACK 16;1;22000;0;22000;20850;1150;
2021-09-27 18:20:13;8992806145417;SCOTCH BRITE;2;3500;0;7000;4814;2186;
2021-09-27 18:20:13;8999999524722;SUNLIGHT LIME NEW PCH 435ML;1;10000;0;10000;9100;900;
2021-09-27 18:21:16;KOPIKO;KOPIKO;12;250;0;3000;2100;900;
2021-09-27 18:21:44;8997028590014;ARGUS 220ML;1;500;0;500;302;198;
2021-09-27 18:21:44;OJELLY;O'JELLY;1;500;0;500;385;115;
2021-09-27 19:25:39;8997222130016;Lemonilo Mie Goreng;2;7500;0;15000;12000;3000;
2021-09-27 19:26:38;8998866501033;MINYAK GORENG SEDAAP POUCH 2L;1;32000;0;32000;29683;2317;
2021-09-27 19:26:38;8997011700123;BIHUN JAGUNG 300GR;1;6000;0;6000;4979;1021;
2021-09-27 19:32:40;8994834003752;TICTIC;2;2000;0;4000;3400;600;
2021-09-27 20:03:24;8998009010231;ULTRA CHO 250;1;6000;0;6000;4784;1216;
2021-09-27 20:03:24;8997009510055;YOU C1000;1;15000;0;15000;13000;2000;
2021-09-27 20:05:08;089686611618;QTELA BARBEQUE;1;5000;0;5000;4266;734;
2021-09-27 20:05:08;8997218380074;ICHITAN MILK TEA;1;8000;0;8000;6583;1417;
2021-09-27 20:06:33;8992959953037;SWEETY BRONZE L1;2;2500;0;5000;3638;1362;
2021-09-27 20:07:05;7992912508305;SWEETY SILVER PANTS L1;2;2500;0;5000;3764;1236;
2021-09-27 20:43:21;8998989300261;GUDANG GARAM SURYA 12 FILTER;1;20000;0;20000;18150;1850;
2021-09-27 21:26:47;8998866200301;MIE SEDAAP GORENG;2;2700;0;5400;4726;674;
2021-09-27 21:26:47;8998866200325;MIE SEDAAP SOTO;1;2700;0;2700;2282;418;
2021-09-27 21:29:14;8997222130191;Lemonilo Ayam Bawang;1;7500;0;7500;6000;1500;
2021-09-27 21:29:14;MILKITA;MILKITA;2;250;0;500;400;100;
2021-09-28 10:27:32;8998866202671;NOODLE SEDAAP MIE KOREAN SPICY SOUP CUP;2;5000;0;10000;8004;1996;
2021-09-28 10:31:08;8998989500166;GUDANG GARAM MERAH BESAR 16KS;2;18000;0;36000;34000;2000;
2021-09-28 10:31:08;8993379200879;SABUN HARMONY MELON 70G;1;2000;0;2000;1652;348;
2021-09-28 10:31:08;8998866200301;MIE SEDAAP GORENG;1;2700;0;2700;2363;337;
2021-09-28 10:31:08;8998866202626;Top Kopi Gula Aren 22gr;2;1000;0;2000;1106;894;
2021-09-28 11:29:08;8998866601436;PODET DAIA BUNGA BAG 850GR & PIRING;1;18000;0;18000;15627;2373;
2021-09-28 11:31:55;GL;GULA 1 LITER;1;11500;0;11500;10500;1000;
2021-09-28 11:31:55;8992628024143;MINYAK GORENG BIMOLI 620ML;1;15000;0;15000;13900;1100;
2021-09-28 11:31:55;8999999195649;SARIWANGI 25X1.86G;1;6000;0;6000;5202;798;
2021-09-28 12:31:54;Telur 3 Biji;Telur 3 Biji;1;5000;0;5000;3600;1400;
2021-09-28 12:33:52;8998866603676;FRES&NATURAL SOAP GREEN 65G;1;1800;0;1800;1425;375;
2021-09-28 12:33:52;8998866613729;EMERON LOVELY NTRL 100ML;1;3500;0;3500;2900;600;
2021-09-28 12:34:53;MILKITA;MILKITA;8;250;0;2000;1600;400;
2021-09-28 12:34:53;8994867007161;ROKOK PENA GOLD 20;1;18000;0;18000;16800;1200;
2021-09-28 13:38:33;8886001038011;BENG-BENG SCT;2;1500;0;3000;2900;100;
2021-09-28 13:40:33;6907992825076;JD WATERMELON APPLE;1;2000;0;2000;1700;300;
2021-09-28 13:40:33;8998866200301;MIE SEDAAP GORENG;1;2700;0;2700;2363;337;
2021-09-28 13:40:33;MILKITA;MILKITA;1;250;0;250;200;50;
2021-09-28 14:04:57;8991102026383;AIR CRYSTALINE 1.5 L;2;5000;0;10000;6942;3058;
2021-09-28 14:15:33;6907992823867;JD CRUNCHY CHOCOLATE MALT;3;5500;0;16500;14100;2400;
2021-09-28 16:37:39;8995555171225;KIMBO SOSIS;1;1000;0;1000;900;100;
2021-09-28 16:37:39;TG;TEH GELAS;1;1000;0;1000;729;271;
2021-09-28 16:37:39;MILKITA;MILKITA;2;250;0;500;400;100;
2021-09-28 16:42:00;8999909001909;MAGNUM REVAMP BLACK 12;1;18000;0;18000;16300;1700;
2021-09-28 16:42:00;7622300335755;OREO SOFT CAKE BOX;1;22000;0;22000;19700;2300;
2021-09-28 16:55:50;TG;TEH GELAS;2;1000;0;2000;1458;542;
2021-09-28 16:55:50;8998866610087;JAVANA ORIGINAL 350ML;3;3000;0;9000;6450;2550;
2021-09-28 16:55:50;8992761166205;FRESTEA GREEN HONEY 350ML;1;4500;0;4500;3000;1500;
2021-09-28 16:55:50;8992761166052;FRESTEA MELATI 350ML;1;4500;0;4500;3000;1500;
2021-09-28 16:55:50;8998866610377;ISOPLUS;1;3000;0;3000;2350;650;
2021-09-28 16:55:50;8994834006128;TICTIC PEDAS;1;2000;0;2000;1700;300;
2021-09-28 17:46:20;8991102303309;WFR TANGO SBJ 176G;1;10000;0;10000;8694;1306;
2021-09-28 18:36:55;8992775110157;GARUDA KACANG KULIT;1;5000;0;5000;3925;1075;
2021-09-28 18:36:55;8996001314005;ROMA KELAPA CREAM CKLT;1;8000;0;8000;6642;1358;
2021-09-28 18:42:07;8992959076200;HN PANTS M34;1;50000;0;50000;45455;4545;
2021-09-28 18:42:07;8992959107515;SFX NON WING 23CM 8;1;4000;0;4000;3288;712;
2021-09-28 18:42:07;8996001305058;ROMA SANDWICH KACANG;1;7000;0;7000;5928;1072;
2021-09-28 18:42:07;7622210580276;OREO CHOCOLATE CREAM 66.5 G;1;4000;0;4000;3200;800;
2021-09-28 18:42:07;8997231980022;O'JELLY MINI STRAWBERRY;1;3000;0;3000;2250;750;
2021-09-28 18:42:07;8991102026383;AIR CRYSTALINE 1.5 L;1;5000;0;5000;3471;1529;
2021-09-28 18:42:07;8992388133345;NU MILK TEA TEH TARIK 330ML;1;6000;0;6000;5125;875;
2021-09-28 18:42:07;6907992823645;JD COCONUT BLISS;2;4000;0;8000;7000;1000;
2021-09-28 18:42:07;8992716109172;BISKUAT BOLU SCT;1;2000;0;2000;1641;359;
2021-09-28 18:42:07;7622300335809;OREO SOFT CAKE;1;2000;0;2000;1641;359;
2021-09-28 18:42:07;8997018720018;SIRUP DHT;1;23000;0;23000;20958;2042;
2021-09-28 18:46:44;OJELLY;O'JELLY;3;500;0;1500;1155;345;
2021-09-28 18:46:44;8991102714846;MILKIDO CKLT;1;3000;0;3000;2153;847;
2021-09-28 18:59:45;8992388133017;NU MILK TEA ORI 330ML;1;6000;0;6000;5125;875;
2021-09-28 19:13:07;8998866202626;Top Kopi Gula Aren 22gr;15;866;0;12990;8295;4695;
2021-09-28 19:13:07;8992761122331;FRESTEA APPEL 500ML;1;6500;0;6500;4791;1709;
2021-09-28 19:22:57;8991002103436;GOOD DAY COOLIN;1;1500;0;1500;890;610;
2021-09-28 19:24:02;6907992825076;JD WATERMELON APPLE;1;2000;0;2000;1700;300;
2021-09-28 19:32:25;6907992824963;JD MILKY CHOCOLATE;1;3000;0;3000;2600;400;
2021-09-28 19:32:25;OJELLY;O'JELLY;10;500;0;5000;3850;1150;
2021-09-28 20:37:51;ARG;ARGUS DOS 220ML;3;14500;0;43500;39900;3600;
2021-09-28 20:37:51;GGK;PLAYGUM PERMEN KARET;3;500;0;1500;1200;300;
2021-09-28 20:49:26;8999999030186;PEPSODENT ACTION 123 COMPLETE 190G;1;14000;0;14000;13200;800;
2021-09-28 20:49:26;GL;GULA 1 LITER;1;11500;0;11500;10500;1000;
2021-09-28 20:49:26;MILKITA;MILKITA;2;250;0;500;400;100;
2021-09-28 20:59:21;8998989110167;SURYA GUDANG GARAM 16 FILTER;1;26000;0;26000;23700;2300;
2021-09-28 21:02:09;8999909002821;MARLBORO BLACK 16;1;22000;0;22000;20850;1150;
2021-09-28 21:50:18;kri;kripik pisang;1;5000;0;5000;4000;1000;
2021-09-28 22:03:08;089686021127;INTER MIE KALDU;2;1000;0;2000;1626;374;
2021-09-28 22:19:06;8992696521797;MILO 22G;2;2500;0;5000;3144;1856;
2021-09-28 22:33:10;8992761139018;ADES 600ML;1;3500;0;3500;2166;1334;
2021-09-28 22:33:10;ARGUS;ARGUS;1;2000;0;2000;1500;500;
2021-09-28 22:47:59;8995333060703;TERIGU KOMPAS 1KG;2;10500;0;21000;19632;1368;
2021-09-28 22:47:59;8993001003908;INDOMILK KENTAL MANIS 545G;3;15000;0;45000;39999;5001;
2021-09-28 22:47:59;8992775000076;GERY SNACK RING CKLT;1;2000;0;2000;1712;288;
2021-09-28 22:47:59;8997028590052;ARGUS BTL 600ML;1;3000;0;3000;1458;1542;
2021-09-29 10:03:27;8999999009601;LIFEBUOY TOTAL10 500ML;1;38500;0;38500;36080;2420;
2021-09-29 10:06:08;711844110083;KECAP ABC 275 ML;1;15000;0;15000;14000;1000;
2021-09-29 10:06:08;8995333060772;TERIGU GATOT KACA 500GR;1;5000;0;5000;4346;654;
2021-09-29 10:07:29;8992775315057;GERY SALUT MALKIST COKLAT;1;6500;0;6500;5516;984;
2021-09-29 10:07:29;8997009510123;ORANGE WATER;2;11000;0;22000;20832;1168;
2021-09-29 10:08:20;8997028590052;ARGUS BTL 600ML;1;3000;0;3000;1458;1542;
2021-09-29 10:08:58;8991102714594;TANGO DRINK BLCK VNL;1;5000;0;5000;3818;1182;
2021-09-29 10:10:35;8992388133017;NU MILK TEA ORI 330ML;1;6000;0;6000;5125;875;
2021-09-29 10:10:35;PRG;PARAGO;8;500;0;4000;3200;800;
2021-09-29 10:11:57;8997028590052;ARGUS BTL 600ML;2;3000;0;6000;2916;3084;
2021-09-29 10:12:54;8992775305102;GERY MALKIST COCONUT;1;6500;0;6500;5516;984;
2021-09-29 10:12:54;8992775315095;GERY MALKIST SWEET CHEESE;1;6500;0;6500;5516;984;
2021-09-29 10:40:03;8992761139018;ADES 600ML;3;3500;0;10500;6498;4002;
2021-09-29 10:40:03;8992388133345;NU MILK TEA TEH TARIK 330ML;1;6000;0;6000;5125;875;
2021-09-29 10:40:03;8992775305102;GERY MALKIST COCONUT;1;6500;0;6500;5516;984;
2021-09-29 10:40:03;8991102714846;MILKIDO CKLT;1;3000;0;3000;2153;847;
2021-09-29 10:40:03;7622201430153;OREO CHOCOLATE 38G;1;2000;0;2000;1641;359;
2021-09-29 10:40:03;PRG;PARAGO;2;500;0;1000;800;200;
2021-09-29 10:40:03;MILKITA;MILKITA;12;250;0;3000;2400;600;
2021-09-29 10:40:03;8997003910684;2CS;2;3000;0;6000;3000;3000;
2021-09-29 10:40:03;8993989311279;CLAS MILD 12;1;18000;0;18000;15800;2200;
2021-09-29 10:40:03;8998866618144;NUVO FAMILY UNGU 76G;2;2000;0;4000;3760;240;
2021-09-29 10:40:03;8997028590014;ARGUS 220ML;2;500;0;1000;604;396;
2021-09-29 10:40:03;8998866202626;Top Kopi Gula Aren 22gr;2;1000;0;2000;1106;894;
2021-09-29 10:40:03;6907992823843;JD MOCHA CRISPY;1;5000;0;5000;4400;600;
2021-09-29 10:40:03;Vita Jelly;Vita Jelly;1;1000;0;1000;766;234;
2021-09-29 10:40:03;8995555171225;KIMBO SOSIS;1;1000;0;1000;900;100;
2021-09-29 10:40:03;Pulpen;pulpen;5;1000;0;5000;3750;1250;
2021-09-29 10:40:03;8994834003752;TICTIC;1;2000;0;2000;1700;300;
2021-09-29 10:40:03;8991102228053;TEH GELAS BOTOL;1;3000;0;3000;1695;1305;
2021-09-29 10:40:03;KOPIKO;KOPIKO;16;250;0;4000;2800;1200;
2021-09-29 10:40:03;8992775002933;GERY MALKIST DOUBLE ABON;1;6500;0;6500;5516;984;
2021-09-29 10:40:03;8991102308861;FULLO BLASTO;2;16000;0;32000;29090;2910;
2021-09-29 10:40:03;8992742360844;POLYTEX SABUT STENLESS;1;4000;0;4000;2200;1800;
2021-09-29 10:40:03;8998866202053;POTABEE AYAM BAKAR PEDAS 68GR;1;8000;0;8000;7200;800;
2021-09-29 10:40:03;ARGUS;ARGUS;4;2000;0;8000;6000;2000;
2021-09-29 10:40:03;8992775305164;GERY MALKIST GREEN TEA;1;6500;0;6500;5500;1000;
2021-09-29 10:40:03;8994867000179;ROKOK PENA MILD 16;1;14500;0;14500;13500;1000;
2021-09-29 11:14:44;8997028590052;ARGUS BTL 600ML;1;3000;0;3000;1458;1542;
2021-09-29 11:19:23;8997028590052;ARGUS BTL 600ML;1;3000;0;3000;1458;1542;
2021-09-29 11:31:37;8992761166052;FRESTEA MELATI 350ML;1;4500;0;4500;3000;1500;
2021-09-29 11:38:03;8991102308892;BLASTO;2;1000;0;2000;1990;10;
2021-09-29 11:38:03;8991001502926;Chaca Peanut;2;1000;0;2000;1600;400;
2021-09-29 11:38:03;Gula gula tusuk;gula gula tusuk;2;500;0;1000;800;200;
2021-09-29 11:38:03;MILKITA;MILKITA;4;250;0;1000;800;200;
2021-09-29 11:49:07;8998866201865;KRISBEE PILLOW CHOCOLAVA 120 GR;1;8000;0;8000;7250;750;
2021-09-29 11:49:31;8997028590052;ARGUS BTL 600ML;1;3000;0;3000;1458;1542;
2021-09-29 12:16:47;8997028590052;ARGUS BTL 600ML;1;3000;0;3000;1458;1542;
2021-09-29 12:16:47;8997028590014;ARGUS 220ML;4;500;0;2000;1208;792;
2021-09-29 12:48:23;8992775002582;DILAN CHOCO;1;2000;0;2000;1503;497;
2021-09-29 12:48:23;8994867007161;ROKOK PENA GOLD 20;1;18000;0;18000;16800;1200;
2021-09-29 12:53:36;8992761122331;FRESTEA APPEL 500ML;1;6500;0;6500;4791;1709;
2021-09-29 12:53:36;8992761002039;FANTA STRAWBERRY PET 390 ML;1;5500;0;5500;4333;1167;
2021-09-29 12:53:36;8991102300421;WFR TANGO COKLAT 176GR;1;10000;0;10000;8694;1306;
2021-09-29 12:53:36;8996001305119;ARDEN 30G;1;2000;0;2000;1650;350;
2021-09-29 13:03:50;KPS;KAPAS MEI QIAN;1;5000;0;5000;4750;250;
2021-09-29 13:03:50;8992696520103;DNCO INSTANT CKLT 39G;3;3500;0;10500;9000;1500;
2021-09-29 14:07:13;8998866610377;ISOPLUS;1;3000;0;3000;2350;650;
2021-09-29 14:13:43;8998866619004;ROYALE SUNNY DAY;1;5000;0;5000;4560;440;
2021-09-29 14:22:13;MATERAI;MATERAI;1;15000;0;15000;10000;5000;
2021-09-29 14:22:13;8992761122331;FRESTEA APPEL 500ML;1;6500;0;6500;4791;1709;
2021-09-29 14:22:13;8997231980022;O'JELLY MINI STRAWBERRY;1;3000;0;3000;2250;750;
2021-09-29 14:22:13;8992730002992;HAI CANDY;1;7000;0;7000;6000;1000;
2021-09-29 14:24:40;KOPIKO;KOPIKO;2;250;0;500;350;150;
2021-09-29 14:44:21;Gula gula tusuk;gula gula tusuk;6;500;0;3000;2400;600;
2021-09-29 14:44:21;8991909101016;URBAN MILD 16;1;17000;0;17000;15800;1200;
2021-09-29 14:44:59;MATERAI;MATERAI;3;15000;0;45000;30000;15000;
2021-09-29 15:19:29;8998866203227;MIE SEDAAP AYAM BAKAR LIMAU;1;2700;0;2700;2163;537;
2021-09-29 15:19:29;8998866200325;MIE SEDAAP SOTO;2;2700;0;5400;4564;836;
2021-09-29 15:19:29;8998989300261;GUDANG GARAM SURYA 12 FILTER;1;20000;0;20000;18150;1850;
2021-09-29 15:41:59;Telur 3 Biji;Telur 3 Biji;1;5000;0;5000;3600;1400;
2021-09-29 15:41:59;8991102387286;TANGO LONG CKLT 47G;1;2000;0;2000;1551;449;
2021-09-29 15:41:59;089686021141;INTER MIE SOTO;3;1000;0;3000;2562;438;
2021-09-29 15:41:59;8992775311509;gery garuda;1;1000;0;1000;700;300;
2021-09-29 15:59:08;Vita Jelly;Vita Jelly;1;1000;0;1000;766;234;
2021-09-29 15:59:08;HT;HOT-HOT;1;500;0;500;350;150;
2021-09-29 16:15:20;8994834003752;TICTIC;2;2000;0;4000;3400;600;
2021-09-29 16:15:20;KRZ;KREZZ COKELAT;1;1000;0;1000;715;285;
2021-09-29 16:15:20;8992761002022;SPRITE PET 390ML;1;5500;0;5500;4333;1167;
2021-09-29 16:50:07;7622300335809;OREO SOFT CAKE;1;2000;0;2000;1641;359;
2021-09-29 17:01:16;Garuda Pilus;Garuda Pilus Rasa Abon Pcs;1;500;0;500;401;99;
2021-09-29 17:01:16;8992775511206;LEO 10GR;1;1000;0;1000;848;152;
2021-09-29 17:01:16;8886013257400;TWISTKO;1;1000;0;1000;900;100;
2021-09-29 17:01:16;MILKITA;MILKITA;2;250;0;500;400;100;
2021-09-29 17:01:16;7622201430184;OREO ORIGINAL 38G;1;2000;0;2000;1641;359;
2021-09-29 17:01:16;8994867000162;ROKOK PUNDIMAS KRETEK16;1;10000;0;10000;8600;1400;
2021-09-29 17:30:24;8992959117583;SFX DS REG FLOW WING 20;1;5000;0;5000;4288;712;
2021-09-29 17:48:03;711844110113;KECAP ABC 135 ML;1;7000;0;7000;6400;600;
2021-09-29 17:48:03;8998866609487;SOKLIN SOFTERGEN 280G;1;5000;0;5000;4425;575;
2021-09-29 18:05:52;8992775001653;GERY SALUT CHOCOLATE COCONUT;2;2000;0;4000;2952;1048;
2021-09-29 18:05:52;8886001038011;BENG-BENG SCT;1;1500;0;1500;1450;50;
2021-09-29 18:05:52;8992716109172;BISKUAT BOLU SCT;1;2000;0;2000;1641;359;
2021-09-29 18:05:52;7622300335809;OREO SOFT CAKE;1;2000;0;2000;1641;359;
2021-09-29 18:05:52;7622300405588;KEJUCAKE 16G;1;2000;0;2000;1641;359;
2021-09-29 18:42:00;8995333060703;TERIGU KOMPAS 1KG;1;10500;0;10500;9816;684;
2021-09-29 19:16:17;8998866202770;MIE SEDAAP SALERO PADANG;1;2500;0;2500;2362;138;
2021-09-29 19:55:05;8992959117613;SFX DAUN SIRIH 1 WP;10;500;0;5000;4130;870;
2021-09-29 20:28:51;8998866500579;BABY HAPPY PANTS XL 7P;1;17000;0;17000;14827;2173;
2021-09-29 21:09:04;8998866202619;MIE SEDAAP KOREAN SPICY SOUP;1;2700;0;2700;2322;378;
2021-09-29 21:09:04;8998866608046;KECAP MANIS SEDAAP POUCH 225ML;1;8500;0;8500;7744;756;
2021-09-29 21:09:04;8992702000063;INDOMILK COKLAT 370G;1;10000;0;10000;9020;980;
2021-09-29 21:09:04;8992775000076;GERY SNACK RING CKLT;2;2000;0;4000;3424;576;
2021-09-29 21:09:04;8992628020152;MINYAK GOREG BIMOLI POUCH 2L;1;32000;0;32000;29800;2200;
2021-09-29 21:09:04;9556006012093;JB BATH TOPTOETOE 200ML;1;16000;0;16000;14820;1180;
2021-09-29 21:36:50;9556001025272;NESCAFE LATTE 240ML;1;8500;0;8500;7834;666;
2021-09-29 21:36:50;ARG;ARGUS DOS 220ML;1;14500;0;14500;13300;1200;
2021-09-29 22:14:10;8999909982000;SAMPOERNA 12 FILTER;1;19000;0;19000;16600;2400;
2021-09-29 22:14:10;8997021110028;Garam Kasar;25;2500;0;62500;37500;25000;
2021-09-29 22:23:39;9556001025272;NESCAFE LATTE 240ML;1;8500;0;8500;7834;666;
2021-09-29 22:23:39;8997028590052;ARGUS BTL 600ML;1;3000;0;3000;1458;1542;
2021-09-30 09:53:07;8993989311699;CLAS MILD 16 FILTER;1;24000;0;24000;21700;2300;
2021-09-30 09:59:19;8991102281430;PERMEN MINTZ DUOMINT;2;5000;0;10000;8000;2000;
2021-09-30 10:18:41;8998866202770;MIE SEDAAP SALERO PADANG;1;2500;0;2500;2362;138;
2021-09-30 10:18:41;8992775211410;PILUS GARUDA PEDAS;1;5000;0;5000;4886;114;
2021-09-30 10:18:41;8998866202626;Top Kopi Gula Aren 22gr;3;688;0;2064;1659;405;
2021-09-30 10:18:41;JGR SHN;JOGER SHINY SACHET;1;500;0;500;437;63;
2021-09-30 11:32:12;8992959953310;SWEETY BRONZE M58;1;85000;0;85000;80304;4696;
2021-09-30 11:32:12;8998866609487;SOKLIN SOFTERGEN 280G;1;5000;0;5000;4425;575;
2021-09-30 11:54:25;GL;GULA 1 LITER;4;11500;0;46000;42000;4000;
2021-09-30 12:29:32;8998989500166;GUDANG GARAM MERAH BESAR 16KS;1;18000;0;18000;17000;1000;
2021-09-30 12:31:46;8992959020005;SWEETY SILVER PANTS XXL5;1;16800;0;16800;15228;1572;
2021-09-30 12:31:46;8992388133345;NU MILK TEA TEH TARIK 330ML;1;6000;0;6000;5125;875;
2021-09-30 12:34:58;Telur 3 Biji;Telur 3 Biji;1;5000;0;5000;3600;1400;
2021-09-30 12:34:58;089686021141;INTER MIE SOTO;1;1000;0;1000;854;146;
2021-09-30 12:34:58;8998866202619;MIE SEDAAP KOREAN SPICY SOUP;1;2700;0;2700;2322;378;
2021-09-30 12:34:58;KERUPUK;KERUPUK BALADO;1;1000;0;1000;900;100;
2021-09-30 12:51:53;Telur 3 Biji;Telur 3 Biji;1;5000;0;5000;3600;1400;
2021-09-30 12:51:53;8992959953037;SWEETY BRONZE L1;1;2500;0;2500;1819;681;
2021-09-30 14:09:43;7622201430153;OREO CHOCOLATE 38G;1;2000;0;2000;1641;359;
2021-09-30 14:09:43;8991102308892;BLASTO;1;1000;0;1000;995;5;
2021-09-30 14:09:43;8992775002582;DILAN CHOCO;1;2000;0;2000;1503;497;
2021-09-30 14:09:43;8994867007161;ROKOK PENA GOLD 20;1;18000;0;18000;16800;1200;
2021-09-30 14:09:43;8998989300261;GUDANG GARAM SURYA 12 FILTER;1;20000;0;20000;18150;1850;
2021-09-30 14:09:44;8992761164546;NUTRIBOOST STRAWBERRY 300ML;2;6500;0;13000;10600;2400;
2021-09-30 14:09:44;COKLAT;COKLAT COIN;2;500;0;1000;850;150;
2021-09-30 14:09:44;8992388133345;NU MILK TEA TEH TARIK 330ML;1;6000;0;6000;5125;875;
2021-09-30 14:09:44;8998866202664;POTABEE WAGYU BEEF STEAK 68 GR;1;8000;0;8000;7200;800;
2021-09-30 15:47:58;8992759120264;LARISST 220;1;10000;0;10000;9200;800;
2021-09-30 15:48:27;8999801700054;SUSU FOYU 1 KG;1;22000;0;22000;19791;2209;
2021-09-30 17:43:35;8991102987875;WFR TANGO POUCH CKL 115G;1;8000;0;8000;6786;1214;
2021-09-30 17:43:35;8995555121244;SOSIS KIMBO;3;1000;0;3000;1950;1050;
2021-09-30 17:59:30;8999909096004;SAMPOERNA 16 FILTER;1;25000;0;25000;23100;1900;
2021-09-30 18:29:59;8999801700054;SUSU FOYU 1 KG;1;22000;0;22000;19791;2209;
2021-09-30 18:29:59;8998866200301;MIE SEDAAP GORENG;1;2700;0;2700;2363;337;
2021-09-30 18:29:59;089686021219;INTER MIE GORENG;3;1000;0;3000;2655;345;
2021-09-30 18:29:59;089686021141;INTER MIE SOTO;2;1000;0;2000;1708;292;
2021-09-30 19:09:50;8993335529419;Sabun Total de Parfumee Floral Vibes;1;24500;0;24500;22000;2500;
2021-09-30 19:09:50;8999999001209;LIFEBUOY BW MILDCARE LD REFF 450 ML;1;25000;0;25000;22110;2890;
2021-09-30 19:09:50;8999999401238;RINSO ANTI NODA 770G;2;21200;0;42400;38676;3724;
2021-09-30 19:09:50;8999999706180;PEPSODENT WHITE 190GR;3;10000;0;30000;28050;1950;
2021-09-30 19:09:50;8999999055769;FAIR&LOVELY MVIT FC FOAM 50 G;1;12500;0;12500;11715;785;
2021-09-30 19:14:12;8999999552343;LUX BW BIRD OF PARADISE 250ML;1;20000;0;20000;17900;2100;
2021-09-30 19:19:40;8993989311699;CLAS MILD 16 FILTER;1;24000;0;24000;21700;2300;
2021-09-30 20:10:19;8992775001998;Gery Salut sandwich;1;1000;0;1000;815;185;
2021-09-30 20:27:36;8997011700123;BIHUN JAGUNG 300GR;4;6000;0;24000;19916;4084;
2021-09-30 21:14:56;8998989300261;GUDANG GARAM SURYA 12 FILTER;2;20000;0;40000;36300;3700;
2021-09-30 21:32:14;8996001314005;ROMA KELAPA CREAM CKLT;1;8000;0;8000;6642;1358;
2021-09-30 21:32:14;ROTI;ROTI 2000;1;2000;0;2000;1800;200;
2021-09-30 21:32:14;8994867006997;ROKOK PENA BOLD 20BTG;1;17000;0;17000;15000;2000;
2021-09-30 21:32:14;123124;KOREK BIASA;1;2000;0;2000;1300;700;
2021-09-30 21:32:14;MILKITA;MILKITA;4;250;0;1000;800;200;
2021-09-30 21:36:09;8991102228053;TEH GELAS BOTOL;1;3000;0;3000;1695;1305;
2021-09-30 21:43:55;8999909096004;SAMPOERNA 16 FILTER;1;25000;0;25000;23100;1900;
2021-09-30 21:45:27;6907992823904;JD CRUNCHY CHOCOLATE VAN;1;8000;0;8000;6800;1200;
2021-09-30 21:45:27;6907992823652;JD CHOCOLATE MILKSHAKE;1;6000;0;6000;5200;800;
2021-09-30 21:52:05;8998866200578;MIE SEDAAP KARI KENTAL;2;2700;0;5400;4662;738;
2021-09-30 21:52:05;8998866200325;MIE SEDAAP SOTO;2;2700;0;5400;4564;836;
2021-09-30 21:58:30;8997027300089;NOMOS;1;4000;0;4000;2963;1037;
2021-09-30 21:58:30;WC;WAFER COKELAT MADE;1;1000;0;1000;800;200;
2021-10-01 10:58:35;8997210107877;VORTEX SMART 3;1;5000;0;5000;4750;250;
2021-10-01 10:58:35;TORT;TORTILA;5;1000;0;5000;5000;0;
2021-10-01 10:58:35;089686021219;INTER MIE GORENG;2;1000;0;2000;1770;230;
2021-10-01 10:58:35;8991002103832;GOOD DAY CHOCOCINNO;3;1500;0;4500;2670;1830;
2021-10-01 10:58:35;KOPIKO;KOPIKO;2;250;0;500;350;150;
2021-10-01 10:58:35;8998898830125;KKB ENER-G ANGGUR;1;5500;0;5500;4824;676;
2021-10-01 10:58:35;ARG;ARGUS DOS 220ML;1;14500;0;14500;13300;1200;
2021-10-01 10:58:35;8999999516208;ROYCO FDS CHICKEN NEW 230G;1;10000;0;10000;9000;1000;
2021-10-01 10:58:35;8998866202626;Top Kopi Gula Aren 22gr;2;1000;0;2000;1106;894;
2021-10-01 10:58:35;8998866202770;MIE SEDAAP SALERO PADANG;1;2500;0;2500;2362;138;
2021-10-01 10:58:35;YOUTOP;YOUTOP;1;1000;0;1000;875;125;
2021-10-01 10:58:35;Vita Jelly;Vita Jelly;1;1000;0;1000;766;234;
2021-10-01 10:58:35;8991102714846;MILKIDO CKLT;1;3000;0;3000;2153;847;
2021-10-01 10:58:35;8997028590014;ARGUS 220ML;3;500;0;1500;906;594;
2021-10-01 10:58:35;8886001038011;BENG-BENG SCT;1;1500;0;1500;1450;50;
2021-10-01 10:58:35;8991102320184;TANGO CHOCO JAVAMOCCA;1;5000;0;5000;4330;670;
2021-10-01 10:58:35;8992775318201;GERY SNACK BANTAL COKLAT;1;2000;0;2000;1712;288;
2021-10-01 10:58:35;7622201430184;OREO ORIGINAL 38G;1;2000;0;2000;1641;359;
2021-10-01 10:58:35;8995555121244;SOSIS KIMBO;1;1000;0;1000;650;350;
2021-10-01 10:58:35;8992775001998;Gery Salut sandwich;1;1000;0;1000;815;185;
2021-10-01 11:06:06;8996001305119;ARDEN 30G;1;2000;0;2000;1650;350;
2021-10-01 11:06:06;8997028590052;ARGUS BTL 600ML;2;3000;0;6000;2916;3084;
2021-10-01 11:23:22;8998989500166;GUDANG GARAM MERAH BESAR 16KS;1;18000;0;18000;17000;1000;
2021-10-01 11:26:46;8999999046996;LIFEBUOY TOTAL10 60G;1;3000;0;3000;1800;1200;
2021-10-01 11:57:06;8995333060703;TERIGU KOMPAS 1KG;1;10500;0;10500;9816;684;
2021-10-01 11:57:06;8998866604963;POWDET DAIA LEMON 290GR;2;5000;0;10000;8900;1100;
2021-10-01 11:57:06;8998866107068;Mama lemon 230 ml;1;4000;0;4000;3500;500;
2021-10-01 11:57:06;8998866602549;NUVO FAMILY BIRU 76G;1;2000;0;2000;1820;180;
2021-10-01 11:57:06;8999999030179;PEPSODENT ACTION 123 COMPLETE 75G;1;6700;0;6700;5170;1530;
2021-10-01 11:57:06;8991002105430;KAPAL API 65G;2;5000;0;10000;8290;1710;
2021-10-01 11:57:06;ROYCO;ROYCO RASA AYAM;2;500;0;1000;750;250;
2021-10-01 11:58:09;8992984920110;CUKA DAPUR DUA BELIBIS;3;4500;0;13500;9750;3750;
2021-10-01 11:58:09;8999999524838;SUNLIGHT MINT POUCH 755ML;2;18000;0;36000;31900;4100;
2021-10-01 11:58:09;8991909101016;URBAN MILD 16;1;17000;0;17000;15800;1200;
2021-10-01 12:32:25;8997028590014;ARGUS 220ML;2;500;0;1000;604;396;
2021-10-01 12:32:25;Vita Jelly;Vita Jelly;1;1000;0;1000;766;234;
2021-10-01 12:32:25;8992957220025;GOLDEN CITY MINI;1;3000;0;3000;2500;500;
2021-10-01 13:15:44;8999909010567;234 DJI SAM SOE 16;1;22500;0;22500;21500;1000;
2021-10-01 13:16:28;8991001502926;Chaca Peanut;1;1000;0;1000;800;200;
2021-10-01 13:16:28;6907992825076;JD WATERMELON APPLE;1;2000;0;2000;1700;300;
2021-10-01 13:47:41;BALON;BALON CABUT;1;1000;0;1000;900;100;
2021-10-01 14:04:43;8998866610377;ISOPLUS;1;3000;0;3000;2350;650;
2021-10-01 14:07:22;BAYFLAST;BAYPLAST;2;500;0;1000;700;300;
2021-10-01 14:07:22;KOPIKO;KOPIKO;4;250;0;1000;700;300;
2021-10-01 14:30:47;8998989300261;GUDANG GARAM SURYA 12 FILTER;1;20000;0;20000;18150;1850;
2021-10-01 14:30:47;KIKO;KIKO;2;1000;0;2000;1000;1000;
2021-10-01 14:37:05;8994867000179;ROKOK PENA MILD 16;2;14500;0;29000;27000;2000;
2021-10-01 14:37:05;MILKITA;MILKITA;12;250;0;3000;2400;600;
2021-10-01 14:39:27;8992761166052;FRESTEA MELATI 350ML;1;4500;0;4500;3000;1500;
2021-10-01 14:39:27;JGR SHN;JOGER SHINY SACHET;1;500;0;500;437;63;
2021-10-01 14:53:35;ROTI;ROTI 2000;2;2000;0;4000;3600;400;
2021-10-01 14:53:35;COKLAT;COKLAT COIN;4;500;0;2000;1700;300;
2021-10-01 14:56:37;6907992825076;JD WATERMELON APPLE;1;2000;0;2000;1700;300;
2021-10-01 14:56:37;COKLAT;COKLAT COIN;2;500;0;1000;850;150;
2021-10-01 15:52:48;8992222050418;GATSBY NORMAL 38GR;1;5000;0;5000;3850;1150;
2021-10-01 16:07:20;OJELLY;O'JELLY;4;500;0;2000;1540;460;
2021-10-01 16:07:20;TG;TEH GELAS;1;1000;0;1000;729;271;
2021-10-01 16:24:40;8992775002582;DILAN CHOCO;1;2000;0;2000;1503;497;
2021-10-01 16:24:40;YOUTOP;YOUTOP;1;1000;0;1000;875;125;
2021-10-01 16:24:40;8992775511206;LEO 10GR;2;1000;0;2000;1696;304;
2021-10-01 16:24:40;8994834005923;SPIX 1000;1;1000;0;1000;850;150;
2021-10-01 16:24:40;8995555171225;KIMBO SOSIS;2;1000;0;2000;1800;200;
2021-10-01 16:44:45;8993989311699;CLAS MILD 16 FILTER;1;24000;0;24000;21700;2300;
2021-10-01 16:48:04;TBR;TEPUNG BERAS ROSE BRAND;1;8000;0;8000;5800;2200;
2021-10-01 16:48:04;8993379210854;SABUN HARMONY APPLE 70G;1;2000;0;2000;1652;348;
2021-10-01 16:48:04;8993379241858;SABUN HARMONY LEMON 70G;1;2000;0;2000;1652;348;
2021-10-01 16:48:04;089686060461;POP MIE RASA KARI AYAM;1;4500;0;4500;3833;667;
2021-10-01 17:31:28;ARGUS;ARGUS;1;2000;0;2000;1500;500;
2021-10-01 17:50:23;ARG;ARGUS DOS 220ML;1;14500;0;14500;13300;1200;
2021-10-01 17:50:23;8994867007161;ROKOK PENA GOLD 20;1;18000;0;18000;16800;1200;
2021-10-01 17:50:53;GGK;PLAYGUM PERMEN KARET;2;500;0;1000;800;200;
2021-10-01 17:50:53;KIKO;KIKO;1;1000;0;1000;500;500;
2021-10-01 18:04:04;7622201430184;OREO ORIGINAL 38G;1;2000;0;2000;1641;359;
2021-10-01 18:07:52;8995333032113;TERIGU GATOT KACA 1 KG;1;9000;0;9000;8572;428;
2021-10-01 18:07:52;8999999400958;MOLTO PEWANGI BLUE 820ML;1;12500;0;12500;11275;1225;
2021-10-01 18:07:52;8992979190986;TOTAL PUTIH SOFTENER;2;15000;0;30000;27048;2952;
2021-10-01 18:07:52;KPS;KAPAS MEI QIAN;1;5000;0;5000;4750;250;
2021-10-01 18:07:52;8998866600538;SOKLIN FLOORCLENER PINK 400ML;1;6000;0;6000;5025;975;
2021-10-01 18:07:52;8999999707859;CLOSEUP GREEN 160G;1;15000;0;15000;13600;1400;
2021-10-01 18:07:52;8999999500399;LUX TS CAMELLIA WHITE;4;3500;0;14000;11200;2800;
2021-10-01 18:07:52;8998866600101;CREAM EKONOMI LEMON 455G;1;5500;0;5500;4750;750;
2021-10-01 18:07:52;8998866108102;POSH GREEN BLOSSOM 150;1;19500;0;19500;17500;2000;
2021-10-01 18:07:52;GL;GULA 1 LITER;1;11500;0;11500;10500;1000;
2021-10-01 18:28:09;8994867000094;ROKOK PUNDIMAS FIL16;1;15000;0;15000;13500;1500;
2021-10-01 18:41:08;8992222050418;GATSBY NORMAL 38GR;1;5000;0;5000;3850;1150;
2021-10-01 18:41:08;8999999524722;SUNLIGHT LIME NEW PCH 435ML;1;10000;0;10000;9100;900;
2021-10-01 18:50:43;ROTI;ROTI 2000;1;2000;0;2000;1800;200;
2021-10-01 18:50:43;8995555171225;KIMBO SOSIS;2;1000;0;2000;1800;200;
2021-10-01 18:50:43;8992775511206;LEO 10GR;2;1000;0;2000;1696;304;
2021-10-01 18:50:43;8994834003752;TICTIC;1;2000;0;2000;1700;300;
2021-10-01 18:52:31;OJELLY;O'JELLY;2;500;0;1000;770;230;
2021-10-01 18:52:31;6907992823645;JD COCONUT BLISS;2;4000;0;8000;7000;1000;
2021-10-01 18:52:31;8998989110167;SURYA GUDANG GARAM 16 FILTER;1;26000;0;26000;23700;2300;
2021-10-01 18:52:31;KIKO;KIKO;2;1000;0;2000;1000;1000;
2021-10-01 18:52:31;8995555171225;KIMBO SOSIS;2;1000;0;2000;1800;200;
2021-10-01 19:16:15;8995555171225;KIMBO SOSIS;2;1000;0;2000;1800;200;
2021-10-01 19:16:15;OJELLY;O'JELLY;2;500;0;1000;770;230;
2021-10-01 19:16:15;ARGUS;ARGUS;1;2000;0;2000;1500;500;
2021-10-01 19:21:42;8992628020152;MINYAK GOREG BIMOLI POUCH 2L;1;32000;0;32000;29800;2200;
2021-10-01 19:21:42;8998866200301;MIE SEDAAP GORENG;3;2700;0;8100;7089;1011;
2021-10-01 19:21:42;8998866200325;MIE SEDAAP SOTO;2;2700;0;5400;4564;836;
2021-10-01 19:44:01;8886001038011;BENG-BENG SCT;3;1500;0;4500;4350;150;
2021-10-01 19:44:01;TORT;TORTILA;1;1000;0;1000;1000;0;
2021-10-01 19:44:01;8991002103337;GOOD DAY VANILLA;1;1500;0;1500;890;610;
2021-10-01 19:44:01;8991102308892;BLASTO;1;1000;0;1000;995;5;
2021-10-01 19:44:01;7622201430184;OREO ORIGINAL 38G;1;2000;0;2000;1641;359;
2021-10-01 20:01:36;8992702000018;INDOMILK PUTIH 370G;1;10000;0;10000;9020;980;
2021-10-01 20:05:20;Vita Jelly;Vita Jelly;1;1000;0;1000;766;234;
2021-10-01 20:05:20;8992775511206;LEO 10GR;2;1000;0;2000;1696;304;
2021-10-01 20:05:20;COKLAT;COKLAT COIN;4;500;0;2000;1700;300;
2021-10-01 20:05:20;8992761122331;FRESTEA APPEL 500ML;1;6500;0;6500;4791;1709;
2021-10-01 20:14:12;ROTI;ROTI 2000;1;2000;0;2000;1800;200;
2021-10-01 20:16:09;8996001600610;TORA MILKY LATTE 180ML;1;3500;0;3500;2750;750;
2021-10-01 20:36:28;8997027300089;NOMOS;1;4000;0;4000;2963;1037;
2021-10-01 20:49:21;8999909002821;MARLBORO BLACK 16;1;22000;0;22000;20850;1150;
2021-10-01 21:08:36;ARGUS;ARGUS;2;2000;0;4000;3000;1000;
2021-10-01 21:08:36;8997028590052;ARGUS BTL 600ML;1;3000;0;3000;1458;1542;
2021-10-01 21:08:36;Garuda Pilus;Garuda Pilus Rasa Abon Pcs;2;500;0;1000;802;198;
2021-10-01 21:08:36;8992775001998;Gery Salut sandwich;1;1000;0;1000;815;185;
2021-10-01 21:13:20;ROTI;ROTI 2000;2;2000;0;4000;3600;400;
2021-10-01 21:13:20;8994834003752;TICTIC;2;2000;0;4000;3400;600;
2021-10-01 21:13:20;8998866202602;KRISBEE FRENCH FRIES 18GR;2;2000;0;4000;3000;1000;
2021-10-01 21:59:49;Telur 3 Biji;Telur 3 Biji;1;5000;0;5000;3600;1400;
2021-10-01 22:13:43;GL;GULA 1 LITER;2;11500;0;23000;21000;2000;
2021-10-01 22:13:43;8991002105409;KOPI KAPAL API;1;20000;0;20000;18888;1112;
2021-10-01 22:13:43;8999999524807;SUNLIGHT HABBATUSSAUDA POUCH 755ML;1;18000;0;18000;15950;2050;
2021-10-01 22:13:43;8999999016128;RINSO MOLTO ROSE FRESH 750ML;1;15000;0;15000;12507;2493;
2021-10-01 22:13:43;8994834003752;TICTIC;1;2000;0;2000;1700;300;
2021-10-01 22:13:43;8997003910684;2CS;1;3000;0;3000;1500;1500;
2021-10-01 22:13:43;6907992825076;JD WATERMELON APPLE;1;2000;0;2000;1700;300;
2021-10-01 22:13:43;Vita Jelly;Vita Jelly;1;1000;0;1000;766;234;
2021-10-02 13:24:15;8991102989381;TANGO LONG BUBBLEGUM 130G;1;5000;0;5000;4345;655;
2021-10-02 16:23:05;6907992823874;JD CRUNCHY CHOCO BLUEBERRY;1;5500;0;5500;4700;800;
2021-10-02 16:23:05;6907992825076;JD WATERMELON APPLE;2;2000;0;4000;3400;600;
2021-10-02 16:23:05;6907992823904;JD CRUNCHY CHOCOLATE VAN;1;8000;0;8000;6800;1200;
2021-10-02 16:23:44;GGK;PLAYGUM PERMEN KARET;4;500;0;2000;1600;400;
2021-10-02 16:23:44;6907992823904;JD CRUNCHY CHOCOLATE VAN;1;8000;0;8000;6800;1200;
2021-10-02 17:37:33;8992696405233;DNCO FORT CKLT 200G;1;19500;0;19500;17667;1833;
2021-10-02 17:37:33;8992696405431;DNCO INSTAN  400G;1;41000;0;41000;38165;2835;
2021-10-02 17:39:43;8996001600641;TORA CAPPUCINO;1;3500;0;3500;2750;750;
2021-10-02 17:43:02;8999099922985;SGM 0-6 600G;1;55000;0;55000;51951;3049;
2021-10-02 17:43:02;8998866500708;FLORIDINA ORANGE;2;3000;0;6000;5000;1000;
2021-10-02 17:43:02;8992959508930;SWEETY SILVER PANTS L 54;1;108000;0;108000;99697;8303;
2021-10-02 17:49:08;8998866200301;MIE SEDAAP GORENG;1;2700;0;2700;2363;337;
2021-10-02 17:49:08;8998866203227;MIE SEDAAP AYAM BAKAR LIMAU;1;2700;0;2700;2163;537;
2021-10-02 17:49:08;8998866500708;FLORIDINA ORANGE;1;3000;0;3000;2500;500;
2021-10-02 17:49:08;8992694242717;ZWITSAL NAT ALOE VERA PWD 100G;1;8400;0;8400;7590;810;
2021-10-02 17:49:08;8994867007161;ROKOK PENA GOLD 20;1;18000;0;18000;16800;1200;
2021-10-02 17:49:08;8991102714846;MILKIDO CKLT;3;3000;0;9000;6459;2541;
2021-10-02 17:51:25;8992761145026;SPRITE PET 250ML;1;3500;0;3500;2417;1083;
2021-10-02 17:51:25;8994867000094;ROKOK PUNDIMAS FIL16;1;15000;0;15000;13500;1500;
2021-10-02 17:51:25;8994834003752;TICTIC;1;2000;0;2000;1700;300;
2021-10-02 18:44:31;ARG;ARGUS DOS 220ML;1;14500;0;14500;13300;1200;
2021-10-02 18:44:31;8991102228053;TEH GELAS BOTOL;1;3000;0;3000;1695;1305;
2021-10-02 18:44:31;KIKO;KIKO;1;1000;0;1000;500;500;
2021-10-02 18:44:31;8998866202602;KRISBEE FRENCH FRIES 18GR;1;2000;0;2000;1500;500;
2021-10-02 18:46:01;8992979120013;TOTAL BUNGA SOFTENER;1;15000;0;15000;13524;1476;
2021-10-02 20:35:08;0105312686040047;yakult;1;2000;0;2000;1500;500;
2021-10-02 20:51:21;8993571002196;CAP 19 OBAT KURAP AIR 10ML;1;5000;0;5000;3637;1363;
2021-10-03 09:08:53;089686021127;INTER MIE KALDU;4;1000;0;4000;3252;748;
2021-10-03 09:08:53;8995899210185;Mi Boncabe;1;3000;0;3000;3000;0;
2021-10-03 09:19:39;8999999524722;SUNLIGHT LIME NEW PCH 435ML;1;10000;0;10000;9100;900;
2021-10-03 09:32:50;8999999519735;PEPSODENT TB BAMBOO SALT;1;13200;0;13200;11990;1210;
2021-10-03 09:32:50;8999999525590;PEPSODENT TB KIDS;1;12900;0;12900;11700;1200;
2021-10-03 09:32:50;8999999005795;DOVE DEO WMN RO SILK DRY 40 ML;1;17800;0;17800;16050;1750;
2021-10-03 09:34:02;8999999524807;SUNLIGHT HABBATUSSAUDA POUCH 755ML;1;18000;0;18000;15950;2050;
2021-10-03 09:37:08;8997218380135;ICHITAN GREEN TEA;1;8000;0;8000;6583;1417;
2021-10-03 09:37:08;8998866500708;FLORIDINA ORANGE;1;3000;0;3000;2500;500;
2021-10-03 09:41:45;8992717781001;NATA DE COCO;1;13000;0;13000;12083;917;
2021-10-03 09:54:23;8992775511206;LEO 10GR;1;1000;0;1000;848;152;
2021-10-03 09:56:58;8994834003752;TICTIC;2;2000;0;4000;3400;600;
2021-10-03 09:56:58;ROTI;ROTI 2000;1;2000;0;2000;1800;200;
2021-10-03 09:56:58;8998866200301;MIE SEDAAP GORENG;2;2700;0;5400;4726;674;
2021-10-03 10:02:14;8992979190986;TOTAL PUTIH SOFTENER;1;15000;0;15000;13524;1476;
2021-10-03 10:15:16;8991102714860;MILKIDO STRAW;1;3000;0;3000;2153;847;
2021-10-03 10:46:40;8996001355008;BENG-BENG SP20G;2;29000;0;58000;40000;18000;
2021-10-03 10:49:01;8998866500708;FLORIDINA ORANGE;1;3000;0;3000;2500;500;
2021-10-03 10:49:01;8992761111533;SPRITE SLIM CAM250ML;1;5000;0;5000;3750;1250;
2021-10-03 10:52:55;6907992825076;JD WATERMELON APPLE;3;2000;0;6000;5100;900;
2021-10-03 10:52:55;TG;TEH GELAS;2;1000;0;2000;1458;542;
2021-10-03 10:52:55;KERUPUK 1000;KERUPUK BALADO;2;1000;0;2000;1800;200;
2021-10-03 10:52:55;8995555121244;SOSIS KIMBO;2;1000;0;2000;1300;700;
2021-10-03 10:52:55;Vita Jelly;Vita Jelly;1;1000;0;1000;766;234;
2021-10-03 10:52:55;8995899210185;Mi Boncabe;1;3000;0;3000;3000;0;
2021-10-03 19:02:24;GL;GULA 1 LITER;4;11500;0;46000;42000;4000;
2021-10-03 19:29:29;TK;TEPUNG KETAN;1;13000;0;13000;13000;0;
2021-10-03 19:29:29;8991002105409;KOPI KAPAL API;1;20000;0;20000;18888;1112;
2021-10-03 19:29:29;GL;GULA 1 LITER;2;11500;0;23000;21000;2000;
2021-10-03 19:29:29;BG;BERAS GURIH PASAR RAME;1;60000;0;60000;56000;4000;
2021-10-03 19:29:29;8999999195649;SARIWANGI 25X1.86G;1;6000;0;6000;5202;798;
2021-10-03 19:29:29;8992705035123;AGAR-AGAR SATELIT COKLAT;6;3500;0;21000;15624;5376;
2021-10-03 19:29:29;8999801700030;SUSU FOYU;1;11500;0;11500;10450;1050;
2021-10-03 19:29:29;8992993250048;BENDICO COCOA POWDER 90G;1;18000;0;18000;16203;1797;
2021-10-03 19:29:29;8992957352153;CHOCO CHIPS 45G;1;4500;0;4500;2850;1650;
2021-10-03 19:29:29;Telur 7 Biji;Telur 7 Biji;1;10000;0;10000;8400;1600;
2021-10-03 19:29:29;Telur 3 Biji;Telur 3 Biji;1;5000;0;5000;3600;1400;
2021-10-03 19:29:29;8992959076200;HN PANTS M34;1;50000;0;50000;45455;4545;
2021-10-03 19:29:29;8991102026383;AIR CRYSTALINE 1.5 L;1;5000;0;5000;3471;1529;
2021-10-03 19:29:29;JD VM;JD VANILLA MILKSHAKE;1;5000;0;5000;4300;700;
2021-10-03 19:29:29;CHYK;CAHAYA MINYAK TERAPI;1;60000;0;60000;50000;10000;
2021-10-03 19:29:29;ARG;ARGUS DOS 220ML;1;14500;0;14500;13300;1200;
2021-10-03 19:29:29;Gula gula tusuk;gula gula tusuk;1;500;0;500;400;100;
2021-10-03 19:34:00;8994867000094;ROKOK PUNDIMAS FIL16;1;15000;0;15000;13500;1500;
2021-10-03 19:34:00;8998989300261;GUDANG GARAM SURYA 12 FILTER;2;20000;0;40000;36300;3700;
2021-10-03 19:34:00;8999909002821;MARLBORO BLACK 16;1;22000;0;22000;20850;1150;
2021-10-03 19:34:00;8995077609985;Tortilla;3;1000;0;3000;2550;450;
2021-10-03 19:34:00;KERUPUK 1000;KERUPUK BALADO;2;1000;0;2000;1800;200;
2021-10-03 19:34:00;089686021219;INTER MIE GORENG;1;1000;0;1000;885;115;
2021-10-03 19:34:00;089686021141;INTER MIE SOTO;1;1000;0;1000;854;146;
2021-10-03 19:34:00;8997028590045;ARGUS BTL 330ML;1;2000;0;2000;1291;709;
2021-10-03 19:34:00;8997028590014;ARGUS 220ML;2;500;0;1000;604;396;
2021-10-03 19:34:00;8997027300089;NOMOS;1;4000;0;4000;2963;1037;
2021-10-03 19:34:00;8992696523067;MILO ACTVGO UHT 180ML;1;4500;0;4500;3515;985;
2021-10-03 19:34:00;Telur 7 Biji;Telur 7 Biji;1;10000;0;10000;8400;1600;
2021-10-03 19:34:00;Telur 3 Biji;Telur 3 Biji;1;5000;0;5000;3600;1400;
2021-10-03 19:34:00;8992775318201;GERY SNACK BANTAL COKLAT;1;2000;0;2000;1712;288;
2021-10-03 19:34:00;8886013257400;TWISTKO;1;1000;0;1000;900;100;
2021-10-03 19:34:00;8997009510055;YOU C1000;1;15000;0;15000;13000;2000;
2021-10-03 19:44:40;8999909010567;234 DJI SAM SOE 16;2;22500;0;45000;43000;2000;
2021-10-03 20:02:12;8999999706180;PEPSODENT WHITE 190GR;1;10000;0;10000;9350;650;
2021-10-03 20:02:12;8992388101085;NU GREEN TEA ORIGINAL 330ML;1;3500;0;3500;2768;732;
2021-10-03 20:02:41;8994867007161;ROKOK PENA GOLD 20;1;18000;0;18000;16800;1200;
2021-10-03 20:02:41;8999909002821;MARLBORO BLACK 16;1;22000;0;22000;20850;1150;
2021-10-03 20:19:41;ARG;ARGUS DOS 220ML;1;14500;0;14500;13300;1200;
2021-10-03 20:23:23;8998989300261;GUDANG GARAM SURYA 12 FILTER;1;20000;0;20000;18150;1850;
2021-10-03 20:40:28;8997028590045;ARGUS BTL 330ML;1;2000;0;2000;1291;709;
2021-10-03 20:43:24;8991111101507;JB POWDER BLOSSOM 50G;1;3500;0;3500;3000;500;
2021-10-03 20:43:24;Vita Jelly;Vita Jelly;1;1000;0;1000;766;234;
2021-10-03 20:43:24;YP;YUPI;2;250;0;500;416;84;
2021-10-03 21:11:35;8998989300261;GUDANG GARAM SURYA 12 FILTER;1;20000;0;20000;18150;1850;
2021-10-03 21:11:35;8997218380074;ICHITAN MILK TEA;1;8000;0;8000;6500;1500;
2021-10-03 21:22:41;8998866202619;MIE SEDAAP KOREAN SPICY SOUP;1;2700;0;2700;2322;378;
2021-10-03 21:34:20;8997009510123;ORANGE WATER;1;11000;0;11000;10416;584;
2021-10-03 21:49:25;ROTI;ROTI 2000;2;2000;0;4000;3600;400;
2021-10-03 21:58:46;8991102023115;Sikat Gigi Formula;1;11000;0;11000;10000;1000;
2021-10-03 22:07:24;GL;GULA 1 LITER;1;11500;0;11500;10500;1000;
2021-10-04 13:05:55;8993989311699;CLAS MILD 16 FILTER;1;24000;0;24000;21700;2300;
2021-10-04 13:05:55;6907992823874;JD CRUNCHY CHOCO BLUEBERRY;1;5500;0;5500;4700;800;
2021-10-04 13:05:55;6907992823867;JD CRUNCHY CHOCOLATE MALT;1;5500;0;5500;4700;800;
2021-10-04 13:14:28;8992761111533;SPRITE SLIM CAM250ML;1;5000;0;5000;3750;1250;
2021-10-04 13:14:28;8992696404441;BEAR BRAND 189ML;1;15000;0;15000;11000;4000;
2021-10-04 13:14:28;8999999529697;CLEAR DEEP CLEANSE MEN 160ML;1;24700;0;24700;22700;2000;
2021-10-04 13:14:28;089686535044;SUN BERAS MERAH;2;8500;0;17000;14820;2180;
2021-10-04 13:14:28;GL;GULA 1 LITER;3;11500;0;34500;31500;3000;
2021-10-04 13:14:28;KERUPUK 1000;KERUPUK BALADO;3;1000;0;3000;2700;300;
2021-10-04 13:14:28;8997028590014;ARGUS 220ML;4;500;0;2000;1208;792;
2021-10-04 13:14:28;ROTI;ROTI 2000;3;2000;0;6000;5400;600;
2021-10-04 13:14:28;8993989311279;CLAS MILD 12;1;18000;0;18000;15800;2200;
2021-10-04 13:14:28;8992761122430;FRESTEA GREEN HONEY 500ML;1;6500;0;6500;4708;1792;
2021-10-04 13:14:28;8992775001783;GERY SALUT MALKIST KELAPA;1;6500;0;6500;5516;984;
2021-10-04 13:14:28;ABC;BATERAI ABC BIRU;4;2250;0;9000;7712;1288;
2021-10-04 13:14:28;8998989300261;GUDANG GARAM SURYA 12 FILTER;1;20000;0;20000;18150;1850;
2021-10-04 13:14:28;6907992825076;JD WATERMELON APPLE;2;2000;0;4000;3400;600;
2021-10-04 13:14:28;8992931006256;tessa;1;1000;0;1000;900;100;
2021-10-04 13:14:28;8999999050009;SUNLIGHT LIME NEW POUCH 95ML;1;2000;0;2000;1600;400;
2021-10-04 13:14:28;8999999030179;PEPSODENT ACTION 123 COMPLETE 75G;1;6700;0;6700;5170;1530;
2021-10-04 13:14:28;8994867000162;ROKOK PUNDIMAS KRETEK16;1;10000;0;10000;8600;1400;
2021-10-04 13:14:28;8998866202619;MIE SEDAAP KOREAN SPICY SOUP;1;2700;0;2700;2322;378;
2021-10-04 13:14:28;089686021219;INTER MIE GORENG;1;1000;0;1000;885;115;
2021-10-04 13:14:28;8991002105430;KAPAL API 65G;1;5000;0;5000;4145;855;
2021-10-04 13:57:41;8992696404441;BEAR BRAND 189ML;1;15000;0;15000;11000;4000;
2021-10-04 13:57:41;8997009510055;YOU C1000;1;15000;0;15000;13000;2000;
2021-10-04 15:03:41;8999999049416;REXONA MEN RO QUANTUM 45 ML;1;15000;0;15000;13550;1450;
2021-10-04 15:03:41;8998866608305;GIV BENGKOANG KOTAK 76G;1;2000;0;2000;1820;180;
2021-10-04 15:03:41;8997210107877;VORTEX SMART 3;1;5000;0;5000;4750;250;
2021-10-04 15:03:41;8998866107471;ZINC ACTIVE SCT;1;5000;0;5000;4500;500;
2021-10-04 16:45:03;8992761166052;FRESTEA MELATI 350ML;2;4500;0;9000;6000;3000;
2021-10-04 16:45:03;8992761166205;FRESTEA GREEN HONEY 350ML;2;4500;0;9000;6000;3000;
2021-10-04 16:45:03;jagung marning;jagung marning;1;5000;0;5000;4500;500;
2021-10-04 17:13:09;8997003910684;2CS;2;3000;0;6000;3000;3000;
2021-10-04 17:13:09;8997028590014;ARGUS 220ML;2;500;0;1000;604;396;
2021-10-04 17:13:09;8991001502926;Chaca Peanut;1;1000;0;1000;800;200;
2021-10-04 17:13:09;Vita Jelly;Vita Jelly;1;1000;0;1000;766;234;
2021-10-04 17:13:09;ROTI;ROTI 2000;1;2000;0;2000;1800;200;
2021-10-04 17:30:01;8999909010567;234 DJI SAM SOE 16;1;22500;0;22500;21500;1000;
2021-10-04 17:30:01;8992388133345;NU MILK TEA TEH TARIK 330ML;1;6000;0;6000;5125;875;
2021-10-04 17:33:42;8992775001998;Gery Salut sandwich;1;1000;0;1000;815;185;
2021-10-04 17:33:42;8992959508312;SWEETY SILVER PANTS XL1;5;3000;0;15000;11620;3380;
2021-10-04 17:43:36;8997009510055;YOU C1000;1;15000;0;15000;13000;2000;
2021-10-04 17:43:36;8992959508930;SWEETY SILVER PANTS L 54;1;108000;0;108000;99697;8303;
2021-10-04 17:43:36;8992775001844;Chocolatos original taste;2;1000;0;2000;1658;342;
2021-10-04 18:12:44;ARG;ARGUS DOS 220ML;1;14500;0;14500;13300;1200;
2021-10-04 18:18:10;8992959117583;SFX DS REG FLOW WING 20;1;5000;0;5000;4288;712;
2021-10-04 18:18:10;8998866107099;WET WIPES KODOMO BABY 50SHT CLSSC;1;20000;0;20000;14150;5850;
2021-10-04 18:18:10;8992759120264;LARISST 220;1;10000;0;10000;9200;800;
2021-10-04 18:18:10;8991002103337;GOOD DAY VANILLA;10;1300;0;13000;8900;4100;
2021-10-04 18:18:10;8998866619004;ROYALE SUNNY DAY;1;5000;0;5000;4560;440;
2021-10-04 18:18:10;TUSTEL;TUSUK TELINGA;1;1000;0;1000;833;167;
2021-10-04 18:18:10;8999999055769;FAIR&LOVELY MVIT FC FOAM 50 G;1;12500;0;12500;11715;785;
2021-10-04 18:18:10;4902430553629;H&S LEMON 70ML;1;11000;0;11000;9501;1499;
2021-10-04 18:18:10;8991102020305;FORMULA TRIPLE ACTION;1;3000;0;3000;2500;500;
2021-10-04 18:18:10;8999999710880;PEPSODENT ACTION123 HERBAL 75G;1;7500;0;7500;6650;850;
2021-10-04 18:18:10;8999999036492;LUX BW PINK SOFT BTL 100ML;1;10000;0;10000;8690;1310;
2021-10-04 18:18:10;8997009510123;ORANGE WATER;1;11000;0;11000;10416;584;
2021-10-04 18:18:10;8997028590052;ARGUS BTL 600ML;1;3000;0;3000;1458;1542;
2021-10-04 18:18:10;ROTI;ROTI 2000;1;2000;0;2000;1800;200;
2021-10-04 18:19:05;8999999508609;LIFEBUOY HAND SANITIZER 50ML;1;13000;0;13000;11600;1400;
2021-10-04 18:19:05;089686727081;DORITOS 55G;1;7000;0;7000;5950;1050;
2021-10-05 20:15:26;Telur 7 Biji;Telur 7 Biji;1;10000;0;10000;8400;1600;
2021-10-05 20:19:52;8999999053291;LIFEBUOY LEMONFRESH 110G;1;15000;0;15000;14245;755;
2021-10-05 20:20:35;8998866107068;Mama lemon 230 ml;1;4000;0;4000;3500;500;
2021-10-05 20:21:45;8999999027056;LIFEBUOY ANTI KETOMBE 9ML;1;5000;0;5000;4500;500;
2021-10-05 20:22:32;8999999048242;SUNSILK SHP SOFT&SMOOTH 9ML;1;11000;0;11000;9300;1700;
2021-10-05 20:23:45;8997028900837;SABUN PAPAYA;1;10000;0;10000;9375;625;
2021-10-05 20:26:33;ICE CREAM;ICE CREAM 2000;2;2000;0;4000;3400;600;
2021-10-05 20:27:08;8997028590052;ARGUS BTL 600ML;4;3000;0;12000;5832;6168;
2021-10-05 20:27:39;8997878002088;Kiko;1;1000;0;1000;450;550;
2021-10-05 20:28:05;8991102714846;MILKIDO CKLT;1;3000;0;3000;2153;847;
2021-10-05 20:28:35;8998866500708;FLORIDINA ORANGE;1;3000;0;3000;2500;500;
2021-10-05 20:28:57;kentang;kripik kentang;1;1000;0;1000;900;100;
2021-10-05 20:30:10;8998989300261;GUDANG GARAM SURYA 12 FILTER;1;20000;0;20000;18150;1850;
2021-10-05 20:30:40;8992702000018;INDOMILK PUTIH 370G;1;10000;0;10000;9020;980;
2021-10-05 20:31:05;8995555121244;SOSIS KIMBO;1;1000;0;1000;650;350;
2021-10-05 20:31:33;8999999195656;SARIWANGI 50X1.85;1;10000;0;10000;9405;595;
2021-10-05 20:32:00;ROTI;ROTI 2000;1;2000;0;2000;1800;200;
2021-10-05 20:32:44;8997028590014;ARGUS 220ML;4;500;0;2000;1208;792;
2021-10-05 20:33:53;ROTI;ROTI 2000;2;2000;0;4000;3600;400;
2021-10-05 20:34:33;GL;GULA 1 LITER;4;11500;0;46000;42000;4000;
2021-10-05 20:37:44;8998866601429;POWDET DAIA BUNGA BAG 290GR;1;5000;0;5000;4450;550;
2021-10-05 20:38:16;8999999706081;PEPSODENT WHITE 75G;1;5000;0;5000;3850;1150;
2021-10-05 20:46:20;8998866202619;MIE SEDAAP KOREAN SPICY SOUP;1;2700;0;2700;2322;378;
2021-10-05 20:48:19;8997028590014;ARGUS 220ML;10;500;0;5000;3020;1980;
2021-10-05 20:49:05;8998866107068;Mama lemon 230 ml;2;4000;0;8000;7000;1000;
2021-10-05 20:49:54;8999999556341;MOLTO EDP PINK ROSE 20ML;2;1000;0;2000;1600;400;
2021-10-05 20:50:21;8995555121244;SOSIS KIMBO;1;1000;0;1000;650;350;
2021-10-05 20:51:49;8999909096004;SAMPOERNA 16 FILTER;1;25000;0;25000;23100;1900;
2021-10-05 20:54:47;8992717781025;SANTAN KELAPA;1;4000;0;4000;3000;1000;
2021-10-05 21:07:34;8998989110167;SURYA GUDANG GARAM 16 FILTER;1;26000;0;26000;23700;2300;
2021-10-05 21:07:34;8998989300261;GUDANG GARAM SURYA 12 FILTER;1;20000;0;20000;18150;1850;
2021-10-05 21:07:34;8991102026383;AIR CRYSTALINE 1.5 L;1;5000;0;5000;3471;1529;
2021-10-05 21:10:31;8991102026383;AIR CRYSTALINE 1.5 L;4;5000;0;20000;13884;6116;
2021-10-05 21:11:03;TG;TEH GELAS;1;1000;0;1000;729;271;
2021-10-05 21:11:25;8993470411433;JOGER CLASSIC;1;1000;0;1000;850;150;
2021-10-05 21:11:53;YP;YUPI;2;250;0;500;416;84;
2021-10-05 21:12:53;8992957220186;COKLAT RUSA;1;2000;0;2000;1700;300;
2021-10-05 21:13:42;7622201430153;OREO CHOCOLATE 38G;1;2000;0;2000;1641;359;
2021-10-05 21:14:57;8998666002525;TB TORA CAFE CAPPUCINO;3;1000;0;3000;2340;660;
2021-10-05 21:15:47;8999909002821;MARLBORO BLACK 16;1;22000;0;22000;20850;1150;
2021-10-05 21:16:55;8992775305188 pcs;Gery Salut Grentea pcs;4;1000;0;4000;3248;752;
2021-10-05 21:23:47;8996001600641;TORA CAPPUCINO;1;3500;0;3500;2750;750;
2021-10-05 21:23:47;8992775002735;CHOCOLATOS SUSU COKELAT;1;4000;0;4000;3520;480;
2021-10-05 21:24:52;8994867000162;ROKOK PUNDIMAS KRETEK16;1;10000;0;10000;8600;1400;
2021-10-05 21:24:52;8991111109107;JB POWDER BEDTIME 75+25g;1;6000;0;6000;5440;560;
2021-10-05 21:46:55;8998866200882;SUKSESMIE GORENG AYAM KRMS 133GR;1;3500;0;3500;3047;453;
2021-10-05 21:49:17;8998866500517;BABY HAPPY PANTS L PCS;2;2000;0;4000;2860;1140;
2021-10-05 21:49:17;8993274534079;PARAGO CHOCO;2;500;0;1000;800;200;
2021-10-05 21:52:55;8993989311279;CLAS MILD 12;1;18000;0;18000;15800;2200;
2021-10-05 21:54:45;8997028590045;ARGUS BTL 330ML;1;2000;0;2000;1291;709;
2021-10-05 21:54:45;8997028590014;ARGUS 220ML;2;500;0;1000;604;396;
2021-10-05 21:55:58;ARG;ARGUS DOS 220ML;2;14500;0;29000;26600;2400;
2021-10-05 21:56:56;089686021141;INTER MIE SOTO;2;1000;0;2000;1708;292;
2021-10-05 21:57:17;kentang;kripik kentang;1;1000;0;1000;900;100;
2021-10-05 21:57:48;8998866107068;Mama lemon 230 ml;1;4000;0;4000;3500;500;
2021-10-05 21:58:28;8992696521797;MILO 22G;2;2500;0;5000;3144;1856;
2021-10-05 21:59:08;8998989300261;GUDANG GARAM SURYA 12 FILTER;1;20000;0;20000;18150;1850;
2021-10-05 21:59:43;Telur 7 Biji;Telur 7 Biji;1;10000;0;10000;8400;1600;
2021-10-05 22:02:03;8992959508312;SWEETY SILVER PANTS XL1;6;3000;0;18000;13944;4056;
2021-10-05 22:02:30;Telur 3 Biji;Telur 3 Biji;1;5000;0;5000;3600;1400;
2021-10-05 22:03:20;8992775318201;GERY SNACK BANTAL COKLAT;2;2000;0;4000;3424;576;
2021-10-05 22:05:06;8991909101016;URBAN MILD 16;1;17000;0;17000;15800;1200;
2021-10-05 22:07:39;8997009510055;YOU C1000;2;15000;0;30000;26000;4000;
2021-10-05 22:08:04;8992931006256;tessa;1;1000;0;1000;900;100;
2021-10-05 22:10:18;kentang;kripik kentang;1;1000;0;1000;900;100;
2021-10-05 22:11:39;0105312686040047;yakult;1;2000;0;2000;1500;500;
2021-10-05 22:14:00;8886013257400;TWISTKO;1;1000;0;1000;900;100;
2021-10-05 22:15:27;8999999529703;CLEAR MEN COOL SPORT MTHL 80ML;2;11000;0;22000;20000;2000;
2021-10-05 22:16:48;GL;GULA 1 LITER;2;11500;0;23000;21000;2000;
2021-10-05 22:17:20;kentang;kripik kentang;3;1000;0;3000;2700;300;
2021-10-05 22:18:00;8997028590014;ARGUS 220ML;4;500;0;2000;1208;792;
2021-10-06 11:06:02;8998866200646;KOPI TOP MURNI;1;11000;0;11000;9600;1400;
2021-10-06 11:23:31;AIR;ARGUS;2;500;0;1000;800;200;
2021-10-06 11:36:37;8997218380135;ICHITAN GREEN TEA;2;8000;0;16000;13000;3000;
2021-10-06 11:36:37;8998009040023;TEH KOTAK;2;5000;0;10000;5416;4584;
2021-10-06 11:36:37;8992761166038;MMP ORANGE 300ML;1;5000;0;5000;3750;1250;
2021-10-06 11:36:37;8992761139018;ADES 600ML;1;3500;0;3500;2166;1334;
2021-10-06 11:36:37;8991102714846;MILKIDO CKLT;1;3000;0;3000;2153;847;
2021-10-06 11:36:37;8995555121244;SOSIS KIMBO;2;1000;0;2000;1300;700;
2021-10-06 11:47:49;MATERAI;MATERAI;10;15000;0;150000;100000;50000;
2021-10-06 12:24:03;8998866202626;Top Kopi Gula Aren 22gr;3;1000;0;3000;1659;1341;
2021-10-06 12:41:33;6907992825076;JD WATERMELON APPLE;2;2000;0;4000;3400;600;
2021-10-06 12:41:33;8997878002088;Kiko;1;1000;0;1000;450;550;
2021-10-06 12:48:10;8992775203422;GARUDA ROSTA OVEN BAWANG 100G;1;8000;0;8000;7322;678;
2021-10-06 12:49:14;8997231980022;O'JELLY MINI STRAWBERRY;1;3000;0;3000;2250;750;
2021-10-06 13:10:48;8992388101085;NU GREEN TEA ORIGINAL 330ML;1;3500;0;3500;2768;732;
2021-10-06 13:10:48;AIR;ARGUS;1;500;0;500;400;100;
2021-10-06 13:11:03;8997878002088;Kiko;2;1000;0;2000;900;1100;
2021-10-06 13:13:55;8991909101016;URBAN MILD 16;1;17000;0;17000;15800;1200;
2021-10-06 13:17:30;8997018720469;TISSUE SE-KA;1;10000;0;10000;9300;700;
2021-10-06 16:58:02;8991914101513;VIPER KRETEK 12;1;6000;0;6000;5000;1000;
2021-10-06 16:58:02;ROTI;ROTI 2000;2;2000;0;4000;3600;400;
2021-10-06 17:15:38;34678;SENDAL MOLLY;1;15000;0;15000;13500;1500;
2021-10-06 17:20:13;8994867007161;ROKOK PENA GOLD 20;1;18000;0;18000;16800;1200;
2021-10-06 18:06:19;9556001025272;NESCAFE LATTE 240ML;1;8500;0;8500;7834;666;
2021-10-06 18:30:05;8996001305119;ARDEN 30G;1;2000;0;2000;1650;350;
2021-10-06 18:30:05;8991102228053;TEH GELAS BOTOL;1;3000;0;3000;1695;1305;
2021-10-06 18:30:05;KIKO;KIKO;3;1000;0;3000;1500;1500;
2021-10-06 18:31:11;8992628024143;MINYAK GORENG BIMOLI 620ML;1;15000;0;15000;13900;1100;
2021-10-06 18:58:18;Vita Jelly;Vita Jelly;2;1000;0;2000;1532;468;
2021-10-06 19:06:51;8999999533731;CITRA TS NATURE WHITE 70G;1;2200;0;2200;1900;300;
2021-10-06 19:09:07;8992761139018;ADES 600ML;1;3500;0;3500;2166;1334;
2021-10-06 19:09:07;8992761122331;FRESTEA APPEL 500ML;1;6500;0;6500;4791;1709;
2021-10-06 19:09:07;Gula gula tusuk;gula gula tusuk;3;500;0;1500;1200;300;
2021-10-06 19:09:07;Gula gula kopiko;gula gula kopiko;10;350;0;3500;2500;1000;
2021-10-06 19:44:01;8998989300261;GUDANG GARAM SURYA 12 FILTER;1;20000;0;20000;18150;1850;
2021-10-06 19:44:01;8999909002821;MARLBORO BLACK 16;1;22000;0;22000;20850;1150;
2021-10-06 19:44:01;TORT;TORTILA;3;1000;0;3000;3000;0;
2021-10-06 19:48:09;Garuda pilus;Garuda Pilus Pedas Pcs;6;500;0;3000;2448;552;
2021-10-06 19:48:09;8997028590014;ARGUS 220ML;4;500;0;2000;1208;792;
2021-10-06 19:51:00;JIPAH;JIPAN;1;5000;0;5000;4000;1000;
2021-10-06 19:52:27;8998866202244;EKOMIE BUMBU KALDU AYAM;2;1000;0;2000;1596;404;
2021-10-06 19:53:34;8998866202244;EKOMIE BUMBU KALDU AYAM;6;1000;0;6000;4788;1212;
2021-10-06 19:54:16;8997009510055;YOU C1000;1;15000;0;15000;13000;2000;
2021-10-06 19:55:43;TG;TEH GELAS;2;1000;0;2000;1458;542;
2021-10-06 19:56:33;TG MARKISA;TEH GELAS MARKISA;2;2000;0;4000;2356;1644;
2021-10-06 19:57:54;8992716109172;BISKUAT BOLU SCT;4;2000;0;8000;6564;1436;
2021-10-06 19:58:11;ARG;ARGUS DOS 220ML;1;14500;0;14500;13300;1200;
2021-10-06 20:00:12;8997028590014;ARGUS 220ML;2;500;0;1000;604;396;
2021-10-06 20:01:07;8993274532105;BOLU;1;1000;0;1000;833;167;
2021-10-06 20:01:31;8995555121244;SOSIS KIMBO;1;1000;0;1000;650;350;
2021-10-06 20:16:51;0105312686040047;yakult;1;2000;0;2000;1500;500;
2021-10-06 20:19:29;ARG;ARGUS DOS 220ML;1;14500;0;14500;13300;1200;
2021-10-06 20:23:02;8998989300261;GUDANG GARAM SURYA 12 FILTER;1;20000;0;20000;18150;1850;
2021-10-06 20:52:51;8992959953044;SWEETY BRONZE XL1;2;3000;0;6000;4622;1378;
2021-10-06 21:14:53;PULPEN SNOWMAN;PULPEN SNOWMAN;1;2500;0;2500;2000;500;
2021-10-06 21:16:01;8993989311279;CLAS MILD 12;1;18000;0;18000;15800;2200;
2021-10-06 21:16:28;8997028590014;ARGUS 220ML;4;500;0;2000;1208;792;
2021-10-06 21:17:37;8999999706081;PEPSODENT WHITE 75G;1;5000;0;5000;3850;1150;
2021-10-06 21:18:44;8992761145026;SPRITE PET 250ML;1;3500;0;3500;2417;1083;
2021-10-06 21:19:12;8992761145033;FANTA STRAW PET 250ML;1;3500;0;3500;2417;1083;
2021-10-06 21:20:29;Gula gula kaki;gula gula kaki;1;500;0;500;400;100;
2021-10-06 21:21:22;8999999001193;LIFEBUOY BW TOTAL10 LD REFF 450 ML;1;25000;0;25000;22110;2890;
2021-10-06 21:22:51;8991102714846;MILKIDO CKLT;1;3000;0;3000;2153;847;
2021-10-06 21:23:19;8998989300261;GUDANG GARAM SURYA 12 FILTER;1;20000;0;20000;18150;1850;
2021-10-06 21:24:38;RT TWR;ROTI TAWAR JUMBO;1;7000;0;7000;6200;800;
2021-10-06 21:25:40;8991102228053;TEH GELAS BOTOL;1;3000;0;3000;1695;1305;
2021-10-06 21:26:43;8991102026383;AIR CRYSTALINE 1.5 L;1;5000;0;5000;3471;1529;
2021-10-06 21:27:13;8992775001783;GERY SALUT MALKIST KELAPA;1;6500;0;6500;5516;984;
2021-10-06 21:29:00;RT;ROTI;1;9000;0;9000;8000;1000;
2021-10-06 21:30:06;8998989300261;GUDANG GARAM SURYA 12 FILTER;1;20000;0;20000;18150;1850;
2021-10-06 21:32:05;Vita Jelly;Vita Jelly;2;1000;0;2000;1532;468;
2021-10-06 21:33:21;8992696521629;DNCO COKLT UHT 180ML;3;5000;0;15000;10599;4401;
2021-10-06 21:33:21;8992388101085;NU GREEN TEA ORIGINAL 330ML;3;3500;0;10500;8304;2196;
2021-10-06 21:34:19;8999999043674;LUX BW CAMELLIA WHITE LD REFF 450 ML;1;25000;0;25000;22330;2670;
2021-10-06 21:34:59;ARG;ARGUS DOS 220ML;1;14500;0;14500;13300;1200;
2021-10-06 21:35:24;GL;GULA 1 LITER;2;11500;0;23000;21000;2000;
2021-10-06 21:36:21;kentang;kripik kentang;1;1000;0;1000;900;100;
2021-10-06 21:38:11;089686535044;SUN BERAS MERAH;2;8500;0;17000;14820;2180;
2021-10-06 21:38:37;8997028590014;ARGUS 220ML;4;500;0;2000;1208;792;
2021-10-06 21:39:01;ROTI;ROTI 2000;3;2000;0;6000;5400;600;
2021-10-06 21:40:55;8993989311279;CLAS MILD 12;1;18000;0;18000;15800;2200;
2021-10-06 21:40:55;8998866500517;BABY HAPPY PANTS L PCS;5;2000;0;10000;7150;2850;
2021-10-06 21:45:25;8992775305102;GERY MALKIST COCONUT;1;6500;0;6500;5516;984;
2021-10-06 21:47:41;8886022830243;BATEREI ABC;4;2500;0;10000;7712;2288;
2021-10-06 21:48:12;8998989300261;GUDANG GARAM SURYA 12 FILTER;1;20000;0;20000;18150;1850;
2021-10-06 21:49:23;ICE CREAM;ICE CREAM 2000;2;2000;0;4000;3400;600;
2021-10-06 21:51:39;8994935000070;MINYAK GORENG DUNIA 450 ML;1;7500;0;7500;6779;721;
2021-10-06 21:52:01;8992931006256;tessa;1;1000;0;1000;900;100;
2021-10-06 21:53:12;GL;GULA 1 LITER;1;11500;0;11500;10500;1000;
2021-10-06 21:53:44;8999999030179;PEPSODENT ACTION 123 COMPLETE 75G;1;6700;0;6700;5170;1530;
2021-10-06 21:54:14;8999999559045;SUNLIGHT LIME CREAM 110G;1;2000;0;2000;1800;200;
2021-10-06 21:54:48;8994867000162;ROKOK PUNDIMAS KRETEK16;1;10000;0;10000;8600;1400;
2021-10-06 21:55:39;8998866200578;MIE SEDAAP KARI KENTAL;1;2700;0;2700;2331;369;
2021-10-06 21:56:17;089686021219;INTER MIE GORENG;2;1000;0;2000;1770;230;
2021-10-06 22:00:31;8991002105430;KAPAL API 65G;1;5000;0;5000;4145;855;
2021-10-06 22:04:57;8992388133345;NU MILK TEA TEH TARIK 330ML;1;6000;0;6000;5125;875;
2021-10-06 22:04:57;8992761122430;FRESTEA GREEN HONEY 500ML;1;6500;0;6500;4708;1792;
2021-10-06 22:05:42;8998989300261;GUDANG GARAM SURYA 12 FILTER;1;20000;0;20000;18150;1850;
2021-10-06 22:06:03;8992761002039;FANTA STRAWBERRY PET 390 ML;1;5500;0;5500;4333;1167;
2021-10-06 22:06:27;8996001600610;TORA MILKY LATTE 180ML;1;3500;0;3500;2750;750;
2021-10-06 22:06:55;kentang;kripik kentang;3;1000;0;3000;2700;300;
2021-10-06 22:07:34;kri;kripik pisang;1;5000;0;5000;4000;1000;
2021-10-06 22:08:30;YP;YUPI;2;250;0;500;416;84;
2021-10-06 22:09:19;8998866200578;MIE SEDAAP KARI KENTAL;1;2700;0;2700;2331;369;
2021-10-06 22:10:12;8998866203227;MIE SEDAAP AYAM BAKAR LIMAU;1;2700;0;2700;2163;537;
2021-10-06 22:10:49;8998866200882;SUKSESMIE GORENG AYAM KRMS 133GR;1;3500;0;3500;3047;453;
2021-10-06 22:11:06;8998989300261;GUDANG GARAM SURYA 12 FILTER;1;20000;0;20000;18150;1850;
2021-10-06 22:11:47;7622300335809;OREO SOFT CAKE;2;2000;0;4000;3282;718;
2021-10-06 22:12:44;7622300335809;OREO SOFT CAKE;1;2000;0;2000;1641;359;
2021-10-06 22:13:40;8992775001653;GERY SALUT CHOCOLATE COCONUT;1;2000;0;2000;1476;524;
2021-10-06 22:14:08;ROTI;ROTI 2000;1;2000;0;2000;1800;200;
2021-10-06 22:14:58;8999909002821;MARLBORO BLACK 16;1;22000;0;22000;20850;1150;
2021-10-06 22:17:02;8999909982000;SAMPOERNA 12 FILTER;1;19000;0;19000;16600;2400;
2021-10-06 22:17:23;TG;TEH GELAS;1;1000;0;1000;729;271;
2021-10-06 22:17:48;8997878002088;Kiko;2;1000;0;2000;900;1100;
2021-10-06 22:18:17;Vita Jelly;Vita Jelly;1;1000;0;1000;766;234;
2021-10-06 22:18:50;8997028590014;ARGUS 220ML;2;500;0;1000;604;396;
2021-10-06 22:19:23;711844110113;KECAP ABC 135 ML;1;7000;0;7000;6400;600;
2021-10-06 22:19:46;ROTI;ROTI 2000;1;2000;0;2000;1800;200;
2021-10-06 22:20:30;8998989500166;GUDANG GARAM MERAH BESAR 16KS;1;18000;0;18000;17000;1000;
2021-10-06 22:20:59;kri;kripik pisang;1;5000;0;5000;4000;1000;
2021-10-06 22:21:22;kentang;kripik kentang;2;1000;0;2000;1800;200;
2021-10-06 22:22:59;8997222130207;Lemonilo Kari Ayam;1;7500;0;7500;6000;1500;
2021-10-06 22:23:32;8998866200578;MIE SEDAAP KARI KENTAL;1;2700;0;2700;2331;369;
2021-10-06 22:23:59;ARG;ARGUS DOS 220ML;1;14500;0;14500;13300;1200;
2021-10-06 22:24:20;8998989300261;GUDANG GARAM SURYA 12 FILTER;1;20000;0;20000;18150;1850;
2021-10-06 22:24:42;8991909101016;URBAN MILD 16;1;17000;0;17000;15800;1200;
2021-10-06 22:25:16;8994834006128;TICTIC PEDAS;1;2000;0;2000;1700;300;
2021-10-06 22:25:33;123124;KOREK BIASA;1;2000;0;2000;1300;700;
2021-10-06 22:25:59;8997878002088;Kiko;2;1000;0;2000;900;1100;
2021-10-06 22:26:49;ICE CREAM;ICE CREAM 2000;1;2000;0;2000;1700;300;
2021-10-06 22:27:18;Vita Jelly;Vita Jelly;1;1000;0;1000;766;234;
2021-10-06 22:27:49;8998989300261;GUDANG GARAM SURYA 12 FILTER;1;20000;0;20000;18150;1850;
2021-10-06 22:28:14;ARG;ARGUS DOS 220ML;4;14500;0;58000;53200;4800;
2021-10-06 22:29:29;kentang;kripik kentang;1;1000;0;1000;900;100;
2021-10-06 22:32:23;ARG;ARGUS DOS 220ML;6;14500;0;87000;79800;7200;
2021-10-06 22:35:29;8719200177314;BLUE BAND 15G;2;2000;0;4000;3000;1000;
2021-10-07 20:26:59;Telur 3 Biji;Telur 3 Biji;1;5000;0;5000;3600;1400;
2021-10-07 20:28:59;0105312686040047;yakult;1;2000;0;2000;1500;500;
2021-10-07 20:35:19;8992696404441;BEAR BRAND 189ML;1;15000;0;15000;11000;4000;
2021-10-07 20:35:19;8992761166038;MMP ORANGE 300ML;1;5000;0;5000;3750;1250;
2021-10-07 20:35:19;Telur 3 Biji;Telur 3 Biji;1;5000;0;5000;3600;1400;
2021-10-07 20:35:19;089686021219;INTER MIE GORENG;3;1000;0;3000;2655;345;
2021-10-07 20:35:19;0105312686040047;yakult;1;2000;0;2000;1500;500;
2021-10-07 20:39:49;kri;kripik pisang;1;5000;0;5000;4000;1000;
2021-10-07 20:39:49;8997028590014;ARGUS 220ML;4;500;0;2000;1208;792;
2021-10-07 20:39:49;8992761166052;FRESTEA MELATI 350ML;1;4500;0;4500;3000;1500;
2021-10-07 20:39:49;kentang;kripik kentang;2;1000;0;2000;1800;200;
2021-10-07 20:45:41;8998866200851;NOODLE SEDAAP MIE BAKSO SPESIAL CUP 77 GR;1;4500;0;4500;3738;762;
2021-10-07 20:45:41;8999999529703;CLEAR MEN COOL SPORT MTHL 80ML;1;11000;0;11000;10000;1000;
2021-10-07 20:48:12;8998866202244;EKOMIE BUMBU KALDU AYAM;2;1000;0;2000;1596;404;
2021-10-07 21:04:00;8999801700054;SUSU FOYU 1 KG;1;22000;0;22000;19791;2209;
2021-10-07 21:21:03;8992759120264;LARISST 220;1;10000;0;10000;9200;800;
2021-10-07 22:00:24;kentang;kripik kentang;1;1000;0;1000;900;100;
2021-10-07 22:02:26;BALON;BALON CABUT;5;1000;0;5000;4500;500;
2021-10-07 22:02:26;ICE CREAM 5.000;ICE CREAM 5.000;1;5000;0;5000;4700;300;
2021-10-07 22:03:36;8992959117583;SFX DS REG FLOW WING 20;1;5000;0;5000;4288;712;
2021-10-07 22:04:04;8995102703534;TERASI DUO 6 GR;1;4000;0;4000;3720;280;
2021-10-07 22:04:34;8995555121244;SOSIS KIMBO;1;1000;0;1000;650;350;
2021-10-07 22:05:21;8992759120264;LARISST 220;1;10000;0;10000;9200;800;
2021-10-07 22:06:08;ICE CREAM;ICE CREAM 2000;1;2000;0;2000;1700;300;
2021-10-07 22:07:07;089686021219;INTER MIE GORENG;2;1000;0;2000;1770;230;
2021-10-07 22:08:07;ICE CREAM 5.000;ICE CREAM 5.000;2;5000;0;10000;9400;600;
2021-10-07 22:08:36;8994867007161;ROKOK PENA GOLD 20;1;18000;0;18000;16800;1200;
2021-10-07 22:09:45;kentang;kripik kentang;1;1000;0;1000;900;100;
2021-10-07 22:09:45;089686021127;INTER MIE KALDU;5;1000;0;5000;4065;935;
2021-10-07 22:10:21;Telur 3 Biji;Telur 3 Biji;1;5000;0;5000;3600;1400;
2021-10-07 22:13:23;089686611670;QTELA BALADO;1;5000;0;5000;4266;734;
2021-10-07 22:13:23;6907992825076;JD WATERMELON APPLE;1;2000;0;2000;1700;300;
2021-10-07 22:13:23;6907992823874;JD CRUNCHY CHOCO BLUEBERRY;1;5500;0;5500;4700;800;
2021-10-07 22:16:29;8996001600610;TORA MILKY LATTE 180ML;1;3500;0;3500;2750;750;
2021-10-07 22:16:29;7622201430153;OREO CHOCOLATE 38G;1;2000;0;2000;1641;359;
2021-10-07 22:16:29;PRG;PARAGO;2;500;0;1000;800;200;
2021-10-07 22:16:29;8992775318201;GERY SNACK BANTAL COKLAT;1;2000;0;2000;1712;288;
2021-10-07 22:16:29;8995555121244;SOSIS KIMBO;1;1000;0;1000;650;350;
2021-10-07 22:16:29;ROTI;ROTI 2000;2;2000;0;4000;3600;400;
2021-10-07 22:17:19;8992388133345;NU MILK TEA TEH TARIK 330ML;1;6000;0;6000;5125;875;
2021-10-07 22:17:38;8991914101513;VIPER KRETEK 12;1;6000;0;6000;5000;1000;
2021-10-07 22:18:09;8997009510116;LEMON WATER;1;7000;0;7000;5694;1306;
2021-10-07 22:19:07;8994867000162;ROKOK PUNDIMAS KRETEK16;1;10000;0;10000;8600;1400;
2021-10-07 22:19:07;8998989300261;GUDANG GARAM SURYA 12 FILTER;1;20000;0;20000;18150;1850;
2021-10-07 22:19:40;8992979130012;TOTAL LEMON SOFTENER;1;15000;0;15000;13524;1476;
2021-10-07 22:19:56;ARG;ARGUS DOS 220ML;1;14500;0;14500;13300;1200;
2021-10-07 22:20:49;8998866200325;MIE SEDAAP SOTO;1;2700;0;2700;2282;418;
2021-10-07 22:24:12;8991102026383;AIR CRYSTALINE 1.5 L;1;5000;0;5000;3471;1529;
2021-10-07 22:24:12;8998866200301;MIE SEDAAP GORENG;2;2700;0;5400;4726;674;
2021-10-07 22:24:12;8991102228053;TEH GELAS BOTOL;1;3000;0;3000;1695;1305;
2021-10-07 22:24:12;8998989110167;SURYA GUDANG GARAM 16 FILTER;1;26000;0;26000;23700;2300;
2021-10-07 22:24:12;8998989300261;GUDANG GARAM SURYA 12 FILTER;1;20000;0;20000;18150;1850;
2021-10-07 22:25:51;8998866202619;MIE SEDAAP KOREAN SPICY SOUP;2;2700;0;5400;4644;756;
2021-10-07 22:27:01;9556040040038;SUSU F&N;2;33000;0;66000;60000;6000;
2021-10-07 22:27:31;8998866202268;KECAP MANIS SEDAAP SPC REFILL 550ML;1;20000;0;20000;17850;2150;
2021-10-07 22:27:54;8998989300261;GUDANG GARAM SURYA 12 FILTER;1;20000;0;20000;18150;1850;
2021-10-07 22:28:12;123124;KOREK BIASA;1;2000;0;2000;1300;700;
2021-10-07 22:28:45;8997878002088;Kiko;3;1000;0;3000;1350;1650;
2021-10-07 22:29:17;8992628020152;MINYAK GOREG BIMOLI POUCH 2L;1;32000;0;32000;29800;2200;
2021-10-07 22:30:10;8991102100823;Formula Acttion Protector 190 gr;1;10000;0;10000;9000;1000;
2021-10-07 22:31:08;8992775110157;GARUDA KACANG KULIT;1;5000;0;5000;3925;1075;
2021-10-07 22:32:06;ICE CREAM 3;ICE CREAM 3000;2;3000;0;6000;5200;800;
2021-10-07 22:32:44;8991102103091;Formula Proteksi;1;3500;0;3500;2650;850;
2021-10-07 22:34:10;8999999534752;PEPSODENT ACTION123 CHARCOAL 65G;1;7400;0;7400;6710;690;
2021-10-07 22:34:48;8999999048174;SUNSILK  BLK SHINE 70+21ML;1;9600;0;9600;8525;1075;
2021-10-07 22:37:30;8999999045913;LIFEBUOY MILDCARE 110GR;1;15000;0;15000;14245;755;
2021-10-07 22:37:52;8991102022460;FORMULA DIAMOND;1;3000;0;3000;2500;500;
2021-10-07 22:38:29;8993093115008;tepun beras;1;8000;0;8000;7000;1000;
2021-10-07 22:38:55;8992761002022;SPRITE PET 390ML;1;5500;0;5500;4333;1167;
2021-10-07 22:39:44;8998989300261;GUDANG GARAM SURYA 12 FILTER;1;20000;0;20000;18150;1850;
2021-10-07 22:39:44;GL;GULA 1 LITER;1;11500;0;11500;10500;1000;
2021-10-07 22:45:37;8998989110167;SURYA GUDANG GARAM 16 FILTER;1;26000;0;26000;23700;2300;
2021-10-08 18:51:39;089686060461;POP MIE RASA KARI AYAM;2;4500;0;9000;7666;1334;
2021-10-08 18:51:39;8991002105430;KAPAL API 65G;1;5000;0;5000;4145;855;
2021-10-08 18:51:39;8998866200301;MIE SEDAAP GORENG;2;2700;0;5400;4726;674;
2021-10-08 18:51:39;8991102228053;TEH GELAS BOTOL;1;3000;0;3000;1695;1305;
2021-10-08 18:51:39;8997878002088;Kiko;2;1000;0;2000;900;1100;
2021-10-08 18:52:00;ROTI;ROTI 2000;1;2000;0;2000;1800;200;
2021-10-08 18:52:25;8995555121244;SOSIS KIMBO;1;1000;0;1000;650;350;
2021-10-08 18:52:57;7622201430153;OREO CHOCOLATE 38G;1;2000;0;2000;1641;359;
2021-10-08 18:53:41;8886001038011;BENG-BENG SCT;1;1500;0;1500;1000;500;
2021-10-08 18:54:11;8998866202244;EKOMIE BUMBU KALDU AYAM;4;1000;0;4000;3192;808;
2021-10-08 18:57:24;8997018920081;RED BULD;1;20000;0;20000;18000;2000;
2021-10-08 18:57:24;8999909002821;MARLBORO BLACK 16;1;22000;0;22000;20850;1150;
2021-10-08 18:58:30;8998866201490;POTABEE REGULER GRILLED SEAWED 68 GR;1;8000;0;8000;7200;800;
2021-10-08 19:00:22;8997028590052;ARGUS BTL 600ML;2;3000;0;6000;2916;3084;
2021-10-08 19:00:22;8997009460343;NEXI NET;2;1000;0;2000;1800;200;
2021-10-08 19:01:28;kentang;kripik kentang;1;1000;0;1000;900;100;
2021-10-08 19:03:45;8991914101513;VIPER KRETEK 12;1;6000;0;6000;5000;1000;
2021-10-08 19:03:45;8886001038011;BENG-BENG SCT;1;1500;0;1500;1000;500;
2021-10-08 19:08:41;8991102387286;TANGO LONG CKLT 47G;1;2000;0;2000;1551;449;
2021-10-08 19:09:12;8992931006256;tessa;1;1000;0;1000;900;100;
2021-10-08 19:09:44;4901730070010;C&C OIL CONTROL FILM PINK 50;1;24000;0;24000;21250;2750;
2021-10-08 19:11:43;8998866202343;MIE SEDAAP KOREAN SPICY;7;2700;0;18900;16891;2009;
2021-10-08 19:13:55;8991102026383;AIR CRYSTALINE 1.5 L;3;5000;0;15000;10413;4587;
2021-10-08 19:13:55;8991909101016;URBAN MILD 16;1;17000;0;17000;15800;1200;
2021-10-08 19:13:55;8993379210854;SABUN HARMONY APPLE 70G;2;2000;0;4000;3304;696;
2021-10-08 19:15:13;8998989110167;SURYA GUDANG GARAM 16 FILTER;1;26000;0;26000;23700;2300;
2021-10-08 19:15:13;123124;KOREK BIASA;1;2000;0;2000;1300;700;
2021-10-08 19:15:13;GGK;PLAYGUM PERMEN KARET;4;500;0;2000;1600;400;
2021-10-08 19:19:15;8992959020012;SWEETY SILVER PANTS XL34;1;78000;0;78000;73637;4363;
2021-10-08 19:19:15;8992959953303;SWEETY BRONZE S64;1;80000;0;80000;76364;3636;
2021-10-08 19:21:17;8999999053048;PONDS FACIAL FOAM 100G;1;27000;0;27000;24900;2100;
2021-10-08 19:21:45;8996001305119;ARDEN 30G;1;2000;0;2000;1650;350;
2021-10-08 19:23:37;8992959508985;SWEETY SILVER PANTS M30;1;56800;0;56800;51819;4981;
2021-10-08 19:25:16;8886022971298;BATERAI ALKALINE 06;1;12000;0;12000;10557;1443;
2021-10-08 19:25:55;8999999560423;DOVE SUPER SHAMPOO 125ML;1;18500;0;18500;17000;1500;
2021-10-08 19:26:59;8998866107464;POSH FRESH SPIRIT 150ML;1;19500;0;19500;17500;2000;
2021-10-08 19:28:45;Gula gula tusuk;gula gula tusuk;4;500;0;2000;1600;400;
2021-10-08 19:29:15;ROTI;ROTI 2000;1;2000;0;2000;1800;200;
2021-10-08 19:45:47;8993007000024;INDOMILK UHT VANILA;1;5000;0;5000;3470;1530;
2021-10-08 19:45:47;6907992823645;JD COCONUT BLISS;1;4000;0;4000;3500;500;
2021-10-08 19:45:47;OJELLY;O'JELLY;3;500;0;1500;1155;345;
2021-10-08 19:45:47;7622300335809;OREO SOFT CAKE;1;2000;0;2000;1641;359;
2021-10-08 20:07:56;8997009510123;ORANGE WATER;1;11000;0;11000;10416;584;
2021-10-08 20:24:33;ROTI;ROTI 2000;1;2000;0;2000;1800;200;
2021-10-08 20:24:33;8998866500708;FLORIDINA ORANGE;1;3000;0;3000;2500;500;
2021-10-10 19:23:19;8999999031602;SARI MURNI 20X1.6G;1;6000;0;6000;5400;600;
2021-10-10 19:24:00;ARG;ARGUS DOS 220ML;1;14500;0;14500;13300;1200;
2021-10-10 19:46:26;8996001312445;MALKIST CAPPUCINO;1;6500;0;6500;5400;1100;
2021-10-10 19:46:26;ROTI;ROTI 2000;2;2000;0;4000;3600;400;
2021-10-10 19:46:26;8992696523067;MILO ACTVGO UHT 180ML;1;4500;0;4500;3515;985;
2021-10-10 19:46:26;Vita Jelly;Vita Jelly;3;1000;0;3000;2298;702;
2021-10-10 19:49:11;MK;MASKER;1;5000;0;5000;4000;1000;
2021-10-10 20:01:18;8998866600538;SOKLIN FLOORCLENER PINK 400ML;1;6000;0;6000;5025;975;
2021-10-10 20:01:38;8999908204202;MY BABY MINYAK TELON 60ML;1;18000;0;18000;16900;1100;
2021-10-10 20:08:30;8886022971298;BATERAI ALKALINE 06;1;12000;0;12000;10557;1443;
2021-10-10 20:10:44;8993989311699;CLAS MILD 16 FILTER;1;24000;0;24000;21700;2300;
2021-10-10 20:10:44;8999999534752;PEPSODENT ACTION123 CHARCOAL 65G;1;7400;0;7400;6710;690;
2021-10-10 20:10:44;7622300335809;OREO SOFT CAKE;1;2000;0;2000;1641;359;
2021-10-10 20:11:45;8993379260026;SABUN MEDICARE BLACK;2;2500;0;5000;4474;526;
2021-10-10 20:13:51;KIKO;KIKO;2;1000;0;2000;1000;1000;
2021-10-10 20:13:51;8992696404441;BEAR BRAND 189ML;1;15000;0;15000;11000;4000;
2021-10-10 20:13:51;8993007003063;ENAAK 500G;1;11000;0;11000;9625;1375;
2021-10-10 20:14:24;8997027300089;NOMOS;1;4000;0;4000;2963;1037;
2021-10-10 20:16:58;Gula gula tusuk;gula gula tusuk;5;500;0;2500;2000;500;
2021-10-10 20:16:58;123124;KOREK BIASA;1;2000;0;2000;1300;700;
2021-10-10 20:16:58;8998009010231;ULTRA CHO 250;1;6000;0;6000;4784;1216;
2021-10-10 20:17:41;8998989300261;GUDANG GARAM SURYA 12 FILTER;1;20000;0;20000;18150;1850;
2021-10-10 20:17:41;ICE CREAM 5;ICE CREAM 5000;1;5000;0;5000;4400;600;
2021-10-10 20:18:25;ICE CREAM 3;ICE CREAM 3000;1;3000;0;3000;2600;400;
2021-10-10 20:20:02;8994867007161;ROKOK PENA GOLD 20;1;18000;0;18000;16800;1200;
2021-10-10 20:20:02;8997218380074;ICHITAN MILK TEA;1;8000;0;8000;6500;1500;
2021-10-10 20:20:33;8997009510123;ORANGE WATER;1;11000;0;11000;10416;584;
2021-10-10 20:22:13;8992761122331;FRESTEA APPEL 500ML;1;6500;0;6500;4791;1709;
2021-10-10 20:22:13;8997218380074;ICHITAN MILK TEA;2;8000;0;16000;13000;3000;
2021-10-10 20:24:58;8992761164539;NUTRIBOOST ORANGE 300ML;1;6500;0;6500;5300;1200;
2021-10-10 20:24:58;8991102987639;WFR TANGO LONG VNL 130G;1;5000;0;5000;3773;1227;
2021-10-10 20:24:58;8992761111533;SPRITE SLIM CAM250ML;1;5000;0;5000;3750;1250;
2021-10-10 20:26:28;8998989300261;GUDANG GARAM SURYA 12 FILTER;2;20000;0;40000;36300;3700;
2021-10-10 20:26:28;8999999031930;PEPSODENT TB TRIPLE CLEAN;1;3500;0;3500;2850;650;
2021-10-10 20:26:55;8998989110167;SURYA GUDANG GARAM 16 FILTER;1;26000;0;26000;23700;2300;
2021-10-10 20:27:29;8998989300261;GUDANG GARAM SURYA 12 FILTER;1;20000;0;20000;18150;1850;
2021-10-10 20:27:43;MK;MASKER;1;5000;0;5000;4000;1000;
2021-10-10 20:28:53;8998866500487;BABY HAPPY PANTS M 20P;1;37000;0;37000;33520;3480;
2021-10-10 20:29:51;8999801700054;SUSU FOYU 1 KG;1;22000;0;22000;19791;2209;
2021-10-10 20:29:51;GL;GULA 1 LITER;10;11500;0;115000;105000;10000;
2021-10-10 20:31:17;8998866201469;POTABEE REGULER BBQ BEEF 68 GR;1;8000;0;8000;7200;800;
2021-10-10 20:31:17;MK;MASKER;1;5000;0;5000;4000;1000;
2021-10-10 20:31:17;8998009010231;ULTRA CHO 250;2;6000;0;12000;9568;2432;
2021-10-10 20:35:04;8998866202053;POTABEE AYAM BAKAR PEDAS 68GR;1;8000;0;8000;7200;800;
2021-10-10 20:35:04;Gula gula kopiko;gula gula kopiko;3;350;0;1050;750;300;
2021-10-10 20:35:04;KOPIKO;KOPIKO;5;250;0;1250;875;375;
2021-10-10 20:37:03;7622300405588;KEJUCAKE 16G;2;2000;0;4000;3282;718;
2021-10-10 20:40:02;8999909002821;MARLBORO BLACK 16;1;22000;0;22000;20850;1150;
2021-10-10 20:40:02;MK;MASKER;1;5000;0;5000;4000;1000;
2021-10-10 20:40:02;8998989500166;GUDANG GARAM MERAH BESAR 16KS;1;18000;0;18000;17000;1000;
2021-10-10 20:40:02;123124;KOREK BIASA;1;2000;0;2000;1300;700;
2021-10-10 20:40:02;8992696523067;MILO ACTVGO UHT 180ML;2;4500;0;9000;7030;1970;
2021-10-10 20:40:02;8997028590052;ARGUS BTL 600ML;1;3000;0;3000;1458;1542;
2021-10-10 20:40:53;8991909101016;URBAN MILD 16;1;17000;0;17000;15800;1200;
2021-10-10 20:41:30;8992761145026;SPRITE PET 250ML;1;3500;0;3500;2417;1083;
2021-10-10 20:42:47;8992761166038;MMP ORANGE 300ML;1;5000;0;5000;3750;1250;
2021-10-10 20:44:22;7622201430153;OREO CHOCOLATE 38G;2;2000;0;4000;3282;718;
2021-10-10 20:46:30;8996001305119;ARDEN 30G;1;2000;0;2000;1650;350;
2021-10-10 20:46:30;8992717781025;SANTAN KELAPA;1;4000;0;4000;3000;1000;
2021-10-10 20:46:30;8997028590045;ARGUS BTL 330ML;1;2000;0;2000;1291;709;
2021-10-10 20:51:00;8886001038011;BENG-BENG SCT;1;1500;0;1500;1000;500;
2021-10-10 20:51:00;GL;GULA 1 LITER;1;11500;0;11500;10500;1000;
2021-10-10 20:51:00;MK BIASA;MASKERBIASA;1;2000;0;2000;15000;-13000;
2021-10-10 20:51:00;JGRP;JOGER PASTA STICK MOBIL;1;13000;0;13000;11750;1250;
2021-10-10 20:51:00;8998866201490;POTABEE REGULER GRILLED SEAWED 68 GR;1;8000;0;8000;7200;800;
2021-10-10 20:52:44;8997027300089;NOMOS;1;4000;0;4000;2963;1037;
2021-10-10 20:52:44;8992388133345;NU MILK TEA TEH TARIK 330ML;1;6000;0;6000;5125;875;
2021-10-10 20:55:00;8992716109172;BISKUAT BOLU SCT;2;2000;0;4000;3282;718;
2021-10-10 20:55:30;GGK;PLAYGUM PERMEN KARET;2;500;0;1000;800;200;
2021-10-10 21:03:10;8998989110167;SURYA GUDANG GARAM 16 FILTER;3;26000;0;78000;71100;6900;
2021-10-10 21:03:36;123124;KOREK BIASA;1;2000;0;2000;1300;700;
2021-10-10 21:11:43;8998989300261;GUDANG GARAM SURYA 12 FILTER;1;20000;0;20000;18150;1850;
2021-10-10 21:24:43;8886013213208;FRENCH FREIS 2000;2;5000;0;10000;7500;2500;
2021-10-10 21:48:10;8999999008475;SUNLIGHT LIME NEW REF 1600ML;1;35000;0;35000;31955;3045;
2021-10-10 21:59:03;8998866200844;NOODLE SEDAAP MIE KARI SPESIAL CUP 81 GR;1;4500;0;4500;3650;850;
2021-10-10 21:59:03;TELUR;TELUR;1;2000;0;2000;1200;800;
2021-10-10 21:59:03;089686043273;INDOMIE SAMBAL RICA;1;2700;0;2700;2452;248;
2021-10-10 22:01:40;8998989300261;GUDANG GARAM SURYA 12 FILTER;2;20000;0;40000;36300;3700;
2021-10-11 20:48:33;8991002114067;PIKOPI;3;1000;0;3000;1635;1365;
2021-10-11 20:49:32;8993226365522;GARAM MEJA GYURI 200GR;2;2000;0;4000;3400;600;
2021-10-11 20:57:28;089686043273;INDOMIE SAMBAL RICA;4;2700;0;10800;9808;992;
2021-10-11 20:57:28;8991102100823;Formula Acttion Protector 190 gr;1;10000;0;10000;9000;1000;
2021-10-11 20:57:28;089686044249;SUPERMI NUTRIMI STEAK AYAM;2;3500;0;7000;5600;1400;
2021-10-11 20:57:28;8998866611152;CREAM EKONOMI VIOLET 455G;1;5500;0;5500;4750;750;
2021-10-11 20:57:28;8998866600101;CREAM EKONOMI LEMON 455G;1;5500;0;5500;4750;750;
2021-10-11 20:57:28;6907992823645;JD COCONUT BLISS;1;4000;0;4000;3500;500;
2021-10-11 20:57:28;6907992823829;JD MILKY MILK;4;3000;0;12000;10400;1600;
2021-10-11 20:57:28;6907992823669;JD MILKY STRAW;1;3000;0;3000;2600;400;
2021-10-11 20:57:28;JD VM;JD VANILLA MILKSHAKE;1;5000;0;5000;4300;700;
2021-10-11 21:05:46;ARG;ARGUS DOS 220ML;3;14500;0;43500;39900;3600;
2021-10-11 22:00:11;8993989311699;CLAS MILD 16 FILTER;1;24000;0;24000;21700;2300;
2021-10-11 22:00:11;8996001600610;TORA MILKY LATTE 180ML;2;3500;0;7000;5500;1500;
2021-10-11 22:01:23;8999999531508;MOLTO HYGIENE SC 10ML;2;500;0;1000;960;40;
2021-10-11 22:01:23;8996001600610;TORA MILKY LATTE 180ML;1;3500;0;3500;2750;750;
2021-10-11 22:07:26;8997028590014;ARGUS 220ML;3;500;0;1500;906;594;
2021-10-11 22:07:26;8992388111145;MIE ABC SELERA PEDAS- SUP TOMAT PEDAS;1;2500;0;2500;2023;477;
2021-10-11 22:07:26;8992775211410;PILUS GARUDA PEDAS;1;5000;0;5000;4886;114;
2021-10-11 22:07:26;8997878002088;Kiko;2;1000;0;2000;900;1100;
2021-10-11 22:07:26;8993274532105;BOLU;2;1000;0;2000;1666;334;
2021-10-11 22:10:09;0105312686040047;yakult;1;2000;0;2000;1500;500;
2021-10-11 22:10:56;8992388101092;NU GREEN TE HONEY 330ML;1;3500;0;3500;2854;646;
2021-10-11 22:17:25;8997025914059;HATARI SEE HONG;1;6000;0;6000;4911;1089;
2021-10-11 22:17:25;8886001038011;BENG-BENG SCT;2;1500;0;3000;2000;1000;
2021-10-11 22:17:25;8995555121244;SOSIS KIMBO;3;1000;0;3000;1950;1050;
2021-10-11 22:17:25;8992775000663;GERY SNACK KEJU;2;2000;0;4000;3424;576;
2021-10-11 22:17:25;8998866500708;FLORIDINA ORANGE;1;3000;0;3000;2500;500;
2021-10-11 22:17:25;ROTI;ROTI 2000;1;2000;0;2000;1800;200;
2021-10-11 22:17:25;123124;KOREK BIASA;1;2000;0;2000;1300;700;
2021-10-11 22:17:25;kentang;kripik kentang;2;1000;0;2000;1800;200;
2021-10-11 22:17:25;8998866500463;BABY HAPPY PANTS M PCS;5;2000;0;10000;7150;2850;
2021-10-11 22:17:25;8992736424293;SASA BUMBU NASI GORENG 20G;1;2000;0;2000;1136;864;
2021-10-11 22:19:36;089686535044;SUN BERAS MERAH;1;8500;0;8500;7410;1090;
2021-10-11 22:19:36;8994867000094;ROKOK PUNDIMAS FIL16;1;15000;0;15000;13500;1500;
2021-10-11 22:19:36;8998989300261;GUDANG GARAM SURYA 12 FILTER;2;20000;0;40000;36300;3700;
2021-10-11 22:20:02;8994867007161;ROKOK PENA GOLD 20;1;18000;0;18000;16800;1200;
2021-10-11 22:20:27;8998866202060;POTABEE AYAM BAKAR PEDAS 35 GR;1;5000;0;5000;4150;850;
2021-10-11 22:21:11;8998866500463;BABY HAPPY PANTS M PCS;2;2000;0;4000;2860;1140;
2021-10-11 22:23:41;8995150101771;M+SUSU RASA JERUK;1;5000;0;5000;4000;1000;
2021-10-11 22:23:41;8995150109418;M+SUSU RASA MANGGA;1;5000;0;5000;4000;1000;
2021-10-11 22:23:41;4902430563895;PANTENE HALUS DAN LEMBUT 10ML;2;1000;0;2000;1572;428;
2021-10-11 22:23:42;Gula gula tusuk;gula gula tusuk;2;500;0;1000;800;200;
2021-10-11 22:25:14;8997210107877;VORTEX SMART 3;1;5000;0;5000;4750;250;
2021-10-11 22:25:55;silet;silet;2;1000;0;2000;1600;400;
2021-10-11 22:28:20;7622300335809;OREO SOFT CAKE;3;2000;0;6000;4923;1077;
2021-10-11 22:28:20;8992761166038;MMP ORANGE 300ML;1;5000;0;5000;3750;1250;
2021-10-11 22:29:37;8992959508312;SWEETY SILVER PANTS XL1;1;3000;0;3000;2324;676;
2021-10-11 22:29:37;Telur 3 Biji;Telur 3 Biji;1;5000;0;5000;3600;1400;
2021-10-11 22:29:37;TELUR;TELUR;2;2000;0;4000;2400;1600;
2021-10-11 22:30:42;8997028590014;ARGUS 220ML;4;500;0;2000;1208;792;
2021-10-11 22:32:44;8993496107549;MINYAK SIIP 1800 ML;1;28000;0;28000;25399;2601;
2021-10-12 20:10:10;8992946521416;SABUN SHINZUI;1;5000;0;5000;4000;1000;
2021-10-12 20:10:10;ARGUS;ARGUS;1;2000;0;2000;1500;500;
2021-10-12 20:10:10;8997878004327;gula-gula milkita;8;250;0;2000;1600;400;
2021-10-12 20:12:08;ARG;ARGUS DOS 220ML;2;14500;0;29000;26600;2400;
2021-10-12 20:24:25;18992628020152;MINYAK GORENG 2 LT;1;34000;0;34000;32000;2000;
2021-10-12 20:24:25;8994834003752;TICTIC;1;2000;0;2000;1700;300;
2021-10-12 20:24:25;7622201430153;OREO CHOCOLATE 38G;1;2000;0;2000;1641;359;
2021-10-12 20:24:25;8998866108317;EMERON HJB ANTDNDF 10ML;2;5000;0;10000;9000;1000;
2021-10-12 20:24:25;8992696521797;MILO 22G;1;2500;0;2500;1572;928;
2021-10-12 20:24:25;8993989311699;CLAS MILD 16 FILTER;1;24000;0;24000;21700;2300;
2021-10-12 20:30:49;8998866610377;ISOPLUS;1;3000;0;3000;2350;650;
2021-10-12 20:30:49;8998866200301;MIE SEDAAP GORENG;3;2700;0;8100;7089;1011;
2021-10-12 20:30:49;8997028590014;ARGUS 220ML;4;500;0;2000;1208;792;
2021-10-12 20:30:49;8999801700054;SUSU FOYU 1 KG;1;22000;0;22000;19791;2209;
2021-10-12 20:33:52;8992702000063;INDOMILK COKLAT 370G;1;10000;0;10000;9020;980;
2021-10-12 20:33:52;8992759120264;LARISST 220;1;10000;0;10000;9200;800;
2021-10-12 20:33:52;8993007003902;Susu Kental Manis Indo milk;1;15000;0;15000;13333;1667;
2021-10-12 20:33:52;8997028590052;ARGUS BTL 600ML;1;3000;0;3000;1458;1542;
2021-10-12 20:34:15;8997028590052;ARGUS BTL 600ML;1;3000;0;3000;1458;1542;
2021-10-12 20:36:51;8999909002821;MARLBORO BLACK 16;1;22000;0;22000;20850;1150;
2021-10-12 20:36:51;8991102026383;AIR CRYSTALINE 1.5 L;1;5000;0;5000;3471;1529;
2021-10-12 20:36:51;krupuk k;Krupuk Kentang;1;5000;0;5000;4500;500;
2021-10-12 20:37:47;8999909096004;SAMPOERNA 16 FILTER;1;25000;0;25000;23100;1900;
2021-10-12 20:37:47;MBL;MOBIL;1;5000;0;5000;3500;1500;
2021-10-12 20:39:02;8992959508312;SWEETY SILVER PANTS XL1;1;3000;0;3000;2324;676;
2021-10-12 20:39:02;8992761166038;MMP ORANGE 300ML;1;5000;0;5000;3750;1250;
2021-10-12 20:47:36;8992959508312;SWEETY SILVER PANTS XL1;1;3000;0;3000;2324;676;
2021-10-12 20:47:36;8993571003988;CAP 19 BEDAK TALK 100G;1;5500;0;5500;4250;1250;
2021-10-12 20:49:14;8999999007782;FAIR&LOVELY MULTIVITAMIN CREAM 25 MG;1;16500;0;16500;14905;1595;
2021-10-12 20:49:40;8992761145033;FANTA STRAW PET 250ML;1;3500;0;3500;2417;1083;
2021-10-12 20:51:07;ARG;ARGUS DOS 220ML;3;14500;0;43500;39900;3600;
2021-10-12 20:51:58;8998009010569;ULTRA CHO 200;1;5000;0;5000;3958;1042;
2021-10-12 20:52:28;8998009010231;ULTRA CHO 250;1;6000;0;6000;4784;1216;
2021-10-12 20:55:47;8999999007782;FAIR&LOVELY MULTIVITAMIN CREAM 25 MG;1;16500;0;16500;14905;1595;
2021-10-12 20:55:47;1212060005003;IMPLORA;1;20000;0;20000;1900;18100;
2021-10-12 20:57:35;8998866201889;KRISBEE PILLOW STRAWBERRY ICE CREAM 120GR;1;8000;0;8000;7250;750;
2021-10-12 21:01:56;8998898830125;KKB ENER-G ANGGUR;2;5500;0;11000;9648;1352;
2021-10-12 21:01:56;8998866203227;MIE SEDAAP AYAM BAKAR LIMAU;1;2700;0;2700;2163;537;
2021-10-12 21:02:26;8997002060168;KRP SINGKOG PDS PANDA DUO;1;8000;0;8000;7300;700;
2021-10-12 21:03:21;8995333060772;TERIGU GATOT KACA 500GR;1;5000;0;5000;4346;654;
2021-10-12 21:03:21;8992775000663;GERY SNACK KEJU;2;2000;0;4000;3424;576;
2021-10-12 21:03:42;8995555171225;KIMBO SOSIS;1;1000;0;1000;900;100;
2021-10-12 21:05:42;8998866500708;FLORIDINA ORANGE;2;3000;0;6000;5000;1000;
2021-10-12 21:05:42;GL;GULA 1 LITER;2;11500;0;23000;21000;2000;
2021-10-12 21:05:42;Garuda pilus;Garuda Pilus Pedas Pcs;1;500;0;500;408;92;
2021-10-12 21:05:42;8997028590014;ARGUS 220ML;2;500;0;1000;604;396;
2021-10-12 21:07:43;6921101219235;YAKUAT JELLY;1;2000;0;2000;1750;250;
2021-10-12 21:07:43;8992761111533;SPRITE SLIM CAM250ML;1;5000;0;5000;3750;1250;
2021-10-12 21:07:43;8997009510123;ORANGE WATER;1;11000;0;11000;10416;584;
2021-10-12 21:08:39;8999999555450;VIXAL PEMB PORS BIRU 190ML;1;5000;0;5000;4200;800;
2021-10-12 21:11:28;8999999016128;RINSO MOLTO ROSE FRESH 750ML;2;15000;0;30000;25014;4986;
2021-10-12 21:13:53;8991111101316;JB OIL 50ML;1;9500;0;9500;8700;800;
2021-10-12 21:13:53;8991102002363;SABUN PRIMA PROTECT 110GR;1;5000;0;5000;3900;1100;
2021-10-12 21:14:25;8994834003752;TICTIC;2;2000;0;4000;3400;600;
2021-10-12 21:14:45;ARG;ARGUS DOS 220ML;1;14500;0;14500;13300;1200;
2021-10-12 21:15:11;TBR;TEPUNG BERAS ROSE BRAND;1;8000;0;8000;6150;1850;
2021-10-12 21:15:56;8991102228053;TEH GELAS BOTOL;1;3000;0;3000;1695;1305;
2021-10-12 21:15:56;8997878002088;Kiko;1;1000;0;1000;450;550;
2021-10-12 21:20:33;089686010824;INDOMIE GORENG SPESIAL;1;2700;0;2700;2452;248;
2021-10-12 21:20:33;8998866202343;MIE SEDAAP KOREAN SPICY;2;2700;0;5400;4826;574;
2021-10-12 21:20:33;ARG;ARGUS DOS 220ML;1;14500;0;14500;13300;1200;
2021-10-12 21:20:33;8997028590014;ARGUS 220ML;4;500;0;2000;1208;792;
2021-10-12 21:20:33;8998989100120;GUDANG GARAM MINI;1;19000;0;19000;16600;2400;
2021-10-12 21:20:33;8992761139018;ADES 600ML;1;3500;0;3500;2166;1334;
2021-10-12 21:21:10;Gula gula kaki;gula gula kaki;2;500;0;1000;800;200;
2021-10-12 21:21:39;8999999049454;REXONA WMN RO FREE SPIRIT 45 ML;1;15000;0;15000;13550;1450;
2021-10-12 21:22:49;7992912508305;SWEETY SILVER PANTS L1;1;2500;0;2500;1882;618;
2021-10-12 21:23:59;4801010531234;JB BATH BLUE 200 (REFILL);1;14000;0;14000;13530;470;
2021-10-12 21:25:00;8998989300261;GUDANG GARAM SURYA 12 FILTER;1;20000;0;20000;18150;1850;
2021-10-12 21:28:02;8997878002088;Kiko;2;1000;0;2000;900;1100;
2021-10-12 21:28:25;ICE CREAM;ICE CREAM 2000;1;2000;0;2000;1700;300;
2021-10-12 21:29:01;8992760223015;OREO CHOCOLATE CREAM 133G;1;8000;0;8000;6300;1700;
2021-10-12 21:32:23;8998866202244;EKOMIE BUMBU KALDU AYAM;3;1000;0;3000;2394;606;
2021-10-12 21:38:03;8998899001166;BAYGON CITRUS FRESH 600ML;1;37000;0;37000;35000;2000;
2021-10-12 21:39:12;8998009010569;ULTRA CHO 200;1;5000;0;5000;3958;1042;
2021-10-12 21:40:51;8991111101316;JB OIL 50ML;1;9500;0;9500;8700;800;
2021-10-12 21:42:15;089686010824;INDOMIE GORENG SPESIAL;2;2700;0;5400;4904;496;
2021-10-12 21:43:53;gg;gula-gula koin;2;500;0;1000;800;200;
2021-10-12 21:44:17;8997028590014;ARGUS 220ML;4;500;0;2000;1208;792;
2021-10-12 21:44:34;Telur 3 Biji;Telur 3 Biji;1;5000;0;5000;3600;1400;
2021-10-12 21:45:09;8993470671752;JOGER STICK DUO KACANG;2;1000;0;2000;1700;300;
2021-10-12 21:45:55;ICE CREAM 3;ICE CREAM 3000;1;3000;0;3000;2600;400;
2021-10-12 21:46:37;Gula gula kaki;gula gula kaki;2;500;0;1000;800;200;
2021-10-12 21:47:19;Gula gula tusuk;gula gula tusuk;2;500;0;1000;800;200;
2021-10-12 21:47:55;Gula gula tusuk;gula gula tusuk;6;500;0;3000;2400;600;
2021-10-12 21:49:47;8997028590014;ARGUS 220ML;2;500;0;1000;604;396;
2021-10-12 21:49:47;8993470411433;JOGER CLASSIC;1;1000;0;1000;850;150;
2021-10-12 21:49:47;8998989300261;GUDANG GARAM SURYA 12 FILTER;2;20000;0;40000;36300;3700;
2021-10-12 21:56:03;TUSTEL;TUSUK TELINGA;2;1000;0;2000;1666;334;
2021-10-12 22:06:23;8992761166038;MMP ORANGE 300ML;1;5000;0;5000;3750;1250;
2021-10-12 22:11:21;8998866200325;MIE SEDAAP SOTO;2;2700;0;5400;4564;836;
2021-10-13 20:19:16;7622201430153;OREO CHOCOLATE 38G;1;2000;0;2000;1641;359;
2021-10-13 20:19:16;8993274534079;PARAGO CHOCO;2;500;0;1000;800;200;
2021-10-13 20:19:16;ROTI;ROTI 2000;1;2000;0;2000;1800;200;
2021-10-13 20:19:16;8997028590045;ARGUS BTL 330ML;4;2000;0;8000;5164;2836;
2021-10-13 20:19:16;MK;MASKER;3;5000;0;15000;12000;3000;
2021-10-13 20:26:14;8992775000076;GERY SNACK RING CKLT;1;2000;0;2000;1712;288;
2021-10-13 20:26:14;8996001314005;ROMA KELAPA CREAM CKLT;1;8000;0;8000;6642;1358;
2021-10-13 20:26:14;8993274534079;PARAGO CHOCO;4;500;0;2000;1600;400;
2021-10-13 20:26:14;gg;gula-gula koin;6;500;0;3000;2400;600;
2021-10-13 20:26:14;ROTI;ROTI 2000;5;2000;0;10000;9000;1000;
2021-10-13 20:26:14;8996001305126;ARDEN BOX;1;18000;0;18000;16500;1500;
2021-10-13 20:26:14;8998898280401;TOLAK ANGIN FLU;1;3500;0;3500;2708;792;
2021-10-13 20:31:46;8991102385060;TANGO WAFFLE CHOX;1;9000;0;9000;8498;502;
2021-10-13 20:31:46;8991102987875;WFR TANGO POUCH CKL 115G;1;8000;0;8000;6786;1214;
2021-10-13 20:31:46;8992761166205;FRESTEA GREEN HONEY 350ML;1;4500;0;4500;3000;1500;
2021-10-13 20:31:46;8994834005923;SPIX 1000;3;1000;0;3000;2550;450;
2021-10-13 20:34:45;8998866500708;FLORIDINA ORANGE;1;3000;0;3000;2500;500;
2021-10-13 20:34:45;8998866500463;BABY HAPPY PANTS M PCS;2;2000;0;4000;2860;1140;
2021-10-13 20:38:06;8992761166038;MMP ORANGE 300ML;5;5000;0;25000;18750;6250;
2021-10-13 20:38:06;8991909101016;URBAN MILD 16;1;17000;0;17000;15800;1200;
2021-10-13 20:38:06;8992388133345;NU MILK TEA TEH TARIK 330ML;1;6000;0;6000;5125;875;
2021-10-13 20:42:53;8996001301579;MALKIST CKLT KELAPA PACK;2;6500;0;13000;10800;2200;
2021-10-13 20:42:53;kri;kripik pisang;1;5000;0;5000;4000;1000;
2021-10-13 20:42:53;8992775610367;Garuda Koro paggang;2;1000;0;2000;1656;344;
2021-10-13 20:42:53;8992775312469;GERY SALUT COKELAT;1;11000;0;11000;9983;1017;
2021-10-13 20:42:53;8997028590045;ARGUS BTL 330ML;1;2000;0;2000;1291;709;
2021-10-13 20:42:53;8992775001042;PILUS GARUDA MI GORENG;1;5000;0;5000;4810;190;
2021-10-13 20:42:53;8997028590014;ARGUS 220ML;2;500;0;1000;604;396;
2021-10-13 20:46:17;8997028590014;ARGUS 220ML;1;500;0;500;302;198;
2021-10-13 20:47:08;8999909002821;MARLBORO BLACK 16;1;22000;0;22000;20850;1150;
2021-10-13 20:50:05;8991102387286;TANGO LONG CKLT 47G;1;2000;0;2000;1551;449;
2021-10-13 20:50:05;8997028590052;ARGUS BTL 600ML;1;3000;0;3000;1458;1542;
2021-10-13 20:50:05;8991102228053;TEH GELAS BOTOL;4;3000;0;12000;6780;5220;
2021-10-13 20:50:58;8996001301142;ROMA KELAPA;1;8000;0;8000;6628;1372;
2021-10-13 20:50:58;MK BIASA;MASKERBIASA;3;2000;0;6000;45000;-39000;
2021-10-13 20:51:21;MK BIASA;MASKERBIASA;3;2000;0;6000;45000;-39000;
2021-10-13 20:58:05;8997028380165;BISKUIT;1;10000;0;10000;9000;1000;
2021-10-13 20:58:05;MK BIASA;MASKERBIASA;2;2000;0;4000;30000;-26000;
2021-10-13 20:58:45;8997013180046;Tissu Tessi B;1;11000;0;11000;9800;1200;
2021-10-13 20:59:08;8992761166205;FRESTEA GREEN HONEY 350ML;1;4500;0;4500;3000;1500;
2021-10-13 20:59:39;8998866202619;MIE SEDAAP KOREAN SPICY SOUP;1;2700;0;2700;2322;378;
2021-10-13 21:00:10;8997028590014;ARGUS 220ML;4;500;0;2000;1208;792;
2021-10-13 21:06:33;ARG;ARGUS DOS 220ML;2;14500;0;29000;26600;2400;
2021-10-13 21:06:33;8992759120264;LARISST 220;3;10000;0;30000;27600;2400;
2021-10-13 21:06:33;8994867007161;ROKOK PENA GOLD 20;1;18000;0;18000;16800;1200;
2021-10-13 21:08:40;8992775110157;GARUDA KACANG KULIT;1;5000;0;5000;3925;1075;
2021-10-13 21:08:40;8998866202060;POTABEE AYAM BAKAR PEDAS 35 GR;1;5000;0;5000;4150;850;
2021-10-13 21:08:40;8991002103764;GOOD DAY CAPPUCINO 10X25G;3;1500;0;4500;4185;315;
2021-10-13 21:08:40;MTR;MOTOR;2;5000;0;10000;7000;3000;
2021-10-13 21:10:36;8998866202244;EKOMIE BUMBU KALDU AYAM;1;1000;0;1000;798;202;
2021-10-13 21:12:39;8998989110167;SURYA GUDANG GARAM 16 FILTER;1;26000;0;26000;23700;2300;
2021-10-13 21:17:16;8992775110157;GARUDA KACANG KULIT;1;5000;0;5000;3925;1075;
2021-10-13 21:17:16;8995333032113;TERIGU GATOT KACA 1 KG;1;9000;0;9000;8572;428;
2021-10-13 21:17:16;Vita Jelly;Vita Jelly;1;1000;0;1000;766;234;
2021-10-13 21:39:09;089686010824;INDOMIE GORENG SPESIAL;2;2700;0;5400;4904;496;
2021-10-13 21:44:25;8999999706180;PEPSODENT WHITE 190GR;1;10000;0;10000;9350;650;
2021-10-13 21:44:25;8992753100101;BKM FULL CREAM GOLD 370;1;15000;0;15000;14000;1000;
2021-10-13 21:53:35;8886013213208;FRENCH FREIS 2000;1;5000;0;5000;3750;1250;
2021-10-13 21:53:35;8997231980015;O'JELLY MINI APPLE;1;3000;0;3000;2250;750;
2021-10-13 21:53:35;8997028590052;ARGUS BTL 600ML;1;3000;0;3000;1458;1542;
2021-10-13 21:53:35;8993007000024;INDOMILK UHT VANILA;1;5000;0;5000;3470;1530;
2021-10-13 21:53:35;7622201430184;OREO ORIGINAL 38G;1;2000;0;2000;1641;359;
2021-10-13 21:53:35;8994907000428;KECAP SACHET ABC;6;600;0;3600;3000;600;
2021-10-13 21:53:35;Gula gula tusuk;gula gula tusuk;2;500;0;1000;800;200;
2021-10-13 21:54:02;8993989311699;CLAS MILD 16 FILTER;1;24000;0;24000;21700;2300;
2021-10-13 21:56:15;8997028590045;ARGUS BTL 330ML;4;2000;0;8000;5164;2836;
2021-10-13 21:56:15;8992957220117;COKLAT BERUANG;2;2000;0;4000;3400;600;
2021-10-13 21:56:45;8995555121244;SOSIS KIMBO;1;1000;0;1000;650;350;
2021-10-13 21:57:46;8998866610377;ISOPLUS;2;3000;0;6000;4700;1300;
2021-10-13 21:59:41;8886001038011;BENG-BENG SCT;1;1500;0;1500;1000;500;
2021-10-13 21:59:41;8991102300544;WFR TANGO VNL 176G;1;10000;0;10000;8694;1306;
2021-10-13 21:59:41;8997218380159;ICHITAN BROWN SUGAR;1;8000;0;8000;6500;1500;
2021-10-13 21:59:41;kri;kripik pisang;1;5000;0;5000;4000;1000;
2021-10-13 21:59:41;KOPIKO;KOPIKO;4;250;0;1000;700;300;
2021-10-13 22:01:07;8998866201889;KRISBEE PILLOW STRAWBERRY ICE CREAM 120GR;1;8000;0;8000;7250;750;
2021-10-13 22:01:07;8997028590045;ARGUS BTL 330ML;1;2000;0;2000;1291;709;
2021-10-13 22:02:22;8998866201889;KRISBEE PILLOW STRAWBERRY ICE CREAM 120GR;1;8000;0;8000;7250;750;
2021-10-13 22:06:26;MK;MASKER;1;5000;0;5000;4000;1000;
2021-10-13 22:06:26;8994867000162;ROKOK PUNDIMAS KRETEK16;1;10000;0;10000;8600;1400;
2021-10-13 22:06:26;ICE CREAM;ICE CREAM 2000;1;2000;0;2000;1700;300;
2021-10-13 22:06:26;8997028590014;ARGUS 220ML;6;500;0;3000;1812;1188;
2021-10-13 22:06:26;GL;GULA 1 LITER;1;11500;0;11500;10500;1000;
2021-10-13 22:06:26;8992775110157;GARUDA KACANG KULIT;1;5000;0;5000;3925;1075;
2021-10-13 22:06:26;8994935000070;MINYAK GORENG DUNIA 450 ML;1;7500;0;7500;6779;721;
2021-10-13 22:06:26;8992946521416;SABUN SHINZUI;1;5000;0;5000;4000;1000;
2021-10-13 22:06:26;ICE CREAM 3;ICE CREAM 3000;1;3000;0;3000;2600;400;
2021-10-13 22:11:50;ICE CREAM 3;ICE CREAM 3000;1;3000;0;3000;2600;400;
2021-10-13 22:12:28;8991102228053;TEH GELAS BOTOL;2;3000;0;6000;3390;2610;
2021-10-13 22:18:04;8996001600641;TORA CAPPUCINO;1;3500;0;3500;2750;750;
2021-10-13 22:18:04;8996001301142;ROMA KELAPA;1;8000;0;8000;6628;1372;
2021-10-13 22:18:04;8991102300544;WFR TANGO VNL 176G;1;10000;0;10000;8694;1306;
2021-10-13 22:18:04;8997028590052;ARGUS BTL 600ML;4;3000;0;12000;5832;6168;
2021-10-13 22:18:04;8998009040023;TEH KOTAK;1;5000;0;5000;2708;2292;
2021-10-13 22:18:04;8991102026383;AIR CRYSTALINE 1.5 L;1;5000;0;5000;3471;1529;
2021-10-13 22:18:04;8992696523067;MILO ACTVGO UHT 180ML;2;4500;0;9000;7030;1970;
2021-10-13 22:18:04;8992931006256;tessa;1;1000;0;1000;900;100;
2021-10-13 22:18:04;ARG;ARGUS DOS 220ML;2;14500;0;29000;26600;2400;
2021-10-13 22:24:40;8997018720469;TISSUE SE-KA;1;10000;0;10000;9300;700;
2021-10-13 22:24:40;ICE CREAM;ICE CREAM 2000;1;2000;0;2000;1700;300;
2021-10-13 22:24:40;8997028590052;ARGUS BTL 600ML;1;3000;0;3000;1458;1542;
2021-10-13 22:24:40;8992724892844;Coklat mede;1;1000;0;1000;800;200;
2021-10-13 22:24:40;MK;MASKER;1;5000;0;5000;4000;1000;
2021-10-13 22:24:40;Telur 3 Biji;Telur 3 Biji;1;5000;0;5000;3600;1400;
2021-10-13 22:24:40;8995333032113;TERIGU GATOT KACA 1 KG;1;9000;0;9000;8572;428;
2021-10-13 22:24:40;8998866201964;MINYAK GORENG SABRINA 2L POUCH;1;28000;0;28000;26753;1247;
2021-10-13 22:24:40;8993379152017;SABUN CUCI SURYA 200G;1;3000;0;3000;2281;719;
2021-10-13 22:24:40;8994907000428;KECAP SACHET ABC;4;600;0;2400;2000;400;
2021-10-13 22:24:40;8995555121244;SOSIS KIMBO;3;1000;0;3000;1950;1050;
2021-10-13 22:25:19;8999999049447;REXONA WMN RO ADVANCED WHITE 45 ML;1;16500;0;16500;14900;1600;
2021-10-13 22:27:51;ICE CREAM 5.500;ICE CREAM 5.500;1;5500;0;5500;4700;800;
2021-10-13 22:27:51;ICE CREAM 6;ICE CREAM 6.000;1;6000;0;6000;5200;800;
2021-10-13 22:27:51;8997028590052;ARGUS BTL 600ML;1;3000;0;3000;1458;1542;
2021-10-13 22:28:31;8992959953334;SWEETY BRONZE XL42;1;80000;0;80000;75455;4545;
2021-10-13 22:31:46;8992959953174;SWEETY BRONZE M34+2;1;58000;0;58000;53182;4818;
2021-10-13 22:31:46;8998866200578;MIE SEDAAP KARI KENTAL;3;2700;0;8100;6993;1107;
2021-10-14 19:31:46;8992702000018;INDOMILK PUTIH 370G;1;10000;0;10000;9020;980;
2021-10-14 19:34:41;8994834003752;TICTIC;2;2000;0;4000;3400;600;
2021-10-14 19:34:41;8991102387286;TANGO LONG CKLT 47G;2;2000;0;4000;3102;898;
2021-10-14 19:34:41;ICE CREAM;ICE CREAM 2000;1;2000;0;2000;1700;300;
2021-10-14 19:34:41;089686021219;INTER MIE GORENG;2;1000;0;2000;1770;230;
2021-10-14 19:37:11;ICE CREAM;ICE CREAM 2000;6;2000;0;12000;10200;1800;
2021-10-14 19:37:11;KIKO;KIKO;3;1000;0;3000;1500;1500;
2021-10-14 19:37:11;gg;gula-gula koin;6;500;0;3000;2400;600;
2021-10-14 19:39:37;ICE CREAM 3;ICE CREAM 3000;1;3000;0;3000;2600;400;
2021-10-14 19:39:37;8997028590014;ARGUS 220ML;4;500;0;2000;1208;792;
2021-10-14 19:39:37;8997009460343;NEXI NET;2;1000;0;2000;1800;200;
2021-10-14 19:39:37;kentang;kripik kentang;2;1000;0;2000;1800;200;
2021-10-14 19:42:17;8992959002032;SWEETY SILVER PANTS L36;1;72000;0;72000;68182;3818;
2021-10-14 19:42:17;8992775311615;CHOCOLATOS;1;12000;0;12000;9983;2017;
2021-10-14 19:42:17;kri;kripik pisang;1;5000;0;5000;4000;1000;
2021-10-14 19:49:03;MK BIASA;MASKERBIASA;2;2000;0;4000;3000;1000;
2021-10-14 20:05:39;8993989311699;CLAS MILD 16 FILTER;1;24000;0;24000;21700;2300;
2021-10-14 20:12:15;8992775001691;GARUDA ROSTA WAGYU BEEF 100G;1;8000;0;8000;7322;678;
2021-10-14 20:12:15;KIKO;KIKO;1;1000;0;1000;500;500;
2021-10-14 20:12:15;Gula gula kopiko;gula gula kopiko;3;350;0;1050;750;300;
2021-10-14 20:22:27;kentang;kripik kentang;1;1000;0;1000;900;100;
2021-10-14 20:22:27;MK;MASKER;2;5000;0;10000;8000;2000;
2021-10-14 20:22:27;8999999049454;REXONA WMN RO FREE SPIRIT 45 ML;1;15000;0;15000;13550;1450;
2021-10-14 20:22:27;8997013180046;Tissu Tessi B;1;11000;0;11000;9800;1200;
2021-10-14 20:23:30;8998866500463;BABY HAPPY PANTS M PCS;5;2000;0;10000;7150;2850;
2021-10-14 20:25:24;8992775110157;GARUDA KACANG KULIT;1;5000;0;5000;3925;1075;
2021-10-14 20:25:24;8991102281430;PERMEN MINTZ DUOMINT;1;5000;0;5000;4000;1000;
2021-10-14 20:26:53;8997009510055;YOU C1000;1;15000;0;15000;13000;2000;
2021-10-14 20:30:32;8992761111533;SPRITE SLIM CAM250ML;1;5000;0;5000;3750;1250;
2021-10-14 20:32:10;0105312686040047;yakult;2;2000;0;4000;3000;1000;
2021-10-14 20:43:27;8998866107112;WET WIPES KODOMO  BABY 50SHT;1;20000;0;20000;14150;5850;
2021-10-14 20:43:27;LEM;LEM TIKUS;1;27000;0;27000;24000;3000;
2021-10-14 20:43:27;8886013213208;FRENCH FREIS 2000;1;5000;0;5000;3750;1250;
2021-10-14 20:43:27;8992696521629;DNCO COKLT UHT 180ML;1;5000;0;5000;3533;1467;
2021-10-14 20:43:27;8992957220186;COKLAT RUSA;2;2000;0;4000;3400;600;
2021-10-14 20:43:27;8999909003439;MARLBORO CRAFTED 12;2;8000;0;16000;14500;1500;
2021-10-14 20:43:27;8998866201469;POTABEE REGULER BBQ BEEF 68 GR;2;8000;0;16000;14400;1600;
2021-10-14 20:43:27;8993324850395;GENTLE CUTTON BUDS 50;1;3000;0;3000;2000;1000;
2021-10-14 20:43:27;8997240540019;tepun tapioka;1;11000;0;11000;9900;1100;
2021-10-14 20:45:29;8998866200882;SUKSESMIE GORENG AYAM KRMS 133GR;1;3500;0;3500;3047;453;
2021-10-14 20:45:29;8998866202244;EKOMIE BUMBU KALDU AYAM;1;1000;0;1000;798;202;
2021-10-14 20:49:33;8991188943062;SASA 250G;1;10000;0;10000;8500;1500;
2021-10-14 20:49:33;8999909096004;SAMPOERNA 16 FILTER;2;25000;0;50000;46200;3800;
2021-10-14 20:49:33;8991002342118;gula-gula kapal api;1;5000;0;5000;4000;1000;
2021-10-14 20:49:33;8997218380074;ICHITAN MILK TEA;1;8000;0;8000;6500;1500;
2021-10-14 20:49:33;TEMBAK;TEMBAK SNIPPER;1;3500;0;3500;2500;1000;
2021-10-14 20:49:33;ARG;ARGUS DOS 220ML;1;14500;0;14500;13300;1200;
2021-10-14 20:51:51;8999909010567;234 DJI SAM SOE 16;2;22500;0;45000;43000;2000;
2021-10-14 20:51:51;8998866202343;MIE SEDAAP KOREAN SPICY;1;2700;0;2700;2413;287;
2021-10-14 20:51:51;8997028590014;ARGUS 220ML;4;500;0;2000;1208;792;
2021-10-14 20:51:51;TG;TEH GELAS;3;1000;0;3000;2187;813;
2021-10-14 20:52:13;kentang;kripik kentang;1;1000;0;1000;900;100;
2021-10-14 20:54:01;MK;MASKER;1;5000;0;5000;4000;1000;
2021-10-14 20:54:27;8995555121244;SOSIS KIMBO;3;1000;0;3000;1950;1050;
2021-10-14 20:54:50;8992775001783;GERY SALUT MALKIST KELAPA;1;6500;0;6500;5516;984;
2021-10-14 20:57:33;ARG;ARGUS DOS 220ML;2;14500;0;29000;26600;2400;
2021-10-14 20:57:33;MK;MASKER;1;5000;0;5000;4000;1000;
2021-10-14 21:02:34;8992775311615;CHOCOLATOS;1;12000;0;12000;9983;2017;
2021-10-14 21:02:34;8992388101085;NU GREEN TEA ORIGINAL 330ML;1;3500;0;3500;2768;732;
2021-10-14 21:02:34;8992717781025;SANTAN KELAPA;2;4000;0;8000;6000;2000;
2021-10-14 21:02:34;8997009510055;YOU C1000;1;15000;0;15000;13000;2000;
2021-10-14 21:02:34;8997028590052;ARGUS BTL 600ML;1;3000;0;3000;1458;1542;
2021-10-14 21:02:34;8997878004327;gula-gula milkita;8;250;0;2000;1600;400;
2021-10-14 21:04:24;8993379200879;SABUN HARMONY MELON 70G;1;2000;0;2000;1652;348;
2021-10-14 21:04:24;8997013180046;Tissu Tessi B;1;11000;0;11000;9800;1200;
2021-10-14 21:04:24;8991102387286;TANGO LONG CKLT 47G;1;2000;0;2000;1551;449;
2021-10-14 21:04:24;8993274534079;PARAGO CHOCO;2;500;0;1000;800;200;
2021-10-14 21:09:39;8996001600641;TORA CAPPUCINO;1;3500;0;3500;2750;750;
2021-10-14 21:09:39;8999908284907;MY BABY MINYAK TELON 90ML;1;25000;0;25000;22700;2300;
2021-10-14 21:09:39;TEMBAK;TEMBAK SNIPPER;1;3500;0;3500;2500;1000;
2021-10-14 21:09:39;8998866608459;POWDET DAIA PUTIH BAG 290GR;1;5000;0;5000;4450;550;
2021-10-14 21:09:39;8998866200578;MIE SEDAAP KARI KENTAL;1;2700;0;2700;2331;369;
2021-10-14 21:09:39;8999999192150;ROYCO FDS CHICKEN 100GR;1;5000;0;5000;4300;700;
2021-10-14 21:09:39;8992717781025;SANTAN KELAPA;1;4000;0;4000;3000;1000;
2021-10-14 21:09:39;8997013180046;Tissu Tessi B;1;11000;0;11000;9800;1200;
2021-10-14 21:09:39;Telur 3 Biji;Telur 3 Biji;1;5000;0;5000;3600;1400;
2021-10-14 21:11:52;AMPLOP;AMPLOP;2;250;0;500;350;150;
2021-10-14 21:11:52;ICE CREAM;ICE CREAM 2000;1;2000;0;2000;1700;300;
2021-10-14 21:11:52;8997878004327;gula-gula milkita;4;250;0;1000;800;200;
2021-10-14 21:11:52;YP;YUPI;6;250;0;1500;1248;252;
2021-10-14 21:19:29;TEMBAK;TEMBAK SNIPPER;1;3500;0;3500;2500;1000;
2021-10-14 21:19:29;gg;gula-gula koin;4;500;0;2000;1600;400;
2021-10-14 21:19:29;Gula gula kaki;gula gula kaki;5;500;0;2500;2000;500;
2021-10-14 21:19:29;089686061024;POP MIE MINI SOTO RL;1;3000;0;3000;2702;298;
2021-10-14 21:19:29;kentang;kripik kentang;1;1000;0;1000;900;100;
2021-10-14 21:19:29;8998989300261;GUDANG GARAM SURYA 12 FILTER;2;20000;0;40000;36300;3700;
2021-10-14 21:19:29;8886467100048;pringles bbq;1;9000;0;9000;6333;2667;
2021-10-14 21:19:29;8999909002821;MARLBORO BLACK 16;1;22000;0;22000;20850;1150;
2021-10-14 21:19:29;8994867007161;ROKOK PENA GOLD 20;1;18000;0;18000;16800;1200;
2021-10-14 21:19:29;8992775913000;CHOCOLATOS CKLT 28G;1;2000;0;2000;1557;443;
2021-10-14 21:19:29;8992959508312;SWEETY SILVER PANTS XL1;1;3000;0;3000;2324;676;
2021-10-14 21:19:29;8991002103764;GOOD DAY CAPPUCINO 10X25G;1;1500;0;1500;1395;105;
2021-10-14 21:19:29;8998989500166;GUDANG GARAM MERAH BESAR 16KS;2;18000;0;36000;34000;2000;
2021-10-14 21:21:33;ARG;ARGUS DOS 220ML;3;14500;0;43500;39900;3600;
2021-10-14 21:21:33;8998989110167;SURYA GUDANG GARAM 16 FILTER;1;26000;0;26000;23700;2300;
2021-10-14 21:21:33;KIKO;KIKO;1;1000;0;1000;500;500;
2021-10-14 21:21:33;8992775001844;Chocolatos original taste;1;1000;0;1000;829;171;
2021-10-14 21:21:33;8991001242013;Top;1;1000;0;1000;500;500;
2021-10-14 21:24:39;8998866202268;KECAP MANIS SEDAAP SPC REFILL 550ML;1;20000;0;20000;17850;2150;
2021-10-14 21:24:39;Telur 7 Biji;Telur 7 Biji;1;10000;0;10000;8400;1600;
2021-10-14 21:24:39;089686021141;INTER MIE SOTO;4;1000;0;4000;3416;584;
2021-10-14 21:24:39;8999999502409;ROYCO FDS BEEF 9G;2;500;0;1000;750;250;
2021-10-14 21:24:39;8997028590014;ARGUS 220ML;2;500;0;1000;604;396;
2021-10-14 21:24:39;Vita Jelly;Vita Jelly;1;1000;0;1000;766;234;
2021-10-14 21:24:39;GL;GULA 1 LITER;1;11500;0;11500;10500;1000;
2021-10-14 21:52:23;8991914101513;VIPER KRETEK 12;1;6000;0;6000;5000;1000;
2021-10-14 22:32:37;8999909002821;MARLBORO BLACK 16;1;22000;0;22000;20850;1150;
2021-10-14 22:32:37;8998989300261;GUDANG GARAM SURYA 12 FILTER;1;20000;0;20000;18150;1850;
2021-10-14 22:32:37;8998989110167;SURYA GUDANG GARAM 16 FILTER;1;26000;0;26000;23700;2300;
2021-10-15 20:52:12;8999999059781;SUNLIGHT LIME NEW POUCH 210ML;1;5000;0;5000;4520;480;
2021-10-15 20:52:12;ROTI;ROTI 2000;1;2000;0;2000;1800;200;
2021-10-15 20:52:12;8998989300261;GUDANG GARAM SURYA 12 FILTER;1;20000;0;20000;18150;1850;
2021-10-15 20:52:12;123124;KOREK BIASA;1;2000;0;2000;1300;700;
2021-10-15 20:52:12;8992717781025;SANTAN KELAPA;1;4000;0;4000;3000;1000;
2021-10-15 20:54:23;ICE CREAM;ICE CREAM 2000;5;2000;0;10000;8500;1500;
2021-10-15 20:54:23;ROTI;ROTI 2000;2;2000;0;4000;3600;400;
2021-10-15 20:55:14;8999999516208;ROYCO FDS CHICKEN NEW 230G;1;10000;0;10000;9000;1000;
2021-10-15 20:58:13;8999909096004;SAMPOERNA 16 FILTER;1;25000;0;25000;23100;1900;
2021-10-15 20:58:13;8998989110167;SURYA GUDANG GARAM 16 FILTER;1;26000;0;26000;23700;2300;
2021-10-15 20:58:13;8995555121244;SOSIS KIMBO;2;1000;0;2000;1300;700;
2021-10-15 20:58:13;8998866611725;EKONOMI PENCUCI PIRING  LIQ 290ML;1;5000;0;5000;4200;800;
2021-10-15 20:58:13;ARG;ARGUS DOS 220ML;2;14500;0;29000;26600;2400;
2021-10-15 21:00:54;MK;MASKER;2;5000;0;10000;8000;2000;
2021-10-15 21:00:54;8992388133345;NU MILK TEA TEH TARIK 330ML;1;6000;0;6000;5125;875;
2021-10-15 21:00:54;ARG;ARGUS DOS 220ML;2;14500;0;29000;26600;2400;
2021-10-15 21:02:09;8999999524722;SUNLIGHT LIME NEW PCH 435ML;1;10000;0;10000;9100;900;
2021-10-15 21:02:09;jagung marning;jagung marning;1;5000;0;5000;4500;500;
2021-10-15 21:02:09;8992761002039;FANTA STRAWBERRY PET 390 ML;1;5500;0;5500;4333;1167;
2021-10-15 21:17:51;9556040040038;SUSU F&N;3;35000;0;105000;90000;15000;
2021-10-15 21:17:51;8992775211410;PILUS GARUDA PEDAS;1;5000;0;5000;4886;114;
2021-10-15 21:17:51;8998866202619;MIE SEDAAP KOREAN SPICY SOUP;1;2700;0;2700;2322;378;
2021-10-15 21:22:27;8997028590045;ARGUS BTL 330ML;1;2000;0;2000;1291;709;
2021-10-15 21:22:27;8995333060772;TERIGU GATOT KACA 500GR;1;5000;0;5000;4346;654;
2021-10-15 21:22:27;8999999502409;ROYCO FDS BEEF 9G;2;500;0;1000;750;250;
2021-10-15 21:22:27;8996001410042;TB TORA MOKA;1;1500;0;1500;870;630;
2021-10-15 21:22:27;ICE CREAM;ICE CREAM 2000;1;2000;0;2000;1700;300;
2021-10-15 21:22:27;8991002103764;GOOD DAY CAPPUCINO 10X25G;1;1500;0;1500;1395;105;
2021-10-15 21:22:27;Gula gula kaki;gula gula kaki;2;500;0;1000;800;200;
2021-10-15 21:28:05;8992388101085;NU GREEN TEA ORIGINAL 330ML;1;3500;0;3500;2768;732;
2021-10-15 21:28:05;8997878004327;gula-gula milkita;2;250;0;500;400;100;
2021-10-15 21:28:05;8992761166205;FRESTEA GREEN HONEY 350ML;1;4500;0;4500;3000;1500;
2021-10-15 21:28:05;8997218380159;ICHITAN BROWN SUGAR;1;8000;0;8000;6500;1500;
2021-10-15 21:31:39;8991102714846;MILKIDO CKLT;1;3000;0;3000;2153;847;
2021-10-15 21:31:39;ROTI;ROTI 2000;2;2000;0;4000;3600;400;
2021-10-15 21:31:39;8994867007161;ROKOK PENA GOLD 20;1;18000;0;18000;16800;1200;
2021-10-15 21:31:39;ICE CREAM 5.500;ICE CREAM 5.500;2;5500;0;11000;9400;1600;
2021-10-15 21:31:39;8998989300261;GUDANG GARAM SURYA 12 FILTER;1;20000;0;20000;18150;1850;
2021-10-15 21:31:39;GL;GULA 1 LITER;2;11500;0;23000;21000;2000;
2021-10-15 21:34:31;8996001302347;SARI GANDUM FAM;2;8500;0;17000;15400;1600;
2021-10-15 21:40:01;8999999049492;REXONA WMN RO POWDER DRY 45 ML;1;15000;0;15000;13500;1500;
2021-10-15 21:40:01;8998866610278;DAIA VIOLET GUSSET 565G;3;10000;0;30000;26100;3900;
2021-10-15 21:40:01;8999999528942;CITRA HBL PEARLY WHITE UV 120ML;1;12000;0;12000;10082;1918;
2021-10-15 21:40:01;8999999528225;CITRA PEARLY WHITE BTL 220ML;1;17200;0;17200;15450;1750;
2021-10-15 21:40:01;8999999007782;FAIR&LOVELY MULTIVITAMIN CREAM 25 MG;1;16500;0;16500;14905;1595;
2021-10-15 21:40:01;kentang;kripik kentang;1;1000;0;1000;900;100;
2021-10-15 21:40:01;TEMBAK;TEMBAK SNIPPER;1;3500;0;3500;2500;1000;
2021-10-15 21:40:01;8998866202664;POTABEE WAGYU BEEF STEAK 68 GR;1;8000;0;8000;7200;800;
2021-10-15 21:40:01;8993274532105;BOLU;1;1000;0;1000;833;167;
2021-10-15 21:40:01;8998989300261;GUDANG GARAM SURYA 12 FILTER;1;20000;0;20000;18150;1850;
2021-10-15 21:43:59;8991001780232;twister choco 80g;1;8000;0;8000;6700;1300;
2021-10-15 21:43:59;8991909101016;URBAN MILD 16;2;17000;0;34000;31600;2400;
2021-10-15 21:43:59;8886013213208;FRENCH FREIS 2000;2;5000;0;10000;7500;2500;
2021-10-15 21:43:59;8993989311699;CLAS MILD 16 FILTER;2;24000;0;48000;43400;4600;
2021-10-15 21:43:59;089686727081;DORITOS 55G;1;7000;0;7000;5950;1050;
2021-10-15 21:43:59;8992775000663;GERY SNACK KEJU;1;2000;0;2000;1712;288;
2021-10-15 21:43:59;ROTI;ROTI 2000;1;2000;0;2000;1800;200;
2021-10-15 21:43:59;8995555121244;SOSIS KIMBO;1;1000;0;1000;650;350;
2021-10-15 21:45:05;8992696404441;BEAR BRAND 189ML;1;15000;0;15000;11000;4000;
2021-10-15 21:48:43;8991111101316;JB OIL 50ML;1;9500;0;9500;8700;800;
2021-10-15 21:48:43;gula gula;gula-gula karet;3;500;0;1500;1200;300;
2021-10-15 21:48:43;8996001302316;MALKIST ABON SCT;1;1000;0;1000;840;160;
2021-10-15 21:51:10;8998989110167;SURYA GUDANG GARAM 16 FILTER;1;26000;0;26000;23700;2300;
2021-10-15 22:09:18;8995555111221;sosis kimbo;1;1000;0;1000;0;1000;
2021-10-15 22:15:35;8995555111221;sosis kimbo;1;1000;0;1000;0;1000;
2021-10-15 22:17:24;8995555111221;sosis kimbo;1;1000;0;1000;0;1000;
2021-10-15 22:22:50;8992959508312;SWEETY SILVER PANTS XL1;6;3000;0;18000;13944;4056;
2021-10-15 22:30:55;8995555111221;sosis kimbo;1;1000;0;1000;0;1000;
2021-10-15 22:43:22;8998866200578;MIE SEDAAP KARI KENTAL;2;2700;0;5400;4662;738;
2021-10-15 22:43:22;TUSTEL;TUSUK TELINGA;1;1000;0;1000;833;167;
2021-10-15 22:43:22;8996001440001;TB JAHE SUSU;1;1500;0;1500;870;630;
2021-10-15 22:43:22;8998866108003;EMERON HJB CLEANFRESH 10ML;1;5000;0;5000;4185;815;
2021-10-15 22:43:22;8997018250010;Kopi jahe bungkus;1;1000;0;1000;800;200;
2021-10-15 22:43:22;8991102023115;Sikat Gigi Formula;1;11000;0;11000;10000;1000;
2021-10-15 22:43:44;8999909002821;MARLBORO BLACK 16;1;22000;0;22000;20850;1150;
2021-10-16 16:42:20;8992761139018;ADES 600ML;1;3500;0;3500;2166;1334;
2021-10-16 16:54:03;8993989311279;CLAS MILD 12;1;18000;0;18000;15800;2200;
2021-10-16 17:08:19;8992979190986;TOTAL PUTIH SOFTENER;1;15000;0;15000;13524;1476;
2021-10-16 17:08:19;8998866808729;ROYALE SOFT WHITE;1;5000;0;5000;4500;500;
2021-10-16 17:08:19;SF TAWAR KUPAS;SAFFANAH ROTI TAWAR KUPAS;1;10000;0;10000;9000;1000;
2021-10-16 17:08:19;8999999502409;ROYCO FDS BEEF 9G;4;500;0;2000;1500;500;
2021-10-16 17:08:19;8998866202626;Top Kopi Gula Aren 22gr;3;1000;0;3000;1659;1341;
2021-10-16 17:21:49;8995555111221;sosis kimbo;1;1000;0;1000;0;1000;
2021-10-16 17:21:49;8993989311699;CLAS MILD 16 FILTER;1;24000;0;24000;21700;2300;
2021-10-16 17:21:49;8997028590014;ARGUS 220ML;3;500;0;1500;906;594;
2021-10-16 17:24:32;8886022830243;BATEREI ABC;4;2500;0;10000;7712;2288;
2021-10-16 17:27:53;8998989500166;GUDANG GARAM MERAH BESAR 16KS;1;18000;0;18000;17000;1000;
2021-10-16 17:29:20;8998866200301;MIE SEDAAP GORENG;2;2700;0;5400;4726;674;
2021-10-16 17:30:04;8991002103535;GOOD DAY ORIGINAL;2;1500;0;3000;1780;1220;
2021-10-16 17:51:25;089686043204;INDOMIE MIE ACEH;2;2700;0;5400;4904;496;
2021-10-16 18:23:04;8993274532105;BOLU;2;1000;0;2000;1666;334;
2021-10-16 18:23:04;8992775001844;Chocolatos original taste;2;1000;0;2000;1658;342;
2021-10-16 18:23:04;8992761111540;FANTA STRAWBERY SLIM CAM 250ML;1;5000;0;5000;3750;1250;
2021-10-16 18:24:15;ICE CREAM 3.500;ICE CREAM 3.500;2;3500;0;7000;6000;1000;
2021-10-16 18:29:27;kentang;kripik kentang;2;1000;0;2000;1800;200;
2021-10-16 18:29:27;8997028590052;ARGUS BTL 600ML;1;3000;0;3000;1458;1542;
2021-10-16 18:29:27;8999999524722;SUNLIGHT LIME NEW PCH 435ML;1;10000;0;10000;9100;900;
2021-10-16 18:29:27;8998989300261;GUDANG GARAM SURYA 12 FILTER;1;20000;0;20000;18150;1850;
2021-10-16 18:29:27;8998866803694;SOKLIN SOFTERGENT PURPLE BAG 770 & PIRING;1;20000;0;20000;18055;1945;
2021-10-16 18:29:27;8993379260798;SABUN MEDICARE LEMON;4;2500;0;10000;8948;1052;
2021-10-16 18:29:27;8999999045920;LIFEBUOY TS TOTAL 10 110GR;1;15000;0;15000;14245;755;
2021-10-16 18:29:27;8999999706180;PEPSODENT WHITE 190GR;1;10000;0;10000;9350;650;
2021-10-16 18:29:54;8991001242013;Top;1;1000;0;1000;500;500;
2021-10-16 20:19:20;089686021219;INTER MIE GORENG;2;1000;0;2000;1770;230;
2021-10-16 20:19:20;8998989300261;GUDANG GARAM SURYA 12 FILTER;1;20000;0;20000;18150;1850;
2021-10-16 20:19:20;8998866202312;NOODLE SEDAAP TASTY BAKMI AYAM 129 GR;1;5000;0;5000;4167;833;
2021-10-16 20:19:20;8991002103764;GOOD DAY CAPPUCINO 10X25G;1;1500;0;1500;1395;105;
2021-10-16 20:19:20;ROYCO;ROYCO RASA AYAM;4;500;0;2000;1500;500;
2021-10-16 20:19:20;8996001410042;TB TORA MOKA;1;1500;0;1500;870;630;
2021-10-16 20:19:20;Vita Jelly;Vita Jelly;1;1000;0;1000;766;234;
2021-10-16 20:19:20;MLTO PINK;MOLTO ALL IN ONE;1;1000;0;1000;800;200;
2021-10-16 20:19:20;8934868015031;REXONA DEO LOTION ICE COOL;1;4500;0;4500;3900;600;
2021-10-16 20:19:20;8999999042639;RINSO ANTI NODA CLS LIQ 40ML;3;1000;0;3000;2415;585;
2021-10-16 20:19:20;8997028590014;ARGUS 220ML;1;500;0;500;302;198;
2021-10-16 20:21:55;gula;GULA;3;11500;0;34500;30000;4500;
2021-10-16 20:26:16;8998989110167;SURYA GUDANG GARAM 16 FILTER;1;26000;0;26000;23700;2300;
2021-10-16 20:27:11;8993989311699;CLAS MILD 16 FILTER;1;24000;0;24000;21700;2300;
2021-10-16 20:33:10;8994867000162;ROKOK PUNDIMAS KRETEK16;1;10000;0;10000;8600;1400;
2021-10-16 20:46:17;8996001305041;ROMA SANDWICH CKLT;1;7000;0;7000;5928;1072;
2021-10-16 20:46:17;Gula gula pulpen;gula gula pulpen;1;2000;0;2000;1750;250;
2021-10-16 21:05:59;089686061024;POP MIE MINI SOTO RL;1;3000;0;3000;2702;298;
2021-10-16 21:29:12;8991111111995;C&C TONER 100ML;1;14000;0;14000;12900;1100;
2021-10-16 21:29:12;6907992825076;JD WATERMELON APPLE;1;2000;0;2000;1700;300;
2021-10-16 21:29:12;8992959117583;SFX DS REG FLOW WING 20;1;5000;0;5000;4288;712;
2021-10-17 19:43:34;8998989300261;GUDANG GARAM SURYA 12 FILTER;1;20000;0;20000;18150;1850;
2021-10-17 19:53:21;8998009040023;TEH KOTAK;1;5000;0;5000;2708;2292;
2021-10-17 19:53:21;8993176110135;MINYAK TELON LANG 30ML;1;10000;0;10000;8167;1833;
2021-10-17 19:53:21;8886467100048;pringles bbq;1;9000;0;9000;6333;2667;
2021-10-17 19:53:21;gg;gula-gula koin;2;500;0;1000;800;200;
2021-10-17 19:53:21;MTR;MOTOR;1;5000;0;5000;3500;1500;
2021-10-17 19:53:21;8993379152017;SABUN CUCI SURYA 200G;1;3000;0;3000;2281;719;
2021-10-17 19:53:21;8991102714846;MILKIDO CKLT;2;3000;0;6000;4306;1694;
2021-10-17 19:53:21;8996001600146;TEH PUCUK HARUM 350ML;1;3000;0;3000;2314;686;
2021-10-17 19:55:34;8996001600146;TEH PUCUK HARUM 350ML;1;3000;0;3000;2314;686;
2021-10-17 19:55:34;8886013213208;FRENCH FREIS 2000;1;5000;0;5000;3750;1250;
2021-10-17 19:55:34;ROTI;ROTI 2000;4;2000;0;8000;7200;800;
2021-10-17 19:57:01;8992696521797;MILO 22G;1;2500;0;2500;1572;928;
2021-10-17 19:57:01;8999999045623;MOLTO AIO BLUE SCH;5;1000;0;5000;4000;1000;
2021-10-17 19:59:00;8998866608718;DAIA SOFTENER PINK;1;5000;0;5000;4450;550;
2021-10-17 19:59:00;089686646047;SUNMARIE;2;7000;0;14000;13252;748;
2021-10-17 20:00:04;8998866500463;BABY HAPPY PANTS M PCS;5;2000;0;10000;7150;2850;
2021-10-17 20:01:21;089686646047;SUNMARIE;2;7000;0;14000;13252;748;
2021-10-17 20:04:49;8998866200578;MIE SEDAAP KARI KENTAL;1;2700;0;2700;2331;369;
2021-10-17 20:04:49;8992775002155;CHOCOLATOS DRINK;1;4000;0;4000;3520;480;
2021-10-17 20:04:49;8991102026383;AIR CRYSTALINE 1.5 L;1;5000;0;5000;3471;1529;
2021-10-17 20:04:49;8996001312278;MALKIST KEJU MANIS;1;6500;0;6500;5400;1100;
2021-10-17 20:04:49;9556006014585;JB SHAMPOO SHOFT&SMOOTH 100ML;1;10500;0;10500;9450;1050;
2021-10-17 20:06:30;MOLTO PINK;MOLTO ALL IN ONE 11 ML;2;500;0;1000;800;200;
2021-10-17 20:06:30;8997878002088;Kiko;1;1000;0;1000;450;550;
2021-10-17 20:07:30;ARG;ARGUS DOS 220ML;1;14500;0;14500;13300;1200;
2021-10-17 20:07:30;089686386127;BUMBU RACIK NASI GORENG SOSIS;2;2000;0;4000;3240;760;
2021-10-17 20:09:32;8997878002088;Kiko;2;1000;0;2000;900;1100;
2021-10-17 20:09:32;MBL;MOBIL;1;5000;0;5000;3500;1500;
2021-10-17 20:09:32;8999909002821;MARLBORO BLACK 16;1;22000;0;22000;20850;1150;
2021-10-17 20:09:32;8997028590014;ARGUS 220ML;4;500;0;2000;1208;792;
2021-10-17 20:11:58;KIKO;KIKO;2;1000;0;2000;1000;1000;
2021-10-17 20:11:58;kentang;kripik kentang;1;1000;0;1000;900;100;
2021-10-17 20:11:58;8999909001909;MAGNUM REVAMP BLACK 12;1;18000;0;18000;16300;1700;
2021-10-17 20:11:58;TG;TEH GELAS;2;1000;0;2000;1458;542;
2021-10-17 20:11:58;089686021219;INTER MIE GORENG;5;1000;0;5000;4425;575;
2021-10-17 20:14:07;ROTI;ROTI 2000;1;2000;0;2000;1800;200;
2021-10-17 20:14:07;8998866808729;ROYALE SOFT WHITE;1;5000;0;5000;4500;500;
2021-10-17 20:14:07;089686021141;INTER MIE SOTO;2;1000;0;2000;1708;292;
2021-10-17 20:14:07;4902430563895;PANTENE HALUS DAN LEMBUT 10ML;10;1000;0;10000;7860;2140;
2021-10-17 20:17:31;089686021219;INTER MIE GORENG;5;1000;0;5000;4425;575;
2021-10-17 20:17:31;ICE CREAM 6;ICE CREAM 6.000;1;6000;0;6000;5200;800;
2021-10-17 20:17:31;ICE CREAM 3.500;ICE CREAM 3.500;1;3500;0;3500;3000;500;
2021-10-17 20:17:31;jagung marning;jagung marning;1;5000;0;5000;4500;500;
2021-10-17 20:17:31;YP;YUPI;8;250;0;2000;1664;336;
2021-10-17 20:17:31;8992775001042;PILUS GARUDA MI GORENG;1;5000;0;5000;4810;190;
2021-10-17 20:17:31;8998866202343;MIE SEDAAP KOREAN SPICY;2;2700;0;5400;4826;574;
2021-10-17 20:20:24;8998989500166;GUDANG GARAM MERAH BESAR 16KS;1;18000;0;18000;17000;1000;
2021-10-17 20:20:24;8998989300261;GUDANG GARAM SURYA 12 FILTER;1;20000;0;20000;18150;1850;
2021-10-17 20:20:24;TUSTEL;TUSUK TELINGA;1;1000;0;1000;833;167;
2021-10-17 20:20:24;KIKO;KIKO;3;1000;0;3000;1500;1500;
2021-10-17 20:20:24;8992628022156;MINYAK GORENG BIMOLI POUCH 1 LT;1;17500;0;17500;16400;1100;
2021-10-17 20:20:24;8998866200325;MIE SEDAAP SOTO;2;2700;0;5400;4564;836;
2021-10-17 20:23:55;8998866200646;KOPI TOP MURNI;1;11000;0;11000;9600;1400;
2021-10-17 20:23:55;ARG;ARGUS DOS 220ML;2;14500;0;29000;26600;2400;
2021-10-17 20:23:55;8999999560713;MOLTO JAPANESE PEACH 720ML;1;19000;0;19000;17000;2000;
2021-10-17 20:23:55;8992957214307;SAFARI MECES;1;5500;0;5500;4500;1000;
2021-10-17 20:23:55;8992959508312;SWEETY SILVER PANTS XL1;1;3000;0;3000;2324;676;
2021-10-17 20:23:55;8991002105409;KOPI KAPAL API;1;20000;0;20000;18888;1112;
2021-10-17 20:43:17;8999909002821;MARLBORO BLACK 16;1;22000;0;22000;20850;1150;
2021-10-17 22:09:16;gula;GULA;4;11500;0;46000;40000;6000;
2021-10-17 22:09:16;8999999524838;SUNLIGHT MINT POUCH 755ML;1;18000;0;18000;15950;2050;
2021-10-17 22:09:16;8999999524807;SUNLIGHT HABBATUSSAUDA POUCH 755ML;1;18000;0;18000;15950;2050;
2021-10-17 22:22:40;8999999027056;LIFEBUOY ANTI KETOMBE 9ML;1;5000;0;5000;4500;500;
2021-10-17 22:22:40;8999999059781;SUNLIGHT LIME NEW POUCH 210ML;1;5000;0;5000;4520;480;
2021-10-17 22:22:40;8993379200886;SABUN HARMONY ORANGE 70G;1;2000;0;2000;1652;348;
2021-10-17 22:22:40;8992775000663;GERY SNACK KEJU;1;2000;0;2000;1712;288;
2021-10-17 22:22:40;8991001780225;twister black vann 80g;1;8000;0;8000;6700;1300;
2021-10-17 22:30:03;8998989110167;SURYA GUDANG GARAM 16 FILTER;1;26000;0;26000;23700;2300;
2021-10-18 20:06:07;8998898853100;SUSU JAHE;2;1500;0;3000;2360;640;
2021-10-18 20:06:07;8993989311279;CLAS MILD 12;1;18000;0;18000;15800;2200;
2021-10-18 20:06:07;KIKO;KIKO;3;1000;0;3000;1500;1500;
2021-10-18 20:06:07;YP;YUPI;4;250;0;1000;832;168;
2021-10-18 20:06:07;8992946521416;SABUN SHINZUI;1;5000;0;5000;4000;1000;
2021-10-18 20:06:07;8994834006128;TICTIC PEDAS;1;2000;0;2000;1700;300;
2021-10-18 20:06:07;8997028590045;ARGUS BTL 330ML;1;2000;0;2000;1291;709;
2021-10-18 20:06:07;8997878004327;gula-gula milkita;4;250;0;1000;800;200;
2021-10-18 20:06:07;8998989300261;GUDANG GARAM SURYA 12 FILTER;1;20000;0;20000;18150;1850;
2021-10-18 20:11:03;Telur 3 Biji;Telur 3 Biji;1;5000;0;5000;3600;1400;
2021-10-18 20:11:03;8999999520885;WIPOL 500 ML;1;10000;0;10000;8600;1400;
2021-10-18 20:11:03;OJELLY;O'JELLY;2;500;0;1000;770;230;
2021-10-18 20:11:03;8998866501033;MINYAK GORENG SEDAAP POUCH 2L;1;32000;0;32000;29683;2317;
2021-10-18 20:11:03;MK;MASKER;1;5000;0;5000;4000;1000;
2021-10-18 20:11:03;ROYCO;ROYCO RASA AYAM;2;500;0;1000;750;250;
2021-10-18 20:11:03;8999999560720;MOLTO TRIKA JAPANESE PEACH 720ML;1;5000;0;5000;4000;1000;
2021-10-18 20:11:03;7622201430184;OREO ORIGINAL 38G;1;2000;0;2000;1641;359;
2021-10-18 20:11:03;Gula gula tusuk;gula gula tusuk;1;500;0;500;400;100;
2021-10-18 20:11:03;PRG;PARAGO;1;500;0;500;400;100;
2021-10-18 20:17:46;8991001242013;Top;3;1000;0;3000;1500;1500;
2021-10-18 20:17:46;ARG;ARGUS DOS 220ML;1;14500;0;14500;13300;1200;
2021-10-18 20:17:46;Gula gula tusuk;gula gula tusuk;1;500;0;500;400;100;
2021-10-18 20:17:46;AMPLOP;AMPLOP;4;250;0;1000;700;300;
2021-10-18 20:17:46;ROTI;ROTI 2000;1;2000;0;2000;1800;200;
2021-10-18 20:17:46;8992388101085;NU GREEN TEA ORIGINAL 330ML;1;3500;0;3500;2768;732;
2021-10-18 20:17:46;ICE CREAM;ICE CREAM 2000;1;2000;0;2000;1700;300;
2021-10-18 20:17:46;8991002114067;PIKOPI;1;1000;0;1000;545;455;
2021-10-18 20:17:46;8998989300261;GUDANG GARAM SURYA 12 FILTER;1;20000;0;20000;18150;1850;
2021-10-18 20:17:46;8995555111221;sosis kimbo;1;1000;0;1000;850;150;
2021-10-18 20:17:46;8998866202671;NOODLE SEDAAP MIE KOREAN SPICY SOUP CUP;1;5000;0;5000;4002;998;
2021-10-18 20:19:49;8996001410042;TB TORA MOKA;1;1500;0;1500;870;630;
2021-10-18 20:19:49;8991102228053;TEH GELAS BOTOL;1;3000;0;3000;1695;1305;
2021-10-18 20:24:13;8991102987639;WFR TANGO LONG VNL 130G;1;5000;0;5000;4350;650;
2021-10-18 20:24:13;8998866202244;EKOMIE BUMBU KALDU AYAM;2;1000;0;2000;1596;404;
2021-10-18 20:24:13;TG;TEH GELAS;2;1000;0;2000;1458;542;
2021-10-18 20:24:13;8998898853100;SUSU JAHE;1;1500;0;1500;1180;320;
2021-10-18 20:24:13;8998866200561;EKOMIE SUPER 600GR;1;10000;0;10000;8615;1385;
2021-10-18 20:24:13;8991102100823;Formula Acttion Protector 190 gr;1;10000;0;10000;9000;1000;
2021-10-18 20:25:14;8991102714495;TANGO DRINK COKLAT;1;5000;0;5000;3818;1182;
2021-10-18 20:28:03;8998866202626;Top Kopi Gula Aren 22gr;3;1000;0;3000;1659;1341;
2021-10-18 20:28:03;8993274532105;BOLU;1;1000;0;1000;833;167;
2021-10-18 20:28:03;089686727081;DORITOS 55G;1;7000;0;7000;5950;1050;
2021-10-18 20:28:03;8999909002821;MARLBORO BLACK 16;2;22000;0;44000;41700;2300;
2021-10-18 20:28:03;8994867007161;ROKOK PENA GOLD 20;2;18000;0;36000;33600;2400;
2021-10-18 20:37:39;0105312686040047;yakult;5;2000;0;10000;7500;2500;
2021-10-18 20:37:39;8997028590052;ARGUS BTL 600ML;1;3000;0;3000;1458;1542;
2021-10-18 20:37:39;4902430553629;H&S LEMON 70ML;1;11000;0;11000;9501;1499;
2021-10-18 20:37:39;8998989500166;GUDANG GARAM MERAH BESAR 16KS;1;18000;0;18000;17000;1000;
2021-10-18 20:37:39;123124;KOREK BIASA;1;2000;0;2000;1300;700;
2021-10-18 20:37:39;kentang;kripik kentang;3;1000;0;3000;2700;300;
2021-10-18 20:37:39;8994834003752;TICTIC;1;2000;0;2000;1700;300;
2021-10-18 20:37:39;8998866201377;KRISBEE FRIES KENTANG GORENG 68 GR;1;5500;0;5500;4620;880;
2021-10-18 20:37:39;8997009510055;YOU C1000;1;15000;0;15000;13000;2000;
2021-10-18 20:37:39;8997028590014;ARGUS 220ML;2;500;0;1000;604;396;
2021-10-18 20:37:39;8995333032113;TERIGU GATOT KACA 1 KG;5;9000;0;45000;42860;2140;
2021-10-18 20:37:39;gula;GULA;1;11500;0;11500;10000;1500;
2021-10-18 20:37:39;089686010824;INDOMIE GORENG SPESIAL;1;2700;0;2700;2452;248;
2021-10-18 20:37:39;8992696404441;BEAR BRAND 189ML;1;15000;0;15000;11000;4000;
2021-10-18 20:38:35;8996001402023;TB TORA SUSU;2;1500;0;3000;1866;1134;
2021-10-18 20:44:21;8994867000162;ROKOK PUNDIMAS KRETEK16;1;10000;0;10000;8600;1400;
2021-10-18 20:50:36;8998866203227;MIE SEDAAP AYAM BAKAR LIMAU;5;2700;0;13500;10815;2685;
2021-10-18 20:50:36;ARG;ARGUS DOS 220ML;3;14500;0;43500;39900;3600;
2021-10-18 20:51:45;8992959117613;SFX DAUN SIRIH 1 WP;1;500;0;500;413;87;
2021-10-18 21:00:46;76239878;MARLBORO GOLD;1;31000;0;31000;29650;1350;
2021-10-18 21:05:16;8999909010567;234 DJI SAM SOE 16;1;22500;0;22500;21500;1000;
2021-10-18 21:27:21;ICE CREAM 5.500;ICE CREAM 5.500;1;5500;0;5500;4700;800;
2021-10-18 21:27:21;TELUR;TELUR;1;2000;0;2000;1200;800;
2021-10-18 21:27:51;8998989110167;SURYA GUDANG GARAM 16 FILTER;1;26000;0;26000;23700;2300;
2021-10-18 21:41:57;8992628022156;MINYAK GORENG BIMOLI POUCH 1 LT;1;17500;0;17500;16400;1100;
2021-10-19 10:40:20;OJELLY;O'JELLY;2;500;0;1000;770;230;
2021-10-19 10:49:02;AG;ARGUS;1;14500;0;14500;13500;1000;
2021-10-19 11:21:49;8997028590014;ARGUS 220ML;4;500;0;2000;1208;792;
2021-10-19 11:21:49;kentang;kripik kentang;1;1000;0;1000;900;100;
2021-10-19 11:45:34;8998989300261;GUDANG GARAM SURYA 12 FILTER;1;20000;0;20000;18150;1850;
2021-10-19 11:45:34;8999909096004;SAMPOERNA 16 FILTER;1;25000;0;25000;23100;1900;
2021-10-19 11:48:16;8992388101085;NU GREEN TEA ORIGINAL 330ML;1;3500;0;3500;2768;732;
2021-10-19 11:48:43;8997878004327;gula-gula milkita;4;250;0;1000;800;200;
2021-10-19 20:04:41;8998989110167;SURYA GUDANG GARAM 16 FILTER;1;26000;0;26000;23700;2300;
2021-10-19 20:09:08;gg;gula-gula koin;4;500;0;2000;1600;400;
2021-10-19 21:03:40;8993093115008;tepun beras;1;8000;0;8000;7000;1000;
2021-10-19 21:10:38;8886013257400;TWISTKO;1;1000;0;1000;900;100;
2021-10-19 21:10:38;8998866202978;Guribee Rumput Laut 68 gr;1;6000;0;6000;5100;900;
2021-10-19 21:10:38;8998866106474;POSH BLAZE PINK 150ML;1;19500;0;19500;17500;2000;
2021-10-19 21:10:38;8992959508848;SWEETY SILVER PANTS L18;1;41500;0;41500;37728;3772;
2021-10-19 21:11:16;8991188943536;SASA SANTAN KELAPA 65ML;2;3000;0;6000;4874;1126;
2021-10-19 21:14:07;8998866200561;EKOMIE SUPER 600GR;1;10000;0;10000;8615;1385;
2021-10-19 21:14:07;8992775913000;CHOCOLATOS CKLT 28G;1;2000;0;2000;1557;443;
2021-10-19 21:17:30;8993001003908;INDOMILK KENTAL MANIS 545G;1;15000;0;15000;13333;1667;
2021-10-19 21:17:30;8992992102423;WIPPY CREAM 200G;1;28000;0;28000;25990;2010;
2021-10-19 21:17:30;8998866202626;Top Kopi Gula Aren 22gr;3;1000;0;3000;1659;1341;
2021-10-19 21:17:52;8992775211410;PILUS GARUDA PEDAS;1;5000;0;5000;4886;114;
2021-10-19 21:19:18;8998866203227;MIE SEDAAP AYAM BAKAR LIMAU;1;2700;0;2700;2163;537;
2021-10-19 21:19:18;Vita Jelly;Vita Jelly;5;1000;0;5000;3830;1170;
2021-10-19 21:21:44;8997028590014;ARGUS 220ML;4;500;0;2000;1208;792;
2021-10-19 21:21:44;8991002114067;PIKOPI;1;1000;0;1000;545;455;
2021-10-19 21:25:10;089686611601;QTELA;1;2000;0;2000;1800;200;
2021-10-19 21:32:21;8998989300261;GUDANG GARAM SURYA 12 FILTER;1;20000;0;20000;18150;1850;
2021-10-19 21:43:00;089686611601;QTELA;1;2000;0;2000;1800;200;
2021-10-19 21:44:39;8998866202671;NOODLE SEDAAP MIE KOREAN SPICY SOUP CUP;2;5000;0;10000;8004;1996;
2021-10-19 21:46:50;8994834006128;TICTIC PEDAS;1;2000;0;2000;1700;300;
2021-10-19 21:46:50;089686611601;QTELA;2;2000;0;4000;3600;400;
2021-10-19 21:46:50;ICE CREAM 3;ICE CREAM 3000;4;3000;0;12000;10400;1600;
2021-10-19 21:49:11;8997028590052;ARGUS BTL 600ML;7;3000;0;21000;10206;10794;
2021-10-19 21:49:11;8997028590045;ARGUS BTL 330ML;30;2000;0;60000;38730;21270;
2021-10-19 21:49:56;8998866201711;KRISBEE KRUNCHY JAGUNG BAKAR MENTEGA 75 GR;1;5500;0;5500;4400;1100;
2021-10-19 21:51:17;8998866500487;BABY HAPPY PANTS M 20P;1;37000;0;37000;33520;3480;
2021-10-19 22:00:07;8992761145026;SPRITE PET 250ML;1;3500;0;3500;2417;1083;
2021-10-19 22:10:03;ARG;ARGUS DOS 220ML;1;14500;0;14500;13300;1200;
2021-10-20 11:10:04;8992775211410;PILUS GARUDA PEDAS;1;5000;0;5000;4886;114;
2021-10-20 11:10:05;8998866203227;MIE SEDAAP AYAM BAKAR LIMAU;2;2700;0;5400;4326;1074;
2021-10-20 11:10:05;8999999720940;CLEAR STYLING CREAM 100G;1;12000;0;12000;10615;1385;
2021-10-20 11:10:05;8934868015024;REXONA DEO LOTION FREE SPIRIT 9G;1;2500;0;2500;2000;500;
2021-10-20 11:12:39;089686611601;QTELA;1;2000;0;2000;1800;200;
2021-10-20 11:12:39;8999999055769;FAIR&LOVELY MVIT FC FOAM 50 G;1;12500;0;12500;11715;785;
2021-10-20 11:12:39;8999999559861;AXE DARK POCKET FRAG 17ML;1;10000;0;10000;8000;2000;
2021-10-20 11:12:39;8999999195656;SARIWANGI 50X1.85;1;10000;0;10000;9405;595;
2021-10-22 13:23:07;8999999518998;RINSO MOLTO PERFUME ESSENSE 770GR;1;21300;0;21300;19338;1962;
2021-10-22 13:23:07;8999999514518;RINSO MOLTO PERF ESSENCE 215ML;1;5000;0;5000;4250;750;
2021-10-22 13:23:07;8999999525675;MOLTO HYGIENE 720ML;1;28000;0;28000;25150;2850;
2021-10-22 13:23:07;8996001355008;BENG-BENG SP20G;1;29000;0;29000;20000;9000;
2021-10-22 13:23:07;8998009010569;ULTRA CHO 200;2;5000;0;10000;7916;2084;
2021-10-22 13:23:07;gula;GULA;3;11500;0;34500;30000;4500;
2021-10-22 13:23:07;8993058304201;BEJO JAHE MERAH;5;3000;0;15000;9465;5535;
2021-10-22 16:37:46;KOPIKO;KOPIKO;2;250;0;500;350;150;
2021-10-22 16:37:46;MILKITA;MILKITA;2;250;0;500;400;100;
2021-10-22 16:37:46;089686611601;QTELA;1;2000;0;2000;1800;200;
2021-10-22 16:37:46;ARG;ARGUS DOS 220ML;1;14500;0;14500;13300;1200;
2021-10-22 16:37:46;8994834003752;TICTIC;1;2000;0;2000;1700;300;
2021-10-22 16:37:46;8991102987639;WFR TANGO LONG VNL 130G;1;5000;0;5000;4350;650;
2021-10-22 16:37:46;8998866200561;EKOMIE SUPER 600GR;1;10000;0;10000;8615;1385;
2021-10-22 16:37:46;8998866200301;MIE SEDAAP GORENG;2;3000;0;6000;4828;1172;
2021-10-22 16:37:46;8998989110167;SURYA GUDANG GARAM 16 FILTER;1;26000;0;26000;23700;2300;
2021-10-22 16:37:46;8992761002022;SPRITE PET 390ML;1;5500;0;5500;4333;1167;
2021-10-22 16:37:46;8992761145019;COCA COLA PET 250ML;1;3500;0;3500;2417;1083;
2021-10-22 16:37:46;KIKO;KIKO;1;1000;0;1000;500;500;
2021-10-22 16:37:46;8991102714495;TANGO DRINK COKLAT;2;5000;0;10000;7636;2364;
2021-10-22 16:37:46;8993989311699;CLAS MILD 16 FILTER;1;24000;0;24000;21700;2300;
2021-10-22 16:37:46;8992628022156;MINYAK GORENG BIMOLI POUCH 1 LT;1;17500;0;17500;16400;1100;
2021-10-22 16:37:46;8992775913000;CHOCOLATOS CKLT 28G;4;2000;0;8000;6228;1772;
2021-10-23 20:33:52;8998866604963;POWDET DAIA LEMON 290GR;2;5000;0;10000;8900;1100;
2021-10-23 20:35:54;8995333032113;TERIGU GATOT KACA 1 KG;3;9000;0;27000;25716;1284;
2021-10-23 20:35:54;8992628022156;MINYAK GORENG BIMOLI POUCH 1 LT;1;17500;0;17500;16400;1100;
2021-10-23 20:37:32;gula;GULA;1;11500;0;11500;10000;1500;
2021-10-23 20:57:13;8992628022156;MINYAK GORENG BIMOLI POUCH 1 LT;1;17500;0;17500;16400;1100;
2021-10-23 20:57:13;8994834003752;TICTIC;2;2000;0;4000;3400;600;
2021-10-23 20:57:13;8991188943536;SASA SANTAN KELAPA 65ML;2;3000;0;6000;4874;1126;
2021-10-23 20:57:13;8998989300261;GUDANG GARAM SURYA 12 FILTER;2;20000;0;40000;36300;3700;
2021-10-23 20:57:13;8991001242013;Top;2;1000;0;2000;1000;1000;
2021-10-23 20:57:13;YP;YUPI;4;250;0;1000;832;168;
2021-10-23 20:57:13;8997028590014;ARGUS 220ML;2;500;0;1000;604;396;
2021-10-23 20:57:13;MK;MASKER;1;5000;0;5000;4000;1000;
2021-10-23 20:57:13;8999801700054;SUSU FOYU 1 KG;1;22000;0;22000;19791;2209;
2021-10-23 20:57:13;089686611601;QTELA;5;2000;0;10000;9000;1000;
2021-10-23 20:57:13;0105312686040047;yakult;1;2000;0;2000;1500;500;
2021-10-23 20:57:13;8999999195649;SARIWANGI 25X1.86G;1;6000;0;6000;5202;798;
2021-10-23 20:57:13;8998989110167;SURYA GUDANG GARAM 16 FILTER;1;26000;0;26000;23700;2300;
2021-10-23 20:57:13;8991102987639;WFR TANGO LONG VNL 130G;1;5000;0;5000;4350;650;
2021-10-24 14:05:55;8992959953303;SWEETY BRONZE S64;1;80000;0;80000;76364;3636;
2021-10-24 14:06:49;8992959953303;SWEETY BRONZE S64;1;80000;0;80000;76364;3636;
2021-10-25 16:18:59;8997021290348;Teh Gunung Tengah;1;6000;0;6000;5000;1000;
2021-10-25 16:18:59;8991188943062;SASA 250G;1;10000;0;10000;8500;1500;
2021-10-25 16:18:59;gula;GULA;3;11500;0;34500;30000;4500;
2021-10-25 18:29:52;ROTI;ROTI 2000;1;2000;0;2000;1800;200;
2021-10-25 18:29:52;8992761139018;ADES 600ML;1;3500;0;3500;2166;1334;
2021-10-25 18:29:52;ARG;ARGUS DOS 220ML;1;14500;0;14500;13300;1200;
2021-10-25 18:29:52;8998866501033;MINYAK GORENG SEDAAP POUCH 2L;2;32000;0;64000;59366;4634;
2021-10-25 20:56:53;8999909003439;MARLBORO CRAFTED 12;1;8000;0;8000;7250;750;
2021-10-25 20:56:53;123124;KOREK BIASA;1;2000;0;2000;1300;700;
2021-10-25 20:56:53;11222;LEM KOREA;1;10000;0;10000;8000;2000;
2021-10-25 20:56:53;8993989311699;CLAS MILD 16 FILTER;3;24000;0;72000;65100;6900;
2021-10-25 20:56:53;8992696523067;MILO ACTVGO UHT 180ML;1;4500;0;4500;3515;985;
2021-10-25 20:56:53;8997028590045;ARGUS BTL 330ML;1;2000;0;2000;1291;709;
2021-10-25 20:56:53;KIKO;KIKO;1;1000;0;1000;500;500;
2021-10-26 20:32:48;8992696404441;BEAR BRAND 189ML;1;15000;0;15000;11000;4000;
2021-10-26 20:36:31;Vita Jelly;Vita Jelly;1;1000;0;1000;766;234;
2021-10-26 20:36:31;8995555111221;sosis kimbo;1;1000;0;1000;850;150;
2021-10-26 20:57:04;8998989110167;SURYA GUDANG GARAM 16 FILTER;1;26000;0;26000;23700;2300;
2021-10-26 21:29:12;8992979190986;TOTAL PUTIH SOFTENER;2;15000;0;30000;27048;2952;
2021-10-26 21:29:12;8992761111540;FANTA STRAWBERY SLIM CAM 250ML;1;5000;0;5000;3750;1250;
2021-10-26 21:29:12;8999999031602;SARI MURNI 20X1.6G;1;6000;0;6000;5400;600;
2021-10-26 21:29:12;8999999707859;CLOSEUP GREEN 160G;1;15000;0;15000;13600;1400;
2021-10-26 21:29:12;089686011036;INDOMIE GORENG PEDAS;2;2700;0;5400;4904;496;
2021-10-26 21:29:12;8998866600101;CREAM EKONOMI LEMON 455G;1;5500;0;5500;4750;750;
2021-10-26 21:29:12;8991004011906;KOPI BORONG;1;10000;0;10000;8333;1667;
2021-10-26 21:29:12;8992736524306;Sasa Bumbu Nasi Goreng Barbeque;2;2000;0;4000;2362;1638;
2021-10-26 21:29:12;8999999500399;LUX TS CAMELLIA WHITE;3;3500;0;10500;8400;2100;
2021-10-26 21:29:12;8996001301142;ROMA KELAPA;1;8000;0;8000;7000;1000;
2021-10-26 21:29:12;8998866600538;SOKLIN FLOORCLENER PINK 400ML;1;6000;0;6000;5025;975;
2021-10-26 21:29:12;8999999400958;MOLTO PEWANGI BLUE 820ML;1;12500;0;12500;11275;1225;
2021-10-26 21:29:12;8993989311699;CLAS MILD 16 FILTER;1;24000;0;24000;21700;2300;
2021-10-26 22:02:26;8998866200325;MIE SEDAAP SOTO;2;2700;0;5400;4564;836;
2021-10-26 22:02:26;8998866200301;MIE SEDAAP GORENG;1;3000;0;3000;2414;586;
2021-10-26 22:17:55;9556001047175;NESCAFE ORI 240ML;2;8500;0;17000;15668;1332;
2021-10-27 15:17:33;Vita Jelly;Vita Jelly;1;1000;0;1000;766;234;
2021-10-27 17:07:28;8992388101085;NU GREEN TEA ORIGINAL 330ML;1;3500;0;3500;2768;732;
2021-10-27 17:10:49;8996001312278;MALKIST KEJU MANIS;1;6500;0;6500;5400;1100;
2021-10-27 17:12:32;8997028590052;ARGUS BTL 600ML;1;3000;0;3000;1458;1542;
2021-10-27 17:26:30;8999999400958;MOLTO PEWANGI BLUE 820ML;1;12500;0;12500;11275;1225;
2021-10-27 17:26:30;8998866608725;DAIA SOFTENER BAG 850G;1;18000;0;18000;15627;2373;
2021-10-27 17:26:30;8999999195656;SARIWANGI 50X1.85;1;10000;0;10000;9405;595;
2021-10-27 17:49:38;8998989110167;SURYA GUDANG GARAM 16 FILTER;1;26000;0;26000;23700;2300;
2021-10-27 17:52:05;8998866610087;JAVANA ORIGINAL 350ML;1;3000;0;3000;2150;850;
2021-10-27 18:23:19;BALON;BALON CABUT;1;1000;0;1000;900;100;
2021-10-27 18:34:23;ARG;ARGUS DOS 220ML;3;14500;0;43500;39900;3600;
2021-10-27 18:42:47;8997028590014;ARGUS 220ML;1;500;0;500;302;198;
2021-10-27 18:42:47;OJELLY;O'JELLY;1;500;0;500;385;115;
2021-10-27 18:46:53;8991909101016;URBAN MILD 16;1;17000;0;17000;15800;1200;
2021-10-27 18:48:11;Vita Jelly;Vita Jelly;1;1000;0;1000;766;234;
2021-10-27 18:59:59;Vita Jelly;Vita Jelly;1;1000;0;1000;766;234;
2021-10-27 19:02:10;MK;MASKER;1;5000;0;5000;4000;1000;
2021-10-27 19:13:43;8998866610278;DAIA VIOLET GUSSET 565G;2;10000;0;20000;17400;2600;
2021-10-27 19:13:43;8998866500517;BABY HAPPY PANTS L PCS;1;2000;0;2000;1430;570;
2021-10-27 19:13:43;8992628022156;MINYAK GORENG BIMOLI POUCH 1 LT;1;17500;0;17500;16400;1100;
2021-10-27 19:13:43;8992717900310;KARA SUN;2;2500;0;5000;4000;1000;
2021-10-27 19:13:43;TBR;TEPUNG BERAS ROSE BRAND;1;8000;0;8000;6150;1850;
2021-10-27 19:13:43;8994834003752;TICTIC;2;2000;0;4000;3400;600;
2021-10-27 19:13:43;OJELLY;O'JELLY;1;500;0;500;385;115;
2021-10-27 19:13:43;8997028590014;ARGUS 220ML;3;500;0;1500;906;594;
2021-10-27 19:13:43;8992628020152;MINYAK GOREG BIMOLI POUCH 2L;1;34000;0;34000;29800;4200;
2021-10-27 19:13:43;Masako;Masako Gantung;1;6000;0;6000;5000;1000;
2021-10-27 19:25:58;8999999048174;SUNSILK  BLK SHINE 70+21ML;1;9600;0;9600;8525;1075;
2021-10-27 19:25:58;8998898853100;SUSU JAHE;2;1500;0;3000;2360;640;
2021-10-27 19:25:58;8998989110129;SURYA KECIL MERAH 12KS;1;20000;0;20000;18450;1550;
2021-10-27 19:25:58;6907992825076;JD WATERMELON APPLE;1;2000;0;2000;1700;300;
2021-10-27 19:25:58;8999801700054;SUSU FOYU 1 KG;1;22000;0;22000;19791;2209;
2021-10-27 19:25:58;089686611601;QTELA;1;2000;0;2000;1800;200;
2021-10-27 19:25:58;8998989110501;gudang garam surya;2;2000;0;4000;2760;1240;
2021-10-27 19:25:58;Vita Jelly;Vita Jelly;1;1000;0;1000;766;234;
2021-10-27 19:25:58;089686021127;INTER MIE KALDU;1;1000;0;1000;813;187;
2021-10-27 19:25:58;ROYCO;ROYCO RASA AYAM;2;500;0;1000;750;250;
2021-10-27 19:25:58;8998866202954;Guribee BBQ Balado 68 gr;1;6000;0;6000;5100;900;
2021-10-27 19:33:36;8998866202053;POTABEE AYAM BAKAR PEDAS 68GR;1;8000;0;8000;7200;800;
2021-10-27 19:33:36;8992775001691;GARUDA ROSTA WAGYU BEEF 100G;1;8000;0;8000;7322;678;
2021-10-27 19:33:36;089686727074;DORITOS 160G;2;12000;0;24000;21400;2600;
2021-10-27 19:33:36;8991102303309;WFR TANGO SBJ 176G;1;10000;0;10000;8694;1306;
2021-10-27 19:33:36;8992761139018;ADES 600ML;1;3500;0;3500;2166;1334;
2021-10-27 19:33:36;8998866201865;KRISBEE PILLOW CHOCOLAVA 120 GR;3;8000;0;24000;21750;2250;
2021-10-27 19:33:36;8998866202954;Guribee BBQ Balado 68 gr;1;6000;0;6000;5100;900;
2021-10-27 19:33:36;8992388133345;NU MILK TEA TEH TARIK 330ML;1;6000;0;6000;5125;875;
2021-10-27 19:33:36;8991102300544;WFR TANGO VNL 176G;1;10000;0;10000;8694;1306;
2021-10-27 19:33:36;8991002114067;PIKOPI;3;1000;0;3000;1635;1365;
2021-10-27 19:43:40;8998866201377;KRISBEE FRIES KENTANG GORENG 68 GR;1;5500;0;5500;4620;880;
2021-10-27 19:43:40;ARG;ARGUS DOS 220ML;3;14500;0;43500;39900;3600;
2021-10-27 19:43:40;BALON;BALON CABUT;1;1000;0;1000;900;100;
2021-10-27 19:43:40;8996001301579;MALKIST CKLT KELAPA PACK;1;6500;0;6500;5400;1100;
2021-10-27 19:43:40;8991102320184;TANGO CHOCO JAVAMOCCA;1;5000;0;5000;4350;650;
2021-10-27 19:43:40;8991001780232;twister choco 80g;1;8000;0;8000;6700;1300;
2021-10-27 19:43:40;8991001780225;twister black vann 80g;1;8000;0;8000;6700;1300;
2021-10-27 19:43:40;8992775913000;CHOCOLATOS CKLT 28G;3;2000;0;6000;4671;1329;
2021-10-27 19:43:40;OJELLY;O'JELLY;2;500;0;1000;770;230;
2021-10-27 19:43:40;Vita Jelly;Vita Jelly;1;1000;0;1000;766;234;
2021-10-27 19:54:02;Vita Jelly;Vita Jelly;1;1000;0;1000;766;234;
2021-10-27 19:54:02;8998989110167;SURYA GUDANG GARAM 16 FILTER;1;26000;0;26000;23700;2300;
2021-10-27 19:54:02;8997028590014;ARGUS 220ML;2;500;0;1000;604;396;
2021-10-27 19:54:02;8993274532105;BOLU;1;1000;0;1000;833;167;
2021-10-27 19:54:02;YP;YUPI;8;250;0;2000;1664;336;
2021-10-27 19:54:02;KOPIKO;KOPIKO;4;250;0;1000;700;300;
2021-10-27 19:54:02;Gula gula kopiko;gula gula kopiko;2;350;0;700;500;200;
2021-10-27 19:54:02;8994867000179;ROKOK PENA MILD 16;1;14500;0;14500;13500;1000;
2021-10-27 19:54:02;8999909001909;MAGNUM REVAMP BLACK 12;2;18000;0;36000;32600;3400;
2021-10-27 19:54:02;8998989500166;GUDANG GARAM MERAH BESAR 16KS;2;18000;0;36000;34000;2000;
2021-10-27 20:02:06;8993571003988;CAP 19 BEDAK TALK 100G;1;5500;0;5500;4250;1250;
2021-10-27 20:02:06;8997218380159;ICHITAN BROWN SUGAR;1;8000;0;8000;6500;1500;
2021-10-27 20:02:06;8992761139018;ADES 600ML;1;3500;0;3500;2166;1334;
2021-10-27 20:02:06;ICE CREAM 5.000;ICE CREAM 5.000;1;5000;0;5000;4700;300;
2021-10-27 20:02:06;8999909096004;SAMPOERNA 16 FILTER;1;25000;0;25000;23100;1900;
2021-10-27 20:02:06;YP;YUPI;6;250;0;1500;1248;252;
2021-10-27 20:02:06;TG APEL;TEH GELAS APEL;1;2000;0;2000;1178;822;
2021-10-27 20:12:13;8997028590014;ARGUS 220ML;2;500;0;1000;604;396;
2021-10-27 20:12:13;8998866200325;MIE SEDAAP SOTO;2;2700;0;5400;4564;836;
2021-10-27 20:12:13;8999909000971;MAGNUM MILD 20;1;24000;0;24000;22750;1250;
2021-10-27 20:12:13;MRC;MERICA LADA;1;1000;0;1000;889;111;
2021-10-27 20:12:13;8998989110167;SURYA GUDANG GARAM 16 FILTER;1;26000;0;26000;23700;2300;
2021-10-27 20:12:13;8997009510055;YOU C1000;1;15000;0;15000;13000;2000;
2021-10-27 20:12:13;8998866203227;MIE SEDAAP AYAM BAKAR LIMAU;1;2700;0;2700;2163;537;
2021-10-27 20:12:13;8992696521797;MILO 22G;1;2500;0;2500;1572;928;
2021-10-27 20:12:13;8991102387286;TANGO LONG CKLT 47G;1;2000;0;2000;1551;449;
2021-10-27 20:12:13;7622300405588;KEJUCAKE 16G;1;2000;0;2000;1641;359;
2021-10-27 20:15:28;RT MNTG;ROTI SISIR MENTEGA;1;2000;0;2000;1600;400;
2021-10-27 20:15:28;8994867007161;ROKOK PENA GOLD 20;1;18000;0;18000;16800;1200;
2021-10-27 20:15:28;8998866200325;MIE SEDAAP SOTO;2;2700;0;5400;4564;836;
2021-10-27 20:15:28;089686611601;QTELA;1;2000;0;2000;1800;200;
2021-10-27 20:15:28;PRG;PARAGO;2;500;0;1000;800;200;
2021-10-27 20:28:41;8998866200578;MIE SEDAAP KARI KENTAL;1;2700;0;2700;2331;369;
2021-10-27 20:28:41;KIKO;KIKO;2;1000;0;2000;1000;1000;
2021-10-27 20:28:41;8991102714860;MILKIDO STRAW;1;3000;0;3000;2153;847;
2021-10-27 20:28:41;OJELLY;O'JELLY;2;500;0;1000;770;230;
2021-10-27 20:28:41;8993072153595;LARISST COTTON 35G;1;5000;0;5000;3300;1700;
2021-10-27 20:28:41;089686060027;POP MIE AYAM JUMBO;1;4500;0;4500;3833;667;
2021-10-27 20:28:41;8992388101085;NU GREEN TEA ORIGINAL 330ML;2;3500;0;7000;5536;1464;
2021-10-27 20:28:41;8998989110167;SURYA GUDANG GARAM 16 FILTER;1;26000;0;26000;23700;2300;
2021-10-27 20:28:41;8997028590014;ARGUS 220ML;4;500;0;2000;1208;792;
2021-10-27 20:28:41;7622201430184;OREO ORIGINAL 38G;1;2000;0;2000;1641;359;
2021-10-27 20:35:08;SURYA;SURYA;2;500;0;1000;1000;0;
2021-10-27 20:35:08;8991111101255;JB SHAMPOO GOLD 50ML;1;5000;0;5000;4500;500;
2021-10-27 20:35:08;8998989300261;GUDANG GARAM SURYA 12 FILTER;1;20000;0;20000;18150;1850;
2021-10-27 20:35:08;8992775001691;GARUDA ROSTA WAGYU BEEF 100G;2;8000;0;16000;14644;1356;
2021-10-27 20:35:08;8997028590045;ARGUS BTL 330ML;1;2000;0;2000;1291;709;
2021-10-27 20:35:08;8997009510055;YOU C1000;2;15000;0;30000;26000;4000;
2021-10-27 20:35:08;8991002114067;PIKOPI;1;1000;0;1000;545;455;
2021-10-27 20:35:08;8997028590014;ARGUS 220ML;2;500;0;1000;604;396;
2021-10-27 20:35:08;089686021141;INTER MIE SOTO;2;1000;0;2000;1708;292;
2021-10-27 20:35:08;089686021219;INTER MIE GORENG;2;1000;0;2000;1770;230;
2021-10-27 20:42:11;Vita Jelly;Vita Jelly;2;1000;0;2000;1532;468;
2021-10-27 20:42:11;8997028590014;ARGUS 220ML;4;500;0;2000;1208;792;
2021-10-27 20:42:11;Garuda pilus;Garuda Pilus Pedas Pcs;4;500;0;2000;1632;368;
2021-10-27 20:42:11;8998866200325;MIE SEDAAP SOTO;1;2700;0;2700;2282;418;
2021-10-27 20:42:11;8996001440001;TB JAHE SUSU;1;1500;0;1500;870;630;
2021-10-27 20:54:19;8991001780140;TWISTER CHOCO;1;5000;0;5000;4600;400;
2021-10-27 20:54:19;8991102218085;CANNON BALL;1;10000;0;10000;9090;910;
2021-10-27 20:54:19;PRG;PARAGO;4;500;0;2000;1600;400;
2021-10-27 20:54:19;8997028590045;ARGUS BTL 330ML;1;2000;0;2000;1291;709;
2021-10-27 20:54:19;MK;MASKER;1;5000;0;5000;4000;1000;
2021-10-27 20:54:19;AMPLOP;AMPLOP;2;250;0;500;350;150;
2021-10-27 20:54:19;gula;GULA;1;11500;0;11500;10000;1500;
2021-10-27 20:54:19;76239878;MARLBORO GOLD;1;31000;0;31000;29650;1350;
2021-10-27 20:54:19;ABC SPW;BATERAI ABC SPW;1;4500;0;4500;3893;607;
2021-10-27 20:54:19;TBR;TEPUNG BERAS ROSE BRAND;1;8000;0;8000;6150;1850;
2021-10-27 20:54:19;8998866107068;Mama lemon 230 ml;1;4000;0;4000;3500;500;
2021-10-27 21:01:49;TBR;TEPUNG BERAS ROSE BRAND;1;8000;0;8000;6150;1850;
2021-10-27 21:01:49;8992775002582;DILAN CHOCO;1;2000;0;2000;1503;497;
2021-10-27 21:01:49;8992628020152;MINYAK GOREG BIMOLI POUCH 2L;1;34000;0;34000;29800;4200;
2021-10-27 21:01:49;8992761111533;SPRITE SLIM CAM250ML;1;5000;0;5000;3750;1250;
2021-10-27 21:01:49;8999999390198;SUNLIGHT LIME NEW POUCH 755ML;1;18000;0;18000;15950;2050;
2021-10-27 21:01:49;8993379200879;SABUN HARMONY MELON 70G;1;2000;0;2000;1652;348;
2021-10-27 21:01:49;8996001305041;ROMA SANDWICH CKLT;2;7000;0;14000;11856;2144;
2021-10-27 21:01:49;8996001304549;SLAI OLAI 1000;1;1000;0;1000;825;175;
2021-10-27 21:01:49;RT MNTG;ROTI SISIR MENTEGA;3;2000;0;6000;4800;1200;
2021-10-27 21:01:49;8994834003752;TICTIC;1;2000;0;2000;1700;300;
2021-10-27 21:01:49;8992775610367;Garuda Koro paggang;2;1000;0;2000;1656;344;
2021-10-27 21:08:58;8997009510055;YOU C1000;1;15000;0;15000;13000;2000;
2021-10-27 21:08:58;TELUR RAK;TELUR RAK;1;37000;0;37000;35000;2000;
2021-10-27 21:08:58;8992745320326;STELLA ORG 200ML;1;15000;0;15000;13300;1700;
2021-10-27 21:08:58;8992775001844;Chocolatos original taste;1;1000;0;1000;829;171;
2021-10-27 21:08:58;8997028590014;ARGUS 220ML;4;500;0;2000;1208;792;
2021-10-27 21:08:58;8991102303309;WFR TANGO SBJ 176G;1;10000;0;10000;8694;1306;
2021-10-27 21:08:58;8991102714860;MILKIDO STRAW;1;3000;0;3000;2153;847;
2021-10-27 21:08:58;8998989300261;GUDANG GARAM SURYA 12 FILTER;1;20000;0;20000;18150;1850;
2021-10-27 21:08:58;8992761139018;ADES 600ML;1;3500;0;3500;2166;1334;
2021-10-27 21:08:58;8997028590052;ARGUS BTL 600ML;1;3000;0;3000;1458;1542;
2021-10-27 21:08:58;8999909096004;SAMPOERNA 16 FILTER;1;25000;0;25000;23100;1900;
2021-10-27 21:08:58;8991909101016;URBAN MILD 16;1;17000;0;17000;15800;1200;
2021-10-27 21:08:58;gg;gula-gula koin;6;500;0;3000;2400;600;
2021-10-27 21:11:31;8991001242013;Top;1;1000;0;1000;500;500;
2021-10-27 21:11:31;7622300335809;OREO SOFT CAKE;1;2000;0;2000;1641;359;
2021-10-27 21:22:56;8997878004327;gula-gula milkita;4;250;0;1000;800;200;
2021-10-27 21:22:56;gula gula;gula-gula karet;2;500;0;1000;800;200;
2021-10-27 21:32:15;Telur 3 Biji;Telur 3 Biji;1;5000;0;5000;3600;1400;
2021-10-27 21:32:15;8995555111221;sosis kimbo;2;1000;0;2000;1700;300;
2021-10-27 21:32:15;4902430803380;DOWNY FLORAL PINK 10ML;2;500;0;1000;786;214;
2021-10-27 21:32:15;8992628010139;MINYAK GORENG BIMOLI 5L;1;88500;0;88500;85675;2825;
2021-10-27 21:32:15;8991914101513;VIPER KRETEK 12;1;6000;0;6000;5000;1000;
2021-10-27 21:32:15;8992761002022;SPRITE PET 390ML;1;5500;0;5500;4333;1167;
2021-10-27 21:32:15;8992761122430;FRESTEA GREEN HONEY 500ML;1;6500;0;6500;4708;1792;
2021-10-27 21:32:15;8886013213208;FRENCH FREIS 2000;1;5000;0;5000;3750;1250;
2021-10-27 21:32:15;RT BAKPIA;ROTI BAKPIA;3;1000;0;3000;2250;750;
2021-10-27 21:32:15;gula;GULA;2;11500;0;23000;20000;3000;
2021-10-27 21:32:15;8999999195656;SARIWANGI 50X1.85;1;10000;0;10000;9405;595;
2021-10-27 21:37:16;8999909003873;MARLBORO 12;1;17000;0;17000;15750;1250;
2021-10-27 22:04:36;8999909096004;SAMPOERNA 16 FILTER;1;25000;0;25000;23100;1900;
2021-10-27 22:22:17;089686043204;INDOMIE MIE ACEH;1;2700;0;2700;2452;248;
2021-10-27 22:22:17;8998866200301;MIE SEDAAP GORENG;1;3000;0;3000;2414;586;
2021-10-27 22:22:17;YP;YUPI;2;250;0;500;416;84;
2021-10-27 22:22:17;8991002304413;RELAXA GRAPE MINT;2;250;0;500;9000;-8500;
2021-10-27 22:22:17;JGR SHN;JOGER SHINY SACHET;1;500;0;500;437;63;
2021-10-28 20:31:12;8994834003752;TICTIC;1;2000;0;2000;1700;300;
2021-10-28 20:31:12;jagung marning;jagung marning;1;5000;0;5000;4500;500;
2021-10-28 20:31:12;8992959953044;SWEETY BRONZE XL1;2;3000;0;6000;4622;1378;
2021-10-28 21:12:58;8999999008475;SUNLIGHT LIME NEW REF 1600ML;1;35000;0;35000;31955;3045;
2021-10-28 21:12:58;8998866601535;BLEACHING SOKLIN PEMUTIH 500ML;1;7000;0;7000;4880;2120;
2021-10-28 21:16:12;ICE CREAM;ICE CREAM 2000;4;2000;0;8000;6800;1200;
2021-10-28 21:17:19;8992959508312;SWEETY SILVER PANTS XL1;4;3000;0;12000;9296;2704;
2021-10-28 21:20:11;ICE CREAM 5.000;ICE CREAM 5.000;1;5000;0;5000;4700;300;
2021-10-28 21:20:11;8992770034175;MASAKO;1;5000;0;5000;4000;1000;
2021-10-28 21:25:11;8991102026383;AIR CRYSTALINE 1.5 L;1;5000;0;5000;3471;1529;
2021-10-28 21:25:11;8991002342118;gula-gula kapal api;1;5000;0;5000;4000;1000;
2021-10-28 21:25:11;8992775305188 pcs;Gery Salut Grentea pcs;1;1000;0;1000;812;188;
2021-10-28 21:25:11;ICE CREAM 5.500;ICE CREAM 5.500;1;5500;0;5500;4700;800;
2021-10-28 21:27:23;8998989110501;gudang garam surya;1;2000;0;2000;1380;620;
2021-10-28 21:29:46;8992736025162;SASA TEPUNG PISANG GORENG;1;5000;0;5000;4455;545;
2021-10-28 21:29:46;8993571003988;CAP 19 BEDAK TALK 100G;1;5500;0;5500;4250;1250;
2021-10-28 21:30:28;FUZO;KUACI FUZO;4;1000;0;4000;3400;600;
2021-10-28 21:33:47;8992761139018;ADES 600ML;1;3500;0;3500;2166;1334;
2021-10-28 21:33:47;Gula gula tusuk;gula gula tusuk;6;500;0;3000;2400;600;
2021-10-28 21:38:12;ARG;ARGUS DOS 220ML;2;14500;0;29000;26600;2400;
2021-10-28 21:39:52;8998866501033;MINYAK GORENG SEDAAP POUCH 2L;1;32000;0;32000;29683;2317;
2021-10-28 21:45:01;8998866202671;NOODLE SEDAAP MIE KOREAN SPICY SOUP CUP;2;5000;0;10000;8004;1996;
2021-10-28 21:45:01;8997028590014;ARGUS 220ML;2;500;0;1000;604;396;
2021-10-28 21:45:01;8998866200325;MIE SEDAAP SOTO;2;2700;0;5400;4564;836;
2021-10-28 21:45:54;8992696404441;BEAR BRAND 189ML;2;15000;0;30000;22000;8000;
2021-10-28 21:48:18;MK;MASKER;1;5000;0;5000;4000;1000;
2021-10-28 21:48:18;8992775211410;PILUS GARUDA PEDAS;1;5000;0;5000;4886;114;
2021-10-28 21:48:18;8992761164539;NUTRIBOOST ORANGE 300ML;1;6500;0;6500;5300;1200;
2021-10-28 21:49:15;8991102387286;TANGO LONG CKLT 47G;1;2000;0;2000;1551;449;
2021-10-28 21:49:15;8991102989534;TANGO VANILA 24G;1;1000;0;1000;609;391;
2021-10-28 21:50:32;ICE CREAM 5.500;ICE CREAM 5.500;1;5500;0;5500;4700;800;
2021-10-28 21:50:32;8992775211410;PILUS GARUDA PEDAS;1;5000;0;5000;4886;114;
2021-10-28 21:50:32;089686611601;QTELA;1;2000;0;2000;1800;200;
2021-10-28 21:50:32;8992761164539;NUTRIBOOST ORANGE 300ML;1;6500;0;6500;5300;1200;
2021-10-28 21:53:00;8998866201889;KRISBEE PILLOW STRAWBERRY ICE CREAM 120GR;1;8000;0;8000;7250;750;
2021-10-28 21:53:00;089686061024;POP MIE MINI SOTO RL;1;3000;0;3000;2702;298;
2021-10-28 21:58:26;8993007003063;ENAAK 500G;1;11000;0;11000;9625;1375;
2021-10-28 21:58:26;8996001600641;TORA CAPPUCINO;1;3500;0;3500;2750;750;
2021-10-28 21:58:26;8998866107068;Mama lemon 230 ml;1;4000;0;4000;3500;500;
2021-10-28 21:58:26;KRIPIK;KRIPIK KENTANG;2;1000;0;2000;1800;200;
2021-10-28 21:58:26;8998866201490;POTABEE REGULER GRILLED SEAWED 68 GR;1;8000;0;8000;7200;800;
2021-10-28 21:58:26;Gula gula kaki;gula gula kaki;6;500;0;3000;2400;600;
2021-10-28 21:58:26;8992775001998;Gery Salut sandwich;1;1000;0;1000;815;185;
2021-10-28 21:59:19;8997226411302;Cheese stick;1;5000;0;5000;3000;2000;
2021-10-28 22:02:30;089686011036;INDOMIE GORENG PEDAS;2;2700;0;5400;4904;496;
2021-10-28 22:02:30;8998866200325;MIE SEDAAP SOTO;1;2700;0;2700;2282;418;
2021-10-28 22:02:30;8999999528812;CITRA  GOLDEN WHITE 120ML;1;11100;0;11100;10082;1018;
2021-10-28 22:07:28;RT;ROTI;1;9000;0;9000;8000;1000;
2021-10-28 22:07:28;8993989311699;CLAS MILD 16 FILTER;1;24000;0;24000;21700;2300;
2021-10-28 22:07:28;8996001302347;SARI GANDUM FAM;2;8500;0;17000;15400;1600;
2021-10-28 22:07:28;8992702000018;INDOMILK PUTIH 370G;1;10000;0;10000;9020;980;
2021-10-28 22:14:54;RT ISI 6;ROTI ISI 6;2;6000;0;12000;10000;2000;
2021-10-28 22:14:54;8998866201728;POTABEE SELECTION SALTED EGG 68G;1;8000;0;8000;7200;800;
2021-10-28 22:14:54;8998866201889;KRISBEE PILLOW STRAWBERRY ICE CREAM 120GR;1;8000;0;8000;7250;750;
2021-10-28 22:14:54;ICE CREAM 5;ICE CREAM 5000;2;5000;0;10000;8800;1200;
2021-10-28 22:14:54;ICE CREAM 6;ICE CREAM 6.000;1;6000;0;6000;5200;800;
2021-10-28 22:14:54;ICE CREAM 3;ICE CREAM 3000;1;3000;0;3000;2600;400;
2021-10-28 22:14:54;ICE CREAM 3.500;ICE CREAM 3.500;1;3500;0;3500;3000;500;
2021-10-28 22:14:54;8992761139018;ADES 600ML;1;3500;0;3500;2166;1334;
2021-10-28 22:14:54;8998866201865;KRISBEE PILLOW CHOCOLAVA 120 GR;1;8000;0;8000;7250;750;
2021-10-28 22:16:09;MTR;MOTOR;2;5000;0;10000;7000;3000;
2021-10-28 22:16:09;ROTI;ROTI 2000;1;2000;0;2000;1800;200;
2021-10-28 22:17:18;gula;GULA;4;11500;0;46000;40000;6000;
2021-10-28 22:19:52;ARG;ARGUS DOS 220ML;1;14500;0;14500;13300;1200;
2021-10-28 22:19:52;balon air;balon air;1;2000;0;2000;1700;300;
2021-10-28 22:19:52;PRG;PARAGO;3;500;0;1500;1200;300;
2021-10-28 22:22:20;BALON;BALON CABUT;3;1000;0;3000;2700;300;
2021-10-28 22:22:20;8998866202244;EKOMIE BUMBU KALDU AYAM;2;1000;0;2000;1596;404;
2021-10-28 22:22:20;KIKO;KIKO;2;1000;0;2000;1000;1000;
2021-10-28 22:23:28;8998866501033;MINYAK GORENG SEDAAP POUCH 2L;1;32000;0;32000;29683;2317;
2021-10-28 22:34:49;8998866501033;MINYAK GORENG SEDAAP POUCH 2L;1;34000;0;34000;29683;4317;
2021-10-28 22:36:09;8999999706081;PEPSODENT WHITE 75G;1;5000;0;5000;3850;1150;
2021-10-28 22:36:34;ARGUS;ARGUS;2;2000;0;4000;3000;1000;
2021-10-28 22:36:55;8992761002039;FANTA STRAWBERRY PET 390 ML;1;5500;0;5500;4333;1167;
2021-10-28 22:37:29;8992761002022;SPRITE PET 390ML;1;5500;0;5500;4333;1167;
2021-10-28 22:37:29;8998009040023;TEH KOTAK;1;5000;0;5000;2708;2292;
2021-10-28 22:38:30;8992775002155;CHOCOLATOS DRINK;3;4000;0;12000;10560;1440;
2021-10-28 22:38:52;ICE CREAM 5.000;ICE CREAM 5.000;1;5000;0;5000;4700;300;
2021-10-28 22:39:21;089686611601;QTELA;4;2000;0;8000;7200;800;
2021-10-29 20:16:00;8998866200301;MIE SEDAAP GORENG;2;3000;0;6000;4828;1172;
2021-10-29 20:16:00;8998866200325;MIE SEDAAP SOTO;1;2700;0;2700;2282;418;
2021-10-29 20:16:00;8998989300261;GUDANG GARAM SURYA 12 FILTER;1;20000;0;20000;18150;1850;
2021-10-29 20:26:47;8999909096004;SAMPOERNA 16 FILTER;1;25000;0;25000;23100;1900;
2021-10-29 20:37:16;089686611601;QTELA;4;2000;0;8000;7200;800;
2021-10-29 20:37:16;SF SOSIS;SAFFANAH ROTI SOSIS;1;6000;0;6000;5500;500;
2021-10-29 20:38:42;8995333032113;TERIGU GATOT KACA 1 KG;1;9000;0;9000;8572;428;
2021-10-29 20:40:26;8998866200301;MIE SEDAAP GORENG;3;3000;0;9000;7242;1758;
2021-10-29 20:40:26;ROTI;ROTI 2000;1;2000;0;2000;1800;200;
2021-10-29 20:40:26;8991102228053;TEH GELAS BOTOL;1;3000;0;3000;1695;1305;
2021-10-29 20:43:19;8992628010139;MINYAK GORENG BIMOLI 5L;1;88500;0;88500;85675;2825;
2021-10-29 20:44:19;8999999552367;SAHAJA CUCI PIRING 400ML;1;8500;0;8500;7300;1200;
2021-10-29 20:45:33;8998009040023;TEH KOTAK;4;5000;0;20000;10832;9168;
2021-10-29 20:51:10;8997009510055;YOU C1000;1;15000;0;15000;13000;2000;
2021-10-29 20:51:10;MK;MASKER;1;5000;0;5000;4000;1000;
2021-10-29 20:52:00;8992761145026;SPRITE PET 250ML;2;3500;0;7000;4834;2166;
2021-10-29 21:10:14;8999999559519;Lifebuoy 500 ml;1;42500;0;42500;38000;4500;
2021-10-29 21:15:47;8999999049447;REXONA WMN RO ADVANCED WHITE 45 ML;1;16500;0;16500;14900;1600;
2021-10-29 21:15:47;9556006014585;JB SHAMPOO SHOFT&SMOOTH 100ML;1;10500;0;10500;9450;1050;
2021-10-29 21:15:47;BALON;BALON CABUT;2;1000;0;2000;1800;200;
2021-10-29 21:15:47;8991001503336;chacha minis hat;1;7500;0;7500;6400;1100;
2021-10-29 21:15:47;8998866200325;MIE SEDAAP SOTO;1;2700;0;2700;2282;418;
2021-10-29 21:15:47;8993093115008;tepun beras;1;8000;0;8000;7000;1000;
2021-10-29 21:15:47;KIKO;KIKO;4;1000;0;4000;2000;2000;
2021-10-29 21:15:47;8998866610087;JAVANA ORIGINAL 350ML;1;3000;0;3000;2150;850;
2021-10-29 21:15:47;Gula gula kopiko;gula gula kopiko;8;350;0;2800;2000;800;
2021-10-29 21:15:47;gula;GULA;1;11500;0;11500;10000;1500;
2021-10-29 21:20:00;8999999554279;SAHAJAPMBRSH LT PCH 730ML;1;10000;0;10000;9100;900;
2021-10-29 21:20:00;8992775311325;GERY SNACK&SEREAL 100G;2;7000;0;14000;12024;1976;
2021-10-29 21:20:00;8992775001783;GERY SALUT MALKIST KELAPA;1;6500;0;6500;5516;984;
2021-10-29 21:20:00;8991102300544;WFR TANGO VNL 176G;1;10000;0;10000;8694;1306;
2021-10-29 21:20:00;8992931006256;tessa;1;1000;0;1000;900;100;
2021-10-29 21:20:00;SKT;SIKAT CUCI;1;6000;0;6000;5000;1000;
2021-10-29 21:20:00;8999999048488;SUNSILK SHP REFRESH ANTI DDRF 70+21ML;1;10000;0;10000;9075;925;
2021-10-29 21:21:50;8998866609494;SOKLIN SOFTERGEN 280G BIRU;1;5000;0;5000;4425;575;
2021-10-29 21:21:50;8998989300261;GUDANG GARAM SURYA 12 FILTER;1;20000;0;20000;18150;1850;
2021-10-29 21:21:50;8992761139018;ADES 600ML;1;3500;0;3500;2166;1334;
2021-10-29 21:21:50;balon air;balon air;2;2000;0;4000;3400;600;
2021-10-29 21:23:39;8991188943062;SASA 250G;1;10000;0;10000;8500;1500;
2021-10-29 21:23:39;8991909101016;URBAN MILD 16;1;17000;0;17000;15800;1200;
2021-10-29 21:23:39;8995333032113;TERIGU GATOT KACA 1 KG;3;9000;0;27000;25716;1284;
2021-10-29 21:23:39;8992628022156;MINYAK GORENG BIMOLI POUCH 1 LT;1;17500;0;17500;16400;1100;
2021-10-29 21:24:20;8992736524306;Sasa Bumbu Nasi Goreng Barbeque;1;2000;0;2000;1181;819;
2021-10-29 21:24:20;BALON;BALON CABUT;1;1000;0;1000;900;100;
2021-10-29 21:25:42;BALON;BALON CABUT;2;1000;0;2000;1800;200;
2021-10-29 21:25:42;8998866501033;MINYAK GORENG SEDAAP POUCH 2L;2;34000;0;68000;59366;8634;
2021-10-29 21:29:32;ARG;ARGUS DOS 220ML;1;14500;0;14500;13300;1200;
2021-10-29 21:29:32;SF SOSIS;SAFFANAH ROTI SOSIS;1;6000;0;6000;5500;500;
2021-10-29 21:29:32;BALON;BALON CABUT;1;1000;0;1000;900;100;
2021-10-29 21:29:32;ICE CREAM;ICE CREAM 2000;1;2000;0;2000;1700;300;
2021-10-29 21:29:32;KIKO;KIKO;3;1000;0;3000;1500;1500;
2021-10-29 21:29:32;Gula gula kaki;gula gula kaki;3;500;0;1500;1200;300;
2021-10-29 21:29:32;8998989110167;SURYA GUDANG GARAM 16 FILTER;1;26000;0;26000;23700;2300;
2021-10-29 21:29:32;8998989300261;GUDANG GARAM SURYA 12 FILTER;1;20000;0;20000;18150;1850;
2021-10-29 21:29:32;8999909002821;MARLBORO BLACK 16;1;22000;0;22000;20850;1150;
2021-10-29 21:29:32;8992959001875;SWEETY SILVER PANTS S1;2;2000;0;4000;3056;944;
2021-10-29 21:29:48;BALON;BALON CABUT;1;1000;0;1000;900;100;
2021-10-29 21:30:04;BALON;BALON CABUT;1;1000;0;1000;900;100;
2021-10-29 21:31:33;BALON;BALON CABUT;9;1000;0;9000;8100;900;
2021-10-29 21:31:33;8992761111533;SPRITE SLIM CAM250ML;1;5000;0;5000;3750;1250;
2021-10-29 21:32:48;ROTI;ROTI 2000;1;2000;0;2000;1800;200;
2021-10-29 21:32:48;8997028590052;ARGUS BTL 600ML;1;3000;0;3000;1458;1542;
2021-10-29 21:32:48;KIKO;KIKO;6;1000;0;6000;3000;3000;
2021-10-29 21:40:55;kiko;kiko;1;1000;0;1000;900;100;
2021-10-29 21:40:55;balon air;balon air;1;2000;0;2000;1700;300;
2021-10-29 21:40:55;RB;RED BOLD;3;20000;0;60000;56400;3600;
2021-10-29 21:41:36;Telur 3 Biji;Telur 3 Biji;1;5000;0;5000;3600;1400;
2021-10-29 21:41:36;ROTI;ROTI 2000;1;2000;0;2000;1800;200;
2021-10-29 21:44:35;kiko;kiko;2;1000;0;2000;1800;200;
2021-10-29 21:46:01;kiko;kiko;2;1000;0;2000;1800;200;
2021-10-29 21:48:02;Vita Jelly;Vita Jelly;1;1000;0;1000;766;234;
2021-10-29 21:48:02;8995150101696;M+SUSU ORIGINAL;1;5000;0;5000;4000;1000;
2021-10-29 21:48:02;8997028590014;ARGUS 220ML;10;500;0;5000;3020;1980;
2021-10-29 21:48:43;kiko;kiko;2;1000;0;2000;1800;200;
2021-10-29 21:49:44;8992775002582;DILAN CHOCO;2;2000;0;4000;3006;994;
2021-10-29 21:50:41;8992761002022;SPRITE PET 390ML;3;5500;0;16500;12999;3501;
2021-10-29 21:50:41;8992761002039;FANTA STRAWBERRY PET 390 ML;2;5500;0;11000;8666;2334;
2021-10-29 21:51:56;8998009010569;ULTRA CHO 200;2;5000;0;10000;7916;2084;
2021-10-29 21:52:58;BALON;BALON CABUT;1;1000;0;1000;900;100;
2021-10-29 21:57:01;8999909001909;MAGNUM REVAMP BLACK 12;1;18000;0;18000;16300;1700;
2021-10-29 21:57:01;8998989500166;GUDANG GARAM MERAH BESAR 16KS;2;18000;0;36000;34000;2000;
2021-10-29 21:59:49;8995333060772;TERIGU GATOT KACA 500GR;1;5000;0;5000;4346;654;
2021-10-29 21:59:49;8997013180046;Tissu Tessi B;1;11000;0;11000;9800;1200;
2021-10-29 21:59:49;8996001305041;ROMA SANDWICH CKLT;1;7000;0;7000;5928;1072;
2021-10-29 22:20:24;Gula gula pulpen;gula gula pulpen;2;2000;0;4000;3500;500;
2021-10-29 22:23:00;8997028590052;ARGUS BTL 600ML;1;3000;0;3000;1458;1542;
2021-10-29 22:23:00;ICE CREAM 5.500;ICE CREAM 5.500;1;5500;0;5500;4700;800;
2021-10-29 22:23:00;ICE CREAM 3;ICE CREAM 3000;3;3000;0;9000;7800;1200;
2021-10-29 22:23:00;ICE CREAM;ICE CREAM 2000;1;2000;0;2000;1700;300;
2021-10-29 22:24:16;8992775305164;GERY MALKIST GREEN TEA;1;6500;0;6500;5500;1000;
2021-10-29 22:24:51;8997028590014;ARGUS 220ML;6;500;0;3000;1812;1188;
2021-10-30 12:41:44;8992775002582;DILAN CHOCO;1;2000;0;2000;1503;497;
2021-10-30 12:43:39;8999909000773;MARLBORO FILTER BLACK 12;1;17000;0;17000;15950;1050;
2021-10-30 12:57:36;8998866201711;KRISBEE KRUNCHY JAGUNG BAKAR MENTEGA 75 GR;1;5500;0;5500;4400;1100;
2021-10-30 12:57:36;123124;KOREK BIASA;2;2000;0;4000;2600;1400;
2021-10-30 12:57:36;ROTI;ROTI 2000;2;2000;0;4000;3600;400;
2021-10-30 12:57:36;8994867000162;ROKOK PUNDIMAS KRETEK16;1;10000;0;10000;8600;1400;
2021-10-30 12:57:36;8992736624310;Sasa bumbu Nasi Goreng Jawa;1;2000;0;2000;1181;819;
2021-10-30 12:57:36;089686021219;INTER MIE GORENG;1;1000;0;1000;885;115;
2021-10-30 17:04:05;7622210462534;OREO MINI STRAW;1;7500;0;7500;6500;1000;
2021-10-30 17:04:05;6907992823652;JD CHOCOLATE MILKSHAKE;1;6000;0;6000;5200;800;
2021-10-30 17:06:42;8992959117583;SFX DS REG FLOW WING 20;1;5000;0;5000;4288;712;
2021-10-30 17:06:42;8997878004327;gula-gula milkita;12;250;0;3000;2400;600;
2021-10-30 21:21:07;8994834003752;TICTIC;1;2000;0;2000;1700;300;
2021-10-30 21:21:07;Gula gula kaki;gula gula kaki;2;500;0;1000;800;200;
2021-10-30 21:21:07;8997028590014;ARGUS 220ML;1;500;0;500;302;198;
2021-10-30 21:21:07;8998866202626;Top Kopi Gula Aren 22gr;1;1000;0;1000;553;447;
2021-10-30 21:21:07;Telur 3 Biji;Telur 3 Biji;1;5000;0;5000;3600;1400;
2021-10-30 21:21:07;8998866200561;EKOMIE SUPER 600GR;1;10000;0;10000;8615;1385;
2021-10-30 21:21:07;8991188943536;SASA SANTAN KELAPA 65ML;1;3000;0;3000;2437;563;
2021-10-30 21:23:23;8999999528881;CITRA HBL NAT GLOWING WHITE UV;1;20000;0;20000;17703;2297;
2021-10-30 21:24:01;8999909982000;SAMPOERNA 12 FILTER;1;19000;0;19000;16600;2400;
2021-10-30 21:26:39;8850007014478;JB POWDER ACTIVE FRESH 100G;2;7000;0;14000;12060;1940;
2021-10-30 21:32:11;6907992825069;JD FRUITY;1;5000;0;5000;4400;600;
2021-10-30 21:32:11;6907992823935;JD SWEETCORN;1;3500;0;3500;3000;500;
2021-10-30 21:38:07;kiko;kiko;2;1000;0;2000;1800;200;
2021-10-30 21:38:07;Gula gula kaki;gula gula kaki;2;500;0;1000;800;200;
2021-10-30 21:38:07;8991102384841;WFR TANGO LONG CKLT 130G;1;5000;0;5000;4345;655;
2021-10-30 21:39:32;8993989311699;CLAS MILD 16 FILTER;1;24000;0;24000;21700;2300;
2021-10-30 21:39:32;8999999046989;LIFEBUOY MILD CARE 60G;1;3000;0;3000;1911;1089;
2021-10-30 21:45:16;RT;ROTI;1;9000;0;9000;8000;1000;
2021-10-30 21:45:16;089686011036;INDOMIE GORENG PEDAS;1;2700;0;2700;2452;248;
2021-10-30 21:45:16;8998866200646;KOPI TOP MURNI;1;11000;0;11000;9600;1400;
2021-10-30 21:45:16;8992716109172;BISKUAT BOLU SCT;1;2000;0;2000;1641;359;
2021-10-30 21:45:16;8992736424293;SASA BUMBU NASI GORENG 20G;1;2000;0;2000;1136;864;
2021-10-30 21:45:16;8995555121244;SOSIS KIMBO;2;1000;0;2000;1300;700;
2021-10-30 21:45:16;7622300335809;OREO SOFT CAKE;1;2000;0;2000;1641;359;
2021-10-30 21:45:16;8998866201469;POTABEE REGULER BBQ BEEF 68 GR;1;8000;0;8000;7200;800;
2021-10-30 21:45:16;8998866200561;EKOMIE SUPER 600GR;1;10000;0;10000;8615;1385;
2021-10-30 21:46:48;8993007003063;ENAAK 500G;1;11000;0;11000;9625;1375;
2021-10-30 21:52:33;8998866200578;MIE SEDAAP KARI KENTAL;6;2700;0;16200;13986;2214;
2021-10-30 21:52:33;8991102228053;TEH GELAS BOTOL;1;3000;0;3000;1695;1305;
2021-10-30 21:52:33;BALON;BALON CABUT;8;1000;0;8000;7200;800;
2021-10-30 21:55:30;8997028590045;ARGUS BTL 330ML;1;2000;0;2000;1291;709;
2021-10-30 21:55:30;8998866610087;JAVANA ORIGINAL 350ML;1;3000;0;3000;2150;850;
2021-10-30 21:55:30;8991102026383;AIR CRYSTALINE 1.5 L;1;5000;0;5000;3471;1529;
2021-10-30 21:57:44;8999909096004;SAMPOERNA 16 FILTER;1;25000;0;25000;23100;1900;
2021-10-30 21:57:44;8992761166212;FRESTEA APPLE 350ML;1;4500;0;4500;3000;1500;
2021-10-30 22:01:44;8993379241858;SABUN HARMONY LEMON 70G;1;2000;0;2000;1652;348;
2021-10-30 22:01:44;8998866500487;BABY HAPPY PANTS M 20P;1;37000;0;37000;33520;3480;
2021-10-30 22:01:44;8998866610087;JAVANA ORIGINAL 350ML;1;3000;0;3000;2150;850;
2021-10-30 22:01:44;8998866200820;NOODLE SEDAAP MIE AYAM BAWANG TLR CUP 77 GR;1;4500;0;4500;3650;850;
2021-10-30 22:01:44;8998989300261;GUDANG GARAM SURYA 12 FILTER;1;20000;0;20000;18150;1850;
2021-10-30 22:01:44;BALON;BALON CABUT;3;1000;0;3000;2700;300;
2021-10-30 22:01:44;MK BIASA;MASKERBIASA;1;2000;0;2000;1500;500;
2021-10-30 22:07:29;8998866200882;SUKSESMIE GORENG AYAM KRMS 133GR;1;3500;0;3500;3047;453;
2021-10-30 22:07:29;8998989300261;GUDANG GARAM SURYA 12 FILTER;1;20000;0;20000;18150;1850;
2021-10-30 22:07:29;BALON;BALON CABUT;1;1000;0;1000;900;100;
2021-10-30 22:07:29;Telur 3 Biji;Telur 3 Biji;1;5000;0;5000;3600;1400;
2021-10-30 22:07:29;kiko;kiko;1;1000;0;1000;900;100;
2021-10-30 22:07:29;8997028590014;ARGUS 220ML;4;500;0;2000;1208;792;
2021-10-30 22:07:29;089686061024;POP MIE MINI SOTO RL;1;3000;0;3000;2702;298;
2021-10-30 22:07:29;8994834006128;TICTIC PEDAS;1;2000;0;2000;1700;300;
2021-10-30 22:07:29;PRG;PARAGO;2;500;0;1000;800;200;
2021-10-30 22:12:03;8997018720018;SIRUP DHT;1;23000;0;23000;20958;2042;
2021-10-30 22:12:03;BALON;BALON CABUT;9;1000;0;9000;8100;900;
2021-10-30 22:12:03;gula;GULA;2;11500;0;23000;20000;3000;
2021-10-30 22:12:03;8992775315057;GERY SALUT MALKIST COKLAT;1;6500;0;6500;5516;984;
2021-10-30 22:12:03;8991102714846;MILKIDO CKLT;1;3000;0;3000;2153;847;
2021-10-30 22:12:03;089686010824;INDOMIE GORENG SPESIAL;1;2700;0;2700;2452;248;
2021-10-30 22:12:03;Gula gula kaki;gula gula kaki;8;500;0;4000;3200;800;
2021-10-30 22:17:09;8991002114067;PIKOPI;3;1000;0;3000;1635;1365;
2021-10-30 22:17:09;8991102228053;TEH GELAS BOTOL;1;3000;0;3000;1695;1305;
2021-10-30 22:17:09;Gula gula kaki;gula gula kaki;6;500;0;3000;2400;600;
2021-10-30 22:17:09;kiko;kiko;4;1000;0;4000;3600;400;
2021-10-30 22:18:00;YP;YUPI;4;250;0;1000;832;168;
2021-10-30 22:19:55;BALON;BALON CABUT;2;1000;0;2000;1800;200;
2021-10-30 22:19:55;8993989311699;CLAS MILD 16 FILTER;1;24000;0;24000;21700;2300;
2021-10-30 22:19:55;8997028590014;ARGUS 220ML;2;500;0;1000;604;396;
2021-10-30 22:21:32;8998866200578;MIE SEDAAP KARI KENTAL;1;2700;0;2700;2331;369;
2021-10-30 22:21:32;089686021127;INTER MIE KALDU;1;1000;0;1000;813;187;
2021-10-30 22:21:32;8998866501033;MINYAK GORENG SEDAAP POUCH 2L;1;34000;0;34000;29683;4317;
2021-10-30 22:22:24;8992775002582;DILAN CHOCO;1;2000;0;2000;1503;497;
2021-10-30 22:22:24;ARG;ARGUS DOS 220ML;1;14500;0;14500;13300;1200;
2021-10-30 22:24:20;8998866501033;MINYAK GORENG SEDAAP POUCH 2L;1;34000;0;34000;29683;4317;
2021-10-30 22:29:13;KRIPIK;KRIPIK KENTANG;2;1000;0;2000;1800;200;
2021-10-30 22:29:13;kiko;kiko;3;1000;0;3000;2700;300;
2021-10-30 22:29:13;8999999059781;SUNLIGHT LIME NEW POUCH 210ML;1;5000;0;5000;4520;480;
2021-10-30 22:29:13;8999999524722;SUNLIGHT LIME NEW PCH 435ML;1;10000;0;10000;9100;900;
2021-10-30 22:30:27;8999909096004;SAMPOERNA 16 FILTER;1;25000;0;25000;23100;1900;
2021-10-30 22:36:21;8999999524722;SUNLIGHT LIME NEW PCH 435ML;1;10000;0;10000;9100;900;
2021-10-30 22:36:21;Gula gula pulpen;gula gula pulpen;5;2000;0;10000;8750;1250;
2021-10-30 22:36:21;8999999030179;PEPSODENT ACTION 123 COMPLETE 75G;1;6700;0;6700;5170;1530;
2021-10-30 22:36:21;8993335523363;TOTAL ALMEERA 250G;1;5000;0;5000;4100;900;
2021-10-30 22:36:21;8991102385121;WFR TANGO VNL 7G;1;8300;0;8300;7455;845;
2021-10-30 22:36:21;gula;GULA;1;11500;0;11500;10000;1500;
2021-10-30 22:36:21;ROTI;ROTI 2000;1;2000;0;2000;1800;200;
2021-10-30 22:36:21;BALON;BALON CABUT;2;1000;0;2000;1800;200;
2021-10-30 22:36:21;8992716109172;BISKUAT BOLU SCT;1;2000;0;2000;1641;359;
2021-10-30 22:36:21;8997028590014;ARGUS 220ML;2;500;0;1000;604;396;
2021-10-30 22:36:21;OJELLY;O'JELLY;1;500;0;500;385;115;
2021-10-30 22:37:09;ARG;ARGUS DOS 220ML;2;14500;0;29000;26600;2400;
2021-10-30 22:38:34;8995333032113;TERIGU GATOT KACA 1 KG;4;9000;0;36000;34288;1712;
2021-10-30 22:38:34;gula;GULA;1;11500;0;11500;10000;1500;
2021-10-30 22:39:26;8997028590052;ARGUS BTL 600ML;1;3000;0;3000;1458;1542;
2021-10-30 22:39:26;8992770033178;Masako;4;500;0;2000;1800;200;
2021-10-31 20:06:41;8999909096004;SAMPOERNA 16 FILTER;1;25000;0;25000;23100;1900;
2021-10-31 20:06:41;8886013213208;FRENCH FREIS 2000;3;5000;0;15000;11250;3750;
2021-10-31 20:13:55;8999909096004;SAMPOERNA 16 FILTER;1;25000;0;25000;23100;1900;
2021-10-31 20:13:55;8991102026383;AIR CRYSTALINE 1.5 L;1;5000;0;5000;3471;1529;
2021-10-31 20:13:55;8992761166212;FRESTEA APPLE 350ML;2;4500;0;9000;6000;3000;
2021-10-31 20:29:59;8991102228053;TEH GELAS BOTOL;1;3000;0;3000;1695;1305;
2021-10-31 20:29:59;8998866200837;NOODLE SEDAAPMIE SOTO CUP 81 GR;1;4500;0;4500;3738;762;
2021-10-31 20:29:59;089686060461;POP MIE RASA KARI AYAM;1;4500;0;4500;3833;667;
2021-10-31 20:29:59;Telur 3 Biji;Telur 3 Biji;1;5000;0;5000;3600;1400;
2021-10-31 20:32:12;8999999533434;CLEAR SHP COOL SPORT MNTL MEN 9 ML;1;10300;0;10300;9300;1000;
2021-10-31 20:55:16;8998866608718;DAIA SOFTENER PINK;1;5000;0;5000;4450;550;
2021-10-31 21:17:01;8998866202695;KOPI MAYOR;1;6000;0;6000;4500;1500;
2021-10-31 21:19:20;8991102714846;MILKIDO CKLT;1;3000;0;3000;2153;847;
2021-10-31 21:23:29;8996001314005;ROMA KELAPA CREAM CKLT;1;8000;0;8000;6642;1358;
2021-10-31 21:42:05;8999999033187;LIFEBUOY SHP KUAT&BERKILAU 340ML;1;29500;0;29500;26850;2650;
2021-10-31 21:42:05;8999999001193;LIFEBUOY BW TOTAL10 LD REFF 450 ML;1;25000;0;25000;22110;2890;
2021-10-31 21:42:05;8999999027261;LIFEBUOY BW LEMONFRESH LD REFF 450 ML;1;25000;0;25000;22110;2890;
2021-10-31 21:42:05;8999999024475;CITRA BW PEARLY WHITE LD 400ML;1;21000;0;21000;19000;2000;
2021-10-31 21:42:05;8999999528225;CITRA PEARLY WHITE BTL 220ML;1;17200;0;17200;15450;1750;
2021-10-31 22:09:05;TERASI;ABC TERASI SCT;2;500;0;1000;580;420;
2021-10-31 22:09:05;8992696404441;BEAR BRAND 189ML;1;12000;0;12000;8585;3415;
2021-10-31 22:09:41;8993058105013;EXTRA JOSS;1;12000;0;12000;9773;2227;
2021-10-31 22:15:26;ICE CREAM 3;ICE CREAM 3000;1;3000;0;3000;2600;400;
2021-10-31 22:15:26;8998989500166;GUDANG GARAM MERAH BESAR 16KS;1;18000;0;18000;17000;1000;
2021-10-31 22:15:26;8999801700030;SUSU FOYU;1;11500;0;11500;10450;1050;
2021-10-31 22:15:26;8996001410042;TB TORA MOKA;4;1500;0;6000;3480;2520;
2021-10-31 22:18:42;8992736025162;SASA TEPUNG PISANG GORENG;1;5000;0;5000;4455;545;
2021-10-31 22:18:42;8992696521797;MILO 22G;10;2500;0;25000;15720;9280;
2021-10-31 22:18:42;RT 1000;ROTI 1000;4;1000;0;4000;3200;800;
2021-10-31 22:18:42;MBL;MOBIL;1;5000;0;5000;3500;1500;
2021-10-31 22:18:42;8992736925134;SASA TEPUNG BUMBU SERBAGUNA;1;5500;0;5500;4700;800;
2021-10-31 22:18:42;8999999037765;pepsodent 225 gr;1;12000;0;12000;10500;1500;
2021-11-01 09:56:24;8997028590014;ARGUS 220ML;6;500;0;3000;1812;1188;
2021-11-01 20:19:19;krupuk k;Krupuk Kentang;2;5000;0;10000;9000;1000;
2021-11-01 20:20:05;8998866500470;BABY HAPPY PANTS M 9P;1;17000;0;17000;15175;1825;
2021-11-01 20:20:39;8999999024482;CITRA BW PEARLY WHITE REFF 220ML;1;12000;0;12000;10700;1300;
2021-11-01 20:21:41;8992959508312;SWEETY SILVER PANTS XL1;1;3000;0;3000;2324;676;
2021-11-01 20:22:13;Telur 3 Biji;Telur 3 Biji;1;5000;0;5000;3600;1400;
2021-11-01 20:23:49;8995333060772;TERIGU GATOT KACA 500GR;1;5000;0;5000;4346;654;
2021-11-01 20:23:49;8992761166205;FRESTEA GREEN HONEY 350ML;1;4500;0;4500;3000;1500;
2021-11-01 20:23:49;8992761164539;NUTRIBOOST ORANGE 300ML;1;6500;0;6500;5300;1200;
2021-11-01 20:23:49;ROTI;ROTI 2000;1;2000;0;2000;1800;200;
2021-11-01 20:23:49;8998009040023;TEH KOTAK;1;5000;0;5000;2708;2292;
2021-11-01 20:30:36;8998866201728;POTABEE SELECTION SALTED EGG 68G;1;8000;0;8000;7200;800;
2021-11-01 20:30:36;ARG;ARGUS DOS 220ML;1;14500;0;14500;13300;1200;
2021-11-01 20:30:36;ABC SPW;BATERAI ABC SPW;1;4500;0;4500;3893;607;
2021-11-01 20:30:36;8994867007161;ROKOK PENA GOLD 20;1;18000;0;18000;16800;1200;
2021-11-01 20:30:36;Gula gula pulpen;gula gula pulpen;4;2000;0;8000;7000;1000;
2021-11-01 20:30:36;8992775312469;GERY SALUT COKELAT;1;11000;0;11000;9983;1017;
2021-11-01 20:30:36;8997028590052;ARGUS BTL 600ML;1;3000;0;3000;1458;1542;
2021-11-01 20:30:36;8998866200325;MIE SEDAAP SOTO;2;2700;0;5400;4564;836;
2021-11-01 20:30:36;8993176110081;MINYAK KAYU PUTIH 30ML;1;12000;0;12000;9091;2909;
2021-11-01 20:30:36;8992775002582;DILAN CHOCO;1;2000;0;2000;1503;497;
2021-11-01 20:33:24;ICE CREAM 6;ICE CREAM 6.000;1;6000;0;6000;5200;800;
2021-11-01 20:33:24;8991002121089;GOOD DAY ORI CAPPUCINO;2;7000;0;14000;9500;4500;
2021-11-01 20:33:24;8992761164539;NUTRIBOOST ORANGE 300ML;1;6500;0;6500;5300;1200;
2021-11-01 20:33:24;ICE CREAM 5;ICE CREAM 5000;2;5000;0;10000;8800;1200;
2021-11-01 20:35:19;ICE CREAM 6;ICE CREAM 6.000;1;6000;0;6000;5200;800;
2021-11-01 20:35:19;Vita Jelly;Vita Jelly;2;1000;0;2000;1532;468;
2021-11-01 20:35:19;ROTI;ROTI 2000;1;2000;0;2000;1800;200;
2021-11-01 20:35:19;8998866201889;KRISBEE PILLOW STRAWBERRY ICE CREAM 120GR;1;8000;0;8000;7250;750;
2021-11-01 20:41:50;8995333060772;TERIGU GATOT KACA 500GR;1;5000;0;5000;4346;654;
2021-11-01 20:41:50;8999999195649;SARIWANGI 25X1.86G;1;6000;0;6000;5202;798;
2021-11-01 20:41:50;8997028380165;BISKUIT;1;10000;0;10000;9000;1000;
2021-11-01 20:41:50;gula;GULA;1;11500;0;11500;10000;1500;
2021-11-01 20:41:50;ICE CREAM 5;ICE CREAM 5000;1;5000;0;5000;4400;600;
2021-11-01 20:41:50;8999999049461;REXONA WMN ROINVISIBLE DRY 45 ML;1;15000;0;15000;13550;1450;
2021-11-01 20:41:50;8991102230308;BLASTER PINK;1;5000;0;5000;3106;1894;
2021-11-01 20:41:50;8997878004327;gula-gula milkita;10;250;0;2500;2000;500;
2021-11-01 20:41:50;ROTI;ROTI 2000;5;2000;0;10000;9000;1000;
2021-11-01 20:41:50;8997028590014;ARGUS 220ML;3;500;0;1500;906;594;
2021-11-01 20:41:50;8993989311699;CLAS MILD 16 FILTER;1;24000;0;24000;21700;2300;
2021-11-01 20:41:50;8992761164539;NUTRIBOOST ORANGE 300ML;1;6500;0;6500;5300;1200;
2021-11-01 20:41:50;8991102228053;TEH GELAS BOTOL;1;3000;0;3000;1695;1305;
2021-11-01 20:44:29;8992959953037;SWEETY BRONZE L1;2;2500;0;5000;3638;1362;
2021-11-01 20:44:29;8992957220087;COKLAT SINGA;4;2000;0;8000;6800;1200;
2021-11-01 20:47:37;8997028590014;ARGUS 220ML;2;500;0;1000;604;396;
2021-11-01 20:47:37;8998866202664;POTABEE WAGYU BEEF STEAK 68 GR;1;8000;0;8000;7200;800;
2021-11-01 20:47:37;8998009040023;TEH KOTAK;1;5000;0;5000;2708;2292;
2021-11-01 20:47:37;8998866501033;MINYAK GORENG SEDAAP POUCH 2L;2;34000;0;68000;59366;8634;
2021-11-01 20:47:37;ARG;ARGUS DOS 220ML;1;14500;0;14500;13300;1200;
2021-11-01 20:49:04;8992761122331;FRESTEA APPEL 500ML;1;6500;0;6500;4791;1709;
2021-11-01 20:51:09;MTR;MOTOR;1;5000;0;5000;3500;1500;
2021-11-01 20:51:09;Vita Jelly;Vita Jelly;5;1000;0;5000;3830;1170;
2021-11-01 20:51:09;7992912508305;SWEETY SILVER PANTS L1;4;2500;0;10000;7528;2472;
2021-11-01 20:51:44;8992761111533;SPRITE SLIM CAM250ML;1;5000;0;5000;3750;1250;
2021-11-01 20:52:14;8997028590014;ARGUS 220ML;4;500;0;2000;1208;792;
2021-11-01 20:57:04;8999999706081;PEPSODENT WHITE 75G;1;5000;0;5000;3850;1150;
2021-11-01 20:57:04;6907992824963;JD MILKY CHOCOLATE;3;3000;0;9000;7800;1200;
2021-11-01 20:58:28;JD VM;JD VANILLA MILKSHAKE;1;5000;0;5000;4300;700;
2021-11-01 20:59:12;8991102387286;TANGO LONG CKLT 47G;2;2000;0;4000;3102;898;
2021-11-01 21:01:26;8998866202244;EKOMIE BUMBU KALDU AYAM;1;1000;0;1000;798;202;
2021-11-01 21:01:26;8998866501033;MINYAK GORENG SEDAAP POUCH 2L;2;34000;0;68000;59366;8634;
2021-11-01 21:02:01;Vita Jelly;Vita Jelly;1;1000;0;1000;766;234;
2021-11-01 21:05:57;8992994110112;yakult;1;10000;0;10000;7000;3000;
2021-11-01 21:07:10;Gula gula kaki;gula gula kaki;1;500;0;500;400;100;
2021-11-01 21:13:20;ARG;ARGUS DOS 220ML;6;14500;0;87000;79800;7200;
2021-11-01 21:13:20;gula;GULA;4;11500;0;46000;40000;6000;
2021-11-01 21:14:39;8997012030748;MADU ENAK;1;1000;0;1000;900;100;
2021-11-01 21:15:54;ICE CREAM 3;ICE CREAM 3000;1;3000;0;3000;2600;400;
2021-11-01 21:17:07;8991001503107;CHACHA PEANUT 35GR;1;5500;0;5500;4900;600;
2021-11-01 21:19:39;8992736524306;Sasa Bumbu Nasi Goreng Barbeque;1;2000;0;2000;1181;819;
2021-11-01 21:19:39;Telur 3 Biji;Telur 3 Biji;1;5000;0;5000;3600;1400;
2021-11-01 21:19:39;TS;TISSUE TESSY;1;5000;0;5000;4200;800;
2021-11-01 21:23:59;8998866610087;JAVANA ORIGINAL 350ML;1;3000;0;3000;2150;850;
2021-11-01 21:23:59;8993351139807;REAL GOOD;1;1000;0;1000;800;200;
2021-11-01 21:24:36;kiko;kiko;1;1000;0;1000;900;100;
2021-11-01 21:26:11;8993351139807;REAL GOOD;1;1000;0;1000;800;200;
2021-11-01 21:26:57;8993351139807;REAL GOOD;1;1000;0;1000;800;200;
2021-11-01 21:27:25;Gula gula tusuk;gula gula tusuk;1;500;0;500;400;100;
2021-11-01 21:29:48;8998866202343;MIE SEDAAP KOREAN SPICY;1;3000;0;3000;2413;587;
2021-11-01 21:38:33;8992753031894;FRISIAN FLAG;2;2000;0;4000;2000;2000;
2021-11-01 21:38:33;TG MARKISA;TEH GELAS MARKISA;1;2000;0;2000;1178;822;
2021-11-01 21:40:13;089686067002;POP MIE PDS DOWER RS AYAM;4;5000;0;20000;17800;2200;
2021-11-01 21:44:14;8998989110167;SURYA GUDANG GARAM 16 FILTER;1;26000;0;26000;23700;2300;
2021-11-01 21:44:14;8999909001909;MAGNUM REVAMP BLACK 12;1;18000;0;18000;16300;1700;
2021-11-01 21:44:14;8998989500166;GUDANG GARAM MERAH BESAR 16KS;1;18000;0;18000;17000;1000;
2021-11-01 21:44:14;8994867007161;ROKOK PENA GOLD 20;1;18000;0;18000;16800;1200;
2021-11-01 21:44:14;ARG;ARGUS DOS 220ML;1;14500;0;14500;13300;1200;
2021-11-01 21:45:13;8998866501033;MINYAK GORENG SEDAAP POUCH 2L;1;34000;0;34000;29683;4317;
2021-11-01 21:45:50;kiko;kiko;2;1000;0;2000;1800;200;
2021-11-01 21:48:18;CC;NICE FACIAL KILOAN 900 GR DUO;1;34500;0;34500;31325;3175;
2021-11-01 21:48:18;ICE CREAM 5;ICE CREAM 5000;1;5000;0;5000;4400;600;
2021-11-01 21:48:45;8998866501033;MINYAK GORENG SEDAAP POUCH 2L;1;34000;0;34000;29683;4317;
2021-11-01 21:49:16;8999801700054;SUSU FOYU 1 KG;1;22000;0;22000;19791;2209;
2021-11-01 21:49:44;gula;GULA;1;11500;0;11500;10000;1500;
2021-11-01 21:50:39;8992761111533;SPRITE SLIM CAM250ML;1;5000;0;5000;3750;1250;
2021-11-01 21:50:39;8997028590014;ARGUS 220ML;2;500;0;1000;604;396;
2021-11-01 21:51:30;ICE CREAM;ICE CREAM 2000;1;2000;0;2000;1700;300;
2021-11-01 21:51:30;8992775211410;PILUS GARUDA PEDAS;1;5000;0;5000;4886;114;
2021-11-01 21:55:13;8997021870076;FRESH CARE SANDAL WOOD 10ML;1;12000;0;12000;10000;2000;
2021-11-01 21:55:13;8991102228053;TEH GELAS BOTOL;1;3000;0;3000;1695;1305;
2021-11-01 21:55:13;8998009040023;TEH KOTAK;1;5000;0;5000;2708;2292;
2021-11-01 21:55:13;Vita Jelly;Vita Jelly;4;1000;0;4000;3064;936;
2021-11-01 21:55:13;8991102387286;TANGO LONG CKLT 47G;1;2000;0;2000;1551;449;
2021-11-01 21:55:13;8991102026383;AIR CRYSTALINE 1.5 L;1;5000;0;5000;3471;1529;
2021-11-01 21:55:13;ROTI;ROTI 2000;1;2000;0;2000;1800;200;
2021-11-01 21:59:01;ICE CREAM 3;ICE CREAM 3000;1;3000;0;3000;2600;400;
2021-11-01 21:59:01;8997028590014;ARGUS 220ML;6;500;0;3000;1812;1188;
2021-11-01 21:59:01;Garuda Pilus;Garuda Pilus Rasa Abon Pcs;2;500;0;1000;802;198;
2021-11-01 21:59:01;8999801700054;SUSU FOYU 1 KG;1;22000;0;22000;19791;2209;
2021-11-01 21:59:01;8998866201520;KOPI TOP TORAJA MURNI;1;11000;0;11000;9600;1400;
2021-11-01 21:59:01;8998866202626;Top Kopi Gula Aren 22gr;1;1000;0;1000;553;447;
2021-11-01 22:04:30;9556001047175;NESCAFE ORI 240ML;1;8500;0;8500;7834;666;
2021-11-01 22:07:17;gula;GULA;3;11500;0;34500;30000;4500;
2021-11-01 22:11:17;8999999551223;RINSO ACTIVE FRESH LIQ 700ML;1;19500;0;19500;17900;1600;
2021-11-01 22:11:17;Telur 7 Biji;Telur 7 Biji;1;10000;0;10000;8400;1600;
2021-11-01 22:11:17;RT;ROTI;1;9000;0;9000;8000;1000;
2021-11-01 22:11:35;8992702000018;INDOMILK PUTIH 370G;1;10000;0;10000;9208;792;
2021-11-01 22:12:23;MARS;MARSHMELLOW;2;500;0;1000;866;134;
2021-11-01 22:12:46;8992761166205;FRESTEA GREEN HONEY 350ML;1;4500;0;4500;3000;1500;
2021-11-01 22:13:19;Garuda pilus pcs;Garuda pilus Rasa Mi Goreng pcs;2;1000;0;2000;1616;384;
2021-11-01 22:21:45;8997218380074;ICHITAN MILK TEA;1;8000;0;8000;6500;1500;
2021-11-01 22:21:45;YP;YUPI;4;250;0;1000;832;168;
2021-11-01 22:29:04;8992959850046;CONFI PANTS M10;1;80000;0;80000;75120;4880;
2021-11-01 22:33:24;8998866202299;KECAP MANIS SEDAAP SPC REFILL 220ML;1;9500;0;9500;8500;1000;
2021-11-02 21:04:56;Garuda pilus pcs;Garuda pilus Rasa Mi Goreng pcs;2;1000;0;2000;1616;384;
2021-11-02 21:04:56;8994834006128;TICTIC PEDAS;1;2000;0;2000;1700;300;
2021-11-02 21:04:56;BALON;BALON CABUT;1;1000;0;1000;900;100;
2021-11-02 21:04:56;8992959001875;SWEETY SILVER PANTS S1;2;2000;0;4000;3056;944;
2021-11-02 21:05:45;8997210107877;VORTEX SMART 3;1;5000;0;5000;4750;250;
2021-11-02 21:06:15;8997210107877;VORTEX SMART 3;1;5000;0;5000;4750;250;
2021-11-02 21:20:40;8993379152017;SABUN CUCI SURYA 200G;2;3000;0;6000;4562;1438;
2021-11-02 21:20:40;8991002121010;GOOD DAY FANTASTIC MOCACINNO;1;7000;0;7000;4750;2250;
2021-11-02 21:20:40;8998866200561;EKOMIE SUPER 600GR;2;10000;0;20000;17230;2770;
2021-11-02 21:20:40;089686386127;BUMBU RACIK NASI GORENG SOSIS;1;2000;0;2000;1620;380;
2021-11-02 21:26:21;8999909004221;SAMPOERNA ULTRAMILD 16;1;22000;0;22000;20350;1650;
2021-11-02 21:26:21;8999999530488;AXE PERFECT CONTROL POMADE 75G;1;30200;0;30200;28050;2150;
2021-11-02 21:26:21;8999999034726;PONDS MEN WHITE BOOST 50G;1;18500;0;18500;17160;1340;
2021-11-02 21:26:21;8992388133345;NU MILK TEA TEH TARIK 330ML;2;6000;0;12000;10250;1750;
2021-11-02 21:31:55;8998898852127;KKB ENER-G MANGGA;1;5500;0;5500;4824;676;
2021-11-02 21:35:33;8991102103091;Formula Proteksi;1;3500;0;3500;2650;850;
2021-11-02 21:35:33;8998866202626;Top Kopi Gula Aren 22gr;1;1000;0;1000;553;447;
2021-11-02 21:35:33;8998866606158;NUVO ACTIVE COOL 110G;1;3000;0;3000;2600;400;
2021-11-02 21:35:33;8997027300089;NOMOS;1;4000;0;4000;2963;1037;
2021-11-02 21:43:56;8992959117583;SFX DS REG FLOW WING 20;2;5000;0;10000;8576;1424;
2021-11-02 21:43:56;8993351139807;REAL GOOD;16;1000;0;16000;12800;3200;
2021-11-02 21:50:43;8993007002967;KRIMER KENTAL MANIS;1;10500;0;10500;9791;709;
2021-11-02 21:51:25;OJELLY;O'JELLY;2;500;0;1000;770;230;
2021-11-02 21:57:25;8992775211410;PILUS GARUDA PEDAS;1;5000;0;5000;4886;114;
2021-11-02 21:57:25;8998866202619;MIE SEDAAP KOREAN SPICY SOUP;1;2700;0;2700;2322;378;
2021-11-02 21:57:25;8993351139807;REAL GOOD;2;1000;0;2000;1600;400;
2021-11-02 21:57:25;8998866201889;KRISBEE PILLOW STRAWBERRY ICE CREAM 120GR;1;8000;0;8000;7250;750;
2021-11-02 21:57:25;8992775002582;DILAN CHOCO;2;2000;0;4000;3006;994;
2021-11-02 21:57:25;8993571004732;SALAS SALEP CAP19 6G;1;7000;0;7000;6000;1000;
2021-11-02 21:57:25;8997027300089;NOMOS;1;4000;0;4000;2963;1037;
2021-11-02 21:58:52;8998989500166;GUDANG GARAM MERAH BESAR 16KS;1;18000;0;18000;17000;1000;
2021-11-02 21:58:52;8994867007161;ROKOK PENA GOLD 20;2;18000;0;36000;33600;2400;
2021-11-02 21:58:52;8993351139807;REAL GOOD;3;1000;0;3000;2400;600;
2021-11-02 22:00:09;8994834006128;TICTIC PEDAS;1;2000;0;2000;1700;300;
2021-11-02 22:03:30;8998898101409;TOLAK ANGIN SIDOMUNCUL;2;3500;0;7000;5416;1584;
2021-11-02 22:08:20;8998866609494;SOKLIN SOFTERGEN 280G BIRU;1;5000;0;5000;4425;575;
2021-11-02 22:08:20;ARG;ARGUS DOS 220ML;1;14500;0;14500;13300;1200;
2021-11-02 22:19:12;8886022830243;BATEREI ABC;5;2500;0;12500;9640;2860;
2021-11-02 22:26:02;8999999524722;SUNLIGHT LIME NEW PCH 435ML;2;10000;0;20000;18200;1800;
2021-11-02 22:26:02;8992702000063;INDOMILK COKLAT 370G;1;10000;0;10000;9208;792;
2021-11-02 22:28:59;8999909001909;MAGNUM REVAMP BLACK 12;1;18000;0;18000;16300;1700;
2021-11-02 22:32:36;8993989311699;CLAS MILD 16 FILTER;1;24000;0;24000;21700;2300;
2021-11-02 22:32:36;8992761166205;FRESTEA GREEN HONEY 350ML;1;4500;0;4500;3000;1500;
2021-11-02 22:32:36;8991909101016;URBAN MILD 16;1;17000;0;17000;15800;1200;
2021-11-02 22:32:36;8992761139018;ADES 600ML;1;3500;0;3500;2166;1334;
2021-11-02 22:32:36;8999999007782;FAIR&LOVELY MULTIVITAMIN CREAM 25 MG;1;16500;0;16500;14905;1595;
2021-11-02 22:32:36;Telur 3 Biji;Telur 3 Biji;1;5000;0;5000;3600;1400;
2021-11-02 22:32:36;089686386127;BUMBU RACIK NASI GORENG SOSIS;1;2000;0;2000;1620;380;
2021-11-02 22:32:36;8998866202244;EKOMIE BUMBU KALDU AYAM;1;1000;0;1000;798;202;
2021-11-02 22:32:36;8993351139807;REAL GOOD;2;1000;0;2000;1600;400;
2021-11-02 22:36:52;8994867006997;ROKOK PENA BOLD 20BTG;1;17000;0;17000;15000;2000;
2021-11-02 22:36:52;RT;ROTI;1;9000;0;9000;8000;1000;
2021-11-02 22:36:52;8993351139807;REAL GOOD;1;1000;0;1000;800;200;
2021-11-02 22:36:52;8991102714846;MILKIDO CKLT;1;3000;0;3000;2153;847;
2021-11-02 22:36:52;8992761111540;FANTA STRAWBERY SLIM CAM 250ML;1;5000;0;5000;3750;1250;
2021-11-02 22:36:52;8998866501033;MINYAK GORENG SEDAAP POUCH 2L;3;34000;0;102000;89049;12951;
2021-11-02 22:37:47;8993351139807;REAL GOOD;2;1000;0;2000;1600;400;
2021-11-02 22:37:47;YP;YUPI;4;250;0;1000;832;168;
2021-11-02 22:41:11;7622300335809;OREO SOFT CAKE;1;2000;0;2000;1641;359;
2021-11-02 22:41:11;089686011036;INDOMIE GORENG PEDAS;1;2700;0;2700;2452;248;
2021-11-02 22:41:11;7622201430153;OREO CHOCOLATE 38G;1;2000;0;2000;1641;359;
2021-11-02 22:41:11;8993351139807;REAL GOOD;3;1000;0;3000;2400;600;
2021-11-02 22:41:11;8999801700030;SUSU FOYU;1;11500;0;11500;10450;1050;
2021-11-02 22:41:11;8995150101696;M+SUSU ORIGINAL;3;5000;0;15000;12000;3000;
2021-11-02 22:41:11;8998866200882;SUKSESMIE GORENG AYAM KRMS 133GR;1;3500;0;3500;3047;453;
2021-11-02 22:42:14;8991102281416;PERMEN MINTZ PPMINT;1;5000;0;5000;4000;1000;
2021-11-02 22:45:02;8999909001909;MAGNUM REVAMP BLACK 12;1;18000;0;18000;16300;1700;
2021-11-02 22:45:02;8998009040023;TEH KOTAK;1;5000;0;5000;2708;2292;
2021-11-02 22:45:02;8997028590052;ARGUS BTL 600ML;2;3000;0;6000;2916;3084;
2021-11-02 22:45:02;8991914101513;VIPER KRETEK 12;1;6000;0;6000;5000;1000;
2021-11-03 11:43:59;8998989110167;SURYA GUDANG GARAM 16 FILTER;1;26000;0;26000;23700;2300;
2021-11-03 20:37:46;8991102228053;TEH GELAS BOTOL;1;3000;0;3000;1695;1305;
2021-11-03 20:40:37;8995555111221;sosis kimbo;2;1000;0;2000;1700;300;
2021-11-03 20:40:37;GGK;PLAYGUM PERMEN KARET;4;500;0;2000;1600;400;
2021-11-03 20:45:53;8994935000049;MINYAK GORENG DAMAI 5L;1;75000;0;75000;73780;1220;
2021-11-03 20:48:02;8991004011906;KOPI BORONG;1;10000;0;10000;8333;1667;
2021-11-03 20:48:02;8997021290348;Teh Gunung Tengah;1;6000;0;6000;5000;1000;
2021-11-03 20:48:02;8997027300089;NOMOS;2;4000;0;8000;5926;2074;
2021-11-03 20:48:38;8999999049416;REXONA MEN RO QUANTUM 45 ML;1;15000;0;15000;13550;1450;
2021-11-03 20:50:16;8993351139807;REAL GOOD;6;1000;0;6000;4800;1200;
2021-11-03 20:50:16;BALON;BALON CABUT;1;1000;0;1000;900;100;
2021-11-03 20:50:16;8998989300261;GUDANG GARAM SURYA 12 FILTER;1;20000;0;20000;18150;1850;
2021-11-03 20:51:58;123124;KOREK BIASA;1;2000;0;2000;1300;700;
2021-11-03 20:51:58;8934868015031;REXONA DEO LOTION ICE COOL;1;4500;0;4500;3900;600;
2021-11-03 20:51:58;8998989110501;gudang garam surya;2;2000;0;4000;2760;1240;
2021-11-03 21:03:36;6907992825076;JD WATERMELON APPLE;1;2000;0;2000;1700;300;
2021-11-03 21:09:09;8991102024778;FORMULA SENSITIVE;1;12000;0;12000;10000;2000;
2021-11-03 21:09:09;8992725910424;LISTERINE FRESH BURST 250ML;1;19000;0;19000;17550;1450;
2021-11-03 21:09:09;8998866106313;EMERON LOVELY GLOW&BRIGHT 200ML;1;7500;0;7500;6475;1025;
2021-11-03 21:09:09;8998989110501;gudang garam surya;3;2000;0;6000;4140;1860;
2021-11-03 21:09:09;ROTI;ROTI 2000;2;2000;0;4000;3600;400;
2021-11-03 21:09:51;RT;ROTI;1;9000;0;9000;8000;1000;
2021-11-03 21:20:42;RB;RED BOLD;1;20000;0;20000;18800;1200;
2021-11-03 21:20:42;8992628022156;MINYAK GORENG BIMOLI POUCH 1 LT;1;17500;0;17500;16675;825;
2021-11-03 21:20:42;8999999042639;RINSO ANTI NODA CLS LIQ 40ML;2;1000;0;2000;1610;390;
2021-11-03 21:20:42;8997028590052;ARGUS BTL 600ML;1;3000;0;3000;1458;1542;
2021-11-03 21:20:42;089686021127;INTER MIE KALDU;1;1000;0;1000;813;187;
2021-11-03 21:20:42;8998866202619;MIE SEDAAP KOREAN SPICY SOUP;1;2700;0;2700;2322;378;
2021-11-03 21:20:42;Garuda pilus;Garuda Pilus Pedas Pcs;2;500;0;1000;816;184;
2021-11-03 21:20:42;8997009510017;YOU C1000 LEMON;1;10000;0;10000;9166;834;
2021-11-03 21:20:42;8999999059781;SUNLIGHT LIME NEW POUCH 210ML;1;5000;0;5000;4520;480;
2021-11-03 21:24:11;8992761111519;COCA COLA SLIM CAM 250ML;3;5000;0;15000;11250;3750;
2021-11-03 22:06:52;8997021870076;FRESH CARE SANDAL WOOD 10ML;1;12000;0;12000;10000;2000;
2021-11-03 22:13:48;ICE CREAM 3;ICE CREAM 3000;1;3000;0;3000;2600;400;
2021-11-03 22:13:48;8998866608459;POWDET DAIA PUTIH BAG 290GR;1;5000;0;5000;4450;550;
2021-11-03 22:13:48;8991102987639;WFR TANGO LONG VNL 130G;1;5000;0;5000;4350;650;
2021-11-03 22:13:48;711844110083;KECAP ABC 275 ML;1;16000;0;16000;15000;1000;
2021-11-03 22:13:48;711844120037;SAMBAL ABC 135 ML;1;7000;0;7000;5600;1400;
2021-11-03 22:13:48;8996001351895;ZUPERRR KEJU SUSU;1;10000;0;10000;8000;2000;
2021-11-03 22:13:48;8993351139807;REAL GOOD;3;1000;0;3000;2400;600;
2021-11-03 22:18:40;8997028590014;ARGUS 220ML;6;500;0;3000;1812;1188;
2021-11-03 22:18:40;089686021141;INTER MIE SOTO;2;1000;0;2000;1708;292;
2021-11-03 22:18:40;8993351139807;REAL GOOD;2;1000;0;2000;1600;400;
2021-11-03 22:18:40;8998989110501;gudang garam surya;4;2000;0;8000;5520;2480;
2021-11-03 22:18:40;KRIPIK;KRIPIK KENTANG;3;1000;0;3000;2700;300;
2021-11-03 22:18:40;089686021127;INTER MIE KALDU;2;1000;0;2000;1626;374;
2021-11-03 22:18:40;8998866202244;EKOMIE BUMBU KALDU AYAM;1;1000;0;1000;798;202;
2021-11-03 22:18:40;RT 1000;ROTI 1000;1;1000;0;1000;800;200;
2021-11-04 10:13:25;8991102714631;TANGO TETRA CKLT;1;5000;0;5000;4545;455;
2021-11-04 20:02:11;8999999008475;SUNLIGHT LIME NEW REF 1600ML;1;35000;0;35000;31955;3045;
2021-11-04 20:07:03;8993351139807;REAL GOOD;3;1000;0;3000;2400;600;
2021-11-04 20:07:03;8998866803694;SOKLIN SOFTERGENT PURPLE BAG 770 & PIRING;1;20000;0;20000;18055;1945;
2021-11-04 20:07:03;ROTI;ROTI 2000;1;2000;0;2000;1800;200;
2021-11-04 20:07:03;8997028590014;ARGUS 220ML;2;500;0;1000;604;396;
2021-11-04 20:07:03;8998989300261;GUDANG GARAM SURYA 12 FILTER;1;20000;0;20000;18150;1850;
2021-11-04 20:07:03;8994867006997;ROKOK PENA BOLD 20BTG;1;17000;0;17000;15000;2000;
2021-11-04 20:07:03;8997028590052;ARGUS BTL 600ML;1;3000;0;3000;1458;1542;
2021-11-04 20:07:03;KOPIKO;KOPIKO;4;250;0;1000;700;300;
2021-11-04 20:07:03;Telur 7 Biji;Telur 7 Biji;1;10000;0;10000;8400;1600;
2021-11-04 20:07:03;8998866200325;MIE SEDAAP SOTO;4;2700;0;10800;9128;1672;
2021-11-04 20:13:02;8886022971298;BATERAI ALKALINE 06;1;12000;0;12000;10557;1443;
2021-11-04 20:13:02;8992959001875;SWEETY SILVER PANTS S1;2;2000;0;4000;3056;944;
2021-11-04 20:13:02;8992957220087;COKLAT SINGA;2;2000;0;4000;3400;600;
2021-11-04 20:22:06;8998866606158;NUVO ACTIVE COOL 110G;3;3000;0;9000;7800;1200;
2021-11-04 20:22:06;8999999030179;PEPSODENT ACTION 123 COMPLETE 75G;1;6700;0;6700;5170;1530;
2021-11-04 20:22:06;8992775305003 pcs;Gery Salut Coklat pcs;2;1000;0;2000;1624;376;
2021-11-04 20:22:06;8992702000063;INDOMILK COKLAT 370G;1;10000;0;10000;9208;792;
2021-11-04 20:22:06;8998866201377;KRISBEE FRIES KENTANG GORENG 68 GR;1;5500;0;5500;4620;880;
2021-11-04 20:22:06;8993351139807;REAL GOOD;3;1000;0;3000;2400;600;
2021-11-04 20:22:06;8998866202244;EKOMIE BUMBU KALDU AYAM;1;1000;0;1000;798;202;
2021-11-04 20:22:06;8997018250218;JAHE MERAH;1;1000;0;1000;833;167;
2021-11-04 20:22:06;8998898847109;KOPI JAHE;1;1500;0;1500;1180;320;
2021-11-04 20:22:06;8997018250058;SUSU JAHE;1;1000;0;1000;800;200;
2021-11-04 20:22:06;8992388101085;NU GREEN TEA ORIGINAL 330ML;1;3500;0;3500;2768;732;
2021-11-04 20:22:06;8992959953334;SWEETY BRONZE XL42;1;80000;0;80000;75455;4545;
2021-11-04 20:22:06;gula;GULA;1;11500;0;11500;10000;1500;
2021-11-04 20:41:47;8998866888639;GIV HIJAU KOTAK 76G;1;2000;0;2000;1820;180;
2021-11-04 20:41:47;8998866601429;POWDET DAIA BUNGA BAG 290GR;3;5000;0;15000;13350;1650;
2021-11-04 20:41:47;8992775000663;GERY SNACK KEJU;1;2000;0;2000;1712;288;
2021-11-04 20:41:47;8992761122430;FRESTEA GREEN HONEY 500ML;1;6500;0;6500;4708;1792;
2021-11-04 20:41:47;8998866201889;KRISBEE PILLOW STRAWBERRY ICE CREAM 120GR;1;8000;0;8000;7250;750;
2021-11-04 20:41:47;8991111101422;JB POWDER 200G;1;11700;0;11700;10660;1040;
2021-11-04 20:41:47;8991111101965;JB POWDER 300G;1;12500;0;12500;11250;1250;
2021-11-04 20:41:47;8991111102832;JB POWDER BEDTIME 300G;1;14500;0;14500;13120;1380;
2021-11-04 20:51:48;8993176110081;MINYAK KAYU PUTIH 30ML;1;12000;0;12000;9091;2909;
2021-11-04 20:51:48;8991102987639;WFR TANGO LONG VNL 130G;1;5000;0;5000;4350;650;
2021-11-04 20:51:48;8991001780140;TWISTER CHOCO;1;5000;0;5000;4600;400;
2021-11-04 20:51:48;ROTI;ROTI 2000;2;2000;0;4000;3600;400;
2021-11-04 20:51:48;089686386127;BUMBU RACIK NASI GORENG SOSIS;1;2000;0;2000;1620;380;
2021-11-04 20:51:48;089686021219;INTER MIE GORENG;1;1000;0;1000;885;115;
2021-11-04 20:51:48;089686011036;INDOMIE GORENG PEDAS;1;2700;0;2700;2452;248;
2021-11-04 20:51:48;KRIPIK;KRIPIK KENTANG;1;1000;0;1000;900;100;
2021-11-04 20:51:48;TBR;TEPUNG BERAS ROSE BRAND;1;8000;0;8000;6150;1850;
2021-11-04 20:51:48;ARG;ARGUS DOS 220ML;1;14500;0;14500;13300;1200;
2021-11-04 20:51:48;ICE CREAM 3;ICE CREAM 3000;1;3000;0;3000;2600;400;
2021-11-04 20:51:48;8999909096004;SAMPOERNA 16 FILTER;1;25000;0;25000;23100;1900;
2021-11-04 20:51:48;8998866501033;MINYAK GORENG SEDAAP POUCH 2L;3;34000;0;102000;89049;12951;
2021-11-04 20:59:04;8995333060772;TERIGU GATOT KACA 500GR;1;5000;0;5000;4346;654;
2021-11-04 20:59:04;8998866202244;EKOMIE BUMBU KALDU AYAM;1;1000;0;1000;798;202;
2021-11-04 20:59:04;8998866202626;Top Kopi Gula Aren 22gr;1;1000;0;1000;553;447;
2021-11-04 20:59:04;11222;LEM KOREA;1;10000;0;10000;8000;2000;
2021-11-04 20:59:04;8999999706081;PEPSODENT WHITE 75G;1;5000;0;5000;3850;1150;
2021-11-04 20:59:04;7118441101378;KECAP ABC 520 ML;1;19000;0;19000;17800;1200;
2021-11-04 20:59:04;SMBL;SAMBAL ABC BLINK 335 ML;1;14000;0;14000;12550;1450;
2021-11-04 20:59:04;8996001301142;ROMA KELAPA;1;8000;0;8000;7000;1000;
2021-11-04 20:59:04;8997028380165;BISKUIT;1;10000;0;10000;9000;1000;
2021-11-04 20:59:04;8992959953013;SWEETY BRONZE S1;6;2000;0;12000;8274;3726;
2021-11-04 20:59:04;8993351139807;REAL GOOD;4;1000;0;4000;3200;800;
2021-11-04 20:59:04;8999999526863;MOLTO ALL IN ONE PINK 11ML;1;5500;0;5500;4800;700;
2021-11-04 21:02:10;8998866105644;EMERON LOVELY SMOTH&BRIGHT 200ML;1;7500;0;7500;6475;1025;
2021-11-04 21:02:10;8997028590014;ARGUS 220ML;3;500;0;1500;906;594;
2021-11-04 21:02:10;8994834006128;TICTIC PEDAS;1;2000;0;2000;1700;300;
2021-11-04 21:02:10;YP;YUPI;6;250;0;1500;1248;252;
2021-11-04 21:02:10;8998866202978;Guribee Rumput Laut 68 gr;1;6000;0;6000;5100;900;
2021-11-04 21:02:39;8999909096004;SAMPOERNA 16 FILTER;2;25000;0;50000;46200;3800;
2021-11-04 21:03:12;8997028590014;ARGUS 220ML;6;500;0;3000;1812;1188;
2021-11-04 21:04:10;8998866200325;MIE SEDAAP SOTO;1;2700;0;2700;2282;418;
2021-11-04 21:04:29;ARG;ARGUS DOS 220ML;1;14500;0;14500;13300;1200;
2021-11-04 21:07:05;8999999516208;ROYCO FDS CHICKEN NEW 230G;1;10000;0;10000;9000;1000;
2021-11-04 21:26:26;8998989300261;GUDANG GARAM SURYA 12 FILTER;1;20000;0;20000;18150;1850;
2021-11-04 21:26:26;8991102989312;WFR TANGO SBJ 7G;1;10000;0;10000;8200;1800;
2021-11-04 21:26:26;8998866202312;NOODLE SEDAAP TASTY BAKMI AYAM 129 GR;1;5000;0;5000;4167;833;
2021-11-04 21:26:26;8998866200578;MIE SEDAAP KARI KENTAL;2;2700;0;5400;4662;738;
2021-11-04 21:26:26;089686021219;INTER MIE GORENG;4;1000;0;4000;3540;460;
2021-11-04 21:26:26;8998866608459;POWDET DAIA PUTIH BAG 290GR;1;5000;0;5000;4450;550;
2021-11-04 21:26:26;8996001410042;TB TORA MOKA;10;1500;0;15000;8700;6300;
2021-11-04 21:26:26;8998866612180;SOKLIN SOFTERGEN 280G SAKURA;1;5000;0;5000;4425;575;
2021-11-04 21:26:26;8991102714846;MILKIDO CKLT;1;3000;0;3000;2153;847;
2021-11-04 21:26:26;8997028590052;ARGUS BTL 600ML;1;3000;0;3000;1458;1542;
2021-11-04 21:26:26;8999999524722;SUNLIGHT LIME NEW PCH 435ML;1;10000;0;10000;9100;900;
2021-11-04 21:26:26;8999999520878;WIPOL 240ML;1;5000;0;5000;4250;750;
2021-11-04 21:26:26;8992696422650;NESCAFE FRENCH VANILLA;1;5000;0;5000;4099;901;
2021-11-04 21:26:26;8999999031930;PEPSODENT TB TRIPLE CLEAN;1;3500;0;3500;2850;650;
2021-11-04 21:26:26;8991188943536;SASA SANTAN KELAPA 65ML;1;3000;0;3000;2437;563;
2021-11-04 21:26:26;8992705025124;AGAR-AGAR SATELIT MERAH;2;3500;0;7000;5208;1792;
2021-11-04 21:30:22;8997028590014;ARGUS 220ML;6;500;0;3000;1812;1188;
2021-11-04 21:30:22;8995150109418;M+SUSU RASA MANGGA;1;5000;0;5000;4000;1000;
2021-11-04 21:30:22;8998866501033;MINYAK GORENG SEDAAP POUCH 2L;2;34000;0;68000;59366;8634;
2021-11-04 21:30:22;8994397000021;LEM FOX;1;12000;0;12000;10800;1200;
2021-11-04 21:30:22;8991102714891;Kopi Seruput susu tulen 200 ml;1;3000;0;3000;2375;625;
2021-11-04 21:30:22;8997028590052;ARGUS BTL 600ML;2;3000;0;6000;2916;3084;
2021-11-04 21:30:57;8991102281416;PERMEN MINTZ PPMINT;1;5000;0;5000;4000;1000;
2021-11-04 21:31:35;8999801700054;SUSU FOYU 1 KG;1;22000;0;22000;19791;2209;
2021-11-04 21:32:57;8998866108003;EMERON HJB CLEANFRESH 10ML;1;5000;0;5000;4185;815;
2021-11-04 21:37:48;ARG;ARGUS DOS 220ML;1;14500;0;14500;13300;1200;
2021-11-04 21:37:48;089686834307;FREISS LECI;1;11000;0;11000;8750;2250;
2021-11-04 21:37:48;8998866201711;KRISBEE KRUNCHY JAGUNG BAKAR MENTEGA 75 GR;1;5500;0;5500;4400;1100;
2021-11-04 21:37:48;8991188943536;SASA SANTAN KELAPA 65ML;2;3000;0;6000;4874;1126;
2021-11-04 21:39:43;8998866202619;MIE SEDAAP KOREAN SPICY SOUP;5;2700;0;13500;11610;1890;
2021-11-04 21:39:43;8991102385121;WFR TANGO VNL 7G;1;8300;0;8300;7455;845;
2021-11-04 21:39:43;BALON;BALON CABUT;3;1000;0;3000;2700;300;
2021-11-04 21:40:26;gula;GULA;1;11500;0;11500;10000;1500;
2021-11-04 21:40:26;8991102987639;WFR TANGO LONG VNL 130G;2;5000;0;10000;8700;1300;
2021-11-04 21:42:24;8991102989312;WFR TANGO SBJ 7G;1;10000;0;10000;8200;1800;
2021-11-04 21:42:24;8998866200325;MIE SEDAAP SOTO;4;2700;0;10800;9128;1672;
2021-11-04 21:42:24;8999999524722;SUNLIGHT LIME NEW PCH 435ML;2;10000;0;20000;18200;1800;
2021-11-04 21:43:52;9556006014585;JB SHAMPOO SHOFT&SMOOTH 100ML;1;10500;0;10500;9450;1050;
2021-11-04 21:43:52;8993335521260;Sabun Total Violet 900gr;1;15000;0;15000;13800;1200;
2021-11-04 21:50:00;8999909096004;SAMPOERNA 16 FILTER;1;25000;0;25000;23100;1900;
2021-11-04 21:50:00;8998866202244;EKOMIE BUMBU KALDU AYAM;2;1000;0;2000;1596;404;
2021-11-04 21:50:00;8997028590014;ARGUS 220ML;6;500;0;3000;1812;1188;
2021-11-04 21:50:00;8998866608305;GIV BENGKOANG KOTAK 76G;1;2000;0;2000;1820;180;
2021-11-04 21:50:00;ROTI;ROTI 2000;1;2000;0;2000;1800;200;
2021-11-04 21:50:00;8998989500166;GUDANG GARAM MERAH BESAR 16KS;1;18000;0;18000;17000;1000;
2021-11-04 21:50:00;8998866202671;NOODLE SEDAAP MIE KOREAN SPICY SOUP CUP;1;5000;0;5000;4002;998;
2021-11-04 21:50:00;089686011036;INDOMIE GORENG PEDAS;1;2700;0;2700;2452;248;
2021-11-04 21:50:00;ICE CREAM;ICE CREAM 2000;8;2000;0;16000;13600;2400;
2021-11-04 21:50:00;8992736925134;SASA TEPUNG BUMBU SERBAGUNA;1;5500;0;5500;4700;800;
2021-11-04 21:50:00;8998866692663;SOKLIN FLOORCLENER KUNING 450ML;1;7000;0;7000;6385;615;
2021-11-04 21:50:00;gula;GULA;1;11500;0;11500;10000;1500;
2021-11-04 21:50:18;8999909096004;SAMPOERNA 16 FILTER;1;25000;0;25000;23100;1900;
2021-11-05 21:13:57;8998989300261;GUDANG GARAM SURYA 12 FILTER;1;20000;0;20000;18150;1850;
2021-11-05 21:13:57;8998866200325;MIE SEDAAP SOTO;1;2700;0;2700;2282;418;
2021-11-05 21:15:27;089686060126;POP MIE BASO JUMBO;1;4500;0;4500;3833;667;
2021-11-05 21:15:27;089686060362;POP MIE SOTO AYAM JUMBO;1;4500;0;4500;3833;667;
2021-11-05 21:17:05;7622201430153;OREO CHOCOLATE 38G;2;2000;0;4000;3282;718;
2021-11-05 21:33:38;PULPEN;PULPEN BIASA;3;2000;0;6000;4500;1500;
2021-11-05 21:34:33;8991102228053;TEH GELAS BOTOL;1;3000;0;3000;1695;1305;
2021-11-05 21:34:33;8998009040023;TEH KOTAK;1;5000;0;5000;2708;2292;
2021-11-05 21:38:01;8991102026383;AIR CRYSTALINE 1.5 L;1;5000;0;5000;3471;1529;
2021-11-05 21:38:01;Telur 3 Biji;Telur 3 Biji;1;5000;0;5000;3600;1400;
2021-11-05 21:38:01;8992775000663;GERY SNACK KEJU;1;2000;0;2000;1712;288;
2021-11-05 21:38:01;PULPEN;PULPEN BIASA;8;2000;0;16000;12000;4000;
2021-11-05 21:38:01;8991002121065;GOOD DAY AVOCADO DELIGHT;1;6000;0;6000;4295;1705;
2021-11-05 21:40:39;123124;KOREK BIASA;1;2000;0;2000;1300;700;
2021-11-05 21:40:39;8997028590052;ARGUS BTL 600ML;2;3000;0;6000;2916;3084;
2021-11-05 21:40:39;8991102281416;PERMEN MINTZ PPMINT;1;5000;0;5000;4000;1000;
2021-11-05 21:40:39;YP;YUPI;16;250;0;4000;3328;672;
2021-11-05 21:40:39;8994834006128;TICTIC PEDAS;1;2000;0;2000;1700;300;
2021-11-05 21:40:39;8997028590014;ARGUS 220ML;2;500;0;1000;604;396;
2021-11-05 22:26:47;8997028590014;ARGUS 220ML;2;500;0;1000;604;396;
2021-11-05 22:26:47;8997028590052;ARGUS BTL 600ML;1;3000;0;3000;1458;1542;
2021-11-05 22:28:18;8992696404441;BEAR BRAND 189ML;1;12000;0;12000;8585;3415;
2021-11-05 22:32:12;8998866608305;GIV BENGKOANG KOTAK 76G;5;2000;0;10000;9100;900;
2021-11-05 22:33:52;089686727081;DORITOS 55G;1;7000;0;7000;5950;1050;
2021-11-05 22:33:52;ICE CREAM 3;ICE CREAM 3000;1;3000;0;3000;2600;400;
2021-11-05 22:33:52;ARGUS;ARGUS;1;2000;0;2000;1500;500;
2021-11-05 22:35:50;Telur 3 Biji;Telur 3 Biji;4;5000;0;20000;14400;5600;
2021-11-06 17:18:05;8992979130012;TOTAL LEMON SOFTENER;1;15000;0;15000;13800;1200;
2021-11-06 17:18:05;8999999557447;PEPSODENT ACTION123 SIWAK 110G;2;9000;0;18000;16000;2000;
2021-11-06 17:18:05;8992736925134;SASA TEPUNG BUMBU SERBAGUNA;1;5500;0;5500;4700;800;
2021-11-06 17:18:05;4902430400886;PANTENE HAIRFALL 130ML;1;20000;0;20000;17860;2140;
2021-11-06 17:18:05;8999999533724;CITRA TS PEARLY WHITE CNT 70G;2;2300;0;4600;3800;800;
2021-11-06 17:18:05;gula;GULA;2;11500;0;23000;20000;3000;
2021-11-06 17:20:17;8999909010567;234 DJI SAM SOE 16;2;22500;0;45000;43000;2000;
2021-11-06 17:23:28;8998866107457;POSH SUMMER LOVE 150ML;1;19500;0;19500;17500;2000;
2021-11-06 17:23:28;8999908059802;MY BABY POWDER KUNING;1;5000;0;5000;3276;1724;
2021-11-06 17:23:28;ROTI;ROTI 2000;2;2000;0;4000;3600;400;
2021-11-06 17:30:09;8993351139807;REAL GOOD;2;1000;0;2000;1600;400;
2021-11-06 18:16:22;8997028590014;ARGUS 220ML;2;500;0;1000;604;396;
2021-11-06 18:16:22;8998989110501;gudang garam surya;2;2000;0;4000;2760;1240;
2021-11-06 19:26:13;8991102022347;SIKAT GIGI FORMULA RIPPLE;1;3000;0;3000;4583;-1583;
2021-11-06 19:34:29;8997028590014;ARGUS 220ML;1;500;0;500;302;198;
2021-11-06 19:34:29;8997028590052;ARGUS BTL 600ML;3;3000;0;9000;4374;4626;
2021-11-06 19:34:29;8998009040023;TEH KOTAK;1;5000;0;5000;2708;2292;
2021-11-06 19:36:36;8997028590014;ARGUS 220ML;4;500;0;2000;1208;792;
2021-11-06 19:36:36;8997028590052;ARGUS BTL 600ML;1;3000;0;3000;1458;1542;
2021-11-06 19:36:36;8991102714846;MILKIDO CKLT;1;3000;0;3000;2153;847;
2021-11-06 19:36:36;8992761111533;SPRITE SLIM CAM250ML;1;5000;0;5000;3750;1250;
2021-11-06 19:43:28;8998866201490;POTABEE REGULER GRILLED SEAWED 68 GR;1;8000;0;8000;7200;800;
2021-11-06 19:43:28;JD VM;JD VANILLA MILKSHAKE;1;5000;0;5000;4300;700;
2021-11-06 19:43:28;ARG;ARGUS DOS 220ML;1;14500;0;14500;13300;1200;
2021-11-06 19:43:28;Gula gula kopiko;gula gula kopiko;3;350;0;1050;750;300;
2021-11-06 19:43:28;8991102987639;WFR TANGO LONG VNL 130G;1;5000;0;5000;4350;650;
2021-11-06 19:43:28;8991102387286;TANGO LONG CKLT 47G;1;2000;0;2000;1551;449;
2021-11-06 19:43:28;Gula gula pulpen;gula gula pulpen;2;2000;0;4000;3500;500;
2021-11-06 19:43:28;8991909101016;URBAN MILD 16;1;17000;0;17000;15800;1200;
2021-11-06 19:46:51;8992761111533;SPRITE SLIM CAM250ML;1;5000;0;5000;3750;1250;
2021-11-06 19:46:51;8998989500166;GUDANG GARAM MERAH BESAR 16KS;1;18000;0;18000;17000;1000;
2021-11-06 19:46:51;ROTI;ROTI 2000;1;2000;0;2000;1800;200;
2021-11-06 19:46:51;8997028590014;ARGUS 220ML;1;500;0;500;302;198;
2021-11-06 19:46:51;8993351139807;REAL GOOD;3;1000;0;3000;2400;600;
2021-11-06 19:46:51;RB;RED BOLD;1;20000;0;20000;18800;1200;
2021-11-06 19:51:52;8994867006997;ROKOK PENA BOLD 20BTG;1;17000;0;17000;15000;2000;
2021-11-06 19:51:52;0105312686040047;yakult;1;2000;0;2000;1500;500;
2021-11-06 19:51:52;ARG 330;ARGUS DOS 330ML;1;35000;0;35000;31000;4000;
2021-11-06 19:51:52;ROTI;ROTI 2000;1;2000;0;2000;1800;200;
2021-11-06 19:51:52;ARG;ARGUS DOS 220ML;1;14500;0;14500;13300;1200;
2021-11-06 19:51:52;8992736925134;SASA TEPUNG BUMBU SERBAGUNA;1;5500;0;5500;4700;800;
2021-11-06 19:51:52;8991102987639;WFR TANGO LONG VNL 130G;1;5000;0;5000;4350;650;
2021-11-06 19:51:52;8992696523067;MILO ACTVGO UHT 180ML;1;4500;0;4500;3719;781;
2021-11-06 19:51:52;8993007001359;INDOMILK KM SCT 37G;1;1500;0;1500;1083;417;
2021-11-06 19:51:52;8999909010567;234 DJI SAM SOE 16;1;22500;0;22500;21500;1000;
2021-11-06 19:57:02;8991102714495;TANGO DRINK COKLAT;2;5000;0;10000;7636;2364;
2021-11-06 19:57:02;8992760223015;OREO CHOCOLATE CREAM 133G;1;8000;0;8000;6300;1700;
2021-11-06 19:57:02;JL;JELLY;2;500;0;1000;800;200;
2021-11-06 19:57:02;8992628020152;MINYAK GOREG BIMOLI POUCH 2L;1;35000;0;35000;29800;5200;
2021-11-06 19:57:02;8992775002582;DILAN CHOCO;1;2000;0;2000;1503;497;
2021-11-06 20:01:41;089686727081;DORITOS 55G;1;7000;0;7000;5950;1050;
2021-11-06 20:01:41;8991102987639;WFR TANGO LONG VNL 130G;1;5000;0;5000;4350;650;
2021-11-06 20:05:58;6907992824963;JD MILKY CHOCOLATE;1;3000;0;3000;2600;400;
2021-11-06 20:10:48;6907992824963;JD MILKY CHOCOLATE;1;3000;0;3000;2600;400;
2021-11-06 20:10:48;8994867000162;ROKOK PUNDIMAS KRETEK16;1;10000;0;10000;8600;1400;
2021-11-06 20:10:48;8997028590014;ARGUS 220ML;3;500;0;1500;906;594;
2021-11-06 20:10:48;8999999538453;SUNSILK SHP SOFT AND  SMOOTH 55 ML;1;5000;0;5000;3750;1250;
2021-11-06 20:10:48;8992946521416;SABUN SHINZUI;2;5000;0;10000;8000;2000;
2021-11-06 20:14:54;8997028590014;ARGUS 220ML;4;500;0;2000;1208;792;
2021-11-06 20:14:54;8992775610367;Garuda Koro paggang;3;1000;0;3000;2484;516;
2021-11-06 20:14:54;8994867000162;ROKOK PUNDIMAS KRETEK16;1;10000;0;10000;8600;1400;
2021-11-06 20:14:54;8992730002992;HAI CANDY;2;7000;0;14000;12000;2000;
2021-11-06 20:14:54;ICE CREAM;ICE CREAM 2000;10;2000;0;20000;17000;3000;
2021-11-06 20:14:54;8993351139807;REAL GOOD;4;1000;0;4000;3200;800;
2021-11-06 20:14:54;8998866200561;EKOMIE SUPER 600GR;2;10000;0;20000;17230;2770;
2021-11-06 20:18:03;6907992823843;JD MOCHA CRISPY;1;5000;0;5000;4400;600;
2021-11-06 20:18:03;8991102714495;TANGO DRINK COKLAT;1;5000;0;5000;3818;1182;
2021-11-06 20:18:03;gula;GULA;2;11500;0;23000;20000;3000;
2021-11-06 20:18:03;ROTI;ROTI 2000;3;2000;0;6000;5400;600;
2021-11-06 20:18:03;8992959117613;SFX DAUN SIRIH 1 WP;2;500;0;1000;826;174;
2021-11-06 20:18:03;8991102213189;BLASTER UNGU;1;5000;0;5000;3106;1894;
2021-11-06 20:23:27;8997028590014;ARGUS 220ML;11;500;0;5500;3322;2178;
2021-11-06 20:23:27;8997878004327;gula-gula milkita;4;250;0;1000;800;200;
2021-11-06 20:23:27;ROTI;ROTI 2000;5;2000;0;10000;9000;1000;
2021-11-06 20:23:27;gula;GULA;1;11500;0;11500;10000;1500;
2021-11-06 20:23:27;8998866604963;POWDET DAIA LEMON 290GR;1;5000;0;5000;4450;550;
2021-11-06 20:23:27;8997028590052;ARGUS BTL 600ML;1;3000;0;3000;1458;1542;
2021-11-06 20:23:27;8991001242013;Top;1;1000;0;1000;500;500;
2021-11-06 20:23:27;8992775001844;Chocolatos original taste;1;1000;0;1000;829;171;
2021-11-06 20:28:03;8997028590014;ARGUS 220ML;6;500;0;3000;1812;1188;
2021-11-06 20:28:03;JD VM;JD VANILLA MILKSHAKE;2;5000;0;10000;8600;1400;
2021-11-06 20:28:03;YP;YUPI;4;250;0;1000;832;168;
2021-11-06 20:28:03;8992775203422;GARUDA ROSTA OVEN BAWANG 100G;1;8000;0;8000;7322;678;
2021-11-06 20:28:03;8992959117613;SFX DAUN SIRIH 1 WP;2;500;0;1000;826;174;
2021-11-06 20:30:05;8997028590014;ARGUS 220ML;6;500;0;3000;1812;1188;
2021-11-06 20:30:05;gula;GULA;1;11500;0;11500;10000;1500;
2021-11-06 20:30:05;9556001004673;MILO NESTLE MALAYSIA ACTIVE GO;1;85000;0;85000;80000;5000;
2021-11-06 20:30:05;8991102987639;WFR TANGO LONG VNL 130G;1;5000;0;5000;4350;650;
2021-11-06 20:32:09;8997028590014;ARGUS 220ML;4;500;0;2000;1208;792;
2021-11-06 20:32:09;711844340008;ABC TERASI;1;7000;0;7000;5800;1200;
2021-11-06 20:32:09;8992770033178;Masako;10;500;0;5000;4500;500;
2021-11-06 20:33:54;8997028590014;ARGUS 220ML;4;500;0;2000;1208;792;
2021-11-06 20:33:54;8998866200646;KOPI TOP MURNI;1;11000;0;11000;9600;1400;
2021-11-06 20:33:54;ARG;ARGUS DOS 220ML;3;14500;0;43500;39900;3600;
2021-11-06 20:35:07;711844610095;LARISSA UDANG 500 GR;1;11000;0;11000;9790;1210;
2021-11-06 20:40:17;ROTI;ROTI 2000;1;2000;0;2000;1800;200;
2021-11-06 20:40:17;8998866201452;POTABEE REGULER BBQ BEEF 35GR;1;5000;0;5000;4150;850;
2021-11-06 20:40:17;8991188943536;SASA SANTAN KELAPA 65ML;1;3000;0;3000;2437;563;
2021-11-06 20:40:17;8992736624310;Sasa bumbu Nasi Goreng Jawa;1;2000;0;2000;1181;819;
2021-11-06 20:40:17;8999999192150;ROYCO FDS CHICKEN 100GR;1;5000;0;5000;4300;700;
2021-11-06 20:40:17;8992959117538;SFX COMFORT SLIM WING 20;1;12000;0;12000;10947;1053;
2021-11-06 20:40:17;8991102994422;TANGO WALUT CHOCOBNN 18G;1;9000;0;9000;8661;339;
2021-11-06 20:40:17;8991102714846;MILKIDO CKLT;2;3000;0;6000;4306;1694;
2021-11-06 20:46:40;8999999524722;SUNLIGHT LIME NEW PCH 435ML;1;10000;0;10000;9100;900;
2021-11-06 20:46:40;8999999036836;LUX BW VELVET JASMINE LD REFF 450 ML;1;25000;0;25000;22110;2890;
2021-11-06 20:46:40;8998866607315;SOKLIN SOFTERGENT SAKURA 770G & PIRING;1;20000;0;20000;18055;1945;
2021-11-06 20:46:40;gula;GULA;2;11500;0;23000;20000;3000;
2021-11-06 20:46:40;8991914101513;VIPER KRETEK 12;1;6000;0;6000;5000;1000;
2021-11-06 20:47:40;ABC;BATERAI ABC BIRU;2;2500;0;5000;3856;1144;
2021-11-06 20:48:56;8999999529321;PONDS ACNE SOL MICELLAR WTR 100ML;1;25000;0;25000;22800;2200;
2021-11-06 20:53:48;gula;GULA;4;11500;0;46000;40000;6000;
2021-11-06 20:53:48;8992696404441;SUSU BURUANG;1;13000;0;13000;8585;4415;
2021-11-06 20:53:48;6907992823935;JD SWEETCORN;1;3500;0;3500;3000;500;
2021-11-06 20:53:48;8993351139807;REAL GOOD;2;1000;0;2000;1600;400;
2021-11-06 20:53:48;8999909000971;MAGNUM MILD 20;1;24000;0;24000;22750;1250;
2021-11-06 20:53:48;8999999559854;AXE BLACK POCKET FRAG 17ML;1;10000;0;10000;8000;2000;
2021-11-06 20:53:48;8992628022156;MINYAK GORENG BIMOLI POUCH 1 LT;1;17500;0;17500;16675;825;
2021-11-06 20:53:48;8997028590052;ARGUS BTL 600ML;1;3000;0;3000;1458;1542;
2021-11-06 20:53:48;8992761111533;SPRITE SLIM CAM250ML;1;5000;0;5000;3750;1250;
2021-11-06 20:53:48;8993335521260;Sabun Total Violet 900gr;1;15000;0;15000;13800;1200;
2021-11-06 20:54:58;8997009510055;YOU C1000;1;15000;0;15000;13000;2000;
2021-11-06 20:55:39;ARGUS DOS;ARGUS DOS;1;15000;0;15000;13500;1500;
2021-11-06 20:57:53;8999909010567;234 DJI SAM SOE 16;2;22500;0;45000;43000;2000;
2021-11-06 20:57:53;gg;gula-gula koin;10;500;0;5000;4000;1000;
2021-11-06 20:57:53;8998866200325;MIE SEDAAP SOTO;1;2700;0;2700;2282;418;
2021-11-06 20:57:53;8998866202244;EKOMIE BUMBU KALDU AYAM;1;1000;0;1000;798;202;
2021-11-06 21:14:01;8995333060772;TERIGU GATOT KACA 500GR;1;5000;0;5000;4346;654;
2021-11-06 21:14:01;YP;YUPI;4;250;0;1000;832;168;
2021-11-06 21:14:01;7622201430184;OREO ORIGINAL 38G;1;2000;0;2000;1641;359;
2021-11-06 21:14:01;8991188943536;SASA SANTAN KELAPA 65ML;1;3000;0;3000;2437;563;
2021-11-06 21:14:01;8999999560720;MOLTO TRIKA JAPANESE PEACH 720ML;1;5000;0;5000;4000;1000;
2021-11-06 21:14:01;8992760223015;OREO CHOCOLATE CREAM 133G;1;8000;0;8000;6300;1700;
2021-11-06 21:20:46;8991914101513;VIPER KRETEK 12;1;6000;0;6000;5000;1000;
2021-11-06 21:20:46;8992775312414;GERY CHOCO HEZELNUT;1;11000;0;11000;9983;1017;
2021-11-06 21:20:46;8991002105430;KAPAL API 65G;1;5000;0;5000;4145;855;
2021-11-06 21:20:46;8998866803694;SOKLIN SOFTERGENT PURPLE BAG 770 & PIRING;1;20000;0;20000;18055;1945;
2021-11-06 21:20:46;8999999552367;SAHAJA CUCI PIRING 400ML;1;8500;0;8500;7300;1200;
2021-11-06 21:20:46;gula;GULA;2;11500;0;23000;20000;3000;
2021-11-06 21:20:46;ROTI;ROTI 2000;1;2000;0;2000;1800;200;
2021-11-06 21:20:46;8997878004327;gula-gula milkita;10;250;0;2500;2000;500;
2021-11-06 21:20:46;KRIPIK;KRIPIK KENTANG;1;1000;0;1000;900;100;
2021-11-06 21:20:46;8997009460435;SEDAP NET;2;500;0;1000;800;200;
2021-11-06 21:26:48;8991914101513;VIPER KRETEK 12;2;6000;0;12000;10000;2000;
2021-11-06 21:26:48;8999801700030;SUSU FOYU;1;11500;0;11500;10450;1050;
2021-11-06 21:26:48;8995150101719;M+SUSU RASA SODA GEMBIRA;1;5000;0;5000;4000;1000;
2021-11-06 21:26:48;8998989500166;GUDANG GARAM MERAH BESAR 16KS;1;18000;0;18000;17000;1000;
2021-11-06 21:26:48;8994867007161;ROKOK PENA GOLD 20;1;18000;0;18000;16800;1200;
2021-11-06 22:07:46;8996001302347;SARI GANDUM FAM;1;8500;0;8500;7700;800;
2021-11-06 22:07:46;8996001301142;ROMA KELAPA;1;8000;0;8000;7000;1000;
2021-11-06 22:07:46;8996001305041;ROMA SANDWICH CKLT;2;7000;0;14000;11856;2144;
2021-11-06 22:07:46;8993083929837;BISKITOP BLACK COOKIES;1;27000;0;27000;23700;3300;
2021-11-06 22:07:46;8992761139018;ADES 600ML;1;3500;0;3500;2166;1334;
2021-11-06 22:07:46;8997021110028;Garam Kasar;1;3000;0;3000;1500;1500;
2021-11-06 22:07:46;8999999192150;ROYCO FDS CHICKEN 100GR;1;5000;0;5000;4300;700;
2021-11-06 22:07:46;BALON;BALON CABUT;3;1000;0;3000;2700;300;
2021-11-06 22:07:46;8997028590014;ARGUS 220ML;1;500;0;500;302;198;
2021-11-06 22:07:46;6907992825076;JD WATERMELON APPLE;1;2000;0;2000;1700;300;
2021-11-06 22:11:15;8991102987639;WFR TANGO LONG VNL 130G;1;5000;0;5000;4350;650;
2021-11-06 22:11:15;8991102387286;TANGO LONG CKLT 47G;1;2000;0;2000;1551;449;
2021-11-06 22:11:15;8993351139807;REAL GOOD;2;1000;0;2000;1600;400;
2021-11-06 22:11:15;BALON;BALON CABUT;1;1000;0;1000;900;100;
2021-11-06 22:12:36;8993351139807;REAL GOOD;1;1000;0;1000;800;200;
2021-11-06 22:12:36;ARG;ARGUS DOS 220ML;1;14500;0;14500;13300;1200;
2021-11-06 22:13:00;ARG;ARGUS DOS 220ML;2;14500;0;29000;26600;2400;
2021-11-06 22:19:21;8997028590014;ARGUS 220ML;6;500;0;3000;1812;1188;
2021-11-06 22:19:21;8998866202343;MIE SEDAAP KOREAN SPICY;2;3000;0;6000;4826;1174;
2021-11-06 22:19:21;8998866200301;MIE SEDAAP GORENG;1;3000;0;3000;2414;586;
2021-11-06 22:20:33;8998866200301;MIE SEDAAP GORENG;1;3000;0;3000;2414;586;
2021-11-06 22:20:33;8998866200325;MIE SEDAAP SOTO;2;2700;0;5400;4564;836;
2021-11-06 22:30:46;8993351139807;REAL GOOD;1;1000;0;1000;800;200;
2021-11-06 22:30:46;8999909002821;MARLBORO BLACK 16;1;22000;0;22000;20900;1100;
2021-11-06 22:30:46;8997028590045;ARGUS BTL 330ML;2;2000;0;4000;2582;1418;
2021-11-06 22:30:46;0105312686040047;yakult;1;2000;0;2000;1500;500;
2021-11-06 22:30:46;ROTI;ROTI 2000;1;2000;0;2000;1800;200;
2021-11-06 22:30:46;7622201430184;OREO ORIGINAL 38G;1;2000;0;2000;1641;359;
2021-11-06 22:30:46;8999909004221;SAMPOERNA ULTRAMILD 16;1;22000;0;22000;20350;1650;
2021-11-06 22:30:46;123124;KOREK BIASA;1;2000;0;2000;1300;700;
2021-11-06 22:30:46;8992760223015;OREO CHOCOLATE CREAM 133G;1;8000;0;8000;6300;1700;
2021-11-06 22:30:46;8998866200851;NOODLE SEDAAP MIE BAKSO SPESIAL CUP 77 GR;3;4500;0;13500;11214;2286;
2021-11-06 22:37:33;8998866202060;POTABEE AYAM BAKAR PEDAS 35 GR;1;5000;0;5000;4150;850;
2021-11-06 22:37:33;8998866201452;POTABEE REGULER BBQ BEEF 35GR;1;5000;0;5000;4150;850;
2021-11-06 22:37:33;8991102384841;WFR TANGO LONG CKLT 130G;1;5000;0;5000;4345;655;
2021-11-06 22:37:33;8991102023115;Sikat Gigi Formula;1;11000;0;11000;10000;1000;
2021-11-06 22:37:33;8999999710880;PEPSODENT ACTION123 HERBAL 75G;1;7500;0;7500;6650;850;
2021-11-06 22:37:33;8993989311699;CLAS MILD 16 FILTER;1;24000;0;24000;21700;2300;
2021-11-06 22:37:33;BR;BERAS 10L;1;86500;0;86500;85000;1500;
2021-11-06 22:37:33;Telur 7 Biji;Telur 7 Biji;1;10000;0;10000;8400;1600;
2021-11-06 22:37:33;8998866608718;DAIA SOFTENER PINK;1;5000;0;5000;4450;550;
2021-11-06 22:37:33;8997028590014;ARGUS 220ML;2;500;0;1000;604;396;
2021-11-06 22:37:33;8995555111221;sosis kimbo;1;1000;0;1000;850;150;
2021-11-06 22:39:08;8991102714846;MILKIDO CKLT;1;3000;0;3000;2153;847;
2021-11-06 22:39:08;8993351139807;REAL GOOD;1;1000;0;1000;800;200;
2021-11-06 22:39:08;8992775002582;DILAN CHOCO;1;2000;0;2000;1503;497;
2021-11-07 16:08:55;6907992823669;JD MILKY STRAW;1;3000;0;3000;2600;400;
2021-11-07 16:08:55;8991001503336;chacha minis hat;1;7500;0;7500;6400;1100;
2021-11-07 16:57:51;BALON;BALON CABUT;3;1000;0;3000;2700;300;
2021-11-07 17:12:55;ROTI;ROTI 2000;2;2000;0;4000;3600;400;
2021-11-07 17:16:10;RT;ROTI;1;9000;0;9000;8000;1000;
2021-11-07 17:33:54;Telur 3 Biji;Telur 3 Biji;1;5000;0;5000;3600;1400;
2021-11-07 18:57:13;8998989121163;SURYA PRO MERAH;1;22000;0;22000;20100;1900;
2021-11-07 18:58:05;ARGUS;ARGUS;1;2000;0;2000;1500;500;
2021-11-07 19:56:10;18997028590011;ARGUS DOS;3;15000;0;45000;40500;4500;
2021-11-07 20:11:29;8991102714860;MILKIDO STRAW;1;3000;0;3000;2153;847;
2021-11-07 21:25:47;8991102281416;PERMEN MINTZ PPMINT;1;5000;0;5000;4000;1000;
2021-11-07 21:38:17;8992959953136;SWEETY BRONZE L20;1;40000;0;40000;36770;3230;
2021-11-07 22:03:52;TELUR RAK;TELUR RAK;1;38000;0;38000;35000;3000;
2021-11-07 22:06:15;ROTI;ROTI 2000;1;2000;0;2000;1800;200;
2021-11-07 22:06:15;8993093115008;tepun beras;3;8000;0;24000;21000;3000;
2021-11-07 22:08:51;jagung marning;jagung marning;1;5000;0;5000;4500;500;
2021-11-07 22:08:51;kri;kripik pisang;2;5000;0;10000;8000;2000;
2021-11-07 22:08:51;8991102281430;PERMEN MINTZ DUOMINT;1;5000;0;5000;4000;1000;
2021-11-07 22:08:51;8998989500166;GUDANG GARAM MERAH BESAR 16KS;1;18000;0;18000;17000;1000;
2021-11-07 22:08:51;8999909004221;SAMPOERNA ULTRAMILD 16;1;22000;0;22000;20350;1650;
2021-11-07 22:13:32;8993093115008;tepun beras;3;8000;0;24000;21000;3000;
2021-11-07 22:13:32;8992933243116;NUTRIJELLL KELAPA;1;6000;0;6000;4833;1167;
2021-11-07 22:13:32;18997028590011;ARGUS DOS;1;15000;0;15000;13500;1500;
2021-11-07 22:13:32;8995333032113;TERIGU GATOT KACA 1 KG;2;9000;0;18000;17144;856;
2021-11-07 22:13:32;8998866202244;EKOMIE BUMBU KALDU AYAM;3;1000;0;3000;2394;606;
2021-11-07 22:13:32;8992388101085;NU GREEN TEA ORIGINAL 330ML;1;3500;0;3500;2768;732;
2021-11-07 22:13:32;7622210462534;OREO MINI STRAW;1;7500;0;7500;6500;1000;
2021-11-07 22:13:32;8997028590052;ARGUS BTL 600ML;2;3000;0;6000;2916;3084;
2021-11-07 22:13:32;7622300335809;OREO SOFT CAKE;1;2000;0;2000;1641;359;
2021-11-07 22:14:05;8992760223015;OREO CHOCOLATE CREAM 133G;1;8000;0;8000;6300;1700;
2021-11-07 22:14:05;7622201430153;OREO CHOCOLATE 38G;1;2000;0;2000;1641;359;
2021-11-07 22:16:57;8997028590014;ARGUS 220ML;2;500;0;1000;604;396;
2021-11-07 22:16:57;089686021219;INTER MIE GORENG;1;1000;0;1000;885;115;
2021-11-07 22:16:57;8999909004221;SAMPOERNA ULTRAMILD 16;1;22000;0;22000;20350;1650;
2021-11-07 22:16:57;8999999559045;SUNLIGHT LIME CREAM 110G;1;2000;0;2000;1800;200;
2021-11-08 11:47:25;8998989110167;SURYA GUDANG GARAM 16 FILTER;1;26000;0;26000;23700;2300;
2021-11-08 20:09:04;8991002105409;KOPI KAPAL API;2;20000;0;40000;37776;2224;
2021-11-08 20:09:04;8993007003063;ENAAK 500G;1;11000;0;11000;9625;1375;
2021-11-08 20:09:04;8997213203095;INLITE 7W;1;34000;0;34000;31000;3000;
2021-11-08 20:24:10;8998989500166;GUDANG GARAM MERAH BESAR 16KS;1;18000;0;18000;17000;1000;
2021-11-08 20:24:10;8991909101016;URBAN MILD 16;2;17000;0;34000;31600;2400;
2021-11-08 20:37:52;8992628020152;MINYAK GOREG BIMOLI POUCH 2L;1;35000;0;35000;29800;5200;
2021-11-08 20:57:31;4902430553636;H&S LEMON  160ML;1;25000;0;25000;18900;6100;
2021-11-08 20:57:31;6907992823935;JD SWEETCORN;1;3500;0;3500;3000;500;
2021-11-08 21:22:24;8997028590045;ARGUS BTL 330ML;1;2000;0;2000;1291;709;
2021-11-08 21:22:24;8991102714907;Kopi Seruput Simanis Aren 200ml;1;3000;0;3000;2375;625;
2021-11-08 21:37:52;8999909000377;SAMPOERNA AVOLUTION;1;31000;0;31000;29450;1550;
2021-11-08 22:07:36;8886008101091;AQUA 1,5 ML;2;5500;0;11000;9200;1800;
2021-11-08 22:17:21;8992628022156;MINYAK GORENG BIMOLI POUCH 1 LT;1;17500;0;17500;16675;825;
2021-11-08 22:19:43;kri;kripik pisang;1;5000;0;5000;4000;1000;
2021-11-08 22:19:43;8995139505019;UPIN IPIN;1;2000;0;2000;1600;400;
2021-11-08 22:19:43;0105312686040047;yakult;1;2000;0;2000;1500;500;
2021-11-08 22:21:19;8996001301142;ROMA KELAPA;1;8000;0;8000;7000;1000;
2021-11-08 22:21:19;ROTI;ROTI 2000;1;2000;0;2000;1800;200;
2021-11-09 21:10:07;9556001025272;NESCAFE LATTE 240ML;1;8500;0;8500;7834;666;
2021-11-09 21:18:03;8999801700030;SUSU FOYU;1;11500;0;11500;10450;1050;
2021-11-09 21:32:06;8993989311699;CLAS MILD 16 FILTER;1;24000;0;24000;21700;2300;
2021-11-09 21:34:30;8995139505019;UPIN IPIN;2;2000;0;4000;3200;800;
2021-11-09 21:34:30;8997009460343;NEXI NET;2;1000;0;2000;1800;200;
2021-11-09 22:32:25;8997018920081;RED BULD;1;20000;0;20000;18000;2000;
2021-11-10 18:55:52;8997009510055;YOU C1000;1;15000;0;15000;13000;2000;
2021-11-10 18:55:52;8999999042592;RINSO MOLTO PERFUME ESSENSE LIQ 4OML;2;1000;0;2000;1604;396;
2021-11-10 18:55:52;SF SOSIS;SAFFANAH ROTI SOSIS;1;6000;0;6000;5500;500;
2021-11-10 18:55:52;8993274532105;BOLU;2;1000;0;2000;1666;334;
2021-11-10 19:00:39;8997028590014;ARGUS 220ML;2;500;0;1000;604;396;
2021-11-10 19:00:39;8991102714846;MILKIDO CKLT;1;3000;0;3000;2153;847;
2021-11-10 19:00:39;8997009460343;NEXI NET;1;1000;0;1000;900;100;
2021-11-10 19:00:39;123124;KOREK BIASA;2;2000;0;4000;2600;1400;
2021-11-10 19:00:39;8997021870595;HOT IN CREAM AROMA THERAPY 60G;1;12500;0;12500;11360;1140;
2021-11-10 19:00:39;8993351139807;REAL GOOD;3;1000;0;3000;2400;600;
2021-11-10 19:09:07;CSM;ROTI COKLAT MATAHARI;1;6000;0;6000;5000;1000;
2021-11-10 19:09:07;gula;GULA;4;11500;0;46000;40000;6000;
2021-11-10 19:09:07;8992761002015;COCA COLA PET 390ML;1;5500;0;5500;4333;1167;
2021-11-10 19:09:07;0105312686040047;yakult;5;2000;0;10000;7500;2500;
2021-11-10 19:09:07;8997218380074;ICHITAN MILK TEA;1;8000;0;8000;6500;1500;
2021-11-10 19:09:07;8991102987639;WFR TANGO LONG VNL 130G;1;5000;0;5000;4350;650;
2021-11-10 19:09:07;8999801700030;SUSU FOYU;1;11500;0;11500;10450;1050;
2021-11-10 19:09:07;089686021127;INTER MIE KALDU;3;1000;0;3000;2439;561;
2021-11-10 19:09:07;089686386127;BUMBU RACIK NASI GORENG SOSIS;1;2000;0;2000;1620;380;
2021-11-10 19:09:07;ROTI;ROTI 2000;1;2000;0;2000;1800;200;
2021-11-10 19:09:07;8998989110501;gudang garam surya;2;2000;0;4000;2760;1240;
2021-11-10 19:09:07;8998989110167;SURYA GUDANG GARAM 16 FILTER;1;26000;0;26000;23700;2300;
2021-11-10 19:13:37;089686011036;INDOMIE GORENG PEDAS;4;2700;0;10800;9808;992;
2021-11-10 19:13:37;8993351139807;REAL GOOD;3;1000;0;3000;2400;600;
2021-11-10 19:13:37;8991102026383;AIR CRYSTALINE 1.5 L;1;5000;0;5000;3471;1529;
2021-11-10 19:13:37;Vita Jelly;Vita Jelly;5;1000;0;5000;3830;1170;
2021-11-10 19:13:37;8998866203227;MIE SEDAAP AYAM BAKAR LIMAU;2;2700;0;5400;4326;1074;
2021-11-10 19:18:10;8991002103764;GOOD DAY CAPPUCINO 10X25G;2;1500;0;3000;2790;210;
2021-11-10 19:18:10;8994867000162;ROKOK PUNDIMAS KRETEK16;1;10000;0;10000;8600;1400;
2021-11-10 19:18:10;8991102281430;PERMEN MINTZ DUOMINT;1;5000;0;5000;4000;1000;
2021-11-10 19:18:10;8997028590014;ARGUS 220ML;1;500;0;500;302;198;
2021-11-10 19:18:10;8996001600269;LE MINERAL 600ML;1;3000;0;3000;1688;1312;
2021-11-10 19:18:10;RT BAKPIA;ROTI BAKPIA;2;1000;0;2000;1500;500;
2021-11-10 19:18:10;8993335523363;TOTAL ALMEERA 250G;1;5000;0;5000;4100;900;
2021-11-10 19:18:10;8998866203227;MIE SEDAAP AYAM BAKAR LIMAU;2;2700;0;5400;4326;1074;
2021-11-10 19:20:24;8999999059781;SUNLIGHT LIME NEW POUCH 210ML;1;5000;0;5000;4520;480;
2021-11-10 19:20:24;8992628022156;MINYAK GORENG BIMOLI POUCH 1 LT;1;17500;0;17500;16675;825;
2021-11-10 19:20:24;Gula gula kaki;gula gula kaki;4;500;0;2000;1600;400;
2021-11-10 19:20:24;8999999531508;MOLTO HYGIENE SC 10ML;4;500;0;2000;1920;80;
2021-11-10 19:21:39;8998866608404;Softener;1;5000;0;5000;4560;440;
2021-11-10 19:22:55;8998989110167;SURYA GUDANG GARAM 16 FILTER;1;26000;0;26000;23700;2300;
2021-11-10 19:33:08;KLOP;KLOP SALUTO;1;16000;0;16000;14545;1455;
2021-11-10 19:33:08;8992775305034;Geri Salut Malkist Bungkus;1;18000;0;18000;16250;1750;
2021-11-10 19:33:08;8992775311547;Chocolatos;4;2000;0;8000;6000;2000;
2021-11-10 19:33:08;8998866201377;KRISBEE FRIES KENTANG GORENG 68 GR;1;5500;0;5500;4620;880;
2021-11-10 19:33:08;8996001304129;SLAI OLAI STROBERI;1;12000;0;12000;9900;2100;
2021-11-10 19:33:35;8991004011906;KOPI BORONG;1;10000;0;10000;8333;1667;
2021-11-10 19:40:55;8991002105430;KAPAL API 65G;1;5000;0;5000;4145;855;
2021-11-10 19:40:55;8992775002582;DILAN CHOCO;1;2000;0;2000;1503;497;
2021-11-10 19:42:02;8936036023657;CHOCO-PIE;1;3000;0;3000;2500;500;
2021-11-10 19:58:15;8999909096004;SAMPOERNA 16 FILTER;1;25000;0;25000;23100;1900;
2021-11-10 20:06:38;8995333032113;TERIGU GATOT KACA 1 KG;4;9000;0;36000;34288;1712;
2021-11-10 20:58:53;ROTI;ROTI 2000;1;2000;0;2000;1800;200;
2021-11-10 20:58:53;8993274532105;BOLU;2;1000;0;2000;1666;334;
2021-11-10 20:58:53;8995555111221;sosis kimbo;3;1000;0;3000;2550;450;
2021-11-10 21:03:33;8992628020152;MINYAK GOREG BIMOLI POUCH 2L;1;35000;0;35000;29800;5200;
2021-11-10 21:12:56;8997028590045;ARGUS BTL 330ML;1;2000;0;2000;1291;709;
2021-11-10 21:17:15;8999909002821;MARLBORO BLACK 16;1;22000;0;22000;20900;1100;
2021-11-10 21:17:15;8994867007161;ROKOK PENA GOLD 20;1;18000;0;18000;16800;1200;
2021-11-10 21:18:16;8992628020152;MINYAK GOREG BIMOLI POUCH 2L;2;35000;0;70000;59600;10400;
2021-11-10 21:23:51;8993351139807;REAL GOOD;1;1000;0;1000;800;200;
2021-11-10 21:26:06;KRIPIK;KRIPIK KENTANG;1;1000;0;1000;900;100;
2021-11-10 21:26:06;8992388101085;NU GREEN TEA ORIGINAL 330ML;3;3500;0;10500;8304;2196;
2021-11-10 21:26:06;8992628020152;MINYAK GOREG BIMOLI POUCH 2L;3;35000;0;105000;89400;15600;
2021-11-10 21:27:55;8997878004327;gula-gula milkita;8;250;0;2000;1600;400;
2021-11-10 21:30:32;8997218380159;ICHITAN BROWN SUGAR;2;8000;0;16000;13000;3000;
2021-11-10 21:31:47;8991102714860;MILKIDO STRAW;1;3000;0;3000;2153;847;
2021-11-10 22:08:59;8992696404441;SUSU BURUANG;1;13000;0;13000;8585;4415;
2021-11-10 22:10:34;8993007001359;INDOMILK KM SCT 37G;2;1500;0;3000;2166;834;
2021-11-10 22:10:34;8999801700030;SUSU FOYU;1;11500;0;11500;10450;1050;
2021-11-10 22:13:17;8996001305041;ROMA SANDWICH CKLT;1;7000;0;7000;5928;1072;
2021-11-10 22:13:17;8993351139807;REAL GOOD;2;1000;0;2000;1600;400;
2021-11-10 22:13:17;8997009460343;NEXI NET;1;1000;0;1000;900;100;
2021-11-10 22:14:28;8992775211410;PILUS GARUDA PEDAS;1;5000;0;5000;4886;114;
2021-11-10 22:14:28;6907992823935;JD SWEETCORN;1;3500;0;3500;3000;500;
2021-11-10 22:23:11;8998866200325;MIE SEDAAP SOTO;4;2700;0;10800;9128;1672;
2021-11-10 22:29:43;TERASI;ABC TERASI SCT;1;1500;0;1500;1000;500;
2021-11-10 22:34:57;8997218010230;yohoo;9;1000;0;9000;8100;900;
2021-11-11 15:56:18;9556001047175;NESCAFE ORI 240ML;1;8500;0;8500;7834;666;
2021-11-11 15:56:18;8999909001909;MAGNUM REVAMP BLACK 12;1;18000;0;18000;16300;1700;
2021-11-11 15:56:18;8997009461654;MORIS VANILLA;1;1000;0;1000;400;600;
2021-11-11 15:56:18;YP;YUPI;2;250;0;500;416;84;
2021-11-11 16:51:03;8999909096004;SAMPOERNA 16 FILTER;1;25000;0;25000;23100;1900;
2021-11-11 16:51:03;8999909004221;SAMPOERNA ULTRAMILD 16;1;22000;0;22000;20350;1650;
2021-11-11 16:51:03;8999909001909;MAGNUM REVAMP BLACK 12;1;18000;0;18000;16300;1700;
2021-11-11 16:51:03;TG MARKISA;TEH GELAS MARKISA;2;2000;0;4000;2356;1644;
2021-11-11 16:51:03;089686017748;SARIMIE GORENG ISI 2;1;3500;0;3500;3120;380;
2021-11-11 16:51:03;8998866200578;MIE SEDAAP KARI KENTAL;1;2700;0;2700;2331;369;
2021-11-11 16:51:03;Gula gula tusuk;gula gula tusuk;2;500;0;1000;800;200;
2021-11-11 16:54:02;8991002105430;KAPAL API 65G;4;5000;0;20000;16580;3420;
2021-11-11 16:54:02;8998866202244;EKOMIE BUMBU KALDU AYAM;5;1000;0;5000;3990;1010;
2021-11-11 16:54:02;8998866200882;SUKSESMIE GORENG AYAM KRMS 133GR;2;3500;0;7000;6094;906;
2021-11-11 16:54:02;8999999195656;SARIWANGI 50X1.85;1;10000;0;10000;9405;595;
2021-11-11 16:54:02;8998866200301;MIE SEDAAP GORENG;3;3000;0;9000;7242;1758;
2021-11-11 16:54:02;gula;GULA;2;11500;0;23000;20000;3000;
2021-11-11 18:29:01;8992696520103;DNCO INSTANT CKLT 39G;1;3500;0;3500;3000;500;
2021-11-11 18:57:39;8996200900092;HEROCYN 85GR;1;13000;0;13000;11650;1350;
2021-11-11 19:00:36;4902430553629;H&S LEMON 70ML;1;11000;0;11000;9501;1499;
2021-11-11 19:17:54;MK;MASKER;1;5000;0;5000;4000;1000;
2021-11-11 19:22:05;8991001502926;Chaca Peanut;1;1000;0;1000;800;200;
2021-11-11 19:22:05;8995139505019;UPIN IPIN;2;2000;0;4000;3200;800;
2021-11-11 19:22:05;8997878004327;gula-gula milkita;4;250;0;1000;800;200;
2021-11-11 19:22:05;8886001038011;BENG-BENG SCT;2;1500;0;3000;2000;1000;
2021-11-11 19:33:18;8991102987639;WFR TANGO LONG VNL 130G;1;5000;0;5000;4350;650;
2021-11-11 19:33:18;8991102989381;TANGO LONG BUBBLEGUM 130G;1;5000;0;5000;4350;650;
2021-11-11 19:33:18;8998009040023;TEH KOTAK;2;5000;0;10000;5416;4584;
2021-11-11 19:50:54;8997028590052;ARGUS BTL 600ML;1;3000;0;3000;1458;1542;
2021-11-11 19:50:54;8886001038011;BENG-BENG SCT;1;1500;0;1500;1000;500;
2021-11-11 19:50:54;8997009461753;TOP ELIT;1;1000;0;1000;400;600;
2021-11-11 19:52:12;8999999195649;SARIWANGI 25X1.86G;2;6000;0;12000;10404;1596;
2021-11-11 19:54:01;8998866203227;MIE SEDAAP AYAM BAKAR LIMAU;1;2700;0;2700;2163;537;
2021-11-11 19:54:01;089686044249;SUPERMI NUTRIMI STEAK AYAM;1;3500;0;3500;2800;700;
2021-11-11 19:59:41;8997001300074;Tokyo Night;1;8500;0;8500;6500;2000;
2021-11-11 19:59:41;8992761002022;SPRITE PET 390ML;1;5500;0;5500;4333;1167;
2021-11-11 19:59:41;8991102714891;Kopi Seruput susu tulen 200 ml;1;3000;0;3000;2375;625;
2021-11-11 19:59:41;8993989311699;CLAS MILD 16 FILTER;1;24000;0;24000;21700;2300;
2021-11-11 20:01:03;8992959117583;SFX DS REG FLOW WING 20;1;5000;0;5000;4288;712;
2021-11-11 20:08:32;8999909002821;MARLBORO BLACK 16;1;22000;0;22000;20900;1100;
2021-11-11 20:09:16;8998866202312;NOODLE SEDAAP TASTY BAKMI AYAM 129 GR;1;5000;0;5000;4167;833;
2021-11-11 20:10:06;8886013257400;TWISTKO;1;1000;0;1000;900;100;
2021-11-11 20:17:15;8998989110501;gudang garam surya;2;2000;0;4000;2760;1240;
2021-11-11 20:17:15;KRIPIK MK;KRIPIK MAKKORONI;1;5000;0;5000;4000;1000;
2021-11-11 20:17:15;SF TAWAR KUPAS;SAFFANAH ROTI TAWAR KUPAS;1;10000;0;10000;9000;1000;
2021-11-11 20:17:15;8886013257400;TWISTKO;1;1000;0;1000;900;100;
2021-11-11 20:17:15;Garuda Pilus;Garuda Pilus Rasa Abon Pcs;1;500;0;500;401;99;
2021-11-11 20:17:15;MILKITA;MILKITA;2;250;0;500;400;100;
2021-11-11 20:17:15;RT MNTG;ROTI SISIR MENTEGA;2;2000;0;4000;3200;800;
2021-11-11 20:17:15;SOSIS;SO NICE SAPI;1;1000;0;1000;940;60;
2021-11-11 20:17:15;gg;gula-gula koin;10;500;0;5000;4000;1000;
2021-11-11 20:17:15;ICE CREAM 5;ICE CREAM 5000;1;5000;0;5000;4400;600;
2021-11-11 20:17:15;8995139505019;UPIN IPIN;1;2000;0;2000;1600;400;
2021-11-11 20:17:15;8997009462040;TIARA;5;1000;0;5000;2125;2875;
2021-11-11 20:25:08;SOSIS;SO NICE SAPI;2;1000;0;2000;1880;120;
2021-11-11 20:25:08;TAMARA;TAMARA;6;1000;0;6000;2520;3480;
2021-11-11 20:25:08;8992775311615;CHOCOLATOS;1;12000;0;12000;9983;2017;
2021-11-11 20:25:08;8992761164539;NUTRIBOOST ORANGE 300ML;1;6500;0;6500;5300;1200;
2021-11-11 20:25:08;8992761139018;ADES 600ML;2;3500;0;7000;4332;2668;
2021-11-11 20:25:08;8993379152017;SABUN CUCI SURYA 200G;1;3000;0;3000;2281;719;
2021-11-11 20:25:08;TUSTEL;TUSUK TELINGA;1;1000;0;1000;833;167;
2021-11-11 20:25:08;8999909010567;234 DJI SAM SOE 16;1;22500;0;22500;21500;1000;
2021-11-11 20:36:01;8991002105430;KOPI KAPAL API 65G;1;5000;0;5000;4145;855;
2021-11-11 20:38:15;8998989110167;SURYA GUDANG GARAM 16 FILTER;1;26000;0;26000;23700;2300;
2021-11-11 20:38:15;ICE CREAM 5;ICE CREAM 5000;1;5000;0;5000;4400;600;
2021-11-11 20:38:15;8993351139807;REAL GOOD;5;1000;0;5000;4000;1000;
2021-11-11 20:38:15;8997218010230;yohoo;5;1000;0;5000;4500;500;
2021-11-11 22:09:16;8886020033431;KAPUR AJAIB ANTI KECOA DAN NYAMUK;1;3000;0;3000;2700;300;
2021-11-12 20:44:43;8997013180046;Tissu Tessi B;2;11000;0;22000;19600;2400;
2021-11-12 20:49:05;8996001308059;Sari gandum sandwich;2;2000;0;4000;3400;600;
2021-11-12 20:53:36;8997028590045;ARGUS BTL 330ML;1;2000;0;2000;1291;709;
2021-11-12 21:00:53;Telur 3 Biji;Telur 3 Biji;1;5000;0;5000;3600;1400;
2021-11-12 21:18:24;ARGUS;ARGUS;1;2000;0;2000;1500;500;
2021-11-12 21:19:00;ARG;ARGUS DOS 220ML;3;15000;0;45000;40500;4500;
2021-11-12 21:31:58;8886022971298;BATERAI ALKALINE 06;1;12000;0;12000;10557;1443;
2021-11-12 21:39:51;8992979120013;TOTAL BUNGA SOFTENER;1;15000;0;15000;13800;1200;
2021-11-12 21:39:51;8999999008475;SUNLIGHT LIME NEW REF 1600ML;1;35000;0;35000;31955;3045;
2021-11-12 21:55:44;8998989500166;GUDANG GARAM MERAH BESAR 16KS;1;18000;0;18000;17000;1000;
2021-11-12 21:55:44;8999909002821;MARLBORO BLACK 16;1;22000;0;22000;20900;1100;
2021-11-12 22:41:33;8998989110167;SURYA GUDANG GARAM 16 FILTER;1;26000;0;26000;23700;2300;
2021-11-14 21:48:15;8998989110167;SURYA GUDANG GARAM 16 FILTER;3;26000;0;78000;71100;6900;
2021-11-14 22:04:08;8996001328163;GULA GULA TAMARIN;8;250;0;2000;1600;400;
2021-11-14 22:04:08;8997013180046;Tissu Tessi B;1;11000;0;11000;9800;1200;
2021-11-14 22:04:08;8992761136178;SPRITE 1L;1;10000;0;10000;9000;1000;
2021-11-14 22:04:08;8997009510123;ORANGE WATER;3;8000;0;24000;18795;5205;
2021-11-14 22:10:39;8992761164539;NUTRIBOOST ORANGE 300ML;1;6500;0;6500;5300;1200;
2021-11-14 22:10:39;9556001047175;NESCAFE ORI 240ML;1;8500;0;8500;7834;666;
2021-11-14 22:10:39;KRIPIK MK;KRIPIK MAKKORONI;1;5000;0;5000;4000;1000;
2021-11-14 22:10:39;8994834003752;TICTIC;1;2000;0;2000;1700;300;
2021-11-14 22:10:39;8992761002022;SPRITE PET 390ML;2;5500;0;11000;8666;2334;
2021-11-14 22:10:39;8992775315057;GERY SALUT MALKIST COKLAT;1;6500;0;6500;5516;984;
2021-11-14 22:10:39;8997028590014;ARGUS 220ML;2;500;0;1000;604;396;
2021-11-14 22:12:26;8886008101053;AQUA 600 ML;1;3500;0;3500;2125;1375;
2021-11-14 22:16:20;MK;MASKER;2;5000;0;10000;8000;2000;
2021-11-14 22:16:20;8992761002022;SPRITE PET 390ML;1;5500;0;5500;4333;1167;
2021-11-14 22:16:20;8994191103638;GULA GULA KARET;10;500;0;5000;4000;1000;
2021-11-14 22:16:20;8996001320068;GULA GULA KOPIKO;6;250;0;1500;1200;300;
2021-11-14 22:16:20;8991102987639;WFR TANGO LONG VNL 130G;1;5000;0;5000;4350;650;
2021-11-15 19:19:09;8992775001783;GERY SALUT MALKIST KELAPA;1;6500;0;6500;5516;984;
2021-11-15 19:19:09;8991102281430;PERMEN MINTZ DUOMINT;1;5000;0;5000;4000;1000;
2021-11-15 19:19:09;8886008101053;AQUA 600 ML;1;3500;0;3500;2125;1375;
2021-11-15 19:19:09;8992741952262;GULA GULA YUPI;6;250;0;1500;1200;300;
2021-11-15 19:19:09;8997009510055;YOU C1000;2;15000;0;30000;26000;4000;
2021-11-15 19:19:09;8992761164539;NUTRIBOOST ORANGE 300ML;1;6500;0;6500;5300;1200;
2021-11-15 19:19:09;8991002303928;GULA GULA RELAXA;6;250;0;1500;1200;300;
2021-11-15 19:21:46;8997028590045;ARGUS BTL 330ML;2;2000;0;4000;2582;1418;
2021-11-15 19:21:46;8991002303928;GULA GULA RELAXA;4;250;0;1000;800;200;
2021-11-15 19:21:46;PULPEN;PULPEN BIASA;2;2000;0;4000;3000;1000;
2021-11-15 19:21:46;8997028590014;ARGUS 220ML;2;500;0;1000;604;396;
2021-11-15 19:21:46;8991909101016;URBAN MILD 16;1;17000;0;17000;15800;1200;
2021-11-15 19:23:20;8995333032113;TERIGU GATOT KACA 1 KG;4;9000;0;36000;34288;1712;
2021-11-15 19:23:20;gula;GULA;1;11500;0;11500;10000;1500;
2021-11-15 19:29:08;8886008101053;AQUA 600 ML;1;3500;0;3500;2125;1375;
2021-11-15 19:29:08;ROTI;ROTI 2000;1;2000;0;2000;1800;200;
2021-11-15 19:29:08;MK;MASKER;1;5000;0;5000;4000;1000;
2021-11-15 19:29:08;8999909010567;234 DJI SAM SOE 16;1;22500;0;22500;21500;1000;
2021-11-15 19:29:08;8993989331659;ROKOK CLAS MILD SILVER;1;22000;0;22000;18900;3100;
2021-11-15 19:29:08;8992775211410;PILUS GARUDA PEDAS;1;5000;0;5000;4886;114;
2021-11-15 19:29:08;8998866202619;MIE SEDAAP KOREAN SPICY SOUP;2;2700;0;5400;4644;756;
2021-11-15 19:39:16;BALON GAS;BALON GAS;1;500;0;500;400;100;
2021-11-15 19:41:45;8991102320184;TANGO CHOCO JAVAMOCCA;1;5000;0;5000;4350;650;
2021-11-15 19:41:45;8997218380159;ICHITAN BROWN SUGAR;1;8000;0;8000;6500;1500;
2021-11-15 19:41:45;8992761166212;FRESTEA APPLE 350ML;1;4500;0;4500;3000;1500;
2021-11-15 19:44:44;PULPEN;PULPEN BIASA;1;2000;0;2000;1500;500;
2021-11-15 19:44:44;8997028590014;ARGUS 220ML;1;500;0;500;302;198;
2021-11-15 19:44:44;8994191103980;GULA GULA MARS;3;500;0;1500;1200;300;
2021-11-15 19:46:32;8998989110167;SURYA GUDANG GARAM 16 FILTER;2;26000;0;52000;47400;4600;
2021-11-15 19:49:55;8992775001844;Chocolatos original taste;1;1000;0;1000;829;171;
2021-11-15 19:55:33;8992775000250;CHOCOLATOS MATCHA;1;2000;0;2000;1557;443;
2021-11-15 19:55:33;8997028590014;ARGUS 220ML;1;500;0;500;302;198;
2021-11-15 19:55:33;8994191103980;GULA GULA MARS;3;500;0;1500;1200;300;
2021-11-15 19:55:33;8993274532105;BOLU;2;1000;0;2000;1666;334;
2021-11-15 19:55:33;8992761122430;FRESTEA GREEN HONEY 500ML;1;6500;0;6500;4708;1792;
2021-11-15 19:55:33;8992761002022;SPRITE PET 390ML;1;5500;0;5500;4333;1167;
2021-11-15 20:00:27;8997028590014;ARGUS 220ML;1;500;0;500;302;198;
2021-11-15 20:13:48;8991002114067;PIKOPI;1;1000;0;1000;545;455;
2021-11-15 20:17:02;8994867007161;ROKOK PENA GOLD 20;1;18000;0;18000;16800;1200;
2021-11-15 20:17:02;ICE CREAM;ICE CREAM 2000;1;2000;0;2000;1700;300;
2021-11-17 15:09:00;8992959953198;SWEETY BRONZE XL 26+2;1;60000;0;60000;54091;5909;
2021-11-17 15:17:20;SF GULUNG;SAFFANAH ROTI GULUNG;1;6000;0;6000;5500;500;
2021-11-17 15:17:20;TG MARKISA;TEH GELAS MARKISA;1;2000;0;2000;1178;822;
2021-11-17 15:17:20;8992761111540;FANTA STRAWBERY SLIM CAM 250ML;1;5000;0;5000;3750;1250;
2021-11-17 15:17:20;8999909004221;SAMPOERNA ULTRAMILD 16;1;22000;0;22000;20350;1650;
2021-11-17 15:17:20;8998866201865;KRISBEE PILLOW CHOCOLAVA 120 GR;1;8000;0;8000;7250;750;
2021-11-17 15:17:20;8992696523067;MILO ACTVGO UHT 180ML;1;4500;0;4500;3719;781;
2021-11-17 15:17:49;kri;kripik pisang;1;5000;0;5000;4000;1000;
2021-11-17 15:19:16;TG MARKISA;TEH GELAS MARKISA;1;2000;0;2000;1178;822;
2021-11-17 15:19:16;8992388101085;NU GREEN TEA ORIGINAL 330ML;1;3500;0;3500;2768;732;
2021-11-17 15:30:59;8992702000063;INDOMILK COKLAT 370G;1;10000;0;10000;9208;792;
2021-11-17 15:30:59;8998866201865;KRISBEE PILLOW CHOCOLAVA 120 GR;1;8000;0;8000;7250;750;
2021-11-17 15:30:59;8992761139018;ADES 600ML;1;3500;0;3500;2166;1334;
2021-11-17 15:30:59;8998866202619;MIE SEDAAP KOREAN SPICY SOUP;2;2700;0;5400;4644;756;
2021-11-17 15:30:59;8999999533731;CITRA TS NATURE WHITE 70G;1;2200;0;2200;1900;300;
2021-11-17 15:30:59;8997028590045;ARGUS BTL 330ML;1;2000;0;2000;1291;709;
2021-11-17 15:30:59;6907992823874;JD CRUNCHY CHOCO BLUEBERRY;1;5500;0;5500;4700;800;
2021-11-17 15:30:59;8997009460343;NEXI NET;2;1000;0;2000;1800;200;
2021-11-17 15:30:59;8997028590014;ARGUS 220ML;2;500;0;1000;604;396;
2021-11-17 15:30:59;8994834003752;TICTIC;2;2000;0;4000;3400;600;
2021-11-17 15:30:59;8992388101085;NU GREEN TEA ORIGINAL 330ML;1;3500;0;3500;2768;732;
2021-11-17 15:30:59;8996001600269;LE MINERAL 600ML;1;3000;0;3000;1688;1312;
2021-11-17 15:30:59;8996001600375;LE MINERAL 330ML;2;2000;0;4000;2834;1166;
2021-11-17 15:35:23;8996001328163;GULA GULA TAMARIN;4;250;0;1000;800;200;
2021-11-17 15:35:23;gula;GULA;1;11500;0;11500;10000;1500;
2021-11-17 15:35:23;8992696425316;NESCAFE BLACK;1;5000;0;5000;4099;901;
2021-11-17 15:35:23;8992761164539;NUTRIBOOST ORANGE 300ML;1;6500;0;6500;5300;1200;
2021-11-17 15:35:23;KRIPIK;KRIPIK KENTANG;1;1000;0;1000;900;100;
2021-11-17 15:35:23;8886001038011;BENG-BENG SCT;1;1500;0;1500;1000;500;
2021-11-17 15:35:53;8998866200561;EKOMIE SUPER 600GR;1;10000;0;10000;8615;1385;
2021-11-17 15:46:42;8998989110129;SURYA KECIL MERAH 12KS;1;20000;0;20000;18450;1550;
2021-11-17 15:46:42;8999909982000;SAMPOERNA 12 FILTER;1;19000;0;19000;16600;2400;
2021-11-17 15:46:42;8997218380159;ICHITAN BROWN SUGAR;1;8000;0;8000;6500;1500;
2021-11-17 15:46:42;8996001600375;LE MINERAL 330ML;1;2000;0;2000;1417;583;
2021-11-17 15:46:42;8999909001909;MAGNUM REVAMP BLACK 12;1;18000;0;18000;16300;1700;
2021-11-17 15:46:42;8992716109172;BISKUAT BOLU SCT;1;2000;0;2000;1641;359;
2021-11-17 15:46:42;8997028590014;ARGUS 220ML;4;500;0;2000;1208;792;
2021-11-17 15:46:42;8996001308059;Sari gandum sandwich;3;2000;0;6000;5100;900;
2021-11-17 15:46:42;8995150101696;M+SUSU ORIGINAL;1;5000;0;5000;4000;1000;
2021-11-17 15:46:42;8993351139807;REAL GOOD;2;1000;0;2000;1600;400;
2021-11-17 15:46:42;8998989500166;GUDANG GARAM MERAH BESAR 16KS;1;18000;0;18000;17000;1000;
2021-11-17 15:46:42;gula;GULA;1;11500;0;11500;10000;1500;
2021-11-17 15:46:42;8998989300261;GUDANG GARAM SURYA 12 FILTER;1;20000;0;20000;18150;1850;
2021-11-17 15:59:02;8998866202619;MIE SEDAAP KOREAN SPICY SOUP;1;2700;0;2700;2322;378;
2021-11-17 15:59:02;089686021127;INTER MIE KALDU;1;1000;0;1000;813;187;
2021-11-17 15:59:02;8998989300261;GUDANG GARAM SURYA 12 FILTER;1;20000;0;20000;18150;1850;
2021-11-17 15:59:02;8998989110501;gudang garam surya;1;2000;0;2000;1380;620;
2021-11-17 15:59:02;8997028590014;ARGUS 220ML;2;500;0;1000;604;396;
2021-11-17 15:59:02;8995555111221;sosis kimbo;4;1000;0;4000;3400;600;
2021-11-17 15:59:02;8998866200325;MIE SEDAAP SOTO;1;2700;0;2700;2282;418;
2021-11-17 15:59:02;8993989311699;CLAS MILD 16 FILTER;1;24000;0;24000;21700;2300;
2021-11-17 15:59:02;8992959953334;SWEETY BRONZE XL42;1;80000;0;80000;75455;4545;
2021-11-17 15:59:02;SFX;SOFTEX DAUN SIRIH 1;1;500;0;500;413;87;
2021-11-17 15:59:02;8991001242013;Top;1;1000;0;1000;500;500;
2021-11-17 15:59:02;8999909004221;SAMPOERNA ULTRAMILD 16;1;22000;0;22000;20350;1650;
2021-11-17 15:59:02;8998989110129;SURYA KECIL MERAH 12KS;1;20000;0;20000;18450;1550;
2021-11-17 16:08:47;8998989500166;GUDANG GARAM MERAH BESAR 16KS;1;18000;0;18000;17000;1000;
2021-11-17 16:08:47;gula;GULA;2;11500;0;23000;20000;3000;
2021-11-17 16:08:47;8999999030179;PEPSODENT ACTION 123 COMPLETE 75G;1;6700;0;6700;5170;1530;
2021-11-17 16:08:47;8991004011906;KOPI BORONG;1;10000;0;10000;8333;1667;
2021-11-17 16:08:47;8991002105409;KOPI KAPAL API;1;20000;0;20000;18888;1112;
2021-11-17 16:08:47;8995139505019;UPIN IPIN;2;2000;0;4000;3200;800;
2021-11-17 16:08:47;8992628022156;MINYAK GORENG BIMOLI POUCH 1 LT;1;17500;0;17500;16675;825;
2021-11-17 16:08:47;ROTI;ROTI 2000;1;2000;0;2000;1800;200;
2021-11-17 16:08:47;8992775312469;GERY SALUT COKELAT;1;11000;0;11000;9983;1017;
2021-11-17 16:08:47;8992388101085;NU GREEN TEA ORIGINAL 330ML;1;3500;0;3500;2768;732;
2021-11-17 16:08:47;8991102987639;WFR TANGO LONG VNL 130G;1;5000;0;5000;4350;650;
2021-11-17 16:08:47;089686021219;INTER MIE GORENG;5;1000;0;5000;4425;575;
2021-11-17 16:08:47;8991102228053;TEH GELAS BOTOL;2;3000;0;6000;3390;2610;
2021-11-17 16:16:23;8992761111533;SPRITE SLIM CAM250ML;1;5000;0;5000;3750;1250;
2021-11-17 16:16:23;6907992823829;JD MILKY MILK;1;3000;0;3000;2600;400;
2021-11-17 16:16:23;8991102714907;Kopi Seruput Simanis Aren 200ml;1;3000;0;3000;2375;625;
2021-11-17 16:16:23;6907992823669;JD MILKY STRAW;4;3000;0;12000;10400;1600;
2021-11-17 16:16:23;8995150101696;M+SUSU ORIGINAL;1;5000;0;5000;4000;1000;
2021-11-17 16:16:23;8994867007161;ROKOK PENA GOLD 20;1;18000;0;18000;16800;1200;
2021-11-17 16:16:23;8998989110501;gudang garam surya;1;2000;0;2000;1380;620;
2021-11-17 16:16:23;8998866200561;EKOMIE SUPER 600GR;1;10000;0;10000;8615;1385;
2021-11-17 16:16:23;8999801700054;SUSU FOYU 1 KG;1;22000;0;22000;19791;2209;
2021-11-17 16:16:23;8996001302323;MALKIST ABON;1;6500;0;6500;4800;1700;
2021-11-17 16:16:23;8993989311699;CLAS MILD 16 FILTER;1;24000;0;24000;21700;2300;
2021-11-17 16:16:23;8998989300261;GUDANG GARAM SURYA 12 FILTER;1;20000;0;20000;18150;1850;
2021-11-17 16:16:23;123124;KOREK BIASA;1;2000;0;2000;1300;700;
2021-11-17 16:25:18;RT MNTG;ROTI SISIR MENTEGA;3;2000;0;6000;4800;1200;
2021-11-17 16:25:18;7622201430153;OREO CHOCOLATE 38G;1;2000;0;2000;1641;359;
2021-11-17 16:25:18;gula;GULA;4;11500;0;46000;40000;6000;
2021-11-17 16:25:18;8991102714907;Kopi Seruput Simanis Aren 200ml;1;3000;0;3000;2375;625;
2021-11-17 16:25:18;8997028590014;ARGUS 220ML;4;500;0;2000;1208;792;
2021-11-17 16:25:18;8995139505019;UPIN IPIN;1;2000;0;2000;1600;400;
2021-11-17 16:25:18;RT BAKPIA;ROTI BAKPIA;5;1000;0;5000;3750;1250;
2021-11-17 16:25:18;8991102022347;SIKAT GIGI FORMULA RIPPLE;1;5000;0;5000;4583;417;
2021-11-17 16:25:18;8998866200301;MIE SEDAAP GORENG;2;3000;0;6000;4828;1172;
2021-11-17 16:25:18;8998866200325;MIE SEDAAP SOTO;1;2700;0;2700;2282;418;
2021-11-17 16:25:18;8992696404441;SUSU BURUANG;1;13000;0;13000;8585;4415;
2021-11-17 16:25:18;6907992823935;JD SWEETCORN;1;3500;0;3500;3000;500;
2021-11-17 16:25:18;8996001308059;Sari gandum sandwich;1;2000;0;2000;1700;300;
2021-11-17 16:32:46;RT MNTG;ROTI SISIR MENTEGA;1;2000;0;2000;1600;400;
2021-11-17 16:32:46;8998989500166;GUDANG GARAM MERAH BESAR 16KS;1;18000;0;18000;17000;1000;
2021-11-17 16:32:46;123124;KOREK BIASA;1;2000;0;2000;1300;700;
2021-11-17 16:32:46;8993007003902;Susu Kental Manis Indo milk;1;15000;0;15000;13333;1667;
2021-11-17 16:32:46;TBR;TEPUNG BERAS ROSE BRAND;1;8000;0;8000;6150;1850;
2021-11-17 16:32:46;8886030322907;PORSTEX BIRU 500ML;1;15500;0;15500;13000;2500;
2021-11-17 16:32:46;8998866200301;MIE SEDAAP GORENG;2;3000;0;6000;4828;1172;
2021-11-17 16:32:46;8998866202619;MIE SEDAAP KOREAN SPICY SOUP;2;2700;0;5400;4644;756;
2021-11-17 16:32:46;089686021127;INTER MIE KALDU;5;1000;0;5000;4065;935;
2021-11-17 16:32:46;8997028590045;ARGUS BTL 330ML;2;2000;0;4000;2582;1418;
2021-11-17 16:32:46;8995333032113;TERIGU GATOT KACA 1 KG;1;9000;0;9000;8572;428;
2021-11-17 16:32:46;8995333060703;TERIGU KOMPAS 1KG;1;10500;0;10500;9816;684;
2021-11-17 16:33:32;8992628020152;MINYAK GOREG BIMOLI POUCH 2L;1;35000;0;35000;29800;5200;
2021-11-17 16:36:33;8991001111883;SILVERQUEEN CHUNKYBAR 33G;2;8000;0;16000;14300;1700;
2021-11-17 16:46:18;8997028590014;ARGUS 220ML;4;500;0;2000;1208;792;
2021-11-17 16:46:18;8995333032113;TERIGU GATOT KACA 1 KG;1;9000;0;9000;8572;428;
2021-11-17 16:46:18;8995333060703;TERIGU KOMPAS 1KG;1;10500;0;10500;9816;684;
2021-11-17 16:46:18;TBR;TEPUNG BERAS ROSE BRAND;1;8000;0;8000;6150;1850;
2021-11-17 16:46:18;TELUR RAK;TELUR RAK;1;38000;0;38000;35000;3000;
2021-11-17 16:46:18;Beras;Beras Liter;4;8000;0;32000;30000;2000;
2021-11-17 16:46:18;8998866202244;EKOMIE BUMBU KALDU AYAM;3;1000;0;3000;2394;606;
2021-11-17 16:46:18;ARG;ARGUS DOS 220ML;1;15000;0;15000;13500;1500;
2021-11-20 11:49:39;gula;GULA;1;11500;0;11500;10000;1500;
2021-11-20 14:59:16;8998866200646;KOPI TOP MURNI;1;11000;0;11000;9600;1400;
2021-11-20 15:07:04;6916597571752;TOFFEE R. COKLAT;2;1000;0;2000;1400;600;
2021-11-20 15:32:58;8991002105584;KAPAL API 6.5 G;2;500;0;1000;780;220;
2021-11-20 15:52:19;8997218010230;yohoo;4;1000;0;4000;3600;400;
2021-11-20 16:02:56;6907992823966;JD BLUEBERRY;1;3500;0;3500;3000;500;
2021-11-20 16:24:43;8997028590045;ARGUS BTL 330ML;35;2000;0;70000;45185;24815;
2021-11-20 16:24:43;8997028590052;ARGUS BTL 600ML;10;3000;0;30000;14580;15420;
2021-11-20 16:24:43;8994023000050;MEGKEJU SERBAGUNA 165G;1;13000;0;13000;12000;1000;
2021-11-20 16:24:43;8995139505019;UPIN IPIN;2;2000;0;4000;3200;800;
2021-11-20 16:24:43;gula;GULA;3;11500;0;34500;30000;4500;
2021-11-20 16:24:43;8995333060703;TERIGU KOMPAS 1KG;1;10500;0;10500;9816;684;
2021-11-20 16:24:43;8998989110167;SURYA GUDANG GARAM 16 FILTER;1;26000;0;26000;23700;2300;
2021-11-20 16:24:43;ICE CREAM 6;ICE CREAM 6.000;3;6000;0;18000;15600;2400;
2021-11-20 16:24:43;8999999531423;CITRA SUN SPF20 230ML;1;22300;0;22300;20735;1565;
2021-11-20 16:24:43;8999999528966;CITRA FRESH WHITE 120ML;1;13200;0;13200;11875;1325;
2021-11-20 16:24:43;8993351139807;REAL GOOD;2;1000;0;2000;1600;400;
2021-11-20 16:24:43;8999999192150;ROYCO FDS CHICKEN 100GR;1;5000;0;5000;4300;700;
2021-11-20 16:24:43;8993226365522;GARAM MEJA GYURI 200GR;1;2000;0;2000;1700;300;
2021-11-20 16:25:58;8998989300261;GUDANG GARAM SURYA 12 FILTER;1;20000;0;20000;18150;1850;
2021-11-20 16:25:58;4800361347594;LACTOGEN 1 180G;1;28000;0;28000;26033;1967;
2021-11-20 16:33:14;ARG;ARGUS DOS 220ML;2;15000;0;30000;27000;3000;
2021-11-20 16:39:04;8992959930762;CONFI CLASS DAY XL1;1;6500;0;6500;5682;818;
2021-11-20 16:39:04;8992696404441;SUSU BURUANG;1;13000;0;13000;8585;4415;
2021-11-20 16:39:04;8992946511790;SHINZUI 85G;1;5000;0;5000;3475;1525;
2021-11-20 16:41:50;8997210107877;VORTEX SMART 3;2;5000;0;10000;9500;500;
2021-11-20 16:45:02;8886022830243;BATEREI ABC;2;3000;0;6000;3856;2144;
2021-11-20 16:52:59;8998989300261;GUDANG GARAM SURYA 12 FILTER;1;20000;0;20000;18150;1850;
2021-11-20 17:08:36;123124;KOREK BIASA;1;2000;0;2000;1300;700;
2021-11-20 17:08:36;8991906105758;ROKOK LA BOLD;1;27000;0;27000;24900;2100;
2021-11-20 17:08:36;8999909096004;SAMPOERNA 16 FILTER;2;25000;0;50000;46200;3800;
2021-11-20 17:08:36;8992696419742;NESCAFE COFFE CREAM;1;5000;0;5000;4099;901;
2021-11-20 17:08:36;8993351139807;REAL GOOD;4;1000;0;4000;3200;800;
2021-11-20 17:08:36;8997009460657;STICK COKELAT;1;1000;0;1000;425;575;
2021-11-20 17:08:36;8992775002582;DILAN CHOCO;1;2000;0;2000;1503;497;
2021-11-20 17:08:36;Vita Jelly;Vita Jelly;1;1000;0;1000;766;234;
2021-11-20 17:12:21;ICE CREAM 5.000;ICE CREAM 5.000;1;5000;0;5000;4700;300;
2021-11-20 17:12:21;BALON GAS;BALON GAS;8;500;0;4000;3200;800;
2021-11-20 17:16:47;Gula gula kaki;gula gula kaki;1;500;0;500;400;100;
2021-11-20 17:16:47;8994834006128;TICTIC PEDAS;2;2000;0;4000;3400;600;
2021-11-20 17:16:47;8997028590045;ARGUS BTL 330ML;1;2000;0;2000;1291;709;
2021-11-20 17:16:47;9556040040038;SUSU F&N;5;35000;0;175000;150000;25000;
2021-11-20 17:16:47;8992730950194;GULA GULA KOIN;10;500;0;5000;4000;1000;
2021-11-20 17:16:47;8999801700030;SUSU FOYU;1;11500;0;11500;10450;1050;
2021-11-20 17:16:47;8994834003752;TICTIC;1;2000;0;2000;1700;300;
2021-11-20 17:18:23;8996001308059;Sari gandum sandwich;1;2000;0;2000;1700;300;
2021-11-20 17:18:23;8999909004221;SAMPOERNA ULTRAMILD 16;1;22000;0;22000;20350;1650;
2021-11-20 17:18:23;8994867006997;ROKOK PENA BOLD 20BTG;1;17000;0;17000;15000;2000;
2021-11-20 17:20:22;MK;MASKER;1;5000;0;5000;4000;1000;
2021-11-20 17:22:19;8996001308059;Sari gandum sandwich;1;2000;0;2000;1700;300;
2021-11-20 17:22:19;8995333060772;TERIGU GATOT KACA 500GR;1;5000;0;5000;4346;654;
2021-11-20 17:22:19;8995333032113;TERIGU GATOT KACA 1 KG;3;9000;0;27000;25716;1284;
2021-11-20 17:22:19;gula;GULA;1;11500;0;11500;10000;1500;
2021-11-20 17:23:43;8995555111221;sosis kimbo;1;1000;0;1000;850;150;
2021-11-20 17:23:43;8999909002821;MARLBORO BLACK 16;1;22000;0;22000;20900;1100;
2021-11-20 17:23:43;711844110083;KECAP ABC 275 ML;1;16000;0;16000;15000;1000;
2021-11-20 17:26:49;8995333032113;TERIGU GATOT KACA 1 KG;2;9000;0;18000;17144;856;
2021-11-20 17:26:49;8993093115008;tepun beras;3;8000;0;24000;21000;3000;
2021-11-20 17:26:49;8992761002022;SPRITE PET 390ML;1;5500;0;5500;4333;1167;
2021-11-20 17:26:49;8992696404441;SUSU BURUANG;1;13000;0;13000;8585;4415;
2021-11-20 17:35:56;8998866201520;KOPI TOP TORAJA MURNI;1;11000;0;11000;9600;1400;
2021-11-20 17:35:56;8993007000086;INDOMILK CKLT 1L;1;16500;0;16500;14791;1709;
2021-11-20 17:35:56;089686043204;INDOMIE MIE ACEH;1;2700;0;2700;2452;248;
2021-11-20 17:35:56;ABC;BATERAI ABC BIRU;1;2500;0;2500;1928;572;
2021-11-20 17:38:17;ABC;BATERAI ABC BIRU;1;3000;0;3000;1928;1072;
2021-11-20 17:41:22;8993351139807;REAL GOOD;2;1000;0;2000;1600;400;
2021-11-20 17:41:22;8991188943062;SASA 250G;1;10000;0;10000;8500;1500;
2021-11-20 17:41:22;8997218010230;yohoo;1;1000;0;1000;900;100;
2021-11-20 17:41:22;PRG;PARAGO;2;500;0;1000;800;200;
2021-11-20 17:43:44;PRG;PARAGO;2;500;0;1000;800;200;
2021-11-20 17:44:08;ARG;ARGUS DOS 220ML;1;15000;0;15000;13500;1500;
2021-11-20 17:46:44;8994867007161;ROKOK PENA GOLD 20;1;19000;0;19000;17400;1600;
2021-11-20 17:56:04;8992696419742;NESCAFE COFFE CREAM;1;5000;0;5000;4099;901;
2021-11-20 17:56:04;8993226365522;GARAM MEJA GYURI 200GR;1;2000;0;2000;1700;300;
2021-11-20 17:56:04;ABC;BATERAI ABC BIRU;2;3000;0;6000;3856;2144;
2021-11-20 17:56:04;8997028590014;ARGUS 220ML;6;500;0;3000;1812;1188;
2021-11-20 17:56:04;8991102987639;WFR TANGO LONG VNL 130G;1;5000;0;5000;4350;650;
2021-11-20 17:56:04;RT MNTG;ROTI SISIR MENTEGA;1;2000;0;2000;1600;400;
2021-11-20 17:56:04;ARG;ARGUS DOS 220ML;3;15000;0;45000;40500;4500;
2021-11-20 17:56:04;8991909101016;URBAN MILD 16;1;17000;0;17000;15800;1200;
2021-11-20 17:56:04;123124;KOREK BIASA;1;2000;0;2000;1300;700;
2021-11-20 17:56:04;8998989300261;GUDANG GARAM SURYA 12 FILTER;1;20000;0;20000;18150;1850;
2021-11-20 17:56:04;8997218010230;yohoo;1;1000;0;1000;900;100;
2021-11-20 17:56:04;8996001600399;LE MINERAL 1500ML;1;5000;0;5000;4042;958;
2021-11-20 17:56:04;8999909004221;SAMPOERNA ULTRAMILD 16;1;22000;0;22000;20350;1650;
2021-11-20 18:05:40;RT MNTG;ROTI SISIR MENTEGA;2;2000;0;4000;3200;800;
2021-11-20 18:05:40;8992761145033;FANTA STRAW PET 250ML;1;3500;0;3500;2417;1083;
2021-11-20 18:05:40;8991002105409;KOPI KAPAL API;1;20000;0;20000;18888;1112;
2021-11-20 18:05:40;8998866692663;SOKLIN FLOORCLENER KUNING 450ML;1;7000;0;7000;6385;615;
2021-11-20 18:05:40;8999999390198;SUNLIGHT LIME NEW POUCH 755ML;1;18000;0;18000;15950;2050;
2021-11-20 18:05:40;SF SOSIS;SAFFANAH ROTI SOSIS;1;6000;0;6000;5500;500;
2021-11-20 18:05:40;8997006030006;RX BOLD;1;20000;0;20000;18100;1900;
2021-11-20 18:05:40;8996001308059;Sari gandum sandwich;1;2000;0;2000;1700;300;
2021-11-20 18:05:40;Vita Jelly;Vita Jelly;1;1000;0;1000;766;234;
2021-11-20 18:05:40;8999909002821;MARLBORO BLACK 16;1;22000;0;22000;20900;1100;
2021-11-20 18:05:40;8994867006997;ROKOK PENA BOLD 20BTG;1;17000;0;17000;15000;2000;
2021-11-20 18:05:40;JL;JELLY;2;500;0;1000;800;200;
2021-11-20 18:05:40;8993007000680;INDOMILK 1L;1;16500;0;16500;14792;1708;
2021-11-20 18:16:39;8996001600269;LE MINERAL 600ML;1;3000;0;3000;1688;1312;
2021-11-20 18:16:39;8992775001783;GERY SALUT MALKIST KELAPA;1;6500;0;6500;5516;984;
2021-11-20 18:16:39;8998866201490;POTABEE REGULER GRILLED SEAWED 68 GR;1;8000;0;8000;7200;800;
2021-11-20 18:16:39;8998866203104;MIE SEDAAP SINGAPORE;3;2500;0;7500;6798;702;
2021-11-20 18:16:39;8999999710866;PEPSODENT 123 HERBAL 190G;1;18000;0;18000;17500;500;
2021-11-20 18:16:39;8996001308059;Sari gandum sandwich;2;2000;0;4000;3400;600;
2021-11-20 18:16:39;MK;MASKER;2;5000;0;10000;8000;2000;
2021-11-20 18:16:39;8998989300261;GUDANG GARAM SURYA 12 FILTER;1;20000;0;20000;18150;1850;
2021-11-20 18:16:39;8994834006128;TICTIC PEDAS;1;2000;0;2000;1700;300;
2021-11-20 18:16:39;TAMARA;TAMARA;4;1000;0;4000;1680;2320;
2021-11-20 18:16:39;JL;JELLY;4;500;0;2000;1600;400;
2021-11-20 18:16:39;BALON GAS;BALON GAS;2;500;0;1000;800;200;
2021-11-20 18:16:39;RT MENARA;ROTI TAWAR MENARA;1;8000;0;8000;7200;800;
2021-11-20 18:26:39;lolipop;lolipop;2;1000;0;2000;1700;300;
2021-11-20 18:26:39;711844110021;KECAP ABC 600 ML;2;22000;0;44000;41400;2600;
2021-11-20 18:26:39;8998866200561;EKOMIE SUPER 600GR;1;10000;0;10000;8615;1385;
2021-11-20 18:26:39;8992628020152;MINYAK GOREG BIMOLI POUCH 2L;1;35000;0;35000;29800;5200;
2021-11-20 18:26:39;8995333060772;TERIGU GATOT KACA 500GR;1;5000;0;5000;4346;654;
2021-11-20 18:26:39;RT MNTG;ROTI SISIR MENTEGA;2;2000;0;4000;3200;800;
2021-11-20 18:26:39;8998866202244;EKOMIE BUMBU KALDU AYAM;3;1000;0;3000;2394;606;
2021-11-20 18:26:39;8998866202619;MIE SEDAAP KOREAN SPICY SOUP;1;2700;0;2700;2322;378;
2021-11-20 18:26:39;JL;JELLY;2;500;0;1000;800;200;
2021-11-20 18:26:39;8998866201490;POTABEE REGULER GRILLED SEAWED 68 GR;1;8000;0;8000;7200;800;
2021-11-20 18:32:12;Garuda pilus;Garuda Pilus Pedas Pcs;2;500;0;1000;816;184;
2021-11-20 18:32:12;8997028590014;ARGUS 220ML;10;500;0;5000;3020;1980;
2021-11-20 18:32:12;TAMARA;TAMARA;4;1000;0;4000;1680;2320;
2021-11-20 18:55:36;8998866200301;MIE SEDAAP GORENG;1;3000;0;3000;2414;586;
2021-11-20 18:55:36;089686043204;INDOMIE MIE ACEH;1;2700;0;2700;2452;248;
2021-11-20 18:55:36;gula;GULA;1;11500;0;11500;10000;1500;
2021-11-20 18:55:36;RT MNTG;ROTI SISIR MENTEGA;1;2000;0;2000;1600;400;
2021-11-20 18:55:36;8999909085114;SAMPOERNA KRETEK HIJAU 12;1;13000;0;13000;11650;1350;
2021-11-20 18:55:36;11222;LEM KOREA;1;10000;0;10000;8000;2000;
2021-11-20 18:55:36;8997028590052;ARGUS BTL 600ML;1;3000;0;3000;1458;1542;
2021-11-20 18:55:36;8991102987639;WFR TANGO LONG VNL 130G;1;5000;0;5000;4350;650;
2021-11-20 18:55:36;089686386011;BUMBU RACIK NASI GORENG;1;2000;0;2000;1450;550;
2021-11-20 18:55:36;8999999036836;LUX BW VELVET JASMINE LD REFF 450 ML;1;25000;0;25000;22110;2890;
2021-11-20 18:55:36;8994834006128;TICTIC PEDAS;1;2000;0;2000;1700;300;
2021-11-20 18:58:11;8992984920110;CUKA DAPUR DUA BELIBIS;1;4500;0;4500;3250;1250;
2021-11-20 18:58:11;8999999502409;ROYCO FDS BEEF 9G;12;500;0;6000;4500;1500;
2021-11-20 18:58:11;8999999059781;SUNLIGHT LIME NEW POUCH 210ML;1;5000;0;5000;4520;480;
2021-11-20 19:01:38;8997018460150;MARLBORO ICE BURST 20;1;31000;0;31000;29650;1350;
2021-11-20 19:02:14;8994191103638;GULA GULA KARET;8;500;0;4000;3200;800;
2021-11-20 19:15:01;8995333060703;TERIGU KOMPAS 1KG;1;10500;0;10500;9816;684;
2021-11-20 19:15:01;RB;RED BOLD;1;20000;0;20000;18800;1200;
2021-11-20 19:15:01;8992775305164;GERY MALKIST GREEN TEA;1;6500;0;6500;5500;1000;
2021-11-20 19:15:01;8992761145026;SPRITE PET 250ML;1;3500;0;3500;2417;1083;
2021-11-20 19:15:01;8991102714846;MILKIDO CKLT;2;3000;0;6000;4306;1694;
2021-11-20 19:15:01;8993154789575;GULA GULA TUSUK;2;500;0;1000;800;200;
2021-11-20 19:15:01;ARG;ARGUS DOS 220ML;5;15000;0;75000;67500;7500;
2021-11-20 19:15:01;76239878;MARLBORO GOLD;1;31000;0;31000;29650;1350;
2021-11-20 19:15:01;8991102228053;TEH GELAS BOTOL;1;3000;0;3000;1695;1305;
2021-11-20 19:15:01;8991102714907;Kopi Seruput Simanis Aren 200ml;1;3000;0;3000;2375;625;
2021-11-20 19:15:01;8996001600375;LE MINERAL 330ML;1;2000;0;2000;1417;583;
2021-11-20 19:15:01;TEMBAK;TEMBAK SNIPPER;1;3500;0;3500;2500;1000;
2021-11-20 19:15:01;7622210437686;BISKUAT;2;500;0;1000;800;200;
2021-11-20 19:32:31;gula gula;gula-gula karet;2;500;0;1000;800;200;
2021-11-20 19:32:31;8994867006997;ROKOK PENA BOLD 20BTG;1;17000;0;17000;15000;2000;
2021-11-20 19:32:31;8998866202626;Top Kopi Gula Aren 22gr;2;1000;0;2000;1106;894;
2021-11-20 19:32:31;SF SOSIS;SAFFANAH ROTI SOSIS;1;6000;0;6000;5500;500;
2021-11-20 19:32:31;8998866608046;KECAP MANIS SEDAAP POUCH 225ML;1;8500;0;8500;7744;756;
2021-11-20 19:32:31;7622210437686;BISKUAT;4;500;0;2000;1600;400;
2021-11-20 19:32:31;8999999530266;LIFEBUOY MATCHA GREENTEA 100ML;1;10500;0;10500;9405;1095;
2021-11-20 19:32:31;8997028590014;ARGUS 220ML;2;500;0;1000;604;396;
2021-11-20 19:32:31;RT MNTG;ROTI SISIR MENTEGA;1;2000;0;2000;1600;400;
2021-11-20 19:32:31;8998989300261;GUDANG GARAM SURYA 12 FILTER;1;20000;0;20000;18150;1850;
2021-11-20 19:32:31;8999999518998;RINSO MOLTO PERFUME ESSENSE 770GR;1;21300;0;21300;19338;1962;
2021-11-20 19:32:31;8992628020152;MINYAK GOREG BIMOLI POUCH 2L;1;35000;0;35000;29800;5200;
2021-11-20 19:32:31;8994907000428;KECAP SACHET ABC;20;600;0;12000;10000;2000;
2021-11-20 19:40:38;8998866203227;MIE SEDAAP AYAM BAKAR LIMAU;1;2700;0;2700;2163;537;
2021-11-20 19:40:38;8991102023115;Sikat Gigi Formula;1;11000;0;11000;10000;1000;
2021-11-20 19:40:38;8997027300089;NOMOS;1;4000;0;4000;2963;1037;
2021-11-20 19:40:38;8998989300261;GUDANG GARAM SURYA 12 FILTER;1;20000;0;20000;18150;1850;
2021-11-20 19:40:38;7622300335809;OREO SOFT CAKE;1;2000;0;2000;1641;359;
2021-11-20 19:40:38;8995555111221;sosis kimbo;1;1000;0;1000;850;150;
2021-11-20 19:40:38;089686727081;DORITOS 55G;1;7000;0;7000;5950;1050;
2021-11-20 19:40:38;8997028590014;ARGUS 220ML;4;500;0;2000;1208;792;
2021-11-20 19:40:38;8991102384841;WFR TANGO LONG CKLT 130G;1;5000;0;5000;4345;655;
2021-11-20 19:40:38;gula;GULA;1;11500;0;11500;10000;1500;
2021-11-20 19:40:38;8996001305041;ROMA SANDWICH CKLT;1;7000;0;7000;5928;1072;
2021-11-20 19:40:38;RT MNTG;ROTI SISIR MENTEGA;2;2000;0;4000;3200;800;
2021-11-20 19:40:38;8992760223015;OREO CHOCOLATE CREAM 133G;1;8000;0;8000;6300;1700;
2021-11-20 19:40:38;ROTI;ROTI 2000;1;2000;0;2000;1800;200;
2021-11-20 19:40:38;8996001600399;LE MINERAL 1500ML;1;5000;0;5000;4042;958;
2021-11-20 19:50:10;8992959117583;SOFTEX DAUN SIRIH;1;5000;0;5000;4288;712;
2021-11-20 19:50:10;8996001320068;GULA GULA KOPIKO;4;250;0;1000;800;200;
2021-11-20 19:50:10;8998866200325;MIE SEDAAP SOTO;1;2700;0;2700;2282;418;
2021-11-20 19:50:10;8998866200301;MIE SEDAAP GORENG;2;3000;0;6000;4828;1172;
2021-11-20 19:50:10;8999909096004;SAMPOERNA 16 FILTER;1;25000;0;25000;23100;1900;
2021-11-20 19:50:10;ROTI;ROTI 2000;2;2000;0;4000;3600;400;
2021-11-20 19:50:10;kri;kripik pisang;1;5000;0;5000;4000;1000;
2021-11-20 19:50:10;8996001440520;ENERGEN JAGUNG;2;1500;0;3000;2300;700;
2021-11-20 19:50:10;8994907001272;KECAP ABC 700 ML;1;22500;0;22500;21000;1500;
2021-11-20 19:53:03;8995333032113;TERIGU GATOT KACA 1 KG;3;9000;0;27000;25716;1284;
2021-11-20 20:05:20;gula;GULA;3;11500;0;34500;30000;4500;
2021-11-20 20:05:20;089686021127;INTER MIE KALDU;2;1000;0;2000;1626;374;
2021-11-20 20:05:20;8992770033178;Masako;6;500;0;3000;2700;300;
2021-11-20 20:05:20;8995555111221;sosis kimbo;2;1000;0;2000;1700;300;
2021-11-20 20:05:20;8998989300261;GUDANG GARAM SURYA 12 FILTER;1;20000;0;20000;18150;1850;
2021-11-20 20:05:20;Telur 3 Biji;Telur 3 Biji;1;5000;0;5000;3600;1400;
2021-11-20 20:05:20;8992775002735;CHOCOLATOS SUSU COKELAT;1;4000;0;4000;3520;480;
2021-11-20 20:05:20;8991909101016;URBAN MILD 16;1;17000;0;17000;15800;1200;
2021-11-20 20:05:20;8997878004327;GULA GULA MILKITA;10;250;0;2500;2000;500;
2021-11-20 20:05:20;8998989110167;SURYA GUDANG GARAM 16 FILTER;1;26000;0;26000;23700;2300;
2021-11-20 20:46:29;8998989110501;gudang garam surya;2;2000;0;4000;2760;1240;
2021-11-20 20:46:29;8997028590014;ARGUS 220ML;2;500;0;1000;604;396;
2021-11-21 18:31:42;8991102987639;WFR TANGO LONG VNL 130G;3;5000;0;15000;13050;1950;
2021-11-21 18:31:42;8994834006128;TICTIC PEDAS;2;2000;0;4000;3400;600;
2021-11-21 18:31:42;8997028590014;ARGUS 220ML;6;500;0;3000;1812;1188;
2021-11-21 18:31:42;123124;KOREK BIASA;1;2000;0;2000;1300;700;
2021-11-21 18:31:42;8992741952262;GULA GULA YUPI;2;250;0;500;400;100;
2021-11-21 18:31:42;8999909004221;SAMPOERNA ULTRAMILD 16;1;22000;0;22000;20350;1650;
2021-11-21 18:31:42;089686727074;DORITOS 160G;1;12000;0;12000;10700;1300;
2021-11-21 18:31:42;8998866201490;POTABEE REGULER GRILLED SEAWED 68 GR;1;8000;0;8000;7200;800;
2021-11-21 18:31:42;8996001600269;LE MINERAL 600ML;1;3000;0;3000;1688;1312;
2021-11-21 18:31:42;8991914101513;VIPER KRETEK 12;1;6000;0;6000;5000;1000;
2021-11-21 18:31:42;8994867000162;ROKOK PUNDIMAS KRETEK16;1;10000;0;10000;8600;1400;
2021-11-21 18:31:42;6907992823966;JD BLUEBERRY;2;3500;0;7000;6000;1000;
2021-11-21 18:31:42;8992730950194;GULA GULA KOIN;2;500;0;1000;800;200;
2021-11-21 18:31:42;8998866200301;MIE SEDAAP GORENG;3;3000;0;9000;7242;1758;
2021-11-21 18:31:42;8993154789575;GULA GULA TUSUK;1;500;0;500;400;100;
2021-11-21 18:31:42;BALON GAS;BALON GAS;1;500;0;500;400;100;
2021-11-21 18:39:13;8992770061034;SAJIKU;1;2000;0;2000;1500;500;
2021-11-21 18:39:13;MBL;MOBIL;1;5000;0;5000;3500;1500;
2021-11-21 18:39:13;PULPEN;PULPEN BIASA;3;2000;0;6000;4500;1500;
2021-11-21 18:39:13;8991002303928;GULA GULA RELAXA;4;250;0;1000;800;200;
2021-11-21 18:39:13;8994834006128;TICTIC PEDAS;1;2000;0;2000;1700;300;
2021-11-21 18:39:13;8997226852006;TEH CAP KAMPUNG MANIS;1;12000;0;12000;10000;2000;
2021-11-21 18:39:13;8997028590014;ARGUS 220ML;2;500;0;1000;604;396;
2021-11-21 18:39:13;8991001503336;chacha minis hat;1;7500;0;7500;6400;1100;
2021-11-21 18:39:13;8992959508893;SWEETY SILVER PANTS S9;1;14500;0;14500;13107;1393;
2021-11-21 18:39:13;Telur 3 Biji;Telur 3 Biji;1;5000;0;5000;3600;1400;
2021-11-21 18:40:02;JELLY;JELLY AGAR;1;1000;0;1000;900;100;
2021-11-21 18:43:16;JELLY;JELLY AGAR;2;1000;0;2000;1800;200;
2021-11-21 18:43:16;8997009510123;ORANGE WATER;1;8000;0;8000;6265;1735;
2021-11-21 18:43:16;8997028590014;ARGUS 220ML;2;500;0;1000;604;396;
2021-11-21 18:43:16;089686021219;INTER MIE GORENG;1;1000;0;1000;885;115;
2021-11-21 18:43:16;KRIPIK;KRIPIK KENTANG;1;1000;0;1000;900;100;
2021-11-21 18:43:16;Garuda pilus pcs;Garuda pilus Rasa Mi Goreng pcs;1;1000;0;1000;808;192;
2021-11-21 18:53:11;JELLY;JELLY AGAR;2;1000;0;2000;1800;200;
2021-11-21 18:53:11;8997009461753;TOP ELIT;2;1000;0;2000;800;1200;
2021-11-21 18:53:11;8999909002821;MARLBORO BLACK 16;1;22000;0;22000;20900;1100;
2021-11-21 18:53:11;KRIPIK;KRIPIK KENTANG;1;1000;0;1000;900;100;
2021-11-21 18:53:11;8992775001806 pcs;Gery salut malkist chocolate coconut pcs;1;1000;0;1000;812;188;
2021-11-21 18:53:11;8992979130012;TOTAL LEMON SOFTENER;1;15000;0;15000;13800;1200;
2021-11-21 18:53:11;4987176052780;PARFUM DOWNY 10 ML;2;500;0;1000;750;250;
2021-11-21 18:53:11;8992761111519;COCA COLA SLIM CAM 250ML;1;5000;0;5000;3750;1250;
2021-11-21 18:53:11;8993989311279;CLAS MILD 12;1;18000;0;18000;15800;2200;
2021-11-21 18:53:11;8997028590014;ARGUS 220ML;4;500;0;2000;1208;792;
2021-11-21 18:53:11;8991102103091;Formula Proteksi;1;3500;0;3500;2650;850;
2021-11-21 18:53:11;8999999034733;PONDS MEN WHITE BOOST 100G;1;29500;0;29500;26620;2880;
2021-11-21 18:53:11;ROTI;ROTI 2000;1;2000;0;2000;1800;200;
2021-11-21 18:53:11;8992761111533;SPRITE SLIM CAM250ML;1;5000;0;5000;3750;1250;
2021-11-21 18:53:11;8998989110167;SURYA GUDANG GARAM 16 FILTER;1;26000;0;26000;23700;2300;
2021-11-21 18:53:11;8991102228053;TEH GELAS BOTOL;1;3000;0;3000;1695;1305;
2021-11-21 18:58:33;ARG;ARGUS DOS 220ML;1;15000;0;15000;13500;1500;
2021-11-21 18:58:33;8992761111533;SPRITE SLIM CAM250ML;1;5000;0;5000;3750;1250;
2021-11-21 18:58:33;8998009040023;TEH KOTAK;1;5000;0;5000;2708;2292;
2021-11-21 18:58:33;8992628020152;MINYAK GOREG BIMOLI POUCH 2L;2;35000;0;70000;59600;10400;
2021-11-21 18:58:33;9556001004673;MILO NESTLE MALAYSIA ACTIVE GO;1;85000;0;85000;80000;5000;
2021-11-21 18:58:33;8997028590014;ARGUS 220ML;4;500;0;2000;1208;792;
2021-11-21 19:03:21;8992775002582;DILAN CHOCO;1;2000;0;2000;1503;497;
2021-11-21 19:03:21;8997218010230;yohoo;1;1000;0;1000;900;100;
2021-11-21 19:07:52;8991001780232;twister choco 80g;1;8000;0;8000;6700;1300;
2021-11-21 19:07:52;8993154789575;GULA GULA TUSUK;1;500;0;500;400;100;
2021-11-21 19:08:43;8993154789575;GULA GULA TUSUK;2;500;0;1000;800;200;
2021-11-21 19:26:12;8991102381024;FULLO VNL PCK;1;10000;0;10000;9000;1000;
2021-11-21 19:26:12;8998989110167;SURYA GUDANG GARAM 16 FILTER;1;26000;0;26000;23700;2300;
2021-11-21 19:26:12;123124;KOREK BIASA;1;2000;0;2000;1300;700;
2021-11-21 19:26:12;ARG;ARGUS DOS 220ML;5;15000;0;75000;67500;7500;
2021-11-21 19:26:12;kri;kripik pisang;1;5000;0;5000;4000;1000;
2021-11-21 19:26:12;8998866202954;Guribee BBQ Balado 68 gr;1;6000;0;6000;5100;900;
2021-11-21 19:26:12;8999999524722;SUNLIGHT LIME NEW PCH 435ML;1;10000;0;10000;9100;900;
2021-11-21 19:26:12;BALON;BALON CABUT;3;1000;0;3000;2700;300;
2021-11-21 19:26:12;8997878004327;GULA GULA MILKITA;4;250;0;1000;800;200;
2021-11-21 19:26:12;SF GULUNG;SAFFANAH ROTI GULUNG;1;6000;0;6000;5500;500;
2021-11-21 19:26:12;VTM;VITAMIN CIMIN;2;500;0;1000;850;150;
2021-11-21 19:26:12;SF TAWAR KUPAS;SAFFANAH ROTI TAWAR KUPAS;1;10000;0;10000;9000;1000;
2021-11-21 19:26:12;TBR;TEPUNG BERAS ROSE BRAND;1;8000;0;8000;6150;1850;
2021-11-21 19:43:29;8998989300261;GUDANG GARAM SURYA 12 FILTER;1;20000;0;20000;18150;1850;
2021-11-21 19:43:29;Pulpen;pulpen;1;1000;0;1000;750;250;
2021-11-21 19:43:29;VTM;VITAMIN CIMIN;6;500;0;3000;2550;450;
2021-11-21 19:43:29;8996001328163;GULA GULA TAMARIN;4;250;0;1000;800;200;
2021-11-21 19:43:29;8991909101016;URBAN MILD 16;1;17000;0;17000;15800;1200;
2021-11-21 19:43:29;123124;KOREK BIASA;1;2000;0;2000;1300;700;
2021-11-21 19:43:29;8992628020152;MINYAK GOREG BIMOLI POUCH 2L;1;35000;0;35000;29800;5200;
2021-11-21 19:43:29;8999999518998;RINSO MOLTO PERFUME ESSENSE 770GR;1;21300;0;21300;19338;1962;
2021-11-21 19:43:29;ROTI;ROTI 2000;4;2000;0;8000;7200;800;
2021-11-21 19:43:29;8998866202244;EKOMIE BUMBU KALDU AYAM;1;1000;0;1000;798;202;
2021-11-21 19:43:29;MBL;MOBIL;1;5000;0;5000;3500;1500;
2021-11-21 19:43:29;TEMBAK;TEMBAK SNIPPER;1;3500;0;3500;2500;1000;
2021-11-21 19:43:29;8997878004327;GULA GULA MILKITA;10;250;0;2500;2000;500;
2021-11-21 20:05:09;SF TAWAR KUPAS;SAFFANAH ROTI TAWAR KUPAS;1;10000;0;10000;9000;1000;
2021-11-21 20:05:09;8999909002821;MARLBORO BLACK 16;1;22000;0;22000;20900;1100;
2021-11-21 20:05:09;ABC;BATERAI ABC BIRU;2;3000;0;6000;3856;2144;
2021-11-21 20:05:09;8997028590014;ARGUS 220ML;2;500;0;1000;604;396;
2021-11-21 20:05:09;8997009462040;TIARA;2;1000;0;2000;850;1150;
2021-11-21 20:05:09;Vita Jelly;Vita Jelly;2;1000;0;2000;1532;468;
2021-11-21 20:05:09;MARS;MARSHMELLOW;4;500;0;2000;1732;268;
2021-11-21 20:05:09;MK;MASKER;1;5000;0;5000;4000;1000;
2021-11-21 20:05:09;8992705025124;AGAR-AGAR SATELIT MERAH;1;3500;0;3500;2604;896;
2021-11-21 20:05:09;8992933241112;NUTRIJELL COKLAT;1;7000;0;7000;6416;584;
2021-11-21 20:05:09;8991111101255;JB SHAMPOO GOLD 50ML;1;5000;0;5000;4500;500;
2021-11-21 20:05:09;ICE CREAM 5.000;ICE CREAM 5.000;1;5000;0;5000;4700;300;
2021-11-21 20:05:09;4902430563888;SHAMPO PANTENE;2;1000;0;2000;1500;500;
2021-11-21 20:05:09;8992775311547;Chocolatos;3;2000;0;6000;4500;1500;
2021-11-21 20:05:09;RT BAKPIA;ROTI BAKPIA;2;1000;0;2000;1500;500;
2021-11-21 20:14:51;8993274532105;BOLU;7;1000;0;7000;5831;1169;
2021-11-21 20:14:51;8998989300261;GUDANG GARAM SURYA 12 FILTER;1;20000;0;20000;18150;1850;
2021-11-21 20:14:51;8992759120264;LARISST 220;1;10000;0;10000;9200;800;
2021-11-21 20:14:51;8991909101016;URBAN MILD 16;1;17000;0;17000;15800;1200;
2021-11-21 20:14:51;VTM;VITAMIN CIMIN;3;500;0;1500;1275;225;
2021-11-21 20:14:51;8998866200301;MIE SEDAAP GORENG;1;3000;0;3000;2414;586;
2021-11-21 20:14:51;MILKITA;MILKITA;2;250;0;500;400;100;
2021-11-21 20:14:51;8991914101513;VIPER KRETEK 12;2;6000;0;12000;10000;2000;
2021-11-21 20:14:51;8991102714679;TANGO TETRA STRAW;1;5000;0;5000;4545;455;
2021-11-21 20:14:51;8992696404441;SUSU BURUANG;1;13000;0;13000;8585;4415;
2021-11-21 20:14:51;8991102300544;WFR TANGO VNL 176G;2;10000;0;20000;17388;2612;
2021-11-21 20:14:51;8996001305041;ROMA SANDWICH CKLT;1;7000;0;7000;5928;1072;
2021-11-21 20:14:51;8997028590014;ARGUS 220ML;6;500;0;3000;1812;1188;
2021-11-21 20:14:51;8991102987875;WFR TANGO POUCH CKL 115G;1;8000;0;8000;6786;1214;
2021-11-21 20:23:29;8991001503336;chacha minis hat;2;7500;0;15000;12800;2200;
2021-11-21 20:23:29;8992775211434;PILUS GARUDA SAPI PANGGANG;1;5000;0;5000;4810;190;
2021-11-21 20:23:29;8998666002525;TB TORA CAFE CAPPUCINO;1;1000;0;1000;780;220;
2021-11-21 20:23:29;8997028590014;ARGUS 220ML;2;500;0;1000;604;396;
2021-11-21 20:23:29;8998866202671;NOODLE SEDAAP MIE KOREAN SPICY SOUP CUP;1;5000;0;5000;4002;998;
2021-11-21 20:23:29;8991102281416;PERMEN MINTZ PPMINT;1;5000;0;5000;4000;1000;
2021-11-21 20:23:29;8991102213189;BLASTER UNGU;1;5000;0;5000;3106;1894;
2021-11-21 20:23:29;6907992825076;JD WATERMELON APPLE;1;2000;0;2000;1700;300;
2021-11-21 20:23:29;MK;MASKER;1;5000;0;5000;4000;1000;
2021-11-21 20:23:29;8991102228053;TEH GELAS BOTOL;1;3000;0;3000;1695;1305;
2021-11-21 20:23:29;ROTI;ROTI 2000;1;2000;0;2000;1800;200;
2021-11-21 20:23:29;7622201430184;OREO ORIGINAL 38G;1;2000;0;2000;1641;359;
2021-11-21 20:23:29;8997009462040;TIARA;1;1000;0;1000;425;575;
2021-11-21 20:23:29;6907992823959;JD HAWTHORN BERRY;1;2000;0;2000;1700;300;
2021-11-21 20:23:29;8998989500166;GUDANG GARAM MERAH BESAR 16KS;2;18000;0;36000;34000;2000;
2021-11-21 20:26:53;8998989300261;GUDANG GARAM SURYA 12 FILTER;1;20000;0;20000;18150;1850;
2021-11-21 20:26:53;8999909001909;MAGNUM REVAMP BLACK 12;1;18000;0;18000;16300;1700;
2021-11-21 20:26:53;8992730950194;GULA GULA KOIN;10;500;0;5000;4000;1000;
2021-11-21 20:26:53;7622300335809;OREO SOFT CAKE;1;2000;0;2000;1641;359;
2021-11-21 20:26:53;8998866608305;GIV BENGKOANG KOTAK 76G;1;2000;0;2000;1820;180;
2021-11-21 20:26:53;RT 1000;ROTI 1000;1;1000;0;1000;800;200;
2021-11-21 20:30:51;8997028590014;ARGUS 220ML;6;500;0;3000;1812;1188;
2021-11-21 20:30:51;8995555111221;sosis kimbo;1;1000;0;1000;850;150;
2021-11-21 20:31:52;8995555111221;sosis kimbo;5;1000;0;5000;4250;750;
2021-11-21 20:43:18;Telur 3 Biji;Telur 3 Biji;1;5000;0;5000;3600;1400;
2021-11-21 20:43:18;8997028380165;BISKUIT;1;10000;0;10000;9000;1000;
2021-11-21 20:43:18;8996001600399;LE MINERAL 1500ML;1;5000;0;5000;4042;958;
2021-11-21 20:43:18;8992694242618;ZWITSAL BB PWD CLSC 100GR;1;7800;0;7800;6930;870;
2021-11-21 20:43:18;8999908284907;MY BABY MINYAK TELON 90ML;1;25000;0;25000;22700;2300;
2021-11-21 20:43:18;gula;GULA;1;11500;0;11500;10000;1500;
2021-11-21 20:43:18;8992761111519;COCA COLA SLIM CAM 250ML;1;5000;0;5000;3750;1250;
2021-11-21 20:43:18;ARG;ARGUS DOS 220ML;4;15000;0;60000;54000;6000;
2021-11-21 20:43:18;8992761111533;SPRITE SLIM CAM250ML;1;5000;0;5000;3750;1250;
2021-11-21 20:43:18;8993274532105;BOLU;1;1000;0;1000;833;167;
2021-11-21 20:43:18;8992959953082;SWEETY BRONZE L8;1;17000;0;17000;15380;1620;
2021-11-21 20:43:18;8992717900310;KARA SUN;3;2500;0;7500;6000;1500;
2021-11-21 20:43:18;8998866200301;MIE SEDAAP GORENG;3;3000;0;9000;7242;1758;
2021-11-21 20:43:18;8998866200820;NOODLE SEDAAP MIE AYAM BAWANG TLR CUP 77 GR;1;4500;0;4500;3650;850;
2021-11-21 20:43:18;8994867007161;ROKOK PENA GOLD 20;1;19000;0;19000;17400;1600;
2021-11-21 20:50:34;8991909101016;URBAN MILD 16;1;17000;0;17000;15800;1200;
2021-11-21 20:50:34;123124;KOREK BIASA;1;2000;0;2000;1300;700;
2021-11-21 20:50:34;VTM;VITAMIN CIMIN;1;500;0;500;425;75;
2021-11-21 20:50:34;gula;GULA;2;11500;0;23000;20000;3000;
2021-11-21 20:50:34;BOLU;BOLU KARAMEL;1;10000;0;10000;9000;1000;
2021-11-21 20:50:34;BALON GAS;BALON GAS;2;500;0;1000;800;200;
2021-11-21 20:50:34;8992730950194;GULA GULA KOIN;1;500;0;500;400;100;
2021-11-21 20:50:34;6907992825076;JD WATERMELON APPLE;1;2000;0;2000;1700;300;
2021-11-21 20:50:34;8998866200561;EKOMIE SUPER 600GR;3;10000;0;30000;25845;4155;
2021-11-21 20:50:34;SKT;SIKAT CUCI;1;6000;0;6000;5000;1000;
2021-11-21 20:50:34;8997013180107;Tissu Roll;1;12500;0;12500;11000;1500;
2021-11-21 20:50:34;8991001780140;TWISTER CHOCO;1;5000;0;5000;4600;400;
2021-11-21 20:50:34;8997878004327;GULA GULA MILKITA;4;250;0;1000;800;200;
2021-11-21 20:50:34;8992730996185;GULA GULA CRISPY;1;2000;0;2000;1500;500;
2021-11-21 20:50:34;ROTI;ROTI 2000;1;2000;0;2000;1800;200;
2021-11-21 20:53:55;8992696404441;SUSU BURUANG;1;13000;0;13000;8585;4415;
2021-11-21 20:53:55;8999999059781;SUNLIGHT LIME NEW POUCH 210ML;1;5000;0;5000;4520;480;
2021-11-21 20:53:55;8992959117583;SOFTEX DAUN SIRIH;1;5000;0;5000;4288;712;
2021-11-21 20:53:55;8998866200301;MIE SEDAAP GORENG;3;3000;0;9000;7242;1758;
2021-11-21 20:53:55;089686043204;INDOMIE MIE ACEH;1;2700;0;2700;2452;248;
2021-11-21 20:54:30;8991102281416;PERMEN MINTZ PPMINT;1;5000;0;5000;4000;1000;
2021-11-21 21:02:21;8997009461753;TOP ELIT;5;1000;0;5000;2000;3000;
2021-11-21 21:02:21;6907992823867;JD CRUNCHY CHOCOLATE MALT;4;5500;0;22000;18800;3200;
2021-11-21 21:02:21;8999999059781;SUNLIGHT LIME NEW POUCH 210ML;1;5000;0;5000;4520;480;
2021-11-21 21:02:21;8992725910424;LISTERINE FRESH BURST 250ML;1;19000;0;19000;17550;1450;
2021-11-21 21:02:21;8992775315057;GERY SALUT MALKIST COKLAT;1;6500;0;6500;5516;984;
2021-11-21 21:02:21;8999909096004;SAMPOERNA 16 FILTER;1;25000;0;25000;23100;1900;
2021-11-21 21:02:21;ARG;ARGUS DOS 220ML;1;15000;0;15000;13500;1500;
2021-11-21 21:02:21;8991102002400;SABUN PRIMA PROTECT;1;17000;0;17000;15600;1400;
2021-11-21 21:02:21;8999999555450;VIXAL PEMB PORS BIRU 190ML;1;5000;0;5000;4200;800;
2021-11-21 21:02:21;8998866200301;MIE SEDAAP GORENG;1;3000;0;3000;2414;586;
2021-11-21 21:02:21;8998866202770;MIE SEDAAP SALERO PADANG;1;2500;0;2500;2362;138;
2021-11-21 21:02:21;ROTI;ROTI 2000;1;2000;0;2000;1800;200;
2021-11-21 21:02:21;8993335521260;Sabun Total Violet 900gr;1;15000;0;15000;13800;1200;
2021-11-21 21:09:06;8991002105409;KOPI KAPAL API;1;20000;0;20000;18888;1112;
2021-11-21 21:09:06;8998866600521;SOKLIN FLOORCLENER KUNING 400ML;1;6000;0;6000;5025;975;
2021-11-21 21:09:06;8999909000971;MAGNUM MILD 20;1;24000;0;24000;22750;1250;
2021-11-21 21:09:06;ARG;ARGUS DOS 220ML;1;15000;0;15000;13500;1500;
2021-11-21 21:09:06;7622210462534;OREO MINI STRAW;2;7500;0;15000;13000;2000;
2021-11-21 21:09:06;8991102380805;FULLO  CKL PCK 8G;1;11000;0;11000;9900;1100;
2021-11-21 21:09:06;8996001355008;BENG-BENG SP20G;1;29000;0;29000;20000;9000;
2021-11-21 21:09:06;BALON GAS;BALON GAS;6;500;0;3000;2400;600;
2021-11-21 21:09:06;8997028590014;ARGUS 220ML;1;500;0;500;302;198;
2021-11-21 21:09:06;8991102384841;WFR TANGO LONG CKLT 130G;1;5000;0;5000;4345;655;
2021-11-21 21:09:06;TAMARA;TAMARA;6;1000;0;6000;2520;3480;
2021-11-21 21:09:06;8992959953020;SWEETY BRONZE M1;1;3000;0;3000;2671;329;
2021-11-21 21:09:06;8992959508893;SWEETY SILVER PANTS S9;1;14500;0;14500;13107;1393;
2021-11-21 21:14:41;MRC;MERICA LADA;5;1000;0;5000;4445;555;
2021-11-21 21:14:41;8999801700030;SUSU FOYU;1;11500;0;11500;10450;1050;
2021-11-21 21:14:41;BALON GAS;BALON GAS;2;500;0;1000;800;200;
2021-11-21 21:14:41;8993226112508;GARAM REFINA;2;3000;0;6000;4922;1078;
2021-11-21 21:14:41;089686021127;INTER MIE KALDU;6;1000;0;6000;4878;1122;
2021-11-21 21:14:41;8998866202619;MIE SEDAAP KOREAN SPICY SOUP;2;2700;0;5400;4644;756;
2021-11-21 21:14:41;8998866200882;SUKSESMIE GORENG AYAM KRMS 133GR;1;3500;0;3500;3047;453;
2021-11-21 22:04:59;8998989110167;SURYA GUDANG GARAM 16 FILTER;2;26000;0;52000;47400;4600;
2021-11-21 22:13:44;TEPUN KANJI;TEPUN KANJI 1 LT;1;11000;0;11000;10000;1000;
2021-11-21 22:13:44;TEPUN;TEPUN KANJI;1;5500;0;5500;4400;1100;
2021-11-21 22:20:27;gula;GULA;1;11500;0;11500;10000;1500;
2021-11-21 22:20:27;8999908284907;MY BABY MINYAK TELON 90ML;1;25000;0;25000;22700;2300;
2021-11-21 22:20:27;8998866611206;FRES&NATURAL BLACK 100ML;1;11500;0;11500;10310;1190;
2021-11-21 22:20:27;8999999554897;DOVE SHP DANDRUFF CARE 9ML;1;11000;0;11000;9300;1700;
2021-11-21 22:20:27;8997013180046;Tissu Tessi B;1;11000;0;11000;9800;1200;
2021-11-21 22:20:27;8991102714846;MILKIDO CKLT;1;3000;0;3000;2153;847;
2021-11-21 22:20:27;8998866601535;BLEACHING SOKLIN PEMUTIH 500ML;1;7000;0;7000;4880;2120;
2021-11-21 22:30:45;MAINAN;MAINAN BALING BALING;1;2000;0;2000;1500;500;
2021-11-21 22:30:45;8992716109172;BISKUAT BOLU SCT;1;2000;0;2000;1641;359;
2021-11-21 22:30:45;8999999036546;LUX BW WHITE VELVET 250ML;1;20000;0;20000;17900;2100;
2021-11-21 22:30:45;8991111101255;JB SHAMPOO GOLD 50ML;1;5000;0;5000;4500;500;
2021-11-21 22:30:45;089686021127;INTER MIE KALDU;4;1000;0;4000;3252;748;
2021-11-21 22:30:45;8991188943062;SASA 250G;1;10000;0;10000;8500;1500;
2021-11-21 22:33:07;089686021127;INTER MIE KALDU;4;1000;0;4000;3252;748;
2021-11-21 22:34:56;ICE CREAM 5;ICE CREAM 5000;2;5000;0;10000;8800;1200;
2021-11-21 22:35:35;8994191103638;GULA GULA KARET;1;500;0;500;400;100;
2021-11-21 22:37:20;8991102714846;MILKIDO CKLT;1;3000;0;3000;2153;847;
2021-11-21 22:37:20;8998866606158;NUVO ACTIVE COOL 110G;2;3000;0;6000;5200;800;
2021-11-21 22:41:01;MAINAN;MAINAN BALING BALING;2;2000;0;4000;3000;1000;
2021-11-21 22:41:01;8992702000063;INDOMILK COKLAT 370G;1;10000;0;10000;9208;792;
2021-11-21 22:41:01;8999999195649;SARIWANGI 25X1.86G;1;6000;0;6000;5202;798;
2021-11-21 22:48:22;8992959117583;SOFTEX DAUN SIRIH;2;5000;0;10000;8576;1424;
2021-11-21 22:48:22;8991102714846;MILKIDO CKLT;1;3000;0;3000;2153;847;
2021-11-21 22:48:22;4902430557122;KONSENTRAT DOWNY;5;1000;0;5000;3750;1250;
2021-11-21 22:48:22;MRC;MERICA LADA;5;1000;0;5000;4445;555;
2021-11-21 22:49:37;8991102002400;SABUN PRIMA PROTECT;1;17000;0;17000;15600;1400;
2021-11-21 22:49:37;8886008101091;AQUA 1,5 ML;1;5500;0;5500;4600;900;
2021-11-21 22:50:56;8998866201728;POTABEE SELECTION SALTED EGG 68G;1;8000;0;8000;7200;800;
2021-11-21 22:52:45;TEPUN KANJI;TEPUN KANJI 1 LT;2;11000;0;22000;20000;2000;
2021-11-21 22:52:45;8993379254469;SABUN LERVIA 90G;1;5000;0;5000;3077;1923;
2021-11-21 22:52:45;8999999538453;SUNSILK SHP SOFT AND  SMOOTH 55 ML;1;5000;0;5000;3750;1250;
2021-11-21 22:55:18;8992959953112;SWEETY BRONZE S20;1;30000;0;30000;26540;3460;
2021-11-21 23:00:56;8999999036546;LUX BW WHITE VELVET 250ML;1;20000;0;20000;17900;2100;
2021-11-21 23:00:56;8999999195649;SARIWANGI 25X1.86G;1;6000;0;6000;5202;798;
2021-11-21 23:00:56;8991102987639;WFR TANGO LONG VNL 130G;1;5000;0;5000;4350;650;
2021-11-21 23:00:56;RT CD;ROTI COKLAT DURIAN;1;8000;0;8000;7200;800;
2021-11-21 23:00:56;8992702000063;INDOMILK COKLAT 370G;1;10000;0;10000;9208;792;
2021-11-21 23:00:56;Telur;Telur;10;2000;0;20000;0;20000;
2021-11-23 20:25:20;8993007000062;INDOMILK CHOCOLATE 190ML;1;5000;0;5000;3475;1525;
2021-11-23 20:40:39;6907992825076;JD WATERMELON APPLE;9;2000;0;18000;15300;2700;
2021-11-23 20:52:03;ARG;ARGUS DOS 220ML;1;15000;0;15000;13500;1500;
2021-11-23 21:10:35;8991188943062;SASA 250G;2;10000;0;20000;17000;3000;
2021-11-23 21:16:41;MATERAI;MATERAI;3;15000;0;45000;30000;15000;
2021-11-23 21:27:49;8994867000179;ROKOK PENA MILD 16;1;15500;0;15500;14500;1000;
2021-11-23 21:42:12;8992696422650;NESCAFE FRENCH VANILLA;1;5000;0;5000;4099;901;
2021-11-23 21:42:12;8997218010230;yohoo;2;1000;0;2000;1800;200;
2021-11-23 21:47:22;8997218010230;yohoo;1;1000;0;1000;900;100;
2021-11-23 22:09:26;8997028590045;ARGUS BTL 330ML;1;2000;0;2000;1291;709;
2021-11-25 18:58:43;8992770033178;Masako;6;500;0;3000;2700;300;
2021-11-25 18:58:43;8995555111221;sosis kimbo;2;1000;0;2000;1700;300;
2021-11-25 19:02:00;8995150101719;M+SUSU RASA SODA GEMBIRA;1;5000;0;5000;4000;1000;
2021-11-25 19:02:00;gula;GULA;1;11500;0;11500;10000;1500;
2021-11-25 19:02:00;8998989300261;GUDANG GARAM SURYA 12 FILTER;1;20000;0;20000;18150;1850;
2021-11-25 19:02:00;Telur 3 Biji;Telur 3 Biji;1;5000;0;5000;3600;1400;
2021-11-25 19:02:00;8992775002155;CHOCOLATOS DRINK;1;4000;0;4000;3520;480;
2021-11-25 19:04:08;SFX;SOFTEX DAUN SIRIH 1;4;500;0;2000;1652;348;
2021-11-25 19:04:27;8998989300261;GUDANG GARAM SURYA 12 FILTER;1;20000;0;20000;18150;1850;
2021-11-25 19:10:32;gula;GULA;4;11500;0;46000;40000;6000;
2021-11-25 19:25:58;8995333032113;TERIGU GATOT KACA 1 KG;4;9000;0;36000;34288;1712;
2021-11-25 19:25:58;gula;GULA;1;11500;0;11500;10000;1500;
2021-11-25 20:13:40;8993989311699;CLAS MILD 16 FILTER;1;24000;0;24000;21700;2300;
2021-11-25 21:40:24;8886013213208;FRENCH FREIS 2000;1;5000;0;5000;3750;1250;
2021-11-25 21:40:24;8996001355756;BENG-BENG MAXX SCT;1;2500;0;2500;2041;459;
2021-11-25 21:40:24;7622300405588;KEJUCAKE 16G;1;2000;0;2000;1641;359;
2021-11-25 21:40:24;8996001312445;MALKIST CAPPUCINO;1;6500;0;6500;5400;1100;
2021-11-25 21:40:24;8997028590014;ARGUS 220ML;4;500;0;2000;1208;792;
2021-11-25 21:40:24;8992775305003 pcs;Gery Salut Coklat pcs;1;1000;0;1000;812;188;
2021-11-25 21:41:10;8997218010230;yohoo;3;1000;0;3000;2700;300;
2021-11-25 21:50:01;8996001401200;GENTLEGEN;2;18000;0;36000;32000;4000;
2021-11-25 21:56:28;8999999195656;SARIWANGI 50X1.85;1;10000;0;10000;9405;595;
2021-11-25 21:58:52;8995139620736;MI GORENG SEJATI;1;2000;0;2000;1700;300;
2021-11-25 22:00:05;AMPLOP;AMPLOP;2;250;0;500;350;150;
2021-11-25 22:03:53;VTM;VITAMIN CIMIN;10;500;0;5000;4250;750;
2021-11-25 22:03:53;8996001600375;LE MINERAL 330ML;4;2000;0;8000;5668;2332;
2021-11-25 22:03:53;ROTI;ROTI 2000;1;2000;0;2000;1800;200;
2021-11-25 22:03:53;MK;MASKER;1;5000;0;5000;4000;1000;
2021-11-25 22:03:53;8992775002582;DILAN CHOCO;1;2000;0;2000;1503;497;
2021-11-25 22:03:53;8997218010230;yohoo;1;1000;0;1000;900;100;
2021-11-25 22:03:53;8993379210854;SABUN HARMONY APPLE 70G;1;2000;0;2000;1652;348;
2021-11-25 22:03:53;8998866109130;SHAMPOOZINC;2;1000;0;2000;600;1400;
2021-11-25 22:06:17;8992717900310;KARA SUN;3;2500;0;7500;6000;1500;
2021-11-25 22:08:51;089686611878;QTELA TEMPE;1;6000;0;6000;5370;630;
2021-11-25 22:08:51;8991914101513;VIPER KRETEK 12;2;6000;0;12000;10000;2000;
2021-11-25 22:08:51;8996001600375;LE MINERAL 330ML;19;2000;0;38000;26923;11077;
2021-11-25 22:09:13;8998989110167;SURYA GUDANG GARAM 16 FILTER;1;26000;0;26000;23700;2300;
2021-11-26 21:03:08;8992628034159;BIMOLI 1 LT;1;21000;0;21000;19000;2000;
2021-11-26 21:03:08;ARG;ARGUS DOS 220ML;5;15000;0;75000;67500;7500;
2021-11-26 21:03:35;8991914101513;VIPER KRETEK 12;2;6000;0;12000;10000;2000;
2021-11-26 21:27:31;8991188943062;SASA 250G;2;10000;0;20000;17000;3000;
2021-11-26 22:18:09;089686010824;INDOMIE GORENG SPESIAL;2;2700;0;5400;4904;496;
2021-11-26 22:44:57;8998866200325;MIE SEDAAP SOTO;2;2700;0;5400;4564;836;
2021-11-27 20:43:00;8992979190986;TOTAL PUTIH SOFTENER;1;15000;0;15000;13524;1476;
2021-11-27 20:43:00;8999999707859;CLOSEUP GREEN 160G;1;15000;0;15000;13600;1400;
2021-11-27 20:43:00;8999999533731;CITRA TS NATURE WHITE 70G;2;2200;0;4400;3800;600;
2021-11-27 20:43:00;8992761111540;FANTA STRAWBERY SLIM CAM 250ML;1;5000;0;5000;3750;1250;
2021-11-27 20:47:26;8999909002821;MARLBORO BLACK 16;1;22000;0;22000;20900;1100;
2021-11-27 20:47:26;8998989300261;GUDANG GARAM SURYA 12 FILTER;1;20000;0;20000;18150;1850;
2021-11-27 21:05:06;8998866200325;MIE SEDAAP SOTO;2;2700;0;5400;4564;836;
2021-11-27 21:35:01;8998866107457;POSH SUMMER LOVE 150ML;2;19500;0;39000;35000;4000;
2021-11-27 21:37:51;1212060005003;IMPLORA;1;20000;0;20000;1900;18100;
2021-11-27 21:44:57;9556006060667;JB BEDTIME 400ML (REFILL);1;24500;0;24500;23390;1110;
2021-11-27 21:44:57;8997021870908;HOT IN CREAM STRONG 60G;1;12500;0;12500;11390;1110;
2021-11-27 22:03:03;8993335529419;Sabun Total de Parfumee Floral Vibes;1;24500;0;24500;22000;2500;
2021-11-27 22:53:47;Telur 7 Biji;Telur 7 Biji;1;10000;0;10000;8400;1600;
2021-11-27 22:53:47;089686011036;INDOMIE GORENG PEDAS;4;2700;0;10800;9808;992;
2021-11-27 22:53:47;8997009510055;YOU C1000;1;15000;0;15000;13000;2000;
2021-11-28 20:26:13;8992761002039;FANTA STRAWBERRY PET 390 ML;1;5500;0;5500;4333;1167;
2021-11-28 20:26:13;8996001600375;LE MINERAL 330ML;1;2000;0;2000;1417;583;
2021-11-28 21:03:05;8991914101513;VIPER KRETEK 12;1;6000;0;6000;5000;1000;
2021-11-28 21:31:14;6907992824963;JD MILKY CHOCOLATE;1;3000;0;3000;2600;400;
2021-11-28 21:32:08;8998989110167;SURYA GUDANG GARAM 16 FILTER;1;26000;0;26000;23700;2300;
2021-11-28 21:32:08;8998989100120;GUDANG GARAM MINI;1;19000;0;19000;16600;2400;
2021-11-28 22:01:34;ARG;ARGUS DOS 220ML;1;15000;0;15000;13500;1500;
2021-11-28 22:17:08;8997028590045;ARGUS BTL 330ML;1;2000;0;2000;1291;709;
2021-12-03 10:21:27;8999909004221;SAMPOERNA ULTRAMILD 16;1;22000;0;22000;20350;1650;
2021-12-03 10:49:10;8997028590014;ARGUS 220ML;4;500;0;2000;1208;792;
2021-12-03 11:05:30;8992628022156;MINYAK GORENG BIMOLI POUCH 1 LT;1;17500;0;17500;16675;825;
2021-12-03 11:05:30;8995333000822;TERIGU KOMPAS SOFT 500GR;1;5500;0;5500;4967;533;
2021-12-03 11:05:30;8998989300261;GUDANG GARAM SURYA 12 FILTER;1;20000;0;20000;18150;1850;
2021-12-03 11:27:48;8993176110074;MINYAK KAYU PUTIH 60ML;1;20000;0;20000;17333;2667;
2021-12-03 11:35:07;8997034170194;ZIGGY 16;5;14000;0;70000;63000;7000;
2021-12-03 11:35:07;8997079804221;FORZA 12;2;11000;0;22000;20000;2000;
2021-12-03 11:35:07;8998898829129;KKB ENER-G JERUK;2;5500;0;11000;9648;1352;
2021-12-03 11:35:07;8991102281430;PERMEN MINTZ DUOMINT;1;5000;0;5000;4000;1000;
2021-12-03 11:35:07;8991001780065;TWISTER BLACK 140G;1;13000;0;13000;11700;1300;
2021-12-03 11:35:07;8991001770301;SELAMAT CLACK VANILA;1;13000;0;13000;11800;1200;
2021-12-03 11:37:58;8993989311279;CLAS MILD 12;1;18000;0;18000;15800;2200;
2021-12-03 12:49:00;8999909004221;SAMPOERNA ULTRAMILD 16;1;22000;0;22000;20350;1650;
2021-12-03 12:58:39;6907992825069;JD FRUITY;1;5000;0;5000;4400;600;
2021-12-03 14:25:43;8997028590052;ARGUS BTL 600ML;1;3000;0;3000;1458;1542;
2021-12-03 15:25:37;8886020033431;KAPUR AJAIB ANTI KECOA DAN NYAMUK;1;3000;0;3000;2700;300;
2021-12-03 16:24:57;ROTI;ROTI 2000;1;2000;0;2000;1800;200;
2021-12-03 17:23:48;7622300405588;KEJUCAKE 16G;1;2000;0;2000;1641;359;
2021-12-03 17:23:48;7622300335809;OREO SOFT CAKE;2;2000;0;4000;3282;718;
2021-12-03 17:25:04;8992959508886;SWEETY SILVER PANTS XL 6+1;1;17500;0;17500;15531;1969;
2021-12-03 17:25:04;089686611618;QTELA BARBEQUE;1;5000;0;5000;4266;734;
2021-12-03 17:25:04;8992696523067;MILO ACTVGO UHT 180ML;1;4500;0;4500;3719;781;
2021-12-03 17:25:04;8997218380159;ICHITAN BROWN SUGAR;1;8000;0;8000;6500;1500;
2021-12-03 17:25:04;8886013213208;FRENCH FREIS 2000;1;5000;0;5000;3750;1250;
2021-12-03 18:30:24;8994867007161;ROKOK PENA GOLD 20;1;19000;0;19000;17400;1600;
2021-12-03 18:30:53;6907992825076;JD WATERMELON APPLE;1;2000;0;2000;1700;300;
2021-12-03 18:30:53;8996001600382;TEH PUCUK 1,36 L;1;12000;0;12000;10000;2000;
2021-12-03 18:35:41;ARG;ARGUS DOS 220ML;6;15000;0;90000;81000;9000;
2021-12-03 18:47:44;8992959117583;SOFTEX DAUN SIRIH;1;5000;0;5000;4288;712;
2021-12-03 18:55:51;8997028590014;ARGUS 220ML;2;500;0;1000;604;396;
2021-12-03 19:04:20;8993989311279;CLAS MILD 12;1;18000;0;18000;15800;2200;
2021-12-03 19:45:31;8993335521260;Sabun Total Violet 900gr;1;15000;0;15000;13800;1200;
2021-12-03 19:45:31;8998866200646;KOPI TOP MURNI;1;11000;0;11000;9600;1400;
2021-12-03 19:45:31;MILKITA;MILKITA;8;250;0;2000;1600;400;
2021-12-03 19:52:36;8997028590014;ARGUS 220ML;4;500;0;2000;1208;792;
2021-12-04 10:49:37;8996001305041;ROMA SANDWICH CKLT;1;7000;0;7000;5928;1072;
2021-12-04 10:49:37;8992760223015;OREO CHOCOLATE CREAM 133G;1;8000;0;8000;6300;1700;
2021-12-04 11:06:06;8886008101053;AQUA 600 ML;2;3500;0;7000;4250;2750;
2021-12-04 11:06:06;8992761139018;ADES 600ML;1;3500;0;3500;2166;1334;
2021-12-04 11:06:57;8999909004221;SAMPOERNA ULTRAMILD 16;1;22000;0;22000;20350;1650;
2021-12-04 12:36:12;8999909002821;MARLBORO BLACK 16;1;22000;0;22000;20900;1100;
2021-12-04 12:50:06;MBL;MOBIL;1;5000;0;5000;3500;1500;
2021-12-04 12:50:06;6907992823973;JD PINEAPPLE;2;5000;0;10000;8600;1400;
2021-12-04 14:39:25;8998989110167;SURYA GUDANG GARAM 16 FILTER;1;26000;0;26000;23700;2300;
2021-12-04 14:39:25;8991909101016;URBAN MILD 16;1;17000;0;17000;15800;1200;
2021-12-04 14:39:25;ROTI;ROTI 2000;6;2000;0;12000;10800;1200;
2021-12-04 15:11:54;MILKITA;MILKITA;4;250;0;1000;800;200;
2021-12-04 15:11:54;8992775002582;DILAN CHOCO;1;2000;0;2000;1503;497;
2021-12-04 16:58:31;8998866612258;RAPIKA SAKURA POUCH 400ML;1;5000;0;5000;4500;500;
2021-12-04 16:58:31;8991001780492;SELAMAT COKLAT;1;13000;0;13000;11800;1200;
2021-12-04 17:45:07;8991002105409;KOPI KAPAL API;1;20000;0;20000;18888;1112;
2021-12-04 17:45:07;8992716109172;BISKUAT BOLU SCT;1;2000;0;2000;1641;359;
2021-12-04 18:11:26;PD;PENDEKAR;40;500;0;20000;14000;6000;
2021-12-04 18:30:06;8997028590014;ARGUS 220ML;2;500;0;1000;604;396;
2021-12-04 18:54:50;8999801700030;SUSU FOYU;1;11500;0;11500;10450;1050;
2021-12-04 18:54:50;ARG;ARGUS DOS 220ML;2;15000;0;30000;27000;3000;
2021-12-04 19:10:46;8997218380074;ICHITAN MILK TEA;1;8000;0;8000;6500;1500;
2021-12-04 19:57:03;8995555121244;SOSIS KIMBO;4;1000;0;4000;2600;1400;
2021-12-04 19:57:03;8997009460343;NEXI NET;3;1000;0;3000;2700;300;
2021-12-04 19:57:03;8997218010230;yohoo;2;1000;0;2000;1800;200;
2021-12-04 19:57:03;8998866200882;SUKSESMIE GORENG AYAM KRMS 133GR;1;3500;0;3500;3047;453;
2021-12-04 20:57:09;8992761111540;FANTA STRAWBERY SLIM CAM 250ML;1;5000;0;5000;3750;1250;
2021-12-04 20:57:09;ROTI;ROTI 2000;1;2000;0;2000;1800;200;
2021-12-04 22:06:43;8991909101016;URBAN MILD 16;1;17000;0;17000;15800;1200;
2021-12-04 22:28:23;8996001600375;LE MINERAL 330ML;1;2000;0;2000;1417;583;
2021-12-04 22:45:47;8992761139018;ADES 600ML;1;3500;0;3500;2166;1334;
2021-12-04 22:45:47;8992761166205;FRESTEA GREEN HONEY 350ML;1;4500;0;4500;3000;1500;
2021-12-04 22:45:47;7622201430153;OREO CHOCOLATE 38G;2;2000;0;4000;3282;718;
2021-12-04 22:48:05;8997009510055;YOU C1000;1;15000;0;15000;13000;2000;
2021-12-04 22:53:19;8993007003063;ENAAK 500G;1;11000;0;11000;9625;1375;
2021-12-04 22:53:19;gula;GULA;2;11500;0;23000;20000;3000;
2021-12-05 10:33:08;8998989300261;GUDANG GARAM SURYA 12 FILTER;1;20000;0;20000;18150;1850;
2021-12-05 10:33:08;8995333032113;TERIGU GATOT KACA 1 KG;4;9000;0;36000;34288;1712;
2021-12-05 10:33:08;gula;GULA;1;11500;0;11500;10000;1500;
2021-12-05 10:33:08;8998989500166;GUDANG GARAM MERAH BESAR 16KS;1;18000;0;18000;17000;1000;
2021-12-05 10:33:08;8999999706180;PEPSODENT WHITE 190GR;1;10000;0;10000;9350;650;
2021-12-05 10:33:08;8999999031930;PEPSODENT TB TRIPLE CLEAN;1;3500;0;3500;2850;650;
2021-12-05 10:33:08;8997009510055;YOU C1000;1;15000;0;15000;13000;2000;
2021-12-05 10:33:08;8992696404441;SUSU BURUANG;1;13000;0;13000;8585;4415;
2021-12-05 10:33:08;8998866200325;MIE SEDAAP SOTO;1;2700;0;2700;2282;418;
2021-12-05 10:33:08;KIKO;KIKO;1;1000;0;1000;500;500;
2021-12-05 10:33:08;KERUPUK 1000;KERUPUK BALADO;5;1000;0;5000;4500;500;
2021-12-05 10:33:08;8995555111221;sosis kimbo;4;1000;0;4000;3400;600;
2021-12-05 10:33:08;8991001502926;Chaca Peanut;2;1000;0;2000;1600;400;
2021-12-05 10:33:08;089686043051;INDOMIE COTO MAKASSAR;1;2800;0;2800;2525;275;
2021-12-05 10:33:08;8998866200882;SUKSESMIE GORENG AYAM KRMS 133GR;1;3500;0;3500;3047;453;
2021-12-05 10:33:08;8991102228053;TEH GELAS BOTOL;1;3000;0;3000;1695;1305;
2021-12-05 10:33:08;ARGUS;ARGUS;1;2000;0;2000;1500;500;
2021-12-05 10:34:50;4902430553636;H&S LEMON  160ML;1;25000;0;25000;18900;6100;
2021-12-05 10:34:50;8999999034733;PONDS MEN WHITE BOOST 100G;1;29500;0;29500;26620;2880;
2021-12-05 10:34:50;8993379254469;SABUN LERVIA 90G;1;5000;0;5000;3077;1923;
2021-12-05 10:34:50;8991102024099;FORMULA CURVE;1;5000;0;5000;3000;2000;
2021-12-05 10:34:50;8991102103091;Formula Proteksi;1;3500;0;3500;2650;850;
2021-12-05 10:34:50;8998866610261;DAIA VIOLET GUSSET BAG 290 GR;1;5000;0;5000;4450;550;
2021-12-05 10:34:50;8998866608404;Softener;1;5000;0;5000;4560;440;
2021-12-05 10:34:50;8991102989381;TANGO LONG BUBBLEGUM 130G;1;5000;0;5000;4350;650;
2021-12-05 10:40:54;8994867007161;ROKOK PENA GOLD 20;2;19000;0;38000;34800;3200;
2021-12-05 10:40:54;8999801700030;SUSU FOYU;1;11500;0;11500;10450;1050;
2021-12-05 10:40:54;8992761166038;MMP ORANGE 300ML;1;5000;0;5000;3750;1250;
2021-12-05 10:40:54;8999909096004;SAMPOERNA 16 FILTER;1;25000;0;25000;23100;1900;
2021-12-05 10:40:54;089686611878;QTELA TEMPE;1;6000;0;6000;5370;630;
2021-12-05 10:40:54;balon air;balon air;1;2000;0;2000;1700;300;
2021-12-05 10:40:54;8997028590014;ARGUS 220ML;2;500;0;1000;604;396;
2021-12-05 10:40:54;8998989500166;GUDANG GARAM MERAH BESAR 16KS;1;18000;0;18000;17000;1000;
2021-12-05 10:40:54;ROTI;ROTI 2000;2;2000;0;4000;3600;400;
2021-12-05 10:40:54;8996001410042;TB TORA MOKA;2;1500;0;3000;1740;1260;
2021-12-05 10:40:54;8998989300261;GUDANG GARAM SURYA 12 FILTER;1;20000;0;20000;18150;1850;
2021-12-05 10:40:54;6907992823973;JD PINEAPPLE;2;5000;0;10000;8600;1400;
2021-12-05 10:40:54;MBL;MOBIL;1;5000;0;5000;3500;1500;
2021-12-05 10:40:54;6907992825076;JD WATERMELON APPLE;1;2000;0;2000;1700;300;
2021-12-05 10:40:54;kiko;kiko;1;1000;0;1000;900;100;
2021-12-05 10:40:54;8999909002876;SAMPOERNA ULTRAMILD 12;1;19000;0;19000;17300;1700;
2021-12-05 10:40:54;gula;GULA;2;11500;0;23000;20000;3000;
2021-12-05 10:40:54;8991188943536;SASA SANTAN KELAPA 65ML;1;3000;0;3000;2437;563;
2021-12-05 10:40:54;OSCAR;OSKAR"S;2;1000;0;2000;850;1150;
2021-12-05 10:40:54;8991002103931;GOOD DAY CARREBIAN NUT;1;1500;0;1500;890;610;
2021-12-05 10:40:54;8996001440049;ENERGEN;1;1500;0;1500;1200;300;
2021-12-05 10:40:54;8996001302316;MALKIST ABON SCT;1;1000;0;1000;840;160;
2021-12-05 10:45:24;089686727081;DORITOS 55G;1;7000;0;7000;5950;1050;
2021-12-05 10:45:24;8992388133345;NU MILK TEA TEH TARIK 330ML;1;6000;0;6000;5125;875;
2021-12-05 10:45:24;8998989300261;GUDANG GARAM SURYA 12 FILTER;1;20000;0;20000;18150;1850;
2021-12-05 10:45:24;8999909002821;MARLBORO BLACK 16;1;22000;0;22000;20900;1100;
2021-12-05 10:45:24;8997028590052;ARGUS BTL 600ML;1;3000;0;3000;1458;1542;
2021-12-05 10:45:24;8994867007161;ROKOK PENA GOLD 20;1;19000;0;19000;17400;1600;
2021-12-05 10:54:00;8996001304129;SLAI OLAI STROBERI;1;12000;0;12000;9900;2100;
2021-12-05 10:54:00;8999999005580;DOVE DEO WMN RONOURISH & SMOOTH 40 ML;1;17800;0;17800;16050;1750;
2021-12-05 10:54:00;8992761111519;COCA COLA SLIM CAM 250ML;1;5000;0;5000;3750;1250;
2021-12-05 10:54:00;8997218380159;ICHITAN BROWN SUGAR;1;8000;0;8000;6500;1500;
2021-12-05 10:54:00;8992741952262;GULA GULA YUPI;4;250;0;1000;800;200;
2021-12-05 10:54:00;8999801700030;SUSU FOYU;1;11500;0;11500;10450;1050;
2021-12-05 10:54:00;8719200177314;BLUE BAND 15G;2;2000;0;4000;3000;1000;
2021-12-05 10:54:00;8993989311279;CLAS MILD 12;1;18000;0;18000;15800;2200;
2021-12-05 10:54:00;ARG;ARGUS DOS 220ML;4;15000;0;60000;54000;6000;
2021-12-05 10:54:00;8996001600399;LE MINERAL 1500ML;1;5000;0;5000;4042;958;
2021-12-05 10:54:00;KRIPIK MK;KRIPIK MAKKORONI;1;5000;0;5000;4000;1000;
2021-12-05 10:54:00;8998866501033;MINYAK GORENG SEDAAP POUCH 2L;1;37000;0;37000;35000;2000;
2021-12-05 10:54:00;8992759120264;LARISST 220;1;10000;0;10000;9200;800;
2021-12-05 10:54:00;8995333060703;TERIGU KOMPAS 1KG;1;10500;0;10500;9816;684;
2021-12-05 11:04:53;Telur 3 Biji;Telur 3 Biji;1;5000;0;5000;3600;1400;
2021-12-05 11:25:38;8999909002876;SAMPOERNA ULTRAMILD 12;1;19000;0;19000;17300;1700;
2021-12-05 11:39:48;6907992823935;JD SWEETCORN;1;3500;0;3500;3000;500;
2021-12-05 11:39:48;6907992823591;JD STRAW MILKSHAKE;1;5000;0;5000;4300;700;
2021-12-05 14:02:51;6907992823942;JD JUJUBE;1;4500;0;4500;3800;700;
2021-12-05 14:02:51;7622300335809;OREO SOFT CAKE;1;2000;0;2000;1641;359;
2021-12-05 14:34:35;8998866202978;Guribee Rumput Laut 68 gr;1;6000;0;6000;5100;900;
2021-12-05 14:38:13;ARG;ARGUS DOS 220ML;1;15000;0;15000;13500;1500;
2021-12-05 14:38:13;8886013213208;FRENCH FREIS 2000;1;5000;0;5000;3750;1250;
2021-12-05 14:38:13;ROTI;ROTI 2000;1;2000;0;2000;1800;200;
2021-12-05 14:42:12;8996001305331;ROMA SANDWICH LEMON;1;7000;0;7000;5500;1500;
2021-12-05 14:42:12;8992694242502;ZWITZAL SOAP CALSSIC 70G;1;3800;0;3800;3410;390;
2021-12-05 14:42:12;8992946512285;SHINZU"U;1;5000;0;5000;4000;1000;
2021-12-05 14:42:12;8991188943536;SASA SANTAN KELAPA 65ML;1;3000;0;3000;2437;563;
2021-12-05 14:42:12;8991102714624;Tanggo Kido Drink 115ml;1;3000;0;3000;2000;1000;
2021-12-05 14:42:12;8992696521629;DNCO COKLT UHT 180ML;1;5000;0;5000;3533;1467;
2021-12-05 14:42:12;8997011931107;Ketumbar bubuk;5;1000;0;5000;4165;835;
2021-12-05 14:42:12;8992959020012;SWEETY SILVER PANTS XL34;1;78000;0;78000;73637;4363;
2021-12-05 14:42:12;8993274532082;BULO COKLAT;2;1000;0;2000;1666;334;
2021-12-05 14:42:12;ROTI;ROTI 2000;1;2000;0;2000;1800;200;
2021-12-05 15:09:26;gula;GULA;3;11500;0;34500;30000;4500;
2021-12-05 18:14:41;8998866200578;MIE SEDAAP KARI KENTAL;3;2700;0;8100;6993;1107;
2021-12-05 18:14:41;8998866203227;MIE SEDAAP AYAM BAKAR LIMAU;2;2700;0;5400;4326;1074;
2021-12-05 18:14:41;8998989300261;GUDANG GARAM SURYA 12 FILTER;1;20000;0;20000;18150;1850;
2021-12-05 18:14:41;8999999529673;CLEARA  IC MENTHOL 80ML;1;11200;0;11200;10120;1080;
2021-12-05 19:01:00;8992388133345;NU MILK TEA TEH TARIK 330ML;1;6000;0;6000;5125;875;
2021-12-05 19:01:00;8992388133017;NU MILK TEA ORI 330ML;1;6000;0;6000;5125;875;
2021-12-05 19:01:00;8992775315057;GERY SALUT MALKIST COKLAT;1;6500;0;6500;5516;984;
2021-12-05 19:01:00;KOPIKO;KOPIKO;2;250;0;500;350;150;
2021-12-05 19:28:10;MBL;MOBIL;1;5000;0;5000;3500;1500;
2021-12-05 19:28:10;ROTI;ROTI 2000;4;2000;0;8000;7200;800;
2021-12-05 19:28:10;8997011700123;BIHUN JAGUNG 300GR;3;6000;0;18000;14937;3063;
2021-12-05 19:33:30;8996001600399;LE MINERAL 1500ML;1;5000;0;5000;4042;958;
2021-12-05 19:53:54;089686043051;INDOMIE COTO MAKASSAR;1;2800;0;2800;2525;275;
2021-12-05 19:53:54;8998866200301;MIE SEDAAP GORENG;2;3000;0;6000;4828;1172;
2021-12-05 19:53:54;8992761166212;FRESTEA APPLE 350ML;1;4500;0;4500;3000;1500;
2021-12-05 19:53:54;8999801700030;SUSU FOYU;2;11500;0;23000;20900;2100;
2021-12-05 19:53:54;8991001502926;Chaca Peanut;2;1000;0;2000;1600;400;
2021-12-05 19:53:54;lolipop;lolipop;2;1000;0;2000;1700;300;
2021-12-05 19:58:20;8991002105430;KOPI KAPAL API 65G;1;5000;0;5000;4145;855;
2021-12-05 19:58:20;8996001440049;ENERGEN;2;1500;0;3000;2400;600;
2021-12-05 20:17:30;8998989300261;GUDANG GARAM SURYA 12 FILTER;1;20000;0;20000;18150;1850;
2021-12-05 20:25:38;8998989110167;SURYA GUDANG GARAM 16 FILTER;1;26000;0;26000;23700;2300;
2021-12-05 20:25:38;8992696404441;SUSU BURUANG;1;13000;0;13000;8585;4415;
2021-12-05 20:44:29;8998989500166;GUDANG GARAM MERAH BESAR 16KS;1;18000;0;18000;17000;1000;
2021-12-05 20:44:29;8999909001909;MAGNUM REVAMP BLACK 12;1;18000;0;18000;16300;1700;
2021-12-05 20:53:38;8992775001783;GERY SALUT MALKIST KELAPA;1;6500;0;6500;5516;984;
2021-12-05 20:53:38;8992775315057;GERY SALUT MALKIST COKLAT;1;6500;0;6500;5516;984;
2021-12-05 20:55:13;8994867000162;ROKOK PUNDIMAS KRETEK16;1;10000;0;10000;8600;1400;
2021-12-05 21:52:42;711844610095;LARISSA UDANG 500 GR;1;11000;0;11000;9790;1210;
2021-12-05 22:08:36;8999909096004;SAMPOERNA 16 FILTER;1;25000;0;25000;23100;1900;
2021-12-05 22:08:36;8998989300261;GUDANG GARAM SURYA 12 FILTER;1;20000;0;20000;18150;1850;
2021-12-05 22:10:15;8998989500166;GUDANG GARAM MERAH BESAR 16KS;1;18000;0;18000;17000;1000;
2021-12-05 22:24:57;8992388133345;NU MILK TEA TEH TARIK 330ML;1;6000;0;6000;5125;875;
2021-12-05 22:24:57;7622300335809;OREO SOFT CAKE;2;2000;0;4000;3282;718;
2021-12-05 22:24:57;8992741952262;GULA GULA YUPI;4;250;0;1000;800;200;
2021-12-05 22:31:43;8991004011906;KOPI BORONG;2;10000;0;20000;16666;3334;
2021-12-05 22:31:43;gula;GULA;2;11500;0;23000;20000;3000;
2021-12-06 12:38:46;8998866203272;MIE SUKSES MANTAP ISI 2;2;3500;0;7000;6092;908;
2021-12-06 12:47:33;8997028590014;ARGUS 220ML;2;500;0;1000;604;396;
2021-12-06 12:47:33;KERUPUK;KERUPUK BALADO;1;1000;0;1000;900;100;
2021-12-06 12:47:33;8997009461753;TOP ELIT;1;1000;0;1000;400;600;
2021-12-06 12:56:13;8997028590014;ARGUS 220ML;4;500;0;2000;1208;792;
2021-12-06 12:56:13;8991102987639;WFR TANGO LONG VNL 130G;1;5000;0;5000;4350;650;
2021-12-06 13:02:27;gula;GULA;1;11500;0;11500;10000;1500;
2021-12-06 13:02:27;8998866200646;KOPI TOP MURNI;1;11000;0;11000;9600;1400;
2021-12-06 13:02:27;8999999036836;LUX BW VELVET JASMINE LD REFF 450 ML;1;25000;0;25000;22110;2890;
2021-12-06 13:02:27;8992628034159;BIMOLI 1 LT;1;21000;0;21000;19000;2000;
2021-12-06 13:17:19;8994867007161;ROKOK PENA GOLD 20;1;19000;0;19000;17400;1600;
2021-12-06 13:53:02;8999909085114;SAMPOERNA KRETEK HIJAU 12;1;13000;0;13000;11650;1350;
2021-12-06 13:53:02;8994867007161;ROKOK PENA GOLD 20;1;19000;0;19000;17400;1600;
2021-12-06 17:07:05;8998866201377;KRISBEE FRIES KENTANG GORENG 68 GR;1;5500;0;5500;4620;880;
2021-12-06 17:07:05;gula gula;gula-gula karet;2;500;0;1000;800;200;
2021-12-06 17:44:49;8998989300261;GUDANG GARAM SURYA 12 FILTER;1;20000;0;20000;18150;1850;
2021-12-06 17:44:49;ROTI;ROTI 2000;1;2000;0;2000;1800;200;
2021-12-06 17:44:49;8998866200882;SUKSESMIE GORENG AYAM KRMS 133GR;1;3500;0;3500;3047;453;
2021-12-06 17:44:49;MILKITA;MILKITA;6;250;0;1500;1200;300;
2021-12-06 17:52:27;8998866200578;MIE SEDAAP KARI KENTAL;3;2700;0;8100;6993;1107;
2021-12-06 17:52:27;8998866200325;MIE SEDAAP SOTO;2;2700;0;5400;4564;836;
2021-12-06 17:52:27;Telur 7 Biji;Telur 7 Biji;1;10000;0;10000;8400;1600;
2021-12-06 17:52:27;8998989110167;SURYA GUDANG GARAM 16 FILTER;1;26000;0;26000;23700;2300;
2021-12-06 17:52:38;8996001328163;GULA GULA TAMARIN;6;250;0;1500;1200;300;
2021-12-06 17:58:37;8998866610261;DAIA VIOLET GUSSET BAG 290 GR;1;5000;0;5000;4450;550;
2021-12-06 17:58:37;8992946512285;SHINZU"U;1;5000;0;5000;4000;1000;
2021-12-06 17:58:37;8997027300089;NOMOS;1;4000;0;4000;2963;1037;
2021-12-06 17:58:37;7622201430153;OREO CHOCOLATE 38G;1;2000;0;2000;1641;359;
2021-12-06 17:58:37;8991001242013;Top;2;1000;0;2000;1000;1000;
2021-12-06 18:19:36;8997028590014;ARGUS 220ML;10;500;0;5000;3020;1980;
2021-12-06 18:32:29;8994867000162;ROKOK PUNDIMAS KRETEK16;1;10000;0;10000;8600;1400;
2021-12-06 18:46:12;8998866106542;EMERON LOVELY NAT PINK 200ML;1;6000;0;6000;5075;925;
2021-12-06 18:46:12;8991001780133;TWISTER BLACK;1;5000;0;5000;4600;400;
2021-12-06 18:46:12;8996001312278;MALKIST KEJU MANIS;1;6500;0;6500;5400;1100;
2021-12-06 18:46:12;8991102387286;TANGO LONG CKLT 47G;10;1700;0;17000;15510;1490;
2021-12-06 18:46:12;8992775305188 pcs;Gery Salut Grentea pcs;7;1000;0;7000;5684;1316;
2021-12-06 18:46:12;8886008101091;AQUA 1,5 ML;1;5000;0;5000;4600;400;
2021-12-06 18:47:43;8998989300261;GUDANG GARAM SURYA 12 FILTER;1;20000;0;20000;18150;1850;
2021-12-06 18:47:43;123124;KOREK BIASA;1;2000;0;2000;1300;700;
2021-12-06 19:42:13;8992959508916;SWEETY SILVER PANTS XXL18;1;54500;0;54500;49546;4954;
2021-12-06 19:44:58;8992775002582;DILAN CHOCO;1;2000;0;2000;1503;497;
2021-12-06 19:45:14;8999999533731;CITRA TS NATURE WHITE 70G;2;2200;0;4400;3800;600;
2021-12-06 19:45:14;8999999533724;CITRA TS PEARLY WHITE CNT 70G;1;2300;0;2300;1900;400;
2021-12-06 19:51:46;8999999195649;SARIWANGI 25X1.86G;1;6000;0;6000;5202;798;
2021-12-06 19:56:37;8998866613705;EMERON LOVELY COOL&BRIGHT 200ML;1;7500;0;7500;6475;1025;
2021-12-06 19:56:37;8991102308861;FULLO BLASTO;1;16000;0;16000;14545;1455;
2021-12-06 20:02:29;8998989300261;GUDANG GARAM SURYA 12 FILTER;1;20000;0;20000;18150;1850;
2021-12-06 20:02:29;8992759120264;LARISST 220;1;10000;0;10000;9200;800;
2021-12-06 20:02:29;8998866200301;MIE SEDAAP GORENG;1;3000;0;3000;2414;586;
2021-12-06 20:02:29;089686043051;INDOMIE COTO MAKASSAR;1;2800;0;2800;2525;275;
2021-12-06 20:02:29;8998866200325;MIE SEDAAP SOTO;1;2700;0;2700;2282;418;
2021-12-06 20:30:41;8991909101016;URBAN MILD 16;1;17000;0;17000;15800;1200;
2021-12-06 20:30:41;8991102987639;WFR TANGO LONG VNL 130G;1;5000;0;5000;4350;650;
2021-12-07 16:12:21;8999909096004;SAMPOERNA 16 FILTER;1;25000;0;25000;23100;1900;
2021-12-07 17:08:31;8993379200886;SABUN HARMONY ORANGE 70G;3;2000;0;6000;4956;1044;
2021-12-07 17:08:31;8993379200855;SABUN HARMONY STRAWBERRY 70G;1;2000;0;2000;1652;348;
2021-12-07 17:08:31;8993335529358;Sabun Oxyklin Cair 750ml;1;21000;0;21000;19200;1800;
2021-12-07 17:08:31;8999999059781;SUNLIGHT LIME NEW POUCH 210ML;1;5000;0;5000;4520;480;
2021-12-07 17:09:31;8851019210292;POCKY 40 GR;1;7000;0;7000;5671;1329;
2021-12-07 17:09:31;8992730950194;GULA GULA KOIN;4;500;0;2000;1600;400;
2021-12-07 17:09:31;MILKITA;MILKITA;4;250;0;1000;800;200;
2021-12-07 17:18:13;8991102385336;TANGO WAFFLE MILK;1;10000;0;10000;8200;1800;
2021-12-07 17:18:13;8998866202770;MIE SEDAAP SALERO PADANG;1;2500;0;2500;2362;138;
2021-12-07 21:34:04;MARS;MARSHMELLOW;22;500;0;11000;9526;1474;
2021-12-07 21:34:05;8998866607315;SOKLIN SOFTERGENT SAKURA 770G & PIRING;1;20000;0;20000;18055;1945;
2021-12-07 21:34:05;8998866692663;SOKLIN FLOORCLENER KUNING 450ML;1;7000;0;7000;6385;615;
2021-12-07 21:34:05;8993324850401;GENTLE CUTTON BUDS 60;1;5000;0;5000;4650;350;
2021-12-07 21:34:05;8999999536244;SUNSILK SHP THICK N LONG170ML;1;20000;0;20000;18150;1850;
2021-12-07 21:34:05;8999999036607;LUX TS SOFT ROSE 75G;2;3500;0;7000;5600;1400;
2021-12-07 21:52:19;8992959953044;SWEETY BRONZE XL1;1;3000;0;3000;2311;689;
2021-12-07 22:35:15;8998866202978;Guribee Rumput Laut 68 gr;1;6000;0;6000;5100;900;
2021-12-07 22:35:15;8992760221028;OREO ORIGINAL 133G;1;8000;0;8000;6300;1700;
2021-12-07 22:35:15;8998866610223;DAIA VIOLET BAG 850G & PIRING;1;18000;0;18000;15627;2373;
2021-12-08 10:16:59;8886013213208;FRENCH FREIS 2000;2;5000;0;10000;7500;2500;
2021-12-08 10:16:59;8992761166205;FRESTEA GREEN HONEY 350ML;2;4500;0;9000;6000;3000;
2021-12-08 10:16:59;ROTI;ROTI 2000;3;2000;0;6000;5400;600;
2021-12-08 10:16:59;8996001600375;LE MINERAL 330ML;2;2000;0;4000;2834;1166;
2021-12-08 10:16:59;8996001600269;LE MINERAL 600ML;1;3000;0;3000;1688;1312;
2021-12-08 10:16:59;balon air;balon air;2;2000;0;4000;3400;600;
2021-12-08 10:57:52;ARG;ARGUS DOS 220ML;1;15000;0;15000;13500;1500;
2021-12-08 10:57:52;8997013180046;Tissu Tessi B;1;11000;0;11000;9800;1200;
2021-12-08 10:57:52;Telur 3 Biji;Telur 3 Biji;1;5000;0;5000;3600;1400;
2021-12-08 11:42:28;8996001600399;LE MINERAL 1500ML;3;5000;0;15000;12126;2874;
2021-12-08 12:02:31;8998989300261;GUDANG GARAM SURYA 12 FILTER;1;20000;0;20000;18150;1850;
2021-12-08 13:53:25;8997028590014;ARGUS 220ML;4;500;0;2000;1208;792;
2021-12-08 13:55:54;8993989311699;CLAS MILD 16 FILTER;1;24000;0;24000;21700;2300;
2021-12-08 14:10:41;9999;ISOLASI LAKBAN;2;8000;0;16000;13000;3000;
2021-12-08 14:41:59;gula;GULA;2;11500;0;23000;20000;3000;
2021-12-08 15:04:17;4902430401142;PANTENE HAIRFALL 70ML;1;12500;0;12500;11439;1061;
2021-12-08 15:05:59;SURYA BTG;SURYA BATANG;3;1666;0;4998;4140;858;
2021-12-08 15:05:59;8997028590014;ARGUS 220ML;2;500;0;1000;604;396;
2021-12-08 17:03:13;7622201430153;OREO CHOCOLATE 38G;1;2000;0;2000;1641;359;
2021-12-08 17:03:13;8998866604741;RAPIKA BIANG UBGU 250MLBTL;1;8500;0;8500;7650;850;
2021-12-08 17:03:42;8997028590014;ARGUS 220ML;4;500;0;2000;1208;792;
2021-12-08 17:03:42;8991002103931;GOOD DAY CARREBIAN NUT;2;1500;0;3000;1780;1220;
2021-12-08 17:04:04;8991001780133;TWISTER BLACK;2;5000;0;10000;9200;800;
2021-12-08 17:04:04;8992775002599;DILAN CHOCO CRUNCHY;1;20000;0;20000;18040;1960;
2021-12-08 17:19:20;MILKITA;MILKITA;8;250;0;2000;1600;400;
2021-12-08 17:19:20;KIKO;KIKO;1;1000;0;1000;500;500;
2021-12-08 17:19:20;8994834006128;TICTIC PEDAS;2;2000;0;4000;3400;600;
2021-12-08 17:19:20;8992775311509;gery garuda;1;1000;0;1000;700;300;
2021-12-08 17:35:10;089686043051;INDOMIE COTO MAKASSAR;2;2800;0;5600;5050;550;
2021-12-08 17:35:10;PD;PENDEKAR;1;500;0;500;350;150;
2021-12-08 18:12:38;8999909982000;SAMPOERNA 12 FILTER;1;19000;0;19000;16600;2400;
2021-12-08 18:12:38;8998989300261;GUDANG GARAM SURYA 12 FILTER;1;20000;0;20000;18150;1850;
2021-12-08 18:38:32;8998989500166;GUDANG GARAM MERAH BESAR 16KS;1;18000;0;18000;17000;1000;
2021-12-08 18:38:32;8998866613262;SUKSESMIE SOTO 111 GR;1;3500;0;3500;2770;730;
2021-12-08 18:45:25;8998989300261;GUDANG GARAM SURYA 12 FILTER;1;20000;0;20000;18150;1850;
2021-12-08 18:53:35;ARG;ARGUS DOS 220ML;1;15000;0;15000;13500;1500;
2021-12-08 19:02:32;ARG;ARGUS DOS 220ML;1;15000;0;15000;13500;1500;
2021-12-08 19:02:32;kiko;kiko;2;1000;0;2000;1800;200;
2021-12-08 19:02:32;8991102228053;TEH GELAS BOTOL;1;3000;0;3000;1695;1305;
2021-12-08 19:24:02;8998866200882;SUKSESMIE GORENG AYAM KRMS 133GR;2;3500;0;7000;6094;906;
2021-12-08 19:24:02;8998866200813;NOODLE SEDAAP MIE GORENG CUP 85 GR;1;5000;0;5000;4002;998;
2021-12-08 19:29:58;MK;MASKER;1;5000;0;5000;4000;1000;
2021-12-08 19:35:14;8991102230308;BLASTER PINK;1;5000;0;5000;3106;1894;
2021-12-08 19:38:54;KIKO;KIKO;1;1000;0;1000;500;500;
2021-12-08 19:40:16;8997009510055;YOU C1000;1;15000;0;15000;13000;2000;
2021-12-08 19:44:39;kiko;kiko;1;1000;0;1000;900;100;
2021-12-08 20:03:39;MK;MASKER;1;5000;0;5000;4000;1000;
2021-12-08 20:09:16;8998989300261;GUDANG GARAM SURYA 12 FILTER;1;20000;0;20000;18150;1850;
2021-12-08 20:09:16;8996001600269;LE MINERAL 600ML;1;3000;0;3000;1688;1312;
2021-12-08 20:15:24;8996001600399;LE MINERAL 1500ML;1;5000;0;5000;4042;958;
2021-12-08 20:21:41;8998866613262;SUKSESMIE SOTO 111 GR;1;3500;0;3500;2770;730;
2021-12-08 20:27:37;8997009510055;YOU C1000;2;15000;0;30000;26000;4000;
2021-12-08 20:32:35;8999909002821;MARLBORO BLACK 16;1;22000;0;22000;20900;1100;
2021-12-08 20:36:54;8999909096004;SAMPOERNA 16 FILTER;1;25000;0;25000;23100;1900;
2021-12-08 20:57:59;8991909101016;URBAN MILD 16;1;17000;0;17000;15800;1200;
2021-12-08 21:50:07;8998866202312;NOODLE SEDAAP TASTY BAKMI AYAM 129 GR;2;5000;0;10000;8334;1666;
2021-12-08 22:06:25;8991906105758;ROKOK LA BOLD;1;27000;0;27000;24900;2100;
2021-12-08 22:09:12;8997021110028;Garam Kasar;2;3000;0;6000;3000;3000;
2021-12-08 22:32:38;8996001600399;LE MINERAL 1500ML;1;5000;0;5000;4042;958;
2021-12-09 14:52:47;gula;GULA;10;11500;0;115000;100000;15000;
2021-12-09 14:52:47;8999999506520;SUNSILK RFR ANTI DDRF 340ML;1;41200;0;41200;37890;3310;
2021-12-09 14:52:47;8999999003067;VASELINE SPF24 100ML;1;19500;0;19500;17600;1900;
2021-12-09 15:00:28;gula;GULA;2;11500;0;23000;20000;3000;
2021-12-09 16:12:14;8992628026147;BIMOLI 250ML;1;8000;0;8000;6650;1350;
2021-12-09 16:12:14;8997012320832;Mamaqu;1;5000;0;5000;4500;500;
2021-12-09 16:22:15;8999999195656;SARIWANGI 50X1.85;1;10000;0;10000;9405;595;
2021-12-09 16:24:21;8991102454155;WAFFLE CHIZMILL;1;9000;0;9000;8498;502;
2021-12-09 17:07:56;8993007000680;INDOMILK 1L;1;16500;0;16500;14792;1708;
2021-12-09 17:55:02;8998989300261;GUDANG GARAM SURYA 12 FILTER;1;20000;0;20000;18150;1850;
2021-12-09 18:18:33;8997028590014;ARGUS 220ML;6;500;0;3000;1812;1188;
2021-12-09 18:18:33;KIKO;KIKO;2;1000;0;2000;1000;1000;
2021-12-09 18:30:47;ARG;ARGUS DOS 220ML;1;15000;0;15000;13500;1500;
2021-12-09 19:04:10;8998989500166;GUDANG GARAM MERAH BESAR 16KS;1;18000;0;18000;17000;1000;
2021-12-09 19:05:49;8998866201520;KOPI TOP TORAJA MURNI;1;11000;0;11000;9600;1400;
2021-12-09 19:05:49;SURYA BTG;SURYA BATANG;3;1666;0;4998;4140;858;
2021-12-09 19:35:43;8991102320184;TANGO CHOCO JAVAMOCCA;2;5000;0;10000;8700;1300;
2021-12-09 19:35:43;8992775001653;GERY SALUT CHOCOLATE COCONUT;1;2000;0;2000;1476;524;
2021-12-09 19:44:53;gula;GULA;1;11500;0;11500;10000;1500;
2021-12-09 19:44:53;8994191103638;GULA GULA KARET;1;500;0;500;400;100;
2021-12-09 19:50:05;8999999524722;SUNLIGHT LIME NEW PCH 435ML;1;10000;0;10000;9100;900;
2021-12-09 20:20:38;8998989300261;GUDANG GARAM SURYA 12 FILTER;1;20000;0;20000;18150;1850;
2021-12-09 20:22:45;8999909002821;MARLBORO BLACK 16;1;22000;0;22000;20900;1100;
2021-12-09 20:22:59;8886008101091;AQUA 1,5 ML;1;5000;0;5000;4600;400;
2021-12-09 20:38:47;8992696523081;MILO UHT 110ML;2;2500;0;5000;4546;454;
2021-12-09 20:38:47;8991914101513;VIPER KRETEK 12;1;6000;0;6000;5000;1000;
2021-12-09 20:54:08;8999909982000;SAMPOERNA 12 FILTER;1;19000;0;19000;16600;2400;
2021-12-09 21:27:09;6907992825076;JD WATERMELON APPLE;6;2000;0;12000;10200;1800;
2021-12-09 21:27:09;6907992823935;JD SWEETCORN;1;3500;0;3500;3000;500;
2021-12-09 21:27:09;6907992823867;JD CRUNCHY CHOCOLATE MALT;1;5500;0;5500;4700;800;
2021-12-09 22:11:11;8991906105758;ROKOK LA BOLD;1;26000;0;26000;24900;1100;
2021-12-10 11:59:57;8997009510123;ORANGE WATER;1;8000;0;8000;6265;1735;
2021-12-10 11:59:57;8997028590014;ARGUS 220ML;2;500;0;1000;604;396;
2021-12-10 11:59:57;gula;GULA;4;11500;0;46000;40000;6000;
2021-12-10 11:59:57;8994907000428;KECAP SACHET ABC;2;600;0;1200;1000;200;
2021-12-10 11:59:57;8994867000162;ROKOK PUNDIMAS KRETEK16;1;10000;0;10000;8600;1400;
2021-12-10 11:59:57;6907992825076;JD WATERMELON APPLE;1;2000;0;2000;1700;300;
2021-12-10 11:59:57;6907992823935;JD SWEETCORN;1;3500;0;3500;3000;500;
2021-12-10 11:59:57;kiko;kiko;1;1000;0;1000;900;100;
2021-12-10 11:59:57;Pulpen;pulpen;2;1000;0;2000;1500;500;
2021-12-10 11:59:57;9556001004673;MILO NESTLE MALAYSIA ACTIVE GO;1;85000;0;85000;80000;5000;
2021-12-10 11:59:57;8999999059903;PONDS AGE MIRACLE DAY CREAM 10G;1;28500;0;28500;25850;2650;
2021-12-10 11:59:57;8992753631209;OMELA 370;1;9500;0;9500;8400;1100;
2021-12-10 11:59:57;8992702000018;INDOMILK PUTIH 370G;1;10000;0;10000;9208;792;
2021-12-10 11:59:57;8992628022156;MINYAK GORENG BIMOLI POUCH 1 LT;1;17500;0;17500;16675;825;
2021-12-10 11:59:57;8998989300261;GUDANG GARAM SURYA 12 FILTER;1;20000;0;20000;18150;1850;
2021-12-10 11:59:57;8992696404441;SUSU BERUANG;1;13000;0;13000;8585;4415;
2021-12-10 12:00:18;KIKO;KIKO;1;1000;0;1000;500;500;
2021-12-10 12:00:18;8997011700123;BIHUN JAGUNG 300GR;1;6000;0;6000;4979;1021;
2021-12-10 12:00:18;ARG;ARGUS DOS 220ML;2;15000;0;30000;27000;3000;
2021-12-10 12:32:50;8994834006128;TICTIC PEDAS;2;2000;0;4000;3400;600;
2021-12-10 12:32:50;MARS;MARSHMELLOW;2;500;0;1000;866;134;
2021-12-10 12:45:59;8992388133017;NU MILK TEA ORI 330ML;2;6000;0;12000;10250;1750;
2021-12-10 12:45:59;8997028590045;ARGUS BTL 330ML;2;2000;0;4000;2582;1418;
2021-12-10 12:45:59;ROTI;ROTI 2000;1;2000;0;2000;1800;200;
2021-12-10 12:45:59;8998989100120;GUDANG GARAM MINI;1;19000;0;19000;16600;2400;
2021-12-10 14:00:55;6907992825076;JD WATERMELON APPLE;1;2000;0;2000;1700;300;
2021-12-10 14:00:55;6907992823874;JD CRUNCHY CHOCO BLUEBERRY;1;5500;0;5500;4700;800;
2021-12-10 14:01:33;8998866200301;MIE SEDAAP GORENG;1;3000;0;3000;2414;586;
2021-12-10 14:33:26;8998989100120;GUDANG GARAM MINI;1;19000;0;19000;16600;2400;
2021-12-10 14:33:26;8994867007161;ROKOK PENA GOLD 20;3;19000;0;57000;52200;4800;
2021-12-10 14:33:26;ARG;ARGUS DOS 220ML;1;15000;0;15000;13500;1500;
2021-12-10 14:46:49;8994867000162;ROKOK PUNDIMAS KRETEK16;1;10000;0;10000;8600;1400;
2021-12-10 15:00:36;8997009510123;ORANGE WATER;1;8000;0;8000;6265;1735;
2021-12-10 15:03:06;8998989300261;GUDANG GARAM SURYA 12 FILTER;1;20000;0;20000;18150;1850;
2021-12-10 15:03:06;8994834006128;TICTIC PEDAS;2;2000;0;4000;3400;600;
2021-12-10 15:03:06;ROTI;ROTI 2000;2;2000;0;4000;3600;400;
2021-12-10 15:17:13;ARG;ARGUS DOS 220ML;1;15000;0;15000;13500;1500;
2021-12-10 15:17:13;LT;LIPSTIK HANASUI;1;27000;0;27000;27000;0;
2021-12-10 15:17:13;SURYA BTG;SURYA BATANG;1;2000;0;2000;1380;620;
2021-12-10 16:15:53;ROTI;ROTI 2000;2;2000;0;4000;3600;400;
2021-12-10 16:15:53;8998866200301;MIE SEDAAP GORENG;1;3000;0;3000;2414;586;
2021-12-10 17:00:26;8999999552374;Sahaja Pencuri Piring 720 Ml;1;13500;0;13500;12000;1500;
2021-12-10 17:00:26;8992806145417;SCOTCH BRITE;2;3500;0;7000;4814;2186;
2021-12-10 17:00:26;KPS;KAPAS MEI QIAN;1;5000;0;5000;4750;250;
2021-12-10 17:00:26;8999999559854;AXE BLACK POCKET FRAG 17ML;2;10000;0;20000;16000;4000;
2021-12-10 17:00:26;8998866603409;RAPIKA UNGU POUCH 400ML;1;5000;0;5000;4500;500;
2021-12-10 17:00:26;8998866612890;GIV TIN & ZAITUN KOTAK 76G;5;2000;0;10000;9100;900;
2021-12-10 17:00:26;8992959117583;SOFTEX DAUN SIRIH;2;5000;0;10000;8576;1424;
2021-12-10 17:00:26;8999999059781;SUNLIGHT LIME NEW POUCH 210ML;1;5000;0;5000;4520;480;
2021-12-10 17:00:26;8998866609029;DAIA PUTIH GUSSWET 565G;1;10000;0;10000;8700;1300;
2021-12-10 17:00:26;8998866610261;DAIA VIOLET GUSSET BAG 290 GR;2;5000;0;10000;8900;1100;
2021-12-10 17:00:26;8998866613002;CREAM EKONOMI PINK 455G;1;5500;0;5500;4750;750;
2021-12-10 17:00:26;8998866611152;CREAM EKONOMI VIOLET 455G;1;5500;0;5500;4750;750;
2021-12-10 17:00:26;8998866608329;CREAM EKONOMI PUTIH 455G;1;5500;0;5500;4750;750;
2021-12-10 17:00:26;8998866671736;CREAM EKONOMI 455G;1;5500;0;5500;4750;750;
2021-12-10 17:00:26;8991102103091;Formula Proteksi;2;3500;0;7000;5300;1700;
2021-12-10 17:00:26;8999999706180;PEPSODENT WHITE 190GR;1;10000;0;10000;9350;650;
2021-12-10 17:00:26;8999999557447;PEPSODENT ACTION123 SIWAK 110G;1;9000;0;9000;8000;1000;
2021-12-10 17:00:26;8999999552473;PEPSODENT ACTION123 SIWAK 65G;1;6200;0;6200;5600;600;
2021-12-10 17:00:26;8999999031930;PEPSODENT TB TRIPLE CLEAN;3;3500;0;10500;8550;1950;
2021-12-10 17:00:26;8995333060703;TERIGU KOMPAS 1KG;1;10500;0;10500;9816;684;
2021-12-10 17:00:26;SASA;SASA;18;500;0;9000;7200;1800;
2021-12-10 17:00:26;BON;BONCABE;10;1000;0;10000;9000;1000;
2021-12-10 17:02:27;8999999552374;Sahaja Pencuri Piring 720 Ml;2;13500;0;27000;24000;3000;
2021-12-10 18:19:08;8991102320184;TANGO CHOCO JAVAMOCCA;2;5000;0;10000;8700;1300;
2021-12-10 18:19:08;8851019210292;POCKY 40 GR;2;7000;0;14000;11342;2658;
2021-12-10 18:19:08;8998866202978;Guribee Rumput Laut 68 gr;2;6000;0;12000;10200;1800;
2021-12-10 18:19:08;8992696523081;MILO UHT 110ML;4;2500;0;10000;9092;908;
2021-12-10 18:19:08;9556006012093;JB BATH TOPTOETOE 200ML;1;16000;0;16000;14820;1180;
2021-12-10 18:28:36;8998989300261;GUDANG GARAM SURYA 12 FILTER;1;20000;0;20000;18150;1850;
2021-12-10 18:28:36;6907992823904;JD CRUNCHY CHOCOLATE VAN;1;8000;0;8000;6800;1200;
2021-12-10 18:40:45;MARS;MARSHMELLOW;2;500;0;1000;866;134;
2021-12-10 18:40:45;8996001328163;GULA GULA TAMARIN;8;250;0;2000;1600;400;
2021-12-10 18:40:45;8997028590014;ARGUS 220ML;4;500;0;2000;1208;792;
2021-12-11 10:22:18;8998866203272;MIE SUKSES MANTAP ISI 2;1;3500;0;3500;3046;454;
2021-12-11 10:23:23;8998866203227;MIE SEDAAP AYAM BAKAR LIMAU;1;2700;0;2700;2163;537;
2021-12-11 10:34:43;MK;MASKER;1;5000;0;5000;4000;1000;
2021-12-11 10:34:43;MBL;MOBIL;2;5000;0;10000;7000;3000;
2021-12-11 10:34:43;8998866605151;CLING HIJAU POUCH 425ML;1;4000;0;4000;3250;750;
2021-12-11 10:34:43;8998866106542;EMERON LOVELY NAT PINK 200ML;1;6000;0;6000;5075;925;
2021-12-11 10:34:43;8991102023115;Sikat Gigi Formula;1;11000;0;11000;10000;1000;
2021-12-11 10:34:43;8992694247163;ZWITSAL SOAP RICH N HON 70G;3;4000;0;12000;10230;1770;
2021-12-11 10:34:43;8999999042592;RINSO MOLTO PERFUME ESSENSE LIQ 4OML;3;1000;0;3000;2406;594;
2021-12-11 10:34:43;8995150101696;M+SUSU ORIGINAL;1;5000;0;5000;4000;1000;
2021-12-11 10:34:43;8999999195649;SARIWANGI 25X1.86G;1;6000;0;6000;5202;798;
2021-12-11 10:34:43;089686043051;INDOMIE COTO MAKASSAR;1;2800;0;2800;2525;275;
2021-12-11 10:34:43;089686021127;INTER MIE KALDU;5;1000;0;5000;4065;935;
2021-12-11 10:34:43;8992736624310;Sasa bumbu Nasi Goreng Jawa;1;2000;0;2000;1181;819;
2021-12-11 10:34:43;TERASI;ABC TERASI SCT;2;1500;0;3000;2000;1000;
2021-12-11 10:44:06;8998866500135;HERSPROTEX SOFTCARE WINGS;1;5500;0;5500;4820;680;
2021-12-11 10:44:06;6907992825076;JD WATERMELON APPLE;1;2000;0;2000;1700;300;
2021-12-11 10:44:06;ROTI;ROTI 2000;3;2000;0;6000;5400;600;
2021-12-11 10:44:06;8997028590014;ARGUS 220ML;6;500;0;3000;1812;1188;
2021-12-11 10:44:06;8993989311279;CLAS MILD 12;1;18000;0;18000;15800;2200;
2021-12-11 10:44:06;4902430745703;DOWNY SUNRISE FRESH 10ML;4;500;0;2000;1572;428;
2021-12-11 10:44:06;8992775002582;DILAN CHOCO;1;2000;0;2000;1503;497;
2021-12-11 10:44:06;8999909002821;MARLBORO BLACK 16;1;22000;0;22000;20900;1100;
2021-12-11 10:44:06;8999999529697;CLEAR DEEP CLEANSE MEN 160ML;1;24700;0;24700;22700;2000;
2021-12-11 10:44:06;8999999390198;SUNLIGHT LIME NEW POUCH 755ML;1;18000;0;18000;15950;2050;
2021-12-11 10:44:06;8994867007161;ROKOK PENA GOLD 20;1;19000;0;19000;17400;1600;
2021-12-11 10:44:06;SURYA BTG;SURYA BATANG;3;2000;0;6000;4140;1860;
2021-12-11 10:44:06;8991914101513;VIPER KRETEK 12;2;6000;0;12000;10000;2000;
2021-12-11 10:54:42;ROTI;ROTI 2000;2;2000;0;4000;3600;400;
2021-12-11 10:54:42;kentang;kripik kentang;1;1000;0;1000;900;100;
2021-12-11 10:54:42;balon air;balon air;2;2000;0;4000;3400;600;
2021-12-11 10:54:42;8993989311699;CLAS MILD 16 FILTER;1;24000;0;24000;21700;2300;
2021-12-11 10:54:42;8992761111519;COCA COLA SLIM CAM 250ML;1;5000;0;5000;3750;1250;
2021-12-11 10:54:42;MRC;MERICA LADA;1;1000;0;1000;889;111;
2021-12-11 10:54:42;8992761111540;FANTA STRAWBERY SLIM CAM 250ML;1;5000;0;5000;3750;1250;
2021-12-11 10:54:42;6907992825076;JD WATERMELON APPLE;1;2000;0;2000;1700;300;
2021-12-11 10:54:42;kiko;kiko;1;1000;0;1000;900;100;
2021-12-11 10:54:42;8992696404441;SUSU BERUANG;1;13000;0;13000;8585;4415;
2021-12-11 10:54:42;8997009510055;YOU C1000;1;15000;0;15000;13000;2000;
2021-12-11 10:54:42;8998866202244;EKOMIE BUMBU KALDU AYAM;1;1000;0;1000;798;202;
2021-12-11 10:54:42;8998866200844;NOODLE SEDAAP MIE KARI SPESIAL CUP 81 GR;1;4500;0;4500;3650;850;
2021-12-11 11:05:25;8998866200325;MIE SEDAAP SOTO;2;2700;0;5400;4564;836;
2021-12-11 11:05:25;MK;MASKER;2;5000;0;10000;8000;2000;
2021-12-11 11:05:25;ARG;ARGUS DOS 220ML;1;15000;0;15000;13500;1500;
2021-12-11 11:05:25;8996001302316;MALKIST ABON SCT;1;1000;0;1000;840;160;
2021-12-11 11:05:25;8998989500166;GUDANG GARAM MERAH BESAR 16KS;1;18000;0;18000;17000;1000;
2021-12-11 11:05:25;8999909096004;SAMPOERNA 16 FILTER;4;25000;0;100000;92400;7600;
2021-12-11 11:05:25;8991102384841;WFR TANGO LONG CKLT 130G;3;5000;0;15000;13035;1965;
2021-12-11 11:05:25;8992775311615;CHOCOLATOS;1;12000;0;12000;9983;2017;
2021-12-11 11:05:25;8994867007161;ROKOK PENA GOLD 20;1;19000;0;19000;17400;1600;
2021-12-11 11:05:25;8999909004221;SAMPOERNA ULTRAMILD 16;1;22000;0;22000;20350;1650;
2021-12-11 11:05:25;8999999401245;RINSO ANTI NODA NCLASSIC 1.4KG;1;36500;0;36500;33147;3353;
2021-12-11 11:05:25;8998866606158;NUVO ACTIVE COOL 110G;1;3000;0;3000;2600;400;
2021-12-11 11:05:25;PULPEN;PULPEN BIASA;1;2000;0;2000;1500;500;
2021-12-11 11:05:25;8996001305041;ROMA SANDWICH CKLT;2;7000;0;14000;11856;2144;
2021-12-11 11:05:25;8999999195649;SARIWANGI 25X1.86G;1;6000;0;6000;5202;798;
2021-12-11 11:13:10;8991102384841;WFR TANGO LONG CKLT 130G;1;5000;0;5000;4345;655;
2021-12-11 11:13:10;8992696523067;MILO ACTVGO UHT 180ML;2;4500;0;9000;7438;1562;
2021-12-11 11:13:10;8994834006128;TICTIC PEDAS;4;2000;0;8000;6800;1200;
2021-12-11 11:13:10;8886001038011;BENG-BENG SCT;1;1500;0;1500;1000;500;
2021-12-11 11:13:10;8998866202237;NOODLE SEDAAP TASTY AYAM GEPREK 124 GR;1;5000;0;5000;4167;833;
2021-12-11 11:13:10;ROTI;ROTI 2000;5;2000;0;10000;9000;1000;
2021-12-11 11:13:10;8997028590045;ARGUS BTL 330ML;1;2000;0;2000;1291;709;
2021-12-11 11:13:10;8996001326237;GULA GULA KIS;8;250;0;2000;1600;400;
2021-12-11 11:13:10;BALON;BALON CABUT;4;1000;0;4000;3600;400;
2021-12-11 11:13:10;ARG;ARGUS DOS 220ML;1;15000;0;15000;13500;1500;
2021-12-11 11:13:10;8999999524722;SUNLIGHT LIME NEW PCH 435ML;1;10000;0;10000;9100;900;
2021-12-11 11:13:10;8999999192150;ROYCO FDS CHICKEN 100GR;1;5000;0;5000;4300;700;
2021-12-11 11:13:10;8998866200844;NOODLE SEDAAP MIE KARI SPESIAL CUP 81 GR;1;4500;0;4500;3650;850;
2021-12-11 11:13:10;8991102022347;SIKAT GIGI FORMULA RIPPLE;1;5000;0;5000;4583;417;
2021-12-11 11:13:10;8991102103091;Formula Proteksi;1;3500;0;3500;2650;850;
2021-12-11 11:22:05;6907992823935;JD SWEETCORN;2;3500;0;7000;6000;1000;
2021-12-11 11:22:05;4902430563888;SHAMPO PANTENE;2;1000;0;2000;1500;500;
2021-12-11 11:22:05;8999999524722;SUNLIGHT LIME NEW PCH 435ML;1;10000;0;10000;9100;900;
2021-12-11 11:22:05;8886008101091;AQUA 1,5 ML;2;5000;0;10000;9200;800;
2021-12-11 11:22:05;8996001600399;LE MINERAL 1500ML;1;5000;0;5000;4042;958;
2021-12-11 11:22:05;8995333060703;TERIGU KOMPAS 1KG;1;10500;0;10500;9816;684;
2021-12-11 11:22:05;8999999526894;RINSO ROYAL GOLD 40ML;1;1000;0;1000;805;195;
2021-12-11 11:22:05;8997009510123;ORANGE WATER;1;8000;0;8000;6265;1735;
2021-12-11 11:22:05;gula;GULA;4;11500;0;46000;40000;6000;
2021-12-11 11:22:05;8997028590014;ARGUS 220ML;2;500;0;1000;604;396;
2021-12-11 11:22:05;8994867000162;ROKOK PUNDIMAS KRETEK16;1;10000;0;10000;8600;1400;
2021-12-11 11:22:05;6907992825076;JD WATERMELON APPLE;1;2000;0;2000;1700;300;
2021-12-11 11:22:05;kiko;kiko;1;1000;0;1000;900;100;
2021-12-11 11:22:05;Pulpen;pulpen;1;1000;0;1000;750;250;
2021-12-11 11:22:05;9556001004673;MILO NESTLE MALAYSIA ACTIVE GO;1;85000;0;85000;80000;5000;
2021-12-11 11:31:41;8999999059903;PONDS AGE MIRACLE DAY CREAM 10G;1;28500;0;28500;25850;2650;
2021-12-11 11:31:41;8992753631209;OMELA 370;1;10000;0;10000;8400;1600;
2021-12-11 11:31:41;8992702000063;INDOMILK COKLAT 370G;1;10000;0;10000;9208;792;
2021-12-11 11:31:41;8992628022156;MINYAK GORENG BIMOLI POUCH 1 LT;1;18000;0;18000;16675;1325;
2021-12-11 11:31:41;8998989300261;GUDANG GARAM SURYA 12 FILTER;1;20000;0;20000;18150;1850;
2021-12-11 11:31:41;8992696404441;SUSU BERUANG;1;13000;0;13000;8585;4415;
2021-12-11 11:31:41;kiko;kiko;4;1000;0;4000;3600;400;
2021-12-11 11:31:41;ARG;ARGUS DOS 220ML;2;15000;0;30000;27000;3000;
2021-12-11 11:31:41;8998866805414;SOKLIN SMART SOFTERNER 800G & PIRING;1;20000;0;20000;18630;1370;
2021-12-11 11:31:41;8991102228053;TEH GELAS BOTOL;1;3000;0;3000;1695;1305;
2021-12-11 11:31:41;8999999059781;SUNLIGHT LIME NEW POUCH 210ML;1;5000;0;5000;4520;480;
2021-12-11 11:31:41;4902430563864;shampo pantene;10;1000;0;10000;7500;2500;
2021-12-11 11:31:41;TBR;TEPUNG BERAS ROSE BRAND;1;8000;0;8000;6150;1850;
2021-12-11 11:31:41;8998866202237;NOODLE SEDAAP TASTY AYAM GEPREK 124 GR;1;5000;0;5000;4167;833;
2021-12-11 11:31:41;8992628020152;MINYAK GOREG BIMOLI POUCH 2L;1;35000;0;35000;29800;5200;
2021-12-11 11:42:15;kiko;kiko;1;1000;0;1000;900;100;
2021-12-11 11:42:15;6907992825076;JD WATERMELON APPLE;1;2000;0;2000;1700;300;
2021-12-11 11:42:15;8998866203227;MIE SEDAAP AYAM BAKAR LIMAU;1;2700;0;2700;2163;537;
2021-12-11 11:42:15;Garuda pilus;Garuda Pilus Pedas Pcs;3;500;0;1500;1224;276;
2021-12-11 11:42:15;ROTI;ROTI 2000;1;2000;0;2000;1800;200;
2021-12-11 11:42:15;UBI;KRIPIK UBI;1;5000;0;5000;4000;1000;
2021-12-11 11:42:15;KRIPIK;KRIPIK KENTANG;1;1000;0;1000;900;100;
2021-12-11 11:42:15;8991102022347;SIKAT GIGI FORMULA RIPPLE;2;5000;0;10000;9166;834;
2021-12-11 11:42:15;8993560026004;DETTOL ORIGINAL;1;20000;0;20000;18524;1476;
2021-12-11 11:42:15;8998866601429;POWDET DAIA BUNGA BAG 290GR;1;5000;0;5000;4450;550;
2021-12-11 11:42:15;8999999534752;PEPSODENT ACTION123 CHARCOAL 65G;1;7400;0;7400;6710;690;
2021-12-11 11:42:15;8991111102603;JB SHAMPOO GOLD 100ML;1;9200;0;9200;8250;950;
2021-12-11 11:42:15;8997028590014;ARGUS 220ML;4;500;0;2000;1208;792;
2021-12-11 11:42:15;8995333032113;TERIGU GATOT KACA 1 KG;4;9000;0;36000;34288;1712;
2021-12-11 11:59:06;gula;GULA;5;11500;0;57500;50000;7500;
2021-12-11 11:59:06;8851019015132;POCKY DOUBLE CHOCOLATE 47G;2;7300;0;14600;11342;3258;
2021-12-11 11:59:06;8992761166052;FRESTEA MELATI 350ML;1;4500;0;4500;3000;1500;
2021-12-11 11:59:06;8991102714846;MILKIDO CKLT;1;3000;0;3000;2153;847;
2021-12-11 11:59:06;8998866611107;RAPIKA BIANG GOLD 250MLBTL;1;8500;0;8500;7650;850;
2021-12-11 11:59:06;8991102384841;WFR TANGO LONG CKLT 130G;1;5000;0;5000;4345;655;
2021-12-11 11:59:06;8999909002821;MARLBORO BLACK 16;1;22000;0;22000;20900;1100;
2021-12-11 11:59:06;8999999059781;SUNLIGHT LIME NEW POUCH 210ML;1;5000;0;5000;4520;480;
2021-12-11 11:59:06;8999999046996;LIFEBUOY TOTAL10 60G;1;3000;0;3000;1800;1200;
2021-12-11 11:59:06;Telur;Telur;2;2000;0;4000;0;4000;
2021-12-11 11:59:06;8996001302316;MALKIST ABON SCT;1;1000;0;1000;840;160;
2021-12-11 11:59:06;8997012321204;MAXX BUMBU BALADO;1;5000;0;5000;4100;900;
2021-12-11 11:59:06;8995333060772;TERIGU GATOT KACA 500GR;1;5000;0;5000;4346;654;
2021-12-11 11:59:06;8992742360844;POLYTEX SABUT STENLESS;1;4000;0;4000;2200;1800;
2021-12-11 12:12:06;SURYA BTG;SURYA BATANG;2;2000;0;4000;2760;1240;
2021-12-11 12:20:14;711844340008;ABC TERASI;1;7000;0;7000;5800;1200;
2021-12-11 12:31:26;kiko;kiko;1;1000;0;1000;900;100;
2021-12-11 12:35:45;6907992825076;JD WATERMELON APPLE;1;2000;0;2000;1700;300;
2021-12-11 12:35:45;8992730950194;GULA GULA KOIN;6;500;0;3000;2400;600;
2021-12-11 13:21:02;8996001600269;LE MINERAL 600ML;12;3000;0;36000;20256;15744;
2021-12-11 13:41:54;8998989300261;GUDANG GARAM SURYA 12 FILTER;1;20000;0;20000;18150;1850;
2021-12-11 13:41:54;8998866203272;MIE SUKSES MANTAP ISI 2;1;3500;0;3500;3046;454;
2021-12-11 14:09:28;8998866202244;EKOMIE BUMBU KALDU AYAM;10;1000;0;10000;7980;2020;
2021-12-11 15:29:59;7622201430153;OREO CHOCOLATE 38G;1;2000;0;2000;1641;359;
2021-12-11 15:29:59;kiko;kiko;1;1000;0;1000;900;100;
2021-12-11 15:29:59;8992775002582;DILAN CHOCO;1;2000;0;2000;1503;497;
2021-12-11 15:29:59;76164217;MARLBORO MERAH;1;31000;0;31000;29650;1350;
2021-12-11 15:29:59;8992959117583;SOFTEX DAUN SIRIH;1;5000;0;5000;4288;712;
2021-12-11 15:29:59;8992775312469;GERY SALUT COKELAT;1;11000;0;11000;9983;1017;
2021-12-11 15:29:59;8991102384841;WFR TANGO LONG CKLT 130G;1;5000;0;5000;4345;655;
2021-12-11 15:29:59;8886013213208;FRENCH FREIS 2000;2;5000;0;10000;7500;2500;
2021-12-11 15:29:59;8992775211410;PILUS GARUDA PEDAS;2;5500;0;11000;9772;1228;
2021-12-11 15:29:59;8996001600399;LE MINERAL 1500ML;1;5000;0;5000;4042;958;
2021-12-11 15:29:59;8996001320068;GULA GULA KOPIKO;8;250;0;2000;1600;400;
2021-12-11 15:29:59;8999999049447;REXONA WMN RO ADVANCED WHITE 45 ML;1;16500;0;16500;14900;1600;
2021-12-11 15:54:36;8996001600269;LE MINERAL 600ML;1;3000;0;3000;1688;1312;
2021-12-11 15:54:36;8886008101053;AQUA 600 ML;1;3500;0;3500;2125;1375;
2021-12-11 15:54:36;8992775001042;PILUS GARUDA MI GORENG;1;5000;0;5000;4810;190;
2021-12-11 17:02:03;ARG;ARGUS DOS 220ML;1;15000;0;15000;13500;1500;
2021-12-11 17:03:06;8994867007161;ROKOK PENA GOLD 20;1;19000;0;19000;17400;1600;
2021-12-11 17:03:06;8999909002821;MARLBORO BLACK 16;1;22000;0;22000;20900;1100;
2021-12-11 17:25:40;TK;TEPUNG KETAN;1;13000;0;13000;13000;0;
2021-12-11 17:25:40;8995333000822;TERIGU KOMPAS SOFT 500GR;1;5500;0;5500;4967;533;
2021-12-11 17:29:20;8997011700123;BIHUN JAGUNG 300GR;3;6000;0;18000;14937;3063;
2021-12-11 17:35:16;PD;PENDEKAR;40;500;0;20000;14000;6000;
2021-12-11 18:20:34;8998866500708;FLORIDINA ORANGE;1;3000;0;3000;2500;500;
2021-12-11 18:20:34;8991002121010;GOOD DAY FANTASTIC MOCACINNO;1;7000;0;7000;4750;2250;
2021-12-11 18:20:34;8991102987639;WFR TANGO LONG VNL 130G;1;5000;0;5000;4350;650;
2021-12-11 18:36:58;SURYA BTG;SURYA BATANG;1;2000;0;2000;1380;620;
2021-12-11 18:36:58;8998989500166;GUDANG GARAM MERAH BESAR 16KS;1;18000;0;18000;17000;1000;
2021-12-11 18:47:30;8998866200561;EKOMIE SUPER 600GR;2;10000;0;20000;17230;2770;
2021-12-11 18:48:11;VTM;VITAMIN CIMIN;3;500;0;1500;1275;225;
2021-12-11 18:48:11;KIKO;KIKO;2;1000;0;2000;1000;1000;
2021-12-11 18:48:11;COKLAT;COKLAT COIN;1;500;0;500;425;75;
2021-12-11 18:50:22;8994867000162;ROKOK PUNDIMAS KRETEK16;1;10000;0;10000;8600;1400;
2021-12-11 19:07:09;8998866200578;MIE SEDAAP KARI KENTAL;1;2700;0;2700;2331;369;
2021-12-11 19:07:09;8998866200561;EKOMIE SUPER 600GR;2;10000;0;20000;17230;2770;
2021-12-11 19:09:07;8999909096004;SAMPOERNA 16 FILTER;2;25000;0;50000;46200;3800;
2021-12-11 19:10:13;123124;KOREK BIASA;1;2000;0;2000;1300;700;
2021-12-11 19:21:15;8998989300261;GUDANG GARAM SURYA 12 FILTER;1;20000;0;20000;18150;1850;
2021-12-11 19:21:15;089686021127;INTER MIE KALDU;2;1000;0;2000;1626;374;
2021-12-11 19:21:15;ROTI;ROTI 2000;2;2000;0;4000;3600;400;
2021-12-11 20:02:51;8992761122430;FRESTEA GREEN HONEY 500ML;1;6500;0;6500;4708;1792;
2021-12-11 20:02:51;8999999195656;SARIWANGI 50X1.85;1;10000;0;10000;9405;595;
2021-12-11 20:05:16;8998989300261;GUDANG GARAM SURYA 12 FILTER;1;20000;0;20000;18150;1850;
2021-12-11 20:15:56;8993154789575;GULA GULA TUSUK;10;500;0;5000;4000;1000;
2021-12-11 21:12:14;8997009510055;YOU C1000;2;15000;0;30000;26000;4000;
2021-12-11 21:15:18;8998866500708;FLORIDINA ORANGE;3;3000;0;9000;7500;1500;
2021-12-11 21:15:18;ARG;ARGUS DOS 220ML;1;15000;0;15000;13500;1500;
2021-12-11 21:18:13;8998866200301;MIE SEDAAP GORENG;3;3000;0;9000;7242;1758;
2021-12-11 21:18:13;8998866203227;MIE SEDAAP AYAM BAKAR LIMAU;2;2700;0;5400;4326;1074;
2021-12-11 21:55:29;8997028590014;ARGUS 220ML;2;500;0;1000;604;396;
2021-12-11 22:12:02;8997028590014;ARGUS 220ML;4;500;0;2000;1208;792;
2021-12-11 22:13:15;TG;TEH GELAS;6;1000;0;6000;4374;1626;
2021-12-11 22:16:49;8999999001155;LIFEBUOY BW TOTAL10 300ML;1;24000;0;24000;21550;2450;
2021-12-11 22:16:49;8991102024099;FORMULA CURVE;1;5000;0;5000;3000;2000;
2021-12-11 22:16:49;8886013213208;FRENCH FREIS 2000;2;5000;0;10000;7500;2500;
2021-12-11 22:16:49;8999999706449;CLOSEUP ICY WHITE 65G;1;9000;0;9000;7865;1135;
2021-12-11 22:25:23;8991914101513;VIPER KRETEK 12;2;6000;0;12000;10000;2000;
2021-12-11 22:45:41;8995102703534;TERASI DUO 6 GR;1;4000;0;4000;3720;280;
2021-12-11 22:51:25;8998866203272;SUKSES AYAM GEPREK;1;4000;0;4000;3046;954;
2021-12-12 11:44:59;8997021110028;Garam Kasar;1;3000;0;3000;1500;1500;
2021-12-12 12:22:36;8991909101016;URBAN MILD 16;1;17000;0;17000;15800;1200;
2021-12-12 12:22:36;VTM;VITAMIN CIMIN;2;500;0;1000;850;150;
2021-12-12 12:22:36;123124;KOREK BIASA;1;2000;0;2000;1300;700;
2021-12-12 12:33:14;6907992823591;JD STRAW MILKSHAKE;4;5000;0;20000;17200;2800;
2021-12-12 13:28:36;8997028590014;ARGUS 220ML;2;500;0;1000;604;396;
2021-12-12 14:59:06;8998866200301;MIE SEDAAP GORENG;1;3000;0;3000;2414;586;
2021-12-12 14:59:06;8998866200325;MIE SEDAAP SOTO;1;2700;0;2700;2282;418;
2021-12-12 16:43:30;SURYA BTG;SURYA BATANG;3;1666;0;4998;4140;858;
2021-12-12 19:12:01;ROTI;ROTI 2000;5;2000;0;10000;9000;1000;
2021-12-12 19:12:01;8999999195656;SARIWANGI 50X1.85;1;10000;0;10000;9405;595;
2021-12-12 19:50:18;8992959508947;SWEETY SILVER PANTS XL 44;1;98000;0;98000;90152;7848;
2021-12-12 20:26:50;8999909982000;SAMPOERNA 12 FILTER;1;19000;0;19000;16600;2400;
2021-12-12 20:26:50;8998989300261;GUDANG GARAM SURYA 12 FILTER;1;20000;0;20000;18150;1850;
2021-12-12 21:17:56;8997028590045;ARGUS BTL 330ML;1;2000;0;2000;1291;709;
2021-12-12 22:00:09;8998989300261;GUDANG GARAM SURYA 12 FILTER;1;20000;0;20000;18150;1850;
2021-12-12 22:00:09;8994867000162;ROKOK PUNDIMAS KRETEK16;1;10000;0;10000;8600;1400;
2021-12-12 22:11:30;ARG;ARGUS DOS 220ML;1;15000;0;15000;13500;1500;
2021-12-12 22:11:30;8993058105013;EXTRA JOSS;1;12000;0;12000;9773;2227;
2021-12-12 22:11:30;8998866202237;NOODLE SEDAAP TASTY AYAM GEPREK 124 GR;1;5000;0;5000;4167;833;
2021-12-12 22:13:57;089686727081;DORITOS 55G;1;7000;0;7000;5950;1050;
2021-12-12 22:13:57;TG APEL;TEH GELAS APEL;1;2000;0;2000;1178;822;
2021-12-12 22:13:57;8992741952262;GULA GULA YUPI;4;250;0;1000;800;200;
2021-12-13 11:56:24;kiko;kiko;9;1000;0;9000;8100;900;
2021-12-13 11:56:24;6907992825076;JD WATERMELON APPLE;1;2000;0;2000;1700;300;
2021-12-13 11:56:24;8994907000428;KECAP SACHET ABC;4;600;0;2400;2000;400;
2021-12-13 11:56:24;8995555121244;SOSIS KIMBO;2;1000;0;2000;1300;700;
2021-12-13 11:56:24;8997011700123;BIHUN JAGUNG 300GR;1;6000;0;6000;4979;1021;
2021-12-13 11:56:24;8886467100017;PRINGLES;2;23000;0;46000;38000;8000;
2021-12-13 11:56:24;8997218380135;ICHITAN GREEN TEA;1;8000;0;8000;6500;1500;
2021-12-13 11:56:24;8996001320068;GULA GULA KOPIKO;8;250;0;2000;1600;400;
2021-12-13 11:56:24;8992775311547;Chocolatos;4;2000;0;8000;6000;2000;
2021-12-13 11:56:24;8996001410042;TB TORA MOKA;1;1500;0;1500;870;630;
2021-12-13 11:56:24;8997028590014;ARGUS 220ML;12;500;0;6000;3624;2376;
2021-12-13 11:56:24;8992959107607;SFX COMFORT SLIM 1;1;5000;0;5000;4000;1000;
2021-12-13 11:56:24;8992959117613;SFX DAUN SIRIH 1 WP;6;500;0;3000;2478;522;
2021-12-13 11:56:24;VTM;VITAMIN CIMIN;1;500;0;500;425;75;
2021-12-13 11:56:24;7622201430153;OREO CHOCOLATE 38G;1;2000;0;2000;1641;359;
2021-12-13 11:56:24;8999999534752;PEPSODENT ACTION123 CHARCOAL 65G;1;7400;0;7400;6710;690;
2021-12-13 11:56:24;8886013213208;FRENCH FREIS 2000;1;5000;0;5000;3750;1250;
2021-12-13 11:56:24;8998866200837;NOODLE SEDAAPMIE SOTO CUP 81 GR;1;4500;0;4500;3738;762;
2021-12-13 11:56:24;8998009010569;ULTRA CHO 200;2;5000;0;10000;7916;2084;
2021-12-13 11:56:24;ROTI;ROTI 2000;1;2000;0;2000;1800;200;
2021-12-13 11:56:24;8999909085114;SAMPOERNA KRETEK HIJAU 12;1;13000;0;13000;11650;1350;
2021-12-13 11:56:24;8996001600375;LE MINERAL 330ML;1;2000;0;2000;1417;583;
2021-12-13 11:56:24;SONICE;SONICE SOSIS AYAM;1;24000;0;24000;23500;500;
2021-12-13 11:56:24;8992696523067;MILO ACTVGO UHT 180ML;1;4500;0;4500;3719;781;
2021-12-13 11:56:24;8996001355008;BENG-BENG SP20G;1;29000;0;29000;20000;9000;
2021-12-13 11:56:24;8991102945370;Tango Choco Javamocca 20x7 gr;1;10000;0;10000;8200;1800;
2021-12-13 12:01:20;8991102026383;AIR CRYSTALINE 1.5 L;1;5000;0;5000;3471;1529;
2021-12-13 12:15:27;8992761166205;FRESTEA GREEN HONEY 350ML;1;4500;0;4500;3000;1500;
2021-12-13 12:20:28;8999908284907;MY BABY MINYAK TELON 90ML;1;25000;0;25000;22700;2300;
2021-12-13 12:40:59;RB;RED BOLD;1;20000;0;20000;18800;1200;
2021-12-13 12:40:59;8998989300261;GUDANG GARAM SURYA 12 FILTER;1;20000;0;20000;18150;1850;
2021-12-13 12:40:59;KIKO;KIKO;1;1000;0;1000;500;500;
2021-12-13 13:09:10;8997028590014;ARGUS 220ML;4;500;0;2000;1208;792;
2021-12-13 13:09:10;KIKO;KIKO;1;1000;0;1000;500;500;
2021-12-13 13:09:10;6907992823973;JD PINEAPPLE;2;5000;0;10000;8600;1400;
2021-12-13 13:21:30;8993335522427;OXYKLIN VIOLET 800 G;1;21500;0;21500;19208;2292;
2021-12-13 13:21:30;089686021127;INTER MIE KALDU;2;1000;0;2000;1626;374;
2021-12-13 13:21:30;8997011700123;BIHUN JAGUNG 300GR;1;6000;0;6000;4979;1021;
2021-12-13 14:06:13;8999909096004;SAMPOERNA 16 FILTER;1;25000;0;25000;23100;1900;
2021-12-13 14:09:39;6907992825076;JD WATERMELON APPLE;1;2000;0;2000;1700;300;
2021-12-13 14:09:39;6907992824963;JD MILKY CHOCOLATE;1;3000;0;3000;2600;400;
2021-12-13 14:38:05;8995333000822;TERIGU KOMPAS SOFT 500GR;1;5500;0;5500;4967;533;
2021-12-13 14:38:05;8994867000162;ROKOK PUNDIMAS KRETEK16;1;10000;0;10000;8600;1400;
2021-12-13 14:38:05;8994867007161;ROKOK PENA GOLD 20;2;19000;0;38000;34800;3200;
2021-12-13 15:14:37;6907992823935;JD SWEETCORN;1;3500;0;3500;3000;500;
2021-12-13 15:14:37;8996001440049;ENERGEN;1;1500;0;1500;1200;300;
2021-12-13 15:38:23;8992775001783;GERY SALUT MALKIST KELAPA;1;6500;0;6500;5516;984;
2021-12-13 15:38:23;8997218380159;ICHITAN BROWN SUGAR;1;8000;0;8000;6500;1500;
2021-12-13 15:53:38;MRC;MERICA LADA;3;1000;0;3000;2667;333;
2021-12-13 15:53:38;8995555121244;SOSIS KIMBO;2;1000;0;2000;1300;700;
2021-12-13 16:15:02;8999999390198;SUNLIGHT LIME NEW POUCH 755ML;1;18000;0;18000;15950;2050;
2021-12-13 17:20:34;089686021127;INTER MIE KALDU;6;1000;0;6000;4878;1122;
2021-12-13 17:20:34;8998866200301;MIE SEDAAP GORENG;1;3000;0;3000;2414;586;
2021-12-13 17:20:34;8998866200325;MIE SEDAAP SOTO;1;2700;0;2700;2282;418;
2021-12-13 19:01:02;8995333032113;TERIGU GATOT KACA 1 KG;5;9000;0;45000;42860;2140;
2021-12-13 19:01:02;089686043051;INDOMIE COTO MAKASSAR;1;2800;0;2800;2525;275;
2021-12-13 19:30:26;8991102320184;TANGO CHOCO JAVAMOCCA;1;5000;0;5000;4350;650;
2021-12-13 19:30:26;8992705025124;AGAR-AGAR SATELIT MERAH;2;3500;0;7000;5208;1792;
2021-12-13 19:30:26;TBR;TEPUNG BERAS ROSE BRAND;1;8000;0;8000;6150;1850;
2021-12-13 19:30:26;8994191103638;GULA GULA KARET;4;500;0;2000;1600;400;
2021-12-13 19:30:26;8995555171225;KIMBO SOSIS;2;1000;0;2000;1800;200;
2021-12-13 19:34:25;8992775001653;GERY SALUT CHOCOLATE COCONUT;1;2000;0;2000;1476;524;
2021-12-13 20:02:52;ROTI;ROTI 2000;1;2000;0;2000;1800;200;
2021-12-13 20:02:52;8998989300261;GUDANG GARAM SURYA 12 FILTER;1;20000;0;20000;18150;1850;
2021-12-13 20:42:36;8993007003063;ENAAK 500G;1;11000;0;11000;9625;1375;
2021-12-13 20:42:57;gula;GULA;1;11500;0;11500;10000;1500;
2021-12-13 20:42:57;MILKITA;MILKITA;2;250;0;500;400;100;
2021-12-13 21:01:13;8992775002582;DILAN CHOCO;2;2000;0;4000;3006;994;
2021-12-13 21:01:13;KIKO;KIKO;2;1000;0;2000;1000;1000;
2021-12-13 21:09:58;8850007652588;C&C NATURAL BRIGHT 100ML;1;22000;0;22000;19900;2100;
2021-12-13 21:09:58;8998866108126;POSH HIJAB WINTER MAGIC 150ML;1;19500;0;19500;17500;2000;
2021-12-13 21:09:58;8998866200578;MIE SEDAAP KARI KENTAL;2;2700;0;5400;4662;738;
2021-12-13 21:09:58;8998866200301;MIE SEDAAP GORENG;2;3000;0;6000;4828;1172;
2021-12-13 21:09:58;PULPEN SNOWMAN;PULPEN SNOWMAN;1;2500;0;2500;2000;500;
2021-12-13 21:29:25;8999909002821;MARLBORO BLACK 16;1;22000;0;22000;21000;1000;
2021-12-13 21:50:27;8998866600569;SOKLIN LANTAI HIJAU 400ML;1;6000;0;6000;5025;975;
2021-12-13 21:50:27;8999909010567;234 DJI SAM SOE 16;1;22500;0;22500;21500;1000;
2021-12-13 21:51:44;8997218380074;ICHITAN MILK TEA;1;8000;0;8000;6500;1500;
2021-12-14 13:06:01;8991002106116;KOPI KAPTEN;1;7000;0;7000;5120;1880;
2021-12-14 13:06:43;8991914101513;VIPER KRETEK 12;2;6000;0;12000;10000;2000;
2021-12-14 13:06:43;8998009010569;ULTRA CHO 200;1;5000;0;5000;3958;1042;
2021-12-14 13:23:42;8997028590014;ARGUS 220ML;4;500;0;2000;1208;792;
2021-12-14 13:23:42;8995555111221;SOSIS KIMBO;1;1000;0;1000;850;150;
2021-12-14 15:44:36;123124;KOREK BIASA;1;2000;0;2000;1300;700;
2021-12-14 15:44:36;8991909101016;URBAN MILD 16;1;17000;0;17000;15800;1200;
2021-12-14 15:44:36;ROYCO;ROYCO RASA AYAM;6;500;0;3000;2250;750;
2021-12-14 16:45:07;8998989500166;GUDANG GARAM MERAH BESAR 16KS;1;18000;0;18000;17000;1000;
2021-12-14 16:45:07;8994867007161;ROKOK PENA GOLD 20;1;19000;0;19000;17400;1600;
2021-12-14 17:05:27;8992775002582;DILAN CHOCO;1;2000;0;2000;1503;497;
2021-12-14 17:05:27;8999801700030;SUSU FOYU;1;11500;0;11500;10450;1050;
2021-12-14 17:05:27;KOPIKO;KOPIKO;2;250;0;500;350;150;
2021-12-14 18:34:37;gula;GULA;3;11500;0;34500;30000;4500;
2021-12-14 18:34:37;8992696521797;MILO 22G;2;2500;0;5000;3144;1856;
2021-12-14 18:35:36;8998866203272;SUKSES AYAM GEPREK;2;4000;0;8000;6092;1908;
2021-12-14 18:35:36;TG;TEH GELAS;1;1000;0;1000;729;271;
2021-12-14 18:35:36;Garuda pilus pcs;Garuda pilus Rasa Mi Goreng pcs;1;1000;0;1000;808;192;
2021-12-14 18:41:24;8999909096004;SAMPOERNA 16 FILTER;1;25000;0;25000;23100;1900;
2021-12-14 18:44:53;ARG;ARGUS DOS 220ML;1;15000;0;15000;13500;1500;
2021-12-14 18:44:53;8991102228053;TEH GELAS BOTOL;1;3000;0;3000;1695;1305;
2021-12-14 18:44:53;4902430563864;shampo pantene;2;1000;0;2000;1500;500;
2021-12-14 18:54:45;8994867000179;ROKOK PENA MILD 16;1;15500;0;15500;14500;1000;
2021-12-14 19:45:41;8999999050009;SUNLIGHT LIME NEW POUCH 95ML;1;2000;0;2000;1600;400;
2021-12-14 19:45:41;8999999559557;LUX BW MAGICAL ORCHID 85ML;1;5000;0;5000;4000;1000;
2021-12-14 20:20:04;8998866606158;NUVO ACTIVE COOL 110G;1;3000;0;3000;2600;400;
2021-12-14 20:20:04;8993379254469;SABUN LERVIA 90G;1;5000;0;5000;3077;1923;
2021-12-14 20:37:55;LP;LIPTIN IMPLORA;1;20000;0;20000;20000;0;
2021-12-14 21:11:39;8999909002821;MARLBORO BLACK 16;1;22000;0;22000;21000;1000;
2021-12-14 21:16:18;8996001600375;LE MINERAL 330ML;2;2000;0;4000;2834;1166;
2021-12-14 21:49:59;8998989300261;GUDANG GARAM SURYA 12 FILTER;1;20000;0;20000;18150;1850;
2021-12-14 22:09:46;8994867000162;ROKOK PUNDIMAS KRETEK16;1;10000;0;10000;8600;1400;
2021-12-14 22:09:46;lolipop;lolipop;2;1000;0;2000;1700;300;
2021-12-14 22:09:46;8997028590014;ARGUS 220ML;1;500;0;500;302;198;
2021-12-14 22:09:46;8993470279651;JOGER CHOCKY BAR;1;1000;0;1000;867;133;
2021-12-14 22:09:46;MILKITA;MILKITA;6;250;0;1500;1200;300;
2021-12-14 22:09:46;ROTI;ROTI 2000;3;2000;0;6000;5400;600;
2021-12-14 22:09:46;ARG;ARGUS DOS 220ML;1;15000;0;15000;13500;1500;
2021-12-14 22:09:46;8997011700123;BIHUN JAGUNG 300GR;1;6000;0;6000;4979;1021;
2021-12-14 22:09:46;6907992823973;JD PINEAPPLE;1;5000;0;5000;4300;700;
2021-12-14 22:09:46;8993989311699;CLAS MILD 16 FILTER;1;24000;0;24000;21700;2300;
2021-12-14 22:23:12;8998989110167;SURYA GUDANG GARAM 16 FILTER;1;26000;0;26000;23700;2300;
2021-12-14 22:25:21;8999999046996;LIFEBUOY TOTAL10 60G;1;3000;0;3000;1800;1200;
2021-12-14 22:25:21;8999999524722;SUNLIGHT LIME NEW PCH 435ML;1;10000;0;10000;9100;900;
2021-12-14 22:25:21;8998866608459;POWDET DAIA PUTIH BAG 290GR;1;5000;0;5000;4450;550;
2021-12-14 22:25:21;8994420100018;SARDEN SAUS PEDAS;1;7000;0;7000;5833;1167;
2021-12-15 12:35:39;8998989110167;SURYA GUDANG GARAM 16 FILTER;1;26000;0;26000;23700;2300;
2021-12-15 12:44:22;8994867000162;ROKOK PUNDIMAS KRETEK16;1;10000;0;10000;8600;1400;
2021-12-15 12:47:24;KERIPIK;KERIPIK UBI;1;2000;0;2000;1800;200;
2021-12-15 13:22:24;8995555111221;SOSIS KIMBO;1;1000;0;1000;850;150;
2021-12-15 14:00:01;8998989300261;GUDANG GARAM SURYA 12 FILTER;1;20000;0;20000;18150;1850;
2021-12-15 14:00:01;6907992823966;JD BLUEBERRY;1;3500;0;3500;3000;500;
2021-12-15 14:00:01;6907992823935;JD SWEETCORN;1;3500;0;3500;3000;500;
2021-12-15 14:14:15;8998866200301;MIE SEDAAP GORENG;1;3000;0;3000;2414;586;
2021-12-15 14:14:15;8996001301142;ROMA KELAPA;1;8000;0;8000;7000;1000;
2021-12-15 14:14:15;8992760223015;OREO CHOCOLATE CREAM 133G;1;8000;0;8000;6300;1700;
2021-12-15 14:17:21;089686043051;INDOMIE COTO MAKASSAR;1;2800;0;2800;2525;275;
2021-12-15 14:17:21;8998866202619;MIE SEDAAP KOREAN SPICY SOUP;2;2700;0;5400;4644;756;
2021-12-15 15:20:12;8999909085114;SAMPOERNA KRETEK HIJAU 12;1;13000;0;13000;11650;1350;
2021-12-15 15:21:15;8993335521260;Sabun Total Violet 900gr;1;15000;0;15000;13800;1200;
2021-12-15 15:29:46;6907992823874;JD CRUNCHY CHOCO BLUEBERRY;1;5500;0;5500;4700;800;
2021-12-15 15:29:46;8993989311699;CLAS MILD 16 FILTER;1;24000;0;24000;21700;2300;
2021-12-15 15:38:35;6907992823867;JD CRUNCHY CHOCOLATE MALT;1;5500;0;5500;4700;800;
2021-12-15 16:25:10;gula;GULA;1;11500;0;11500;10000;1500;
2021-12-15 17:44:57;8999999559564;LUX BW SOFT ROSE 90ML;1;5000;0;5000;4000;1000;
2021-12-15 17:44:57;8998866608718;DAIA SOFTENER PINK;2;5000;0;10000;8900;1100;
2021-12-15 17:44:57;8998866613699;EMERON LOVELY COOLBRIGHT 100ML;1;4300;0;4300;3800;500;
2021-12-15 17:45:39;8998866201728;POTABEE SELECTION SALTED EGG 68G;1;8000;0;8000;7200;800;
2021-12-15 17:45:39;8998866201865;KRISBEE PILLOW CHOCOLAVA 120 GR;1;8000;0;8000;7250;750;
2021-12-15 17:45:39;8998009010569;ULTRA CHO 200;1;5000;0;5000;3958;1042;
2021-12-15 17:59:51;8996001600269;LE MINERAL 600ML;1;3000;0;3000;1688;1312;
2021-12-15 17:59:51;8997028590014;ARGUS 220ML;4;500;0;2000;1208;792;
2021-12-15 18:06:57;8991188943536;SASA SANTAN KELAPA 65ML;2;3000;0;6000;4874;1126;
2021-12-15 19:24:52;8994867007161;ROKOK PENA GOLD 20;1;19000;0;19000;17400;1600;
2021-12-15 19:29:31;ARG;ARGUS DOS 220ML;1;15000;0;15000;13500;1500;
2021-12-15 19:39:05;8999909002821;MARLBORO BLACK 16;1;22000;0;22000;21000;1000;
2021-12-15 20:22:58;8999909010567;234 DJI SAM SOE 16;1;22500;0;22500;21500;1000;
2021-12-15 20:29:56;8998866200325;MIE SEDAAP SOTO;1;2700;0;2700;2282;418;
2021-12-15 20:29:56;8998866200301;MIE SEDAAP GORENG;1;3000;0;3000;2414;586;
2021-12-15 20:29:56;8998866200578;MIE SEDAAP KARI KENTAL;1;2700;0;2700;2331;369;
2021-12-15 20:59:04;8994867000179;ROKOK PENA MILD 16;1;15500;0;15500;14500;1000;
2021-12-15 21:01:13;ARG;ARGUS DOS 220ML;3;15000;0;45000;40500;4500;
2021-12-15 21:01:13;gula;GULA;4;11500;0;46000;40000;6000;
2021-12-15 21:53:29;SURYA BTG;SURYA BATANG;6;2000;0;12000;8280;3720;
2021-12-15 22:06:43;8991909101016;URBAN MILD 16;1;17000;0;17000;15800;1200;
2021-12-15 22:06:43;SURYA BTG;SURYA BATANG;1;2000;0;2000;1380;620;
2021-12-16 12:19:00;8996001600375;LE MINERAL 330ML;1;2000;0;2000;1417;583;
2021-12-16 18:04:08;8996001600269;LE MINERAL 600ML;1;3000;0;3000;1688;1312;
2021-12-16 18:04:08;8998989300261;GUDANG GARAM SURYA 12 FILTER;1;20000;0;20000;18150;1850;
2021-12-16 18:16:54;8998866610261;DAIA VIOLET GUSSET BAG 290 GR;1;5000;0;5000;4450;550;
2021-12-16 18:16:54;8999999050009;SUNLIGHT LIME NEW POUCH 95ML;1;2000;0;2000;1600;400;
2021-12-16 18:16:54;089686043051;INDOMIE COTO MAKASSAR;1;2800;0;2800;2525;275;
2021-12-16 18:16:54;8991102384841;WFR TANGO LONG CKLT 130G;3;5000;0;15000;13035;1965;
2021-12-16 18:16:54;8996001304129;SLAI OLAI STROBERI;1;12000;0;12000;9900;2100;
2021-12-16 18:16:54;8991102380805;FULLO  CKL PCK 8G;1;11000;0;11000;9900;1100;
2021-12-16 18:16:54;8996001301142;ROMA KELAPA;4;8000;0;32000;28000;4000;
2021-12-16 18:16:54;8998866202343;MIE SEDAAP KOREAN SPICY;5;3000;0;15000;12065;2935;
2021-12-16 18:16:54;8992775312414;GERY CHOCO HEZELNUT;1;11000;0;11000;9983;1017;
2021-12-16 18:16:54;8998989500166;GUDANG GARAM MERAH BESAR 16KS;2;18000;0;36000;34000;2000;
2021-12-16 18:16:54;8851019210292;POCKY 40 GR;1;7000;0;7000;5671;1329;
2021-12-16 18:16:54;8992959508305;SWEETY SILVER PANST L1;2;2500;0;5000;3764;1236;
2021-12-16 18:16:54;8998866109130;SHAMPOOZINC;11;1000;0;11000;3300;7700;
2021-12-16 18:16:54;8998866200578;MIE SEDAAP KARI KENTAL;2;2700;0;5400;4662;738;
2021-12-16 18:16:54;Garuda pilus pcs;Garuda pilus Rasa Mi Goreng pcs;1;1000;0;1000;808;192;
2021-12-16 18:16:54;8998009010569;ULTRA CHO 200;2;5000;0;10000;7916;2084;
2021-12-16 18:16:54;8991102714624;Tanggo Kido Drink 115ml;2;3000;0;6000;4000;2000;
2021-12-16 18:16:54;8998866203272;SUKSES AYAM GEPREK;1;4000;0;4000;3046;954;
2021-12-16 18:16:54;8992775315057;GERY SALUT MALKIST COKLAT;1;6500;0;6500;5516;984;
2021-12-16 18:16:54;JGR SHN;JOGER SHINY SACHET;2;500;0;1000;874;126;
2021-12-16 18:16:54;Garuda pilus;Garuda Pilus Pedas Pcs;6;500;0;3000;2448;552;
2021-12-16 18:16:54;8997028590045;ARGUS BTL 330ML;2;2000;0;4000;2582;1418;
2021-12-16 18:16:54;KIKO;KIKO;6;1000;0;6000;3000;3000;
2021-12-16 18:16:54;8996001328163;GULA GULA TAMARIN;8;250;0;2000;1600;400;
2021-12-16 18:16:54;9556001004673;MILO NESTLE MALAYSIA ACTIVE GO;1;85000;0;85000;80000;5000;
2021-12-16 18:16:54;8992761145033;FANTA STRAW PET 250ML;1;3500;0;3500;2417;1083;
2021-12-16 18:16:54;8994834006128;TICTIC PEDAS;1;2000;0;2000;1700;300;
2021-12-16 18:16:54;PRG;PARAGO;1;500;0;500;400;100;
2021-12-16 18:16:54;8998866202619;MIE SEDAAP KOREAN SPICY SOUP;2;2700;0;5400;4644;756;
2021-12-16 18:16:54;089686611878;QTELA TEMPE;1;6000;0;6000;5370;630;
2021-12-16 18:16:54;8997009460343;NEXI NET;2;1000;0;2000;1800;200;
2021-12-16 18:16:54;8997009461753;TOP ELIT;3;1000;0;3000;1200;1800;
2021-12-16 18:16:54;8997878004327;GULA GULA MILKITA;2;250;0;500;400;100;
2021-12-16 18:16:54;8999909001909;MAGNUM REVAMP BLACK 12;1;18000;0;18000;16300;1700;
2021-12-16 18:16:54;8997027300089;NOMOS;1;4000;0;4000;2963;1037;
2021-12-16 18:16:54;8998866202244;EKOMIE BUMBU KALDU AYAM;12;1000;0;12000;9576;2424;
2021-12-16 18:16:54;8992742360844;POLYTEX SABUT STENLESS;1;4000;0;4000;2200;1800;
2021-12-16 18:16:54;8991002105430;KOPI KAPAL API 65G;4;5000;0;20000;16580;3420;
2021-12-16 18:16:54;8996001600375;LE MINERAL 330ML;1;2000;0;2000;1417;583;
2021-12-16 18:16:54;8994867007161;ROKOK PENA GOLD 20;1;19000;0;19000;17400;1600;
2021-12-16 18:16:54;KERIPIK;KERIPIK UBI;1;2000;0;2000;1800;200;
2021-12-16 18:23:28;ROTI;ROTI 2000;2;2000;0;4000;3600;400;
2021-12-16 18:28:06;8999999195656;SARIWANGI 50X1.85;1;10000;0;10000;9405;595;
2021-12-16 18:28:06;8996001302316;MALKIST ABON SCT;3;1000;0;3000;2520;480;
2021-12-16 19:02:16;8992761111533;SPRITE SLIM CAM250ML;1;5000;0;5000;3750;1250;
2021-12-16 19:02:16;8886001038011;BENG-BENG SCT;2;1500;0;3000;2000;1000;
2021-12-16 19:05:25;8992761111533;SPRITE SLIM CAM250ML;1;5000;0;5000;3750;1250;
2021-12-16 19:05:25;8886013213208;FRENCH FREIS 2000;2;5000;0;10000;7500;2500;
2021-12-16 19:30:21;8999909010567;234 DJI SAM SOE 16;2;22500;0;45000;43000;2000;
2021-12-16 19:49:36;gula;GULA;1;11500;0;11500;10000;1500;
2021-12-16 19:49:36;8994191103638;GULA GULA KARET;1;500;0;500;400;100;
2021-12-16 20:03:08;PULPEN SNOWMAN;PULPEN SNOWMAN;1;2500;0;2500;2000;500;
2021-12-16 20:20:55;6907992825076;JD WATERMELON APPLE;1;2000;0;2000;1700;300;
2021-12-16 20:20:55;6907992823669;JD MILKY STRAW;1;3000;0;3000;2600;400;
2021-12-16 20:20:55;6907992824963;JD MILKY CHOCOLATE;1;3000;0;3000;2600;400;
2021-12-16 20:20:55;MARS;MARSHMELLOW;6;500;0;3000;2598;402;
2021-12-16 20:22:55;Vita Jelly;Vita Jelly;1;1000;0;1000;766;234;
2021-12-16 20:32:15;8998866202343;MIE SEDAAP KOREAN SPICY;2;3000;0;6000;4826;1174;
2021-12-16 20:32:15;8998866200301;MIE SEDAAP GORENG;4;3000;0;12000;9656;2344;
2021-12-16 20:32:15;8998989110167;SURYA GUDANG GARAM 16 FILTER;1;26000;0;26000;23700;2300;
2021-12-16 20:32:15;8991102228053;TEH GELAS BOTOL;1;3000;0;3000;1695;1305;
2021-12-16 20:34:59;089686021127;INTER MIE KALDU;5;1000;0;5000;4065;935;
2021-12-16 20:34:59;8998866202244;EKOMIE BUMBU KALDU AYAM;7;1000;0;7000;5586;1414;
2021-12-16 20:34:59;8992959508947;SWEETY SILVER PANTS XL 44;1;98000;0;98000;90152;7848;
2021-12-16 20:44:57;KIKO;KIKO;1;1000;0;1000;500;500;
2021-12-16 20:50:57;8997218380074;ICHITAN MILK TEA;1;8000;0;8000;6500;1500;
2021-12-16 20:55:33;8992979190986;TOTAL PUTIH SOFTENER;1;15000;0;15000;13524;1476;
2021-12-16 20:55:33;8999999707859;CLOSEUP GREEN 160G;1;15000;0;15000;13600;1400;
2021-12-16 20:55:33;8998866107464;POSH FRESH SPIRIT 150ML;1;19500;0;19500;17500;2000;
2021-12-16 20:55:33;8999999533717;CITRA TS FRESH WHITE 70G;2;2200;0;4400;3800;600;
2021-12-16 20:55:33;8999999048242;SUNSILK SHP SOFT&SMOOTH 9ML;1;11000;0;11000;9300;1700;
2021-12-16 21:06:44;8992696404441;SUSU BERUANG;1;13000;0;13000;8585;4415;
2021-12-16 21:06:44;8997009510055;YOU C1000;1;15000;0;15000;13000;2000;
2021-12-16 21:06:44;7622300335809;OREO SOFT CAKE;1;2000;0;2000;1641;359;
2021-12-16 21:46:12;8999909002821;MARLBORO BLACK 16;1;22000;0;22000;21000;1000;
2021-12-17 16:01:28;8996001600269;LE MINERAL 600ML;1;3000;0;3000;1688;1312;
2021-12-17 16:01:28;SURYA BTG;SURYA BATANG;3;1666;0;4998;4140;858;
2021-12-17 16:26:25;9556001025272;NESCAFE LATTE 240ML;1;8500;0;8500;7834;666;
2021-12-17 16:26:25;8886008101053;AQUA 600 ML;5;3500;0;17500;10625;6875;
2021-12-17 18:08:00;ROTI;ROTI 2000;2;2000;0;4000;3600;400;
2021-12-17 18:39:25;8991901101083;ROKOK CRYSTAL MERAH;1;16500;0;16500;14800;1700;
2021-12-17 18:39:25;RB;RED BOLD;2;20000;0;40000;37600;2400;
2021-12-17 18:39:25;8999909000773;MARLBORO BLACK 12;1;17000;0;17000;15950;1050;
2021-12-17 18:40:08;8999909982000;SAMPOERNA 12 FILTER;1;19000;0;19000;16600;2400;
2021-12-17 18:41:33;8996001600269;LE MINERAL 600ML;2;3000;0;6000;3376;2624;
2021-12-17 18:41:33;8994834003752;TICTIC;1;2000;0;2000;1700;300;
2021-12-17 18:41:33;8992761166038;MMP ORANGE 300ML;1;5000;0;5000;3750;1250;
2021-12-17 19:01:53;8999999559854;AXE BLACK POCKET FRAG 17ML;1;10000;0;10000;8000;2000;
2021-12-17 19:13:13;8993083929912;BISKITOP ASSORTED WAFER STICK;1;30000;0;30000;28400;1600;
2021-12-17 19:13:13;8993083929837;BISKITOP BLACK COOKIES;1;27000;0;27000;23700;3300;
2021-12-17 19:13:13;8998866202343;MIE SEDAAP KOREAN SPICY;2;3000;0;6000;4826;1174;
2021-12-17 19:14:51;8998989300261;GUDANG GARAM SURYA 12 FILTER;1;20000;0;20000;18150;1850;
2021-12-17 20:11:40;TG;TEH GELAS;3;1000;0;3000;2187;813;
2021-12-17 20:11:40;Vita Jelly;Vita Jelly;3;1000;0;3000;2298;702;
2021-12-17 21:09:37;8997013180046;Tissu Tessi B;1;11000;0;11000;9800;1200;
2021-12-17 21:09:37;MILKITA;MILKITA;4;250;0;1000;800;200;
2021-12-17 21:10:52;8996001600375;LE MINERAL 330ML;1;2000;0;2000;1417;583;
2021-12-17 21:15:41;76239878;MARLBORO GOLD;1;31000;0;31000;29650;1350;
2021-12-17 21:19:36;8998866610377;ISOPLUS;1;3000;0;3000;2350;650;
2021-12-17 21:21:38;6907992823867;JD CRUNCHY CHOCOLATE MALT;1;5500;0;5500;4700;800;
2021-12-17 21:29:23;8997028590045;ARGUS BTL 330ML;1;2000;0;2000;1291;709;
2021-12-17 21:29:23;8991102714891;Kopi Seruput susu tulen 200 ml;1;3000;0;3000;2375;625;
2021-12-17 21:53:03;ARG;ARGUS DOS 220ML;1;15000;0;15000;13500;1500;
2021-12-17 21:53:41;8999999538422;CLEAR SHP ICM UNISEX 55 ML;1;5000;0;5000;3750;1250;
2021-12-17 22:06:45;SURYA BTG;SURYA BATANG;3;1666;0;4998;4140;858;
2021-12-18 10:55:37;8998866107112;WET WIPES KODOMO  BABY 50SHT;1;10000;0;10000;14150;-4150;
2021-12-18 10:55:37;8992959508848;SWEETY SILVER PANTS L18;1;41500;0;41500;37728;3772;
2021-12-18 10:55:37;8997009510123;ORANGE WATER;3;8000;0;24000;18795;5205;
2021-12-18 10:55:37;8998127912370;DUNHILL 20;1;33000;0;33000;31500;1500;
2021-12-18 11:36:00;8993989311699;CLAS MILD 16 FILTER;1;24000;0;24000;21700;2300;
2021-12-18 11:42:21;8998666002525;TB TORA CAFE CAPPUCINO;1;1000;0;1000;780;220;
2021-12-18 11:42:21;KOPIKO;KOPIKO;4;250;0;1000;700;300;
2021-12-18 11:42:21;8992741952262;GULA GULA YUPI;4;250;0;1000;800;200;
2021-12-18 11:50:33;8995333060703;TERIGU KOMPAS 1KG;1;10500;0;10500;9816;684;
2021-12-18 11:51:25;6907992823973;JD PINEAPPLE;1;5000;0;5000;4300;700;
2021-12-18 12:05:10;SURYA BTG;SURYA BATANG;3;1666.6600000000001;0;4999.9800000000005;4140;859.98;
2021-12-18 12:48:43;8998866200301;MIE SEDAAP GORENG;1;3000;0;3000;2414;586;
2021-12-18 12:48:43;8994834003752;TICTIC;2;2000;0;4000;3400;600;
2021-12-18 14:51:44;8993989311699;CLAS MILD 16 FILTER;1;24000;0;24000;21700;2300;
2021-12-18 14:51:44;8997028590052;ARGUS BTL 600ML;2;3000;0;6000;2916;3084;
2021-12-18 14:51:44;8992761002039;FANTA STRAWBERRY PET 390 ML;1;5500;0;5500;4333;1167;
2021-12-18 15:04:38;SURYA BTG;SURYA BATANG;3;1666.6600000000001;0;4999.9800000000005;4140;859.98;
2021-12-18 15:23:38;8991914101513;VIPER KRETEK 12;1;6000;0;6000;5000;1000;
2021-12-18 15:23:39;8991102714624;Tanggo Kido Drink 115ml;2;3000;0;6000;4000;2000;
2021-12-18 16:56:59;8992628034159;BIMOLI SPESIAL 1 LT;1;21000;0;21000;19000;2000;
2021-12-18 17:25:04;KIKO;KIKO;2;1000;0;2000;1000;1000;
2021-12-18 17:35:56;8998989300261;GUDANG GARAM SURYA 12 FILTER;1;20000;0;20000;18150;1850;
2021-12-18 17:55:05;8991002103931;GOOD DAY CARREBIAN NUT;2;1500;0;3000;1780;1220;
2021-12-18 18:36:19;8886008101091;AQUA 1,5 ML;1;5500;0;5500;4600;900;
2021-12-18 18:37:22;KIKO;KIKO;1;1000;0;1000;500;500;
2021-12-18 18:37:22;8997028590014;ARGUS 220ML;4;500;0;2000;1208;792;
2021-12-18 18:37:22;KOPIKO;KOPIKO;8;250;0;2000;1400;600;
2021-12-18 18:37:30;6907992823829;JD MILKY MILK;1;3000;0;3000;2600;400;
2021-12-18 20:00:03;6907992824963;JD MILKY CHOCOLATE;1;3000;0;3000;2600;400;
2021-12-18 20:00:03;8996001600375;LE MINERAL 330ML;1;2000;0;2000;1417;583;
2021-12-18 20:00:03;8997028590014;ARGUS 220ML;4;500;0;2000;1208;792;
2021-12-18 20:15:40;KIKO;KIKO;3;1000;0;3000;1500;1500;
2021-12-18 20:15:40;8998989300261;GUDANG GARAM SURYA 12 FILTER;1;20000;0;20000;18150;1850;
2021-12-18 20:19:27;ROTI;ROTI 2000;2;2000;0;4000;3600;400;
2021-12-18 20:19:27;TG;TEH GELAS;1;1000;0;1000;729;271;
2021-12-18 20:31:35;6907992824963;JD MILKY CHOCOLATE;1;3000;0;3000;2600;400;
2021-12-18 20:31:35;TBR;TEPUNG BERAS ROSE BRAND;1;8000;0;8000;6150;1850;
2021-12-18 20:31:35;TG;TEH GELAS;1;1000;0;1000;729;271;
2021-12-18 20:31:35;Vita Jelly;Vita Jelly;1;1000;0;1000;766;234;
2021-12-18 20:38:27;8999801700030;SUSU FOYU;1;11500;0;11500;10450;1050;
2021-12-18 20:57:29;8995333032113;TERIGU GATOT KACA 1 KG;4;9000;0;36000;34288;1712;
2021-12-18 20:57:29;gula;GULA;1;11500;0;11500;10000;1500;
2021-12-18 21:28:36;123124;KOREK BIASA;1;2000;0;2000;1300;700;
2021-12-18 21:28:36;8997028590052;ARGUS BTL 600ML;1;3000;0;3000;1458;1542;
2021-12-18 21:42:43;8992979190986;TOTAL PUTIH SOFTENER;1;15000;0;15000;13524;1476;
2021-12-18 21:42:43;8999999390198;SUNLIGHT LIME NEW POUCH 755ML;1;18000;0;18000;15950;2050;
2021-12-18 22:08:50;8993007003063;ENAAK 500G;1;11000;0;11000;9625;1375;
2021-12-18 22:08:50;8998989110167;SURYA GUDANG GARAM 16 FILTER;1;26000;0;26000;23700;2300;
2021-12-18 22:08:50;8998866609180;SOKLIN SOFTERGENT POUCH 750ML;1;18000;0;18000;16435;1565;
2021-12-18 22:08:50;8998866612173;SOKLIN SOFTERGENT PINK 770G & PIRING;1;20000;0;20000;18055;1945;
2021-12-18 22:08:50;8991102026383;AIR CRYSTALINE 1.5 L;1;5000;0;5000;3471;1529;
2021-12-18 22:13:31;8998866200301;MIE SEDAAP GORENG;2;3000;0;6000;4828;1172;
2021-12-18 22:13:31;8998866200325;MIE SEDAAP SOTO;2;2700;0;5400;4564;836;
2021-12-18 22:13:31;8998866202244;EKOMIE BUMBU KALDU AYAM;15;1000;0;15000;11970;3030;
2021-12-18 22:13:31;gula gula;gula-gula karet;1;500;0;500;400;100;
2021-12-18 22:21:39;8998989110167;SURYA GUDANG GARAM 16 FILTER;1;26000;0;26000;23700;2300;
2021-12-19 11:41:40;8998866202619;MIE SEDAAP KOREAN SPICY SOUP;1;2700;0;2700;2322;378;
2021-12-19 11:41:40;8998866202343;MIE SEDAAP KOREAN SPICY;1;3000;0;3000;2413;587;
2021-12-19 12:27:19;BALON;BALON CABUT;4;1000;0;4000;3600;400;
2021-12-19 12:42:45;8997028590014;ARGUS 220ML;4;500;0;2000;1208;792;
2021-12-19 13:30:28;8991102024099;FORMULA CURVE;1;5000;0;5000;3000;2000;
2021-12-19 13:36:21;4902430563864;shampo pantene;1;1000;0;1000;750;250;
2021-12-19 13:36:21;8998866605137;CLING BIRU POUCH 425ML;1;4000;0;4000;3250;750;
2021-12-19 14:03:01;8886467100017;PRINGLES;1;20000;0;20000;19000;1000;
2021-12-19 14:03:01;8991102587648;TANGO TIRAMISU POUCH 115G;1;8000;0;8000;6874;1126;
2021-12-19 14:03:01;Vita Jelly;Vita Jelly;1;1000;0;1000;766;234;
2021-12-19 14:03:32;8998989100120;GUDANG GARAM MINI;1;19000;0;19000;16600;2400;
2021-12-19 14:03:32;8998989300261;GUDANG GARAM SURYA 12 FILTER;4;20000;0;80000;72600;7400;
2021-12-19 14:13:53;8991102384841;WFR TANGO LONG CKLT 130G;1;5000;0;5000;4333;667;
2021-12-19 14:13:53;8991102989381;TANGO LONG BUBBLEGUM 130G;1;5000;0;5000;4350;650;
2021-12-19 14:44:28;76164217;MARLBORO MERAH;1;31000;0;31000;29650;1350;
2021-12-19 15:09:47;8886030322907;PORSTEX BIRU 500ML;1;15500;0;15500;13000;2500;
2021-12-19 15:09:47;8999999524722;SUNLIGHT LIME NEW PCH 435ML;1;10000;0;10000;9100;900;
2021-12-19 15:09:47;8886020001126;SWALLOW KAMP WHITE 150G;1;14000;0;14000;13000;1000;
2021-12-19 15:09:47;8934868015031;REXONA DEO LOTION ICE COOL;2;4500;0;9000;7800;1200;
2021-12-20 21:06:17;8886008101053;AQUA 600 ML;2;3500;0;7000;4250;2750;
2021-12-20 21:30:16;8999999528805;CITRA HBL PEARLY WHITE UV 230ML;1;20000;0;20000;18040;1960;
2021-12-20 21:30:16;8999999036836;LUX BW VELVET JASMINE LD REFF 450 ML;1;25000;0;25000;22110;2890;
2021-12-20 21:30:16;8991102384841;WFR TANGO LONG CKLT 130G;1;5000;0;5000;4333;667;
2021-12-20 21:56:54;8999999502409;ROYCO FDS BEEF 9G;2;500;0;1000;750;250;
2021-12-20 22:01:50;ROTI;ROTI 2000;1;2000;0;2000;1800;200;
2021-12-20 22:18:52;6907992825076;JD WATERMELON APPLE;1;2000;0;2000;1700;300;
2021-12-20 22:18:52;6907992824963;JD MILKY CHOCOLATE;1;3000;0;3000;2600;400;
2021-12-20 22:18:52;MK BIASA;MASKERBIASA;1;2000;0;2000;1500;500;
2021-12-20 22:18:52;CB;CANNON BALL PCS;2;500;0;1000;750;250;
2021-12-20 22:18:52;JELLY;JELLY AGAR;1;1000;0;1000;900;100;
2021-12-20 22:18:52;8999909001909;MAGNUM REVAMP BLACK 12;1;18000;0;18000;16300;1700;
2021-12-20 22:18:52;ARG;ARGUS DOS 220ML;1;15000;0;15000;13500;1500;
2021-12-20 22:18:52;8998866203272;SUKSES AYAM GEPREK;2;4000;0;8000;6092;1908;
2021-12-20 22:18:52;8997028590014;ARGUS 220ML;5;500;0;2500;1510;990;
2021-12-20 22:18:52;8991914101513;VIPER KRETEK 12;2;6000;0;12000;10000;2000;
2021-12-20 22:18:52;8998866200325;MIE SEDAAP SOTO;2;2700;0;5400;4564;836;
2021-12-20 22:18:52;KPS;KAPAS MEI QIAN;1;5000;0;5000;4750;250;
2021-12-20 22:18:52;8998989110129;SURYA KECIL MERAH 12KS;1;20000;0;20000;18450;1550;
2021-12-20 22:18:52;8997028590045;ARGUS BTL 330ML;3;2000;0;6000;3873;2127;
2021-12-20 22:18:52;KIKO;KIKO;2;1000;0;2000;1000;1000;
2021-12-20 22:27:39;8999999533717;CITRA TS FRESH WHITE 70G;1;2200;0;2200;1900;300;
2021-12-20 22:27:39;4902430563888;SHAMPO PANTENE;1;1000;0;1000;750;250;
2021-12-20 22:27:39;ARG;ARGUS DOS 220ML;1;15000;0;15000;13500;1500;
2021-12-20 22:27:39;KIKO;KIKO;3;1000;0;3000;1500;1500;
2021-12-20 22:27:39;MBL;MOBIL;2;5000;0;10000;7000;3000;
2021-12-20 22:27:39;BALON GAS;BALON GAS;6;500;0;3000;2400;600;
2021-12-20 22:27:39;ES POTONG;ES POTONG;2;1000;0;2000;1000;1000;
2021-12-20 22:27:39;8993154789575;GULA GULA TUSUK;2;500;0;1000;800;200;
2021-12-20 22:27:39;6907992823966;JD BLUEBERRY;1;3500;0;3500;3000;500;
2021-12-20 22:27:39;TG;TEH GELAS;2;1000;0;2000;1458;542;
2021-12-20 22:27:39;8991102714891;Kopi Seruput susu tulen 200 ml;1;3000;0;3000;2375;625;
2021-12-20 22:27:39;8993470411433;JOGER CLASSIC;1;1000;0;1000;850;150;
2021-12-20 22:27:39;8993470671752;JOGER STICK DUO KACANG;1;1000;0;1000;850;150;
2021-12-20 22:27:39;8991102714846;MILKIDO CKLT;1;3000;0;3000;2153;847;
2021-12-20 22:27:39;8998866202244;EKOMIE BUMBU KALDU AYAM;1;1000;0;1000;798;202;
2021-12-20 22:27:39;089686021127;INTER MIE KALDU;1;1000;0;1000;813;187;
2021-12-20 22:36:26;8999999533717;CITRA TS FRESH WHITE 70G;1;2200;0;2200;1900;300;
2021-12-20 22:36:26;VTM;VITAMIN CIMIN;1;500;0;500;425;75;
2021-12-20 22:36:26;8991102987639;WFR TANGO LONG VNL 130G;1;5000;0;5000;4350;650;
2021-12-20 22:36:26;8991102714860;MILKIDO STRAW;2;3000;0;6000;4306;1694;
2021-12-20 22:36:26;8993154789575;GULA GULA TUSUK;40;500;0;20000;16000;4000;
2021-12-20 22:36:26;8996001600269;LE MINERAL 600ML;1;3000;0;3000;1688;1312;
2021-12-20 22:36:26;kiko;kiko;3;1000;0;3000;2700;300;
2021-12-20 22:36:26;8998866202619;MIE SEDAAP KOREAN SPICY SOUP;1;2700;0;2700;2322;378;
2021-12-20 22:36:26;8997028590014;ARGUS 220ML;4;500;0;2000;1208;792;
2021-12-20 22:36:26;8992979120013;TOTAL BUNGA SOFTENER;1;15000;0;15000;13800;1200;
2021-12-20 22:36:26;4902430803380;DOWNY FLORAL PINK 10ML;10;500;0;5000;3930;1070;
2021-12-20 22:36:26;SURYA BTG;SURYA BATANG;6;1500;0;9000;8280;720;
2021-12-20 22:36:26;ES POTONG;ES POTONG;1;1000;0;1000;500;500;
2021-12-20 22:36:26;8992717781025;SANTAN KELAPA;1;4000;0;4000;3000;1000;
2021-12-20 22:36:26;CB;CANNON BALL PCS;2;500;0;1000;750;250;
2021-12-20 22:37:30;KPS;KAPAS MEI QIAN;1;5000;0;5000;4750;250;
2021-12-20 22:45:44;SURYA BTG;SURYA BATANG;3;1500;0;4500;4140;360;
2021-12-20 22:45:44;089686021141;INTER MIE SOTO;2;1000;0;2000;1708;292;
2021-12-20 22:45:44;6907992823867;JD CRUNCHY CHOCOLATE MALT;1;5500;0;5500;4700;800;
2021-12-20 22:45:44;RT 1000;ROTI 1000;1;1000;0;1000;800;200;
2021-12-20 22:45:44;8995555111221;SOSIS KIMBO;1;1000;0;1000;850;150;
2021-12-20 22:45:44;8999999050009;SUNLIGHT LIME NEW POUCH 95ML;1;2000;0;2000;1600;400;
2021-12-20 22:45:44;8992761166052;FRESTEA MELATI 350ML;1;4500;0;4500;3000;1500;
2021-12-20 22:45:44;8999909982000;SAMPOERNA 12 FILTER;1;19000;0;19000;16600;2400;
2021-12-20 22:45:44;4902430563888;SHAMPO PANTENE;1;1000;0;1000;750;250;
2021-12-20 22:45:44;8998989110167;SURYA GUDANG GARAM 16 FILTER;1;26000;0;26000;23700;2300;
2021-12-21 20:53:46;8999909010567;234 DJI SAM SOE 16;1;22500;0;22500;21500;1000;
2021-12-21 21:06:16;8997028590014;ARGUS 220ML;4;500;0;2000;1208;792;
2021-12-21 21:29:56;8996001600375;LE MINERAL 330ML;6;2000;0;12000;8502;3498;
2021-12-21 22:07:10;8997009510123;ORANGE WATER;1;8000;0;8000;6265;1735;
2021-12-21 22:20:59;8999909096004;SAMPOERNA 16 FILTER;1;25000;0;25000;23100;1900;
2021-12-22 20:08:07;8999909002821;MARLBORO BLACK 16;1;22000;0;22000;21000;1000;
2021-12-22 20:08:07;MK;MASKER;1;5000;0;5000;4000;1000;
2021-12-22 20:19:24;8997210107877;VORTEX SMART 3;1;5000;0;5000;4750;250;
2021-12-22 20:19:24;6907992823966;JD BLUEBERRY;1;3500;0;3500;3000;500;
2021-12-22 20:19:24;ROTI;ROTI 2000;1;2000;0;2000;1800;200;
2021-12-22 20:19:24;8998866203227;MIE SEDAAP AYAM BAKAR LIMAU;1;2700;0;2700;2163;537;
2021-12-22 20:19:24;8992775001653;GERY SALUT CHOCOLATE COCONUT;1;2000;0;2000;1476;524;
2021-12-22 20:19:24;8997028590014;ARGUS 220ML;4;500;0;2000;1208;792;
2021-12-22 20:19:24;SURYA BTG;SURYA BATANG;3;2000;0;6000;4140;1860;
2021-12-22 20:19:24;8998989300261;GUDANG GARAM SURYA 12 FILTER;2;20000;0;40000;36300;3700;
2021-12-22 20:19:24;8998866200325;MIE SEDAAP SOTO;2;2700;0;5400;4564;836;
2021-12-22 20:19:24;BALON;BALON CABUT;7;1000;0;7000;6300;700;
2021-12-22 20:19:24;8993989311699;CLAS MILD 16 FILTER;1;24000;0;24000;21700;2300;
2021-12-22 20:19:24;4902430401142;PANTENE HAIRFALL 70ML;1;12500;0;12500;11439;1061;
2021-12-22 20:21:15;8998866200301;MIE SEDAAP GORENG;2;3000;0;6000;4828;1172;
2021-12-22 20:29:30;8992775315057;GERY SALUT MALKIST COKLAT;1;6500;0;6500;5516;984;
2021-12-22 20:29:30;8992628022156;MINYAK GORENG BIMOLI POUCH 1 LT;1;18000;0;18000;16675;1325;
2021-12-22 20:29:30;8997012030748;MADU ENAK;2;1000;0;2000;1800;200;
2021-12-22 20:29:30;089686727081;DORITOS 55G;1;7000;0;7000;5950;1050;
2021-12-22 20:29:30;TG MARKISA;TEH GELAS MARKISA;1;2000;0;2000;1178;822;
2021-12-22 20:29:30;8992741952262;GULA GULA YUPI;4;250;0;1000;800;200;
2021-12-22 20:29:30;8994867007161;ROKOK PENA GOLD 20;1;19000;0;19000;17400;1600;
2021-12-22 20:29:30;KOPIKO;KOPIKO;4;250;0;1000;700;300;
2021-12-22 20:29:30;8998866203227;MIE SEDAAP AYAM BAKAR LIMAU;1;2700;0;2700;2163;537;
2021-12-22 20:29:30;8998866200325;MIE SEDAAP SOTO;1;2700;0;2700;2282;418;
2021-12-22 20:29:30;8998866202237;NOODLE SEDAAP TASTY AYAM GEPREK 124 GR;1;5000;0;5000;4167;833;
2021-12-22 20:29:30;8991102714891;Kopi Seruput susu tulen 200 ml;1;3000;0;3000;2375;625;
2021-12-22 20:29:30;8991102714860;MILKIDO STRAW;1;3000;0;3000;2153;847;
2021-12-22 20:29:30;8997028590014;ARGUS 220ML;2;500;0;1000;604;396;
2021-12-22 20:29:30;kiko;kiko;1;1000;0;1000;900;100;
2021-12-22 20:29:30;8994867000179;ROKOK PENA MILD 16;1;15500;0;15500;14500;1000;
2021-12-22 20:37:39;8992702000063;INDOMILK COKLAT 370G;2;10000;0;20000;18416;1584;
2021-12-22 20:37:39;8996001314005;ROMA KELAPA CREAM CKLT;2;8000;0;16000;13284;2716;
2021-12-22 20:37:39;MK BIASA;MASKERBIASA;1;2000;0;2000;1500;500;
2021-12-22 20:37:39;SURYA BTG;SURYA BATANG;3;2000;0;6000;4140;1860;
2021-12-22 20:37:39;8997028590014;ARGUS 220ML;2;500;0;1000;604;396;
2021-12-22 20:37:39;8993154789575;GULA GULA TUSUK;2;500;0;1000;800;200;
2021-12-22 20:37:39;8996001302323;MALKIST ABON;1;6500;0;6500;4800;1700;
2021-12-22 20:37:39;6907992823850;JD CHOCO CIRLE;1;5500;0;5500;4700;800;
2021-12-22 20:37:39;8999909003873;MARLBORO ADVANCE 12;1;17000;0;17000;15750;1250;
2021-12-22 20:37:39;089686535044;SUN BERAS MERAH;1;8500;0;8500;7410;1090;
2021-12-22 20:37:39;8997218380159;ICHITAN BROWN SUGAR;1;8000;0;8000;6500;1500;
2021-12-22 20:37:39;089686535242;SUN PISANG SUSU;1;8500;0;8500;7410;1090;
2021-12-22 20:37:39;BALON;BALON CABUT;3;1000;0;3000;2700;300;
2021-12-22 20:45:42;8992856892507;VITALIS PINK 120ML;1;22000;0;22000;19900;2100;
2021-12-22 20:45:42;kiko;kiko;1;1000;0;1000;900;100;
2021-12-22 20:45:42;BALON;BALON CABUT;10;1000;0;10000;9000;1000;
2021-12-22 20:45:42;SURYA BTG;SURYA BATANG;6;2000;0;12000;8280;3720;
2021-12-22 20:45:42;8996001305041;ROMA SANDWICH CKLT;2;7000;0;14000;11856;2144;
2021-12-22 20:45:42;9556001004673;MILO NESTLE MALAYSIA ACTIVE GO;1;85000;0;85000;76000;9000;
2021-12-22 20:45:42;6907992823829;JD MILKY MILK;1;3000;0;3000;2600;400;
2021-12-22 20:45:42;6907992823669;JD MILKY STRAW;1;3000;0;3000;2600;400;
2021-12-22 20:45:42;8992761111533;SPRITE SLIM CAM250ML;1;5000;0;5000;3750;1250;
2021-12-22 20:45:42;8998866200301;MIE SEDAAP GORENG;3;3000;0;9000;7242;1758;
2021-12-22 20:45:42;8992959508879;SWEETY SILVER PANTS L7;1;17000;0;17000;15228;1772;
2021-12-22 20:45:42;ARG;ARGUS DOS 220ML;1;15000;0;15000;13500;1500;
2021-12-22 20:45:42;ROTI;ROTI 2000;3;2000;0;6000;5400;600;
2021-12-22 20:58:14;8993989311699;CLAS MILD 16 FILTER;1;24000;0;24000;21700;2300;
2021-12-22 20:58:14;8991102228053;TEH GELAS BOTOL;1;3000;0;3000;1695;1305;
2021-12-22 20:58:14;6907992823867;JD CRUNCHY CHOCOLATE MALT;1;5500;0;5500;4700;800;
2021-12-22 20:58:14;8991102320184;TANGO CHOCO JAVAMOCCA;1;5000;0;5000;4350;650;
2021-12-22 20:58:14;8992628020152;MINYAK GOREG BIMOLI POUCH 2L;1;35000;0;35000;29800;5200;
2021-12-22 20:58:14;8998866203227;MIE SEDAAP AYAM BAKAR LIMAU;2;2700;0;5400;4326;1074;
2021-12-22 20:58:14;8998866200301;MIE SEDAAP GORENG;1;3000;0;3000;2414;586;
2021-12-22 20:58:14;8998989300261;GUDANG GARAM SURYA 12 FILTER;1;20000;0;20000;18150;1850;
2021-12-22 20:58:14;8998866200882;SUKSESMIE GORENG AYAM KRMS 133GR;1;3500;0;3500;3047;453;
2021-12-22 20:58:14;8992775211410;PILUS GARUDA PEDAS;1;5000;0;5000;4886;114;
2021-12-22 20:58:14;8997028590014;ARGUS 220ML;8;500;0;4000;2416;1584;
2021-12-22 20:58:14;8992736220802;Sasa Bumbu Nasi Goreng sambal matah;1;2000;0;2000;1181;819;
2021-12-22 20:58:14;MK;MASKER;2;5000;0;10000;8000;2000;
2021-12-22 20:58:14;8991102714860;MILKIDO STRAW;1;3000;0;3000;2153;847;
2021-12-22 20:59:05;8992628020152;MINYAK GOREG BIMOLI POUCH 2L;1;35000;0;35000;29800;5200;
2021-12-22 21:09:37;8995333032113;TERIGU GATOT KACA 1 KG;2;9000;0;18000;17144;856;
2021-12-22 21:09:37;BALON;BALON CABUT;12;1000;0;12000;10800;1200;
2021-12-22 21:09:37;8999999192150;ROYCO FDS CHICKEN 100GR;1;5000;0;5000;4300;700;
2021-12-22 21:09:37;ARG;ARGUS DOS 220ML;1;15000;0;15000;13500;1500;
2021-12-22 21:09:37;8992696404441;SUSU BERUANG;1;13000;0;13000;8585;4415;
2021-12-22 21:09:37;8996001312278;MALKIST KEJU MANIS;1;6500;0;6500;5400;1100;
2021-12-22 21:09:37;MBL;MOBIL;1;5000;0;5000;3500;1500;
2021-12-22 21:09:37;kiko;kiko;3;1000;0;3000;2700;300;
2021-12-22 21:09:37;MTR;MOTOR;1;5000;0;5000;3500;1500;
2021-12-22 21:09:37;6907992823973;JD PINEAPPLE;1;5000;0;5000;4300;700;
2021-12-22 21:09:37;balon air;balon air;3;2000;0;6000;5100;900;
2021-12-22 21:09:37;8997012321204;MAXX BUMBU BALADO;1;5000;0;5000;4100;900;
2021-12-22 21:09:37;8998866202237;NOODLE SEDAAP TASTY AYAM GEPREK 124 GR;1;5000;0;5000;4167;833;
2021-12-22 21:09:37;8995333000822;TERIGU KOMPAS SOFT 500GR;3;5500;0;16500;14901;1599;
2021-12-22 21:09:37;8998989500166;GUDANG GARAM MERAH BESAR 16KS;2;18000;0;36000;34000;2000;
2021-12-22 21:11:50;8993007001557;INDOMILK SKM 37G;2;1500;0;3000;2162;838;
2021-12-22 21:11:50;ROTI;ROTI 2000;2;2000;0;4000;3600;400;
2021-12-22 21:11:50;8997028590014;ARGUS 220ML;2;500;0;1000;604;396;
2021-12-22 21:17:24;Garuda pilus;Garuda Pilus Pedas Pcs;2;500;0;1000;816;184;
2021-12-22 21:18:34;8993989311279;CLAS MILD 12;1;18000;0;18000;15800;2200;
2021-12-22 21:27:16;gula;GULA;2;11500;0;23000;20000;3000;
2021-12-22 22:00:43;TS;TISSUE TESSY;1;5000;0;5000;4200;800;
2021-12-22 22:39:32;8996001320068;GULA GULA KOPIKO;4;250;0;1000;800;200;
2021-12-22 22:39:32;8993989311699;CLAS MILD 16 FILTER;1;24000;0;24000;21700;2300;
2021-12-22 22:39:32;8999999008475;SUNLIGHT LIME NEW REF 1600ML;1;35000;0;35000;31955;3045;
2021-12-22 22:39:32;8998866202671;NOODLE SEDAAP MIE KOREAN SPICY SOUP CUP;1;5000;0;5000;4002;998;
2021-12-22 22:39:32;8992959117583;SOFTEX DAUN SIRIH;1;5000;0;5000;4288;712;
2021-12-22 22:39:32;8998866603546;SOKLIN FLOORCLENER UNGU 450ML;1;7000;0;7000;6385;615;
2021-12-22 22:39:32;BALON GAS;BALON GAS;4;500;0;2000;1600;400;
2021-12-22 22:39:32;balon air;balon air;1;2000;0;2000;1700;300;
2021-12-22 22:39:32;8992730950194;GULA GULA KOIN;2;500;0;1000;800;200;
2021-12-22 22:39:32;6907992825069;JD FRUITY;1;5000;0;5000;4400;600;
2021-12-22 22:39:32;4902430542753;PARFUM DOWNY;5;1000;0;5000;3750;1250;
2021-12-22 22:39:32;8999999059781;SUNLIGHT LIME NEW POUCH 210ML;1;5000;0;5000;4520;480;
2021-12-22 22:39:32;8992696404441;SUSU BERUANG;1;13000;0;13000;8585;4415;
2021-12-22 22:39:32;8992946521416;SABUN SHINZUI;2;5000;0;10000;8000;2000;
2021-12-22 22:39:32;4902430566889;SHAMPO HEAD & SHOULDERS;11;1000;0;11000;8580;2420;
2021-12-22 22:41:47;089686044249;SUPERMI NUTRIMI STEAK AYAM;3;3500;0;10500;8400;2100;
2021-12-22 22:41:47;8991102387286;TANGO LONG CKLT 47G;5;2000;0;10000;7970;2030;
2021-12-23 20:53:50;8991909101016;URBAN MILD 16;1;17000;0;17000;15800;1200;
2021-12-23 21:04:18;8995555111221;SOSIS KIMBO;4;1000;0;4000;3400;600;
2021-12-23 21:04:18;Garuda Pilus;Garuda Pilus Rasa Abon Pcs;3;500;0;1500;1203;297;
2021-12-23 21:04:18;8996001600375;LE MINERAL 330ML;2;2000;0;4000;2834;1166;
2021-12-23 21:04:18;8991001243034;TOP 9G;1;1000;0;1000;820;180;
2021-12-23 21:04:18;CB;CANNON BALL PCS;2;500;0;1000;750;250;
2021-12-23 21:04:18;8999909002821;MARLBORO BLACK 16;1;22000;0;22000;21000;1000;
2021-12-23 21:04:18;8991906105758;ROKOK LA BOLD;1;26000;0;26000;24900;1100;
2021-12-23 21:04:18;8886008101053;AQUA 600 ML;3;3500;0;10500;6375;4125;
2021-12-23 21:04:18;089686646047;SUNMARIE;1;7000;0;7000;6626;374;
2021-12-23 21:04:18;8996001305058;ROMA SANDWICH KACANG;1;7000;0;7000;5928;1072;
2021-12-23 21:04:18;balon air;balon air;1;1000;0;1000;1700;-700;
2021-12-23 21:04:18;8991909101016;URBAN MILD 16;1;17000;0;17000;15800;1200;
2021-12-23 21:04:18;MK;MASKER;1;5000;0;5000;4000;1000;
2021-12-23 21:04:18;ARG;ARGUS DOS 220ML;1;15000;0;15000;13500;1500;
2021-12-23 21:04:18;8992222050418;GATSBY NORMAL 38GR;1;5000;0;5000;3850;1150;
2021-12-23 21:21:09;089686021127;INTER MIE KALDU;1;1000;0;1000;813;187;
2021-12-23 21:21:09;8997028590014;ARGUS 220ML;12;500;0;6000;3624;2376;
2021-12-23 21:21:09;8998866200301;MIE SEDAAP GORENG;3;3000;0;9000;7242;1758;
2021-12-23 21:21:09;8992775211434;PILUS GARUDA SAPI PANGGANG;2;5000;0;10000;9620;380;
2021-12-23 21:21:09;8991102384841;WFR TANGO LONG CKLT 130G;1;5000;0;5000;4333;667;
2021-12-23 21:21:09;ROTI;ROTI 2000;2;2000;0;4000;3600;400;
2021-12-23 21:21:09;8993226365522;GARAM MEJA GYURI 200GR;1;2000;0;2000;1700;300;
2021-12-23 21:21:09;8999999390198;SUNLIGHT LIME NEW POUCH 755ML;1;18000;0;18000;15950;2050;
2021-12-23 21:21:09;8998989300261;GUDANG GARAM SURYA 12 FILTER;1;20000;0;20000;18150;1850;
2021-12-23 21:21:09;8998989100120;GUDANG GARAM MINI;1;19000;0;19000;16600;2400;
2021-12-23 21:21:09;8997028590052;ARGUS BTL 600ML;3;3000;0;9000;4374;4626;
2021-12-23 21:21:09;089686060027;POP MIE AYAM JUMBO;2;4500;0;9000;7666;1334;
2021-12-23 21:21:09;8886001038011;BENG-BENG SCT;2;1500;0;3000;2000;1000;
2021-12-23 21:21:09;6907992823867;JD CRUNCHY CHOCOLATE MALT;1;5500;0;5500;4700;800;
2021-12-23 21:21:09;6907992823966;JD BLUEBERRY;1;3500;0;3500;3000;500;
2021-12-23 21:30:39;8993154789575;GULA GULA TUSUK;1;500;0;500;400;100;
2021-12-23 21:30:39;8998989300261;GUDANG GARAM SURYA 12 FILTER;1;20000;0;20000;18150;1850;
2021-12-23 21:30:39;8997028590014;ARGUS 220ML;6;500;0;3000;1812;1188;
2021-12-23 21:30:39;kiko;kiko;2;1000;0;2000;1800;200;
2021-12-23 21:30:39;gula;GULA;1;11500;0;11500;10000;1500;
2021-12-23 21:30:39;8997018720469;TISSUE SE-KA;1;10000;0;10000;9300;700;
2021-12-23 21:30:39;8992959117583;SOFTEX DAUN SIRIH;1;5000;0;5000;4288;712;
2021-12-23 21:30:39;SURYA BTG;SURYA BATANG;2;2000;0;4000;2760;1240;
2021-12-23 21:30:39;123124;KOREK BIASA;1;2000;0;2000;1300;700;
2021-12-23 21:30:39;089686021141;INTER MIE SOTO;3;1000;0;3000;2562;438;
2021-12-23 21:30:39;ROTI;ROTI 2000;1;2000;0;2000;1800;200;
2021-12-23 21:30:39;8995333060772;TERIGU GATOT KACA 500GR;1;5000;0;5000;4346;654;
2021-12-23 21:30:39;8995333032113;TERIGU GATOT KACA 1 KG;2;9000;0;18000;17144;856;
2021-12-23 21:30:39;8997012321204;MAXX BUMBU BALADO;1;5000;0;5000;4100;900;
2021-12-23 21:30:39;8999999538439;CLEAR SHP CSC UNISEX 55ML;1;5000;0;5000;3750;1250;
2021-12-23 21:31:07;ROTI;ROTI 2000;5;2000;0;10000;9000;1000;
2021-12-23 21:45:01;8998866200882;SUKSESMIE GORENG AYAM KRMS 133GR;1;3500;0;3500;3047;453;
2021-12-23 21:45:01;8998866202619;MIE SEDAAP KOREAN SPICY SOUP;1;2700;0;2700;2322;378;
2021-12-23 21:45:01;089686611519;QTELA SINGKONG;1;5000;0;5000;4266;734;
2021-12-23 21:45:01;8998866202954;Guribee BBQ Balado 68 gr;1;6000;0;6000;5100;900;
2021-12-23 21:45:01;8998866201490;POTABEE REGULER GRILLED SEAWED 68 GR;1;8000;0;8000;7200;800;
2021-12-23 21:45:01;8991102384841;WFR TANGO LONG CKLT 130G;1;5000;0;5000;4333;667;
2021-12-23 21:45:01;8991002121003;GOOD DAY TIRAMISU BLISS;1;6000;0;6000;4295;1705;
2021-12-23 21:45:01;8998866203272;SUKSES AYAM GEPREK;1;4000;0;4000;3046;954;
2021-12-23 21:45:01;8991111112091;C&C DAILY PORE CLEANSER;1;22000;0;22000;19900;2100;
2021-12-23 21:45:01;ROTI;ROTI 2000;1;2000;0;2000;1800;200;
2021-12-23 21:45:01;8992717900310;KARA SUN;1;2500;0;2500;2000;500;
2021-12-23 21:45:01;8993007001359;INDOMILK KM SCT 37G;1;1500;0;1500;1083;417;
2021-12-23 21:45:01;JD VM;JD VANILLA MILKSHAKE;1;5000;0;5000;4300;700;
2021-12-23 21:45:01;8996001600375;LE MINERAL 330ML;1;2000;0;2000;1417;583;
2021-12-23 21:45:01;7622300335809;OREO SOFT CAKE;1;2000;0;2000;1641;359;
2021-12-23 21:52:07;089686044249;SUPERMI NUTRIMI STEAK AYAM;1;3500;0;3500;2800;700;
2021-12-23 21:52:07;8998866202770;MIE SEDAAP SALERO PADANG;1;2500;0;2500;2362;138;
2021-12-23 21:52:07;8991102387286;TANGO LONG CKLT 47G;3;2000;0;6000;4782;1218;
2021-12-23 21:52:07;8992775315057;GERY SALUT MALKIST COKLAT;1;6500;0;6500;5516;984;
2021-12-23 21:52:07;8998866200882;SUKSESMIE GORENG AYAM KRMS 133GR;2;3500;0;7000;6094;906;
2021-12-23 21:52:07;8998866200325;MIE SEDAAP SOTO;2;2700;0;5400;4564;836;
2021-12-23 21:52:07;8992770033178;Masako;4;500;0;2000;1800;200;
2021-12-23 21:52:07;8992770034175;MASAKO;1;5000;0;5000;4000;1000;
2021-12-23 21:52:07;8999999059781;SUNLIGHT LIME NEW POUCH 210ML;1;5000;0;5000;4520;480;
2021-12-23 21:52:07;8993989311699;CLAS MILD 16 FILTER;1;24000;0;24000;21700;2300;
2021-12-23 21:52:07;8991188943536;SASA SANTAN KELAPA 65ML;1;3000;0;3000;2437;563;
2021-12-23 21:52:07;8999909010567;234 DJI SAM SOE 16;1;22500;0;22500;21500;1000;
2021-12-23 21:52:07;8992628020152;MINYAK GOREG BIMOLI POUCH 2L;1;35000;0;35000;29800;5200;
2021-12-23 21:52:07;8992959953129;SWEETY BRONZE M20;1;35000;0;35000;33020;1980;
2021-12-23 21:52:07;ARG;ARGUS DOS 220ML;6;15000;0;90000;81000;9000;
2021-12-23 22:00:19;8992696521797;MILO 22G;1;2500;0;2500;1572;928;
2021-12-23 22:00:19;089686611519;QTELA SINGKONG;1;5000;0;5000;4266;734;
2021-12-23 22:00:19;8998866202404;NOODLE SEDAAP MIE KOREAN SPICY CHICKEN CUP;1;5000;0;5000;4002;998;
2021-12-23 22:00:19;8998866202619;MIE SEDAAP KOREAN SPICY SOUP;2;2700;0;5400;4644;756;
2021-12-23 22:00:19;kiko;kiko;4;1000;0;4000;3600;400;
2021-12-23 22:00:19;TG;TEH GELAS;1;1000;0;1000;729;271;
2021-12-23 22:00:19;ARG;ARGUS DOS 220ML;1;15000;0;15000;13500;1500;
2021-12-23 22:00:19;8991002121065;GOOD DAY AVOCADO DELIGHT;2;6000;0;12000;8590;3410;
2021-12-23 22:00:19;8997218380074;ICHITAN MILK TEA;2;8000;0;16000;13000;3000;
2021-12-23 22:00:19;8886008101053;AQUA 600 ML;3;3500;0;10500;6375;4125;
2021-12-23 22:00:19;8997009510123;ORANGE WATER;1;8000;0;8000;6265;1735;
2021-12-23 22:00:19;8999909000711;MAGNUM MILD 16;1;21000;0;21000;19350;1650;
2021-12-23 22:00:19;8999909096004;SAMPOERNA 16 FILTER;1;25000;0;25000;23100;1900;
2021-12-23 22:00:19;8996001600375;LE MINERAL 330ML;1;2000;0;2000;1417;583;
2021-12-23 22:00:19;8995555111221;SOSIS KIMBO;3;1000;0;3000;2550;450;
2021-12-23 22:08:32;ARG;ARGUS DOS 220ML;4;15000;0;60000;54000;6000;
2021-12-23 22:08:32;8998866608084;KECAP MANIS SEDAAP POUCH 550ML;2;20000;0;40000;35700;4300;
2021-12-23 22:08:32;JD VM;JD VANILLA MILKSHAKE;1;5000;0;5000;4300;700;
2021-12-23 22:08:32;8992730950194;GULA GULA KOIN;4;500;0;2000;1600;400;
2021-12-23 22:08:32;8999801700030;SUSU FOYU;1;11500;0;11500;10450;1050;
2021-12-23 22:08:32;4902430745703;DOWNY SUNRISE FRESH 10ML;4;500;0;2000;1572;428;
2021-12-23 22:08:32;8999999057640;MOLTO EDP BLK PURPLE 20ML;1;1000;0;1000;800;200;
2021-12-23 22:08:32;8886001038011;BENG-BENG SCT;1;1500;0;1500;1000;500;
2021-12-23 22:08:32;8996001440049;ENERGEN;2;1500;0;3000;2400;600;
2021-12-23 22:08:32;Garuda pilus;Garuda Pilus Pedas Pcs;4;500;0;2000;1632;368;
2021-12-23 22:08:32;8999909002821;MARLBORO BLACK 16;1;22000;0;22000;21000;1000;
2021-12-23 22:08:32;8992628020152;MINYAK GOREG BIMOLI POUCH 2L;1;35000;0;35000;29800;5200;
2021-12-23 22:08:32;8998989500166;GUDANG GARAM MERAH BESAR 16KS;1;18000;0;18000;17000;1000;
2021-12-23 22:08:32;8991102023115;Sikat Gigi Formula;1;11000;0;11000;10000;1000;
2021-12-23 22:14:32;8993989311699;CLAS MILD 16 FILTER;1;24000;0;24000;21700;2300;
2021-12-23 22:14:32;8992736925134;SASA TEPUNG BUMBU SERBAGUNA;1;5500;0;5500;4700;800;
2021-12-23 22:14:32;8992696404441;SUSU BERUANG;1;13000;0;13000;8585;4415;
2021-12-23 22:14:32;ROTI;ROTI 2000;1;2000;0;2000;1800;200;
2021-12-23 22:14:32;8998866200882;SUKSESMIE GORENG AYAM KRMS 133GR;1;3500;0;3500;3047;453;
2021-12-23 22:14:32;8994867007161;ROKOK PENA GOLD 20;1;19000;0;19000;17400;1600;
2021-12-23 22:14:32;8994867000179;ROKOK PENA MILD 16;2;15500;0;31000;29000;2000;
2021-12-23 22:14:32;Garuda Pilus;Garuda Pilus Rasa Abon Pcs;4;500;0;2000;1604;396;
2021-12-23 22:14:32;8991001243034;TOP 9G;1;1000;0;1000;820;180;
2021-12-23 22:14:32;6907992823935;JD SWEETCORN;1;3500;0;3500;3000;500;
2021-12-23 22:14:32;6907992823966;JD BLUEBERRY;1;3500;0;3500;3000;500;
2021-12-23 22:14:32;kiko;kiko;1;1000;0;1000;900;100;
2021-12-24 21:59:34;8999999024482;CITRA BW PEARLY WHITE REFF 220ML;1;12000;0;12000;10700;1300;
2021-12-24 22:00:40;Vita Jelly;Vita Jelly;10;1000;0;10000;7660;2340;
2021-12-24 22:00:40;ROTI;ROTI 2000;5;2000;0;10000;9000;1000;
2021-12-26 11:05:25;ARG;ARGUS DOS 220ML;1;15000;0;15000;13500;1500;
2021-12-26 11:05:25;8997011700123;BIHUN JAGUNG 300GR;1;6000;0;6000;4979;1021;
2021-12-26 11:14:07;8991102714846;MILKIDO CKLT;1;3000;0;3000;2153;847;
2021-12-26 11:20:40;8991001502933;CHACHA TUBE;1;7500;0;7500;6400;1100;
2021-12-26 11:20:40;8996001326237;GULA GULA KIS;2;250;0;500;400;100;
2021-12-26 11:20:40;8991102308892;BLASTO;2;1500;0;3000;2240;760;
2021-12-26 11:24:49;8851019210292;POCKY COOKIES & CREAME 47 GR;1;7000;0;7000;5671;1329;
2021-12-26 11:29:39;8992775002735;CHOCOLATOS SUSU COKELAT;1;4000;0;4000;3520;480;
2021-12-26 11:29:39;6907992823591;JD STRAW MILKSHAKE;2;5000;0;10000;8600;1400;
2021-12-26 11:31:05;KIKO;KIKO;2;1000;0;2000;1000;1000;
2021-12-26 11:36:43;8992696521797;MILO 22G;1;2500;0;2500;1572;928;
2021-12-26 12:05:02;8997009510055;YOU C1000;1;15000;0;15000;13000;2000;
2021-12-26 12:05:02;8992696404441;SUSU BERUANG;1;13000;0;13000;8585;4415;
2021-12-26 12:05:02;8997218380135;ICHITAN GREEN TEA;4;8000;0;32000;26000;6000;
2021-12-26 12:05:02;ARG;ARGUS DOS 220ML;1;15000;0;15000;13500;1500;
2021-12-26 12:07:48;8992761111533;SPRITE SLIM CAM250ML;1;5000;0;5000;3750;1250;
2021-12-26 12:41:32;8998989110167;SURYA GUDANG GARAM 16 FILTER;2;26000;0;52000;47400;4600;
2021-12-26 12:46:54;8993324850395;GENTLE CUTTON BUDS 50;1;3000;0;3000;2000;1000;
2021-12-26 12:56:05;4902430563888;SHAMPO PANTENE;2;1000;0;2000;1500;500;
2021-12-26 12:56:05;AMPLOP;AMPLOP;4;250;0;1000;700;300;
2021-12-26 12:57:06;8997028590014;ARGUS 220ML;8;500;0;4000;2416;1584;
2021-12-26 12:57:06;8991102384841;WFR TANGO LONG CKLT 130G;1;5000;0;5000;4333;667;
2021-12-26 15:00:18;089686021141;INTER MIE SOTO;2;1000;0;2000;1708;292;
2021-12-26 15:00:18;089686021127;INTER MIE KALDU;3;1000;0;3000;2439;561;
2021-12-26 15:37:00;SURYA BTG;SURYA BATANG;6;1666;0;9996;8280;1716;
2021-12-26 18:08:38;ROTI;ROTI 2000;1;2000;0;2000;1800;200;
2021-12-26 18:08:38;HT;HOT-HOT;1;500;0;500;350;150;
2021-12-26 18:08:38;PD;PENDEKAR;1;500;0;500;350;150;
2021-12-26 18:08:38;MBL;MOBIL;1;5000;0;5000;3500;1500;
2021-12-26 18:08:38;MILKITA;MILKITA;4;250;0;1000;800;200;
2021-12-26 18:25:23;8999999524807;SUNLIGHT HABBATUSSAUDA POUCH 755ML;1;18000;0;18000;15950;2050;
2021-12-26 18:25:23;8998866692663;SOKLIN FLOORCLENER KUNING 450ML;1;7000;0;7000;6385;615;
2021-12-26 18:25:23;8991002105409;KOPI KAPAL API;1;20000;0;20000;18888;1112;
2021-12-26 18:26:55;7622201430153;OREO CHOCOLATE 38G;1;2000;0;2000;1641;359;
2021-12-26 18:26:55;CB;CANNON BALL PCS;2;500;0;1000;750;250;
2021-12-26 18:43:09;8997028590014;ARGUS 220ML;2;500;0;1000;604;396;
2021-12-26 18:43:09;ROTI;ROTI 2000;2;2000;0;4000;3600;400;
2021-12-26 18:43:09;7622210437686;BISKUAT;4;500;0;2000;1600;400;
2021-12-26 19:21:40;8991102387286;TANGO LONG CKLT 47G;2;2000;0;4000;3188;812;
2021-12-26 19:21:40;8995333060796;TEPUNG DUA PEDANG 1KG;1;9000;0;9000;7953;1047;
2021-12-26 19:30:36;8886008101091;AQUA 1,5 ML;1;5500;0;5500;4600;900;
2021-12-26 19:30:36;8996001440049;ENERGEN;1;1500;0;1500;1200;300;
2021-12-26 19:41:14;8993989311699;CLAS MILD 16 FILTER;1;24000;0;24000;21700;2300;
2021-12-26 19:45:00;8999999007799;FAIR & LOVELY MULTIVITAMIN CREAM 50G;1;29000;0;29000;26785;2215;
2021-12-26 19:45:00;KPS;KAPAS MEI QIAN;1;5000;0;5000;4750;250;
2021-12-26 19:45:00;8992979190986;TOTAL PUTIH SOFTENER;1;15000;0;15000;13524;1476;
2021-12-26 19:45:00;8992946512223;SHINZUI;2;5000;0;10000;8000;2000;
2021-12-26 19:45:00;8999999053031;PONDS WHITE BEAUTY FACIAL FOAM100G;1;26000;0;26000;23700;2300;
2021-12-26 19:48:06;8995333000822;TERIGU KOMPAS SOFT 500GR;2;5500;0;11000;9934;1066;
2021-12-26 20:03:23;8991909101016;URBAN MILD 16;1;17000;0;17000;15800;1200;
2021-12-26 20:17:28;8992628034159;BIMOLI SPESIAL 1 LT;1;21000;0;21000;19000;2000;
2021-12-26 20:29:48;8992959508909;SWEETY SILVER PANTS S18;1;30500;0;30500;27617;2883;
2021-12-26 20:38:20;8992959508916;SWEETY SILVER PANTS XXL18;1;54500;0;54500;49546;4954;
2021-12-26 20:39:40;8991906105758;ROKOK LA BOLD;2;26000;0;52000;49800;2200;
2021-12-26 20:39:40;8998989300261;GUDANG GARAM SURYA 12 FILTER;1;20000;0;20000;18150;1850;
2021-12-26 20:43:42;8994191103638;GULA GULA KARET;1;500;0;500;400;100;
2021-12-26 20:45:13;8886008101091;AQUA 1,5 ML;1;5500;0;5500;4600;900;
2021-12-26 20:45:13;8999909096004;SAMPOERNA 16 FILTER;1;25000;0;25000;23100;1900;
2021-12-26 20:45:22;8994191103638;GULA GULA KARET;1;500;0;500;400;100;
2021-12-26 21:18:14;8999909002821;MARLBORO BLACK 16;1;22000;0;22000;21000;1000;
2021-12-26 21:58:46;8992759120264;LARISST 220;1;10000;0;10000;9200;800;
2021-12-26 21:58:46;8991001780133;TWISTER BLACK;1;5000;0;5000;4600;400;
2021-12-27 11:07:58;8996001305058;ROMA SANDWICH KACANG;1;7000;0;7000;5928;1072;
2021-12-27 12:25:16;8993989311279;CLAS MILD 12;1;18000;0;18000;15800;2200;
2021-12-27 12:47:11;ARG;ARGUS DOS 220ML;1;15000;0;15000;13500;1500;
2021-12-27 12:47:11;KIKO;KIKO;2;1000;0;2000;1000;1000;
2021-12-27 12:47:11;8991102228053;TEH GELAS BOTOL;1;3000;0;3000;1695;1305;
2021-12-27 12:57:33;6907992823966;JD BLUEBERRY;1;3500;0;3500;3000;500;
2021-12-27 13:11:20;8992759120264;LARISST 220;2;11000;0;22000;18400;3600;
2021-12-27 13:11:20;8992959117538;SFX COMFORT SLIM WING 20;1;12000;0;12000;10947;1053;
2021-12-27 13:11:39;TG;TEH GELAS;2;1000;0;2000;1458;542;
2021-12-27 13:35:36;8994867007161;ROKOK PENA GOLD 20;1;19000;0;19000;17400;1600;
2021-12-27 13:38:35;8998866679596;SOKLIN LANTAI BIRU 780ML;1;12000;0;12000;10020;1980;
2021-12-27 16:19:45;8999909010567;234 DJI SAM SOE 16;1;22500;0;22500;21500;1000;
2021-12-27 16:58:01;8997009510055;YOU C1000;1;15000;0;15000;13000;2000;
2021-12-27 16:58:01;SURYA BTG;SURYA BATANG;3;1666;0;4998;4140;858;
2021-12-27 17:11:51;8998989500166;GUDANG GARAM MERAH BESAR 16KS;1;18000;0;18000;17000;1000;
2021-12-27 17:18:29;8992628034159;BIMOLI SPESIAL 1 LT;1;21000;0;21000;19000;2000;
2021-12-27 17:27:04;gula;GULA;1;11500;0;11500;10000;1500;
2021-12-27 18:09:03;MILKITA;MILKITA;4;250;0;1000;800;200;
2021-12-27 18:09:03;ES POTONG;ES POTONG;2;1000;0;2000;1000;1000;
2021-12-27 18:17:54;8997009510055;YOU C1000;1;15000;0;15000;13000;2000;
2021-12-27 18:17:54;8992696404441;SUSU BERUANG;1;13000;0;13000;8585;4415;
2021-12-27 19:58:10;TG;TEH GELAS;1;1000;0;1000;729;271;
2021-12-27 19:58:10;8997028590014;ARGUS 220ML;2;500;0;1000;604;396;
2021-12-27 19:58:10;7622210437686;BISKUAT;2;500;0;1000;800;200;
2021-12-27 19:58:10;8991001780133;TWISTER BLACK;1;5000;0;5000;4600;400;
2021-12-27 19:58:10;8991102384841;WFR TANGO LONG CKLT 130G;1;5000;0;5000;4333;667;
2021-12-27 19:58:10;CB;CANNON BALL PCS;1;500;0;500;375;125;
2021-12-27 19:58:10;8886001038011;BENG-BENG SCT;1;1500;0;1500;1000;500;
2021-12-27 19:58:10;ROTI;ROTI 2000;1;2000;0;2000;1800;200;
2021-12-27 19:58:10;KIKO;KIKO;1;1000;0;1000;500;500;
2021-12-27 21:37:08;SURYA BTG;SURYA BATANG;3;1666;0;4998;4140;858;
2021-12-27 21:37:08;8998989500166;GUDANG GARAM MERAH BESAR 16KS;1;18000;0;18000;17000;1000;
2021-12-27 21:37:08;8998866200301;MIE SEDAAP GORENG;1;3000;0;3000;2414;586;
2021-12-27 22:04:23;8991102714846;MILKIDO CKLT;1;3000;0;3000;2153;847;
2021-12-27 22:07:57;8991914101513;VIPER KRETEK 12;1;6000;0;6000;5600;400;
2021-12-28 11:12:56;ROTI;ROTI 2000;3;2000;0;6000;5400;600;
2021-12-28 11:12:56;KERIPIK;KERIPIK UBI;2;2000;0;4000;3600;400;
2021-12-28 11:12:56;8993274532105;BOLU;2;1000;0;2000;1666;334;
2021-12-28 11:12:56;SURYA BTG;SURYA BATANG;15;1666;0;24990;20700;4290;
2021-12-28 11:12:56;8998866202244;EKOMIE BUMBU KALDU AYAM;1;1000;0;1000;798;202;
2021-12-28 11:12:56;8991111109107;JB POWDER BEDTIME 75+25g;1;6000;0;6000;5440;560;
2021-12-28 11:12:56;8992628034159;BIMOLI SPESIAL 1 LT;1;21000;0;21000;19000;2000;
2021-12-28 11:12:56;MLTO PINK;MOLTO ALL IN ONE;3;1000;0;3000;2400;600;
2021-12-28 11:12:56;8992696521797;MILO 22G;6;2500;0;15000;9432;5568;
2021-12-28 11:12:56;8996001600375;LE MINERAL 330ML;4;2000;0;8000;5668;2332;
2021-12-28 11:12:56;8991914101513;VIPER KRETEK 12;2;6000;0;12000;11200;800;
2021-12-28 11:12:56;8993989311699;CLAS MILD 16 FILTER;1;24000;0;24000;21700;2300;
2021-12-28 11:12:56;8991188943536;SASA SANTAN KELAPA 65ML;1;3000;0;3000;2437;563;
2021-12-28 11:12:56;BALON;BALON CABUT;3;1000;0;3000;2700;300;
2021-12-28 11:12:56;8992775211410;PILUS GARUDA PEDAS;1;5000;0;5000;4886;114;
2021-12-28 11:12:56;8996001600146;TEH PUCUK HARUM 350ML;1;3000;0;3000;2314;686;
2021-12-28 11:12:56;8886001038011;BENG-BENG SCT;2;1500;0;3000;2000;1000;
2021-12-28 11:12:56;8997218380074;ICHITAN MILK TEA;2;8000;0;16000;13000;3000;
2021-12-28 11:12:56;8995333000822;TERIGU KOMPAS SOFT 500GR;4;5500;0;22000;19868;2132;
2021-12-28 11:12:56;8998989300261;GUDANG GARAM SURYA 12 FILTER;2;20000;0;40000;36300;3700;
2021-12-28 11:12:56;8997028590014;ARGUS 220ML;8;500;0;4000;2416;1584;
2021-12-28 11:12:56;9556001004673;MILO NESTLE MALAYSIA ACTIVE GO;1;85000;0;85000;76000;9000;
2021-12-28 11:12:56;8991102384841;WFR TANGO LONG CKLT 130G;2;5000;0;10000;8666;1334;
2021-12-28 11:12:56;8998866202619;MIE SEDAAP KOREAN SPICY SOUP;3;2700;0;8100;6966;1134;
2021-12-28 11:12:56;8851019210292;POCKY COOKIES & CREAME 47 GR;1;7000;0;7000;5671;1329;
2021-12-28 11:12:56;8851019210117;POCKY CHOCOLATE FLAVOUR 47G;1;7500;0;7500;5671;1829;
2021-12-28 11:12:56;8992761166038;MMP ORANGE 300ML;1;5000;0;5000;3750;1250;
2021-12-28 11:12:56;8997009461753;TOP ELIT;5;1000;0;5000;2000;3000;
2021-12-28 11:12:56;8999999030179;PEPSODENT ACTION 123 COMPLETE 75G;1;6700;0;6700;5170;1530;
2021-12-28 11:12:56;9556006004234;JB SHAMPOO SOFT&SMOOTH 200ML;1;18500;0;18500;17020;1480;
2021-12-28 11:12:56;8998866200301;MIE SEDAAP GORENG;2;3000;0;6000;4828;1172;
2021-12-28 11:12:56;8998866200578;MIE SEDAAP KARI KENTAL;1;2700;0;2700;2331;369;
2021-12-28 11:12:56;8999801700030;SUSU FOYU;1;11500;0;11500;10450;1050;
2021-12-28 11:12:56;KIKO;KIKO;1;1000;0;1000;500;500;
2021-12-28 11:12:56;8992702000063;INDOMILK COKLAT 370G;1;10000;0;10000;9208;792;
2021-12-28 11:12:56;8995333060703;TERIGU KOMPAS 1KG;1;10500;0;10500;9816;684;
2021-12-28 11:12:56;8999999567279;SARIWANGI JAHE KUNYIT;1;7500;0;7500;6600;900;
2021-12-28 11:12:56;8998866203272;SUKSES AYAM GEPREK;1;4000;0;4000;3046;954;
2021-12-28 11:12:56;8993335529419;Sabun Total de Parfumee Floral Vibes;1;24500;0;24500;22000;2500;
2021-12-28 11:12:56;8991002101746;KOPI ABC MOCCA;1;1500;0;1500;990;510;
2021-12-28 11:12:56;7622201430153;OREO CHOCOLATE 38G;1;2000;0;2000;1641;359;
2021-12-28 11:12:56;8998866202671;NOODLE SEDAAP MIE KOREAN SPICY SOUP CUP;1;5000;0;5000;4002;998;
2021-12-28 11:12:56;8999909010567;234 DJI SAM SOE 16;2;22500;0;45000;43000;2000;
2021-12-28 11:12:56;8998989110167;SURYA GUDANG GARAM 16 FILTER;1;26000;0;26000;23700;2300;
2021-12-28 11:12:56;8886013213208;FRENCH FREIS 2000;1;5000;0;5000;3750;1250;
2021-12-28 11:12:56;8998866201711;KRISBEE KRUNCHY JAGUNG BAKAR MENTEGA 75 GR;1;5500;0;5500;4400;1100;
2021-12-28 11:12:56;089686021127;INTER MIE KALDU;5;1000;0;5000;4065;935;
2021-12-28 11:48:43;8997028590014;ARGUS 220ML;18;500;0;9000;5436;3564;
2021-12-28 11:48:43;8997028590045;ARGUS BTL 330ML;1;2000;0;2000;1291;709;
2021-12-28 11:48:43;8991102320184;TANGO CHOCO JAVAMOCCA;1;5000;0;5000;4350;650;
2021-12-28 11:48:43;BALON;BALON CABUT;8;1000;0;8000;7200;800;
2021-12-28 11:48:43;8991002106116;KOPI KAPTEN;1;7000;0;7000;5120;1880;
2021-12-28 11:48:43;8999999195649;SARIWANGI 25X1.86G;2;6000;0;12000;10404;1596;
2021-12-28 11:48:43;8992753031894;FRISIAN FLAG;2;2000;0;4000;2000;2000;
2021-12-28 11:48:43;8998898830125;KKB ENER-G ANGGUR;1;5500;0;5500;4824;676;
2021-12-28 11:48:43;ROTI;ROTI 2000;1;2000;0;2000;1800;200;
2021-12-28 11:48:43;8999909002821;MARLBORO BLACK 16;2;22000;0;44000;41700;2300;
2021-12-28 11:48:43;SURYA BTG;SURYA BATANG;7;2000;0;14000;9660;4340;
2021-12-28 11:48:43;gula;GULA;3;11500;0;34500;30000;4500;
2021-12-28 11:48:43;8998866600569;SOKLIN LANTAI HIJAU 400ML;1;6000;0;6000;5025;975;
2021-12-28 11:48:43;8997027490018;LADAMAS MERICA BUBUK;1;9500;0;9500;8898;602;
2021-12-28 11:48:43;8996001301142;ROMA KELAPA;1;8000;0;8000;7000;1000;
2021-12-28 11:48:43;8996001305058;ROMA SANDWICH KACANG;3;7000;0;21000;17784;3216;
2021-12-28 11:48:43;8995333060703;TERIGU KOMPAS 1KG;3;10500;0;31500;29448;2052;
2021-12-28 11:48:43;8992696523067;MILO ACTVGO UHT 180ML;1;4500;0;4500;3719;781;
2021-12-28 11:48:43;6907992823867;JD CRUNCHY CHOCOLATE MALT;1;5500;0;5500;4700;800;
2021-12-28 11:48:43;KIKO;KIKO;3;1000;0;3000;1500;1500;
2021-12-28 11:48:43;6907992825069;JD FRUITY;1;5000;0;5000;4400;600;
2021-12-28 11:48:43;8998866200325;MIE SEDAAP SOTO;1;2700;0;2700;2282;418;
2021-12-28 11:48:43;8998866200882;SUKSESMIE GORENG AYAM KRMS 133GR;1;3500;0;3500;3047;453;
2021-12-28 11:48:43;8992979120013;TOTAL BUNGA SOFTENER;1;15000;0;15000;13800;1200;
2021-12-28 11:48:43;MARS;MARSHMELLOW;4;500;0;2000;1732;268;
2021-12-28 11:48:43;milkita;milkita;3;500;0;1500;1110;390;
2021-12-28 11:48:43;8993470279651;JOGER CHOCKY BAR;1;1000;0;1000;867;133;
2021-12-28 11:48:43;8886013213208;FRENCH FREIS 2000;3;5000;0;15000;11250;3750;
2021-12-28 11:48:43;8996001440049;ENERGEN;1;1500;0;1500;1200;300;
2021-12-28 11:48:43;8991002103764;GOOD DAY CAPPUCINO 10X25G;2;1500;0;3000;2790;210;
2021-12-28 11:48:43;8992696521797;MILO 22G;4;2500;0;10000;6288;3712;
2021-12-28 11:48:43;8999909000544;MARLBORO BLACK 20;1;29000;0;29000;27800;1200;
2021-12-28 11:48:43;8886008101091;AQUA 1,5 ML;1;5500;0;5500;4600;900;
2021-12-28 11:48:43;711844150003;ABC ORANGE;2;12000;0;24000;19800;4200;
2021-12-28 11:48:43;8991102385336;TANGO WAFFLE MILK;1;10000;0;10000;8200;1800;
2021-12-28 11:48:43;8998866609043;DAIA SOFTENER GUSSET 565G;1;10000;0;10000;8700;1300;
2021-12-28 11:48:43;8998866202619;MIE SEDAAP KOREAN SPICY SOUP;2;2700;0;5400;4644;756;
2021-12-28 11:48:43;4902430557122;KONSENTRAT DOWNY;3;1000;0;3000;2250;750;
2021-12-28 11:48:43;8991102228053;TEH GELAS BOTOL;1;3000;0;3000;1695;1305;
2021-12-28 11:48:43;8851019210292;POCKY COOKIES & CREAME 47 GR;2;7000;0;14000;11342;2658;
2021-12-28 11:48:43;8851019210117;POCKY CHOCOLATE FLAVOUR 47G;1;7500;0;7500;5671;1829;
2021-12-28 11:48:43;8996001600375;LE MINERAL 330ML;2;2000;0;4000;2834;1166;
2021-12-28 11:48:43;7622300761349;OREO MINI CKLT;2;7500;0;15000;13000;2000;
2021-12-28 11:48:43;8991002121010;GOOD DAY FANTASTIC MOCACINNO;1;7000;0;7000;4750;2250;
2021-12-28 11:48:43;8992696404441;SUSU BERUANG;1;12000;0;12000;8585;3415;
2021-12-28 11:48:43;8998866203272;SUKSES AYAM GEPREK;2;4000;0;8000;6092;1908;
2021-12-28 11:48:43;8992959508893;SWEETY SILVER PANTS S9;1;14500;0;14500;13107;1393;
2021-12-28 11:48:43;8998866202671;NOODLE SEDAAP MIE KOREAN SPICY SOUP CUP;1;5000;0;5000;4002;998;
2021-12-28 11:48:43;8998866202244;EKOMIE BUMBU KALDU AYAM;15;1000;0;15000;11970;3030;
2021-12-28 11:48:43;8994834006128;TICTIC PEDAS;1;2000;0;2000;1700;300;
2021-12-28 11:48:43;8991102714624;Tanggo Kido Drink 115ml;6;3000;0;18000;12000;6000;
2021-12-28 11:48:43;6907992823966;JD BLUEBERRY;1;3500;0;3500;3000;500;
2021-12-28 11:48:43;7622210437686;BISKUAT;2;500;0;1000;800;200;
2021-12-28 11:48:43;089686611519;QTELA SINGKONG;1;5000;0;5000;4266;734;
2021-12-28 11:48:43;8992696521629;DNCO COKLT UHT 180ML;1;5000;0;5000;3533;1467;
2021-12-28 11:48:43;Garuda Pilus;Garuda Pilus Rasa Abon Pcs;2;500;0;1000;802;198;
2021-12-28 11:48:43;8998866201711;KRISBEE KRUNCHY JAGUNG BAKAR MENTEGA 75 GR;1;5500;0;5500;4400;1100;
2021-12-28 11:48:43;8998989300261;GUDANG GARAM SURYA 12 FILTER;1;20000;0;20000;18150;1850;
2021-12-28 11:48:43;8998866693578;SOKLIN FLOORCLENER PINK 900ML;1;14000;0;14000;12436;1564;
2021-12-28 11:48:43;4902430745703;DOWNY SUNRISE FRESH 10ML;10;500;0;5000;3930;1070;
2021-12-28 11:48:43;4902430803380;DOWNY FLORAL PINK 10ML;10;500;0;5000;3930;1070;
2021-12-28 11:48:43;CB;CANNON BALL PCS;1;500;0;500;375;125;
2021-12-28 12:48:03;8992760223015;OREO CHOCOLATE CREAM 133G;1;8000;0;8000;6300;1700;
2021-12-28 12:53:14;8997028590014;ARGUS 220ML;4;500;0;2000;1208;792;
2021-12-28 13:10:09;4801010562108;JB SOAP MILK 100GR;1;5000;0;5000;4410;590;
2021-12-28 13:10:09;8993379254469;SABUN LERVIA 90G;1;5000;0;5000;3077;1923;
2021-12-28 13:10:09;8992694246340;ZWITSAL SHP NAT AVKS 100ML;1;11800;0;11800;10395;1405;
2021-12-28 13:10:09;8999908059802;MY BABY POWDER KUNING;1;5000;0;5000;3276;1724;
2021-12-28 13:10:09;8992959953037;SWEETY BRONZE L1;1;2500;0;2500;1819;681;
2021-12-28 13:10:09;8992959001875;SWEETY SILVER PANTS S1;1;2000;0;2000;1528;472;
2021-12-28 13:10:09;8993072254018;MELROSE COTTON BUDS BSR;1;5000;0;5000;4050;950;
2021-12-28 13:11:09;8992741952262;GULA GULA YUPI;7;250;0;1750;1400;350;
2021-12-28 14:01:27;7118441101378;KECAP ABC 520 ML;1;19000;0;19000;17800;1200;
2021-12-28 14:04:34;ROTI;ROTI 2000;2;2000;0;4000;3600;400;
2021-12-28 14:04:34;8996001440049;ENERGEN;8;1500;0;12000;9600;2400;
2021-12-28 14:04:34;8992775315095;GERY MALKIST SWEET CHEESE;1;6500;0;6500;5516;984;
2021-12-28 14:04:34;8997009510055;YOU C1000;2;15000;0;30000;26000;4000;
2021-12-28 14:05:08;8997878004327;GULA GULA MILKITA;2;250;0;500;400;100;
2021-12-28 14:59:32;8991102714594;TANGO DRINK BLCK VNL;1;5000;0;5000;3818;1182;
2021-12-28 15:06:39;8996001600375;LE MINERAL 330ML;2;2000;0;4000;2834;1166;
2021-12-28 15:06:39;8991102385053;WAFFLE CRANCHOX 7G;2;1000;0;2000;810;1190;
2021-12-28 15:06:39;SURYA BTG;SURYA BATANG;3;1666;0;4998;4140;858;
2021-12-28 15:10:11;8991914101513;VIPER KRETEK 12;1;6000;0;6000;5600;400;
2021-12-28 15:54:25;8993226365676;LADA PUTIH;2;1000;0;2000;1550;450;
2021-12-28 15:54:25;HT;HOT-HOT;10;500;0;5000;3500;1500;
2021-12-28 15:54:25;MARS;MARSHMELLOW;10;500;0;5000;4330;670;
2021-12-28 15:54:25;8992775511206;LEO 10GR;1;1000;0;1000;848;152;
2021-12-28 16:04:41;8886008101091;AQUA 1,5 ML;1;5500;0;5500;4600;900;
2021-12-28 16:07:48;8991002105409;KOPI KAPAL API;1;20000;0;20000;18888;1112;
2021-12-28 16:17:19;8992959953044;SWEETY BRONZE XL1;1;3000;0;3000;2311;689;
2021-12-28 16:17:19;HT;HOT-HOT;2;500;0;1000;700;300;
2021-12-28 16:17:19;8992775511206;LEO 10GR;1;1000;0;1000;848;152;
2021-12-28 16:17:19;milkita;milkita;2;500;0;1000;740;260;
2021-12-28 16:17:19;8996001326237;GULA GULA KIS;4;250;0;1000;800;200;
2021-12-28 17:11:24;8992696405417;DNCO INSTANT 27G;1;3500;0;3500;3000;500;
2021-12-28 17:11:24;8993226365676;LADA PUTIH;2;1000;0;2000;1550;450;
2021-12-28 17:11:24;gula;GULA;1;11500;0;11500;10000;1500;
2021-12-28 17:31:43;6907992823973;JD PINEAPPLE;1;5000;0;5000;4300;700;
2021-12-28 17:31:43;8992696404441;SUSU BERUANG;1;12000;0;12000;8585;3415;
2021-12-28 17:31:43;8996001600375;LE MINERAL 330ML;2;2000;0;4000;2834;1166;
2021-12-28 17:31:43;8999999524722;SUNLIGHT LIME NEW PCH 435ML;1;10000;0;10000;9100;900;
2021-12-28 17:37:02;8992770033178;Masako;2;500;0;1000;900;100;
2021-12-28 18:09:43;8998989300261;GUDANG GARAM SURYA 12 FILTER;1;20000;0;20000;18150;1850;
2021-12-28 18:12:13;8991001503336;chacha minis hat;1;7500;0;7500;6400;1100;
2021-12-28 18:13:17;ROTI;ROTI 2000;1;2000;0;2000;1800;200;
2021-12-28 18:15:22;gula;GULA;1;11500;0;11500;10000;1500;
2021-12-28 18:15:22;ARG;ARGUS DOS 220ML;1;15000;0;15000;13500;1500;
2021-12-28 18:15:22;PD;PENDEKAR;1;500;0;500;350;150;
2021-12-28 18:23:23;8992979120013;TOTAL BUNGA SOFTENER;1;15000;0;15000;13800;1200;
2021-12-28 18:23:23;8999999059781;SUNLIGHT LIME NEW POUCH 210ML;1;5000;0;5000;4520;480;
2021-12-28 18:23:23;8991002105409;KOPI KAPAL API;1;20000;0;20000;18888;1112;
2021-12-28 18:24:42;8998866200301;MIE SEDAAP GORENG;5;3000;0;15000;12070;2930;
2021-12-28 18:24:42;8998866200325;MIE SEDAAP SOTO;5;2700;0;13500;11410;2090;
2021-12-28 18:24:42;8996001355008;BENG-BENG SP20G;1;29000;0;29000;20000;9000;
2021-12-28 18:24:42;8998866805414;SOKLIN SMART SOFTERNER 800G & PIRING;1;20000;0;20000;18630;1370;
2021-12-28 18:24:42;OSCAR;OSKAR"S;20;1000;0;20000;8500;11500;
2021-12-28 18:36:42;8997028590014;ARGUS 220ML;2;500;0;1000;604;396;
2021-12-28 18:36:42;7622210437686;BISKUAT;5;500;0;2500;2000;500;
2021-12-28 18:44:22;8997018720018;SIRUP DHT;1;23000;0;23000;20958;2042;
2021-12-28 18:44:22;ARG;ARGUS DOS 220ML;1;15000;0;15000;13500;1500;
2021-12-28 18:44:22;6907992823904;JD CRUNCHY CHOCOLATE VAN;1;8000;0;8000;6800;1200;
2021-12-28 18:44:22;6907992823911;JD CRUNCHY HONEYDEW MELON;1;8000;0;8000;6800;1200;
2021-12-30 21:45:40;gula;GULA;2;11500;0;23000;20000;3000;
2021-12-30 21:45:40;8886008101053;AQUA 600 ML;4;3500;0;14000;8500;5500;
2021-08-13 11:59:55;8996200900092;HEROCYN 85GR;1;13000;0;13000;11650;1350;
2021-08-13 11:59:55;8998866500708;FLORIDINA ORANGE;3;3000;0;9000;7500;1500;
2021-08-13 11:59:55;8997012030748;MADU ENAK;2;1000;0;2000;1800;200;
2021-08-13 11:59:55;8992959509005;SWEETY SILVER PANTS XL26;1;61500;0;61500;55910;5590;
2021-08-13 11:59:55;8992702000063;INDOMILK COKLAT 370G;1;10000;0;10000;9208;792;
2021-08-13 11:59:55;8992696425316;NESCAFE BLACK;1;5000;0;5000;4099;901;
2021-08-13 11:59:55;089686611618;QTELA BARBEQUE;1;5000;0;5000;4266;734;
2021-08-13 11:59:55;AMPLOP;AMPLOP;4;250;0;1000;700;300;
2021-08-13 11:59:55;8992775001615;CHOCOLATOS SWEET CHEESE;1;18000;0;18000;15483;2517;
2021-08-13 11:59:55;8992775311615;CHOCOLATOS;1;12000;0;12000;9983;2017;
2021-08-13 11:59:55;8992761139018;ADES 600ML;2;3500;0;7000;4332;2668;
2021-08-13 11:59:55;8999909982000;SAMPOERNA 12 FILTER;1;19000;0;19000;16600;2400;
2021-08-13 11:59:55;8992761002022;SPRITE PET 390ML;1;5500;0;5500;4333;1167;
2021-08-13 11:59:55;8993007000024;INDOMILK UHT VANILA;1;5000;0;5000;3470;1530;
2021-08-13 11:59:55;8992696523067;MILO ACTVGO UHT 180ML;1;5000;0;5000;3719;1281;
2021-12-19 12:06:03;8992761166052;FRESTEA MELATI 350ML;1;4500;0;4500;3000;1500;
2021-12-19 12:06:03;8999909085114;SAMPOERNA KRETEK HIJAU 12;1;14000;0;14000;11650;2350;
2021-12-30 12:10:29;8886008101053;AQUA 600 ML;2;3500;0;7000;4250;2750;
2021-12-30 12:10:29;6907992825076;JD WATERMELON APPLE;1;2000;0;2000;1700;300;
2021-12-30 12:10:29;gula;GULA;2;12500;0;25000;23000;2000;
2021-12-30 12:10:29;8992870410206;Salonpas;1;7000;0;7000;5700;1300;
2021-12-30 12:10:29;8997027300089;NOMOS;1;4000;0;4000;2963;1037;
2021-12-30 12:11:07;8997018720018;SIRUP DHT;1;24000;0;24000;22750;1250;
2021-11-23 09:22:30;8996001600399;LE MINERAL 1500ML;1;5000;0;5000;4042;958;
2021-11-23 09:22:30;8998866501033;MINYAK GORENG SEDAAP POUCH 2L;1;37000;0;37000;35000;2000;
2021-11-23 09:22:30;8992759120264;LARISST 220;1;11000;0;11000;9200;1800;
2021-11-23 10:23:50;8995333060703;TERIGU KOMPAS 1KG;1;11500;0;11500;10400;1100;
2021-11-23 10:23:50;8999999049492;REXONA WMN RO POWDER DRY 45 ML;1;15000;0;15000;13500;1500;
2021-11-23 10:23:50;8999999567279;SARIWANGI JAHE KUNYIT;1;7500;0;7500;6600;900;
2021-11-23 10:23:50;gula;GULA;1;12500;0;12500;11500;1000;
2021-11-23 11:35:23;8993072254018;MELROSE COTTON BUDS BSR;1;5000;0;5000;4050;950;
2021-11-23 11:35:23;089686044249;SUPERMI NUTRIMI STEAK AYAM;1;3500;0;3500;2800;700;
2021-11-23 11:35:23;8998866605809;SOKLIN SMART WHITE 800GR 7 PIRING;1;20000;0;20000;18630;1370;
2021-11-23 11:35:46;8994867000179;ROKOK PENA MILD 16;1;15500;0;15500;14500;1000;
2021-11-23 11:53:09;8998866200837;NOODLE SEDAAPMIE SOTO CUP 81 GR;1;5000;0;5000;3825;1175;
2021-11-23 11:53:09;6907992823973;JD PINEAPPLE;1;5000;0;5000;4300;700;
2021-11-23 11:53:09;8997218010230;yohoo;1;1000;0;1000;900;100;
2021-11-23 11:53:09;TBR;TEPUNG BERAS ROSE BRAND;1;8000;0;8000;6150;1850;
2021-11-23 11:53:09;8998866200301;MIE SEDAAP GORENG;1;3000;0;3000;2414;586;
2021-11-23 11:53:09;8998866200578;MIE SEDAAP KARI KENTAL;1;2700;0;2700;2423;277;
2021-11-23 13:49:32;SURYA BTG;SURYA BATANG;2;2000;0;4000;2840;1160;
2021-11-23 14:37:04;8997028590014;ARGUS 220ML;2;500;0;1000;684;316;
2021-11-23 14:37:04;8998989300261;GUDANG GARAM SURYA 12 FILTER;1;20000;0;20000;18650;1350;
2021-11-23 14:37:04;8994867007161;ROKOK PENA GOLD 20;1;19000;0;19000;17400;1600;
2021-11-23 15:33:06;8998866501033;MINYAK GORENG SEDAAP POUCH 2L;2;37000;0;74000;70000;4000;
2021-11-23 15:33:06;8992761166038;PULPY ORANGE 300ML;4;5000;0;20000;15000;5000;
2021-11-23 15:34:16;089686535044;SUN BERAS MERAH;1;8500;0;8500;7410;1090;
2021-11-23 15:34:16;ROTI;ROTI 2000;2;2000;0;4000;3600;400;
2021-11-23 16:15:36;8999909002821;MARLBORO BLACK 16;1;23000;0;23000;21850;1150;
2021-11-23 16:35:57;8991909101016;URBAN MILD 16;1;17000;0;17000;15800;1200;
2021-11-23 16:49:21;123124;KOREK BIASA;1;2000;0;2000;1300;700;
2021-11-23 16:49:21;ROYCO;ROYCO RASA AYAM;10;500;0;5000;3750;1250;
2021-11-23 16:49:21;8997028590014;ARGUS 220ML;2;500;0;1000;684;316;
2021-11-23 16:49:21;8997018259464;ES MEGASUS;1;1000;0;1000;800;200;
2021-11-23 21:26:52;SURYA BTG;SURYA BATANG;1;2000;0;2000;1420;580;
2021-11-23 21:26:52;8886020033431;KAPUR AJAIB ANTI KECOA DAN NYAMUK;1;3000;0;3000;2700;300;
2021-11-23 21:26:52;8998866203227;MIE SEDAAP AYAM BAKAR LIMAU;1;2700;0;2700;2163;537;
2021-11-23 21:26:52;8992696404441;SUSU BERUANG;1;10000;0;10000;8585;1415;
2021-11-23 21:26:52;PULPEN;PULPEN BIASA;1;2000;0;2000;1500;500;
2021-11-23 22:28:24;8991002105409;KOPI KAPAL API;1;20000;0;20000;18888;1112;
2021-11-23 22:28:24;8718291777199;PHILIPS 8W;1;41000;0;41000;38000;3000;
2021-11-23 22:28:24;8992628022156;MINYAK GORENG BIMOLI POUCH 1 LT;1;23000;0;23000;20000;3000;
2021-11-23 22:28:24;8998989500166;GUDANG GARAM MERAH BESAR 16KS;1;18000;0;18000;17000;1000;
2021-11-23 20:29:53;TELUR;TELUR;3;1667;0;5001;3498;1503;
2021-11-23 20:29:53;8998866200301;MIE SEDAAP GORENG;1;3000;0;3000;2414;586;
2021-11-23 20:29:53;711844110144;KECAP ABC 225 ML;1;9000;0;9000;8200;800;
2021-11-23 20:29:53;ROTI;ROTI 2000;1;2000;0;2000;1800;200;
2021-11-23 20:29:53;8991102987639;WFR TANGO LONG VNL 130G;1;5000;0;5000;4350;650;
2021-11-23 20:29:53;8998866201889;KRISBEE PILLOW STRAWBERRY ICE CREAM 120GR;1;8000;0;8000;7250;750;
2021-11-23 12:37:45;8995333032113;TERIGU GATOT KACA 1 KG;3;10000;0;30000;27039;2961;
2021-11-23 12:37:45;8998866202619;MIE SEDAAP KOREAN SPICY SOUP;1;2700;0;2700;2322;378;
2021-11-23 12:37:45;8994867000179;ROKOK PENA MILD 16;1;15500;0;15500;14500;1000;
2021-11-23 12:37:45;MILKITA;MILKITA;2;250;0;500;400;100;
2021-11-24 09:40:26;8996001600399;LE MINERAL 1500ML;1;5000;0;5000;4042;958;
2021-11-24 09:40:26;TAMARA;TAMARA;2;1000;0;2000;840;1160;
2021-11-24 09:40:26;8991002303928;GULA GULA RELAXA;4;250;0;1000;800;200;
2021-11-24 10:19:14;8992946521416;SABUN SHINZUI;1;5000;0;5000;4000;1000;
2021-11-24 10:19:14;8999999030179;PEPSODENT ACTION 123 COMPLETE 75G;1;6700;0;6700;5170;1530;
2021-11-24 10:19:14;8999999046989;LIFEBUOY MILD CARE 60G;1;3000;0;3000;1911;1089;
2021-11-24 11:05:04;089686611519;QTELA SINGKONG;1;6000;0;6000;4266;1734;
2021-11-24 11:05:04;8994834003752;TICTIC;1;2000;0;2000;1700;300;
2021-11-24 11:05:04;8993110071133;sosis rasa ayam;2;1000;0;2000;1800;200;
2021-11-24 11:05:04;ROTI;ROTI 2000;1;2000;0;2000;1800;200;
2021-11-24 12:14:48;8999999031602;SARI MURNI 20X1.6G;1;6000;0;6000;5400;600;
2021-11-24 12:14:48;8991102714860;MILKIDO STRAW;3;3000;0;9000;6459;2541;
2021-11-24 12:14:48;8996001600269;LE MINERAL 600ML;2;3000;0;6000;3376;2624;
2021-11-24 12:14:48;8886008101053;AQUA 600 ML;1;3500;0;3500;2125;1375;
2021-11-24 12:14:48;TG;TEH GELAS;1;1000;0;1000;729;271;
2021-11-24 12:14:48;8992775001042;PILUS GARUDA MI GORENG;1;5500;0;5500;4810;690;
2021-11-24 12:14:48;8992775001806 pcs;Gery salut malkist chocolate coconut pcs;2;1000;0;2000;1624;376;
2021-11-24 12:14:48;OSCAR;OSKAR"S;1;1000;0;1000;425;575;
2021-11-24 11:19:19;6907992823966;JD BLUEBERRY;1;3500;0;3500;3000;500;
2021-11-24 11:19:19;8997028590014;ARGUS 220ML;2;500;0;1000;684;316;
2021-11-24 12:20:59;TAMARA;TAMARA;2;1000;0;2000;840;1160;
2021-11-24 12:20:59;8997028590014;ARGUS 220ML;2;500;0;1000;684;316;
2021-11-24 12:24:34;8998866202923;FLORIDINA COCO;1;3000;0;3000;2500;500;
2021-11-24 12:24:34;8993989311279;CLAS MILD 12;1;18000;0;18000;15800;2200;
2021-11-24 12:24:34;8992761166052;FRESTEA MELATI 350ML;1;4500;0;4500;3000;1500;
2021-11-24 12:33:13;8992696521629;DNCO COKLT UHT 180ML;1;5000;0;5000;3533;1467;
2021-11-24 12:33:13;8992761166038;PULPY ORANGE 300ML;1;5000;0;5000;3750;1250;
2021-11-24 12:33:13;8996001600375;LE MINERAL 330ML;1;2000;0;2000;1417;583;
2021-11-24 12:40:07;8996001328163;GULA GULA TAMARIN;8;250;0;2000;1600;400;
2021-11-24 12:40:07;8997218010230;yohoo;1;1000;0;1000;900;100;
2021-11-24 12:40:07;VTM;VITAMIN CIMIN;2;500;0;1000;850;150;
2021-11-24 12:40:07;8992761166038;PULPY ORANGE 300ML;2;5000;0;10000;7500;2500;
2021-11-24 12:44:30;8998866501033;MINYAK GORENG SEDAAP POUCH 2L;2;37000;0;74000;70000;4000;
2021-11-24 12:44:30;8997218380159;ICHITAN BROWN SUGAR;1;8000;0;8000;6500;1500;
2021-11-24 12:44:30;8997218380135;ICHITAN GREEN TEA;1;8000;0;8000;6500;1500;
2021-11-24 12:44:30;8992761164546;NUTRIBOOST STRAWBERRY 300ML;1;6500;0;6500;5300;1200;
2021-11-24 12:44:30;8992775001042;PILUS GARUDA MI GORENG;1;5500;0;5500;4810;690;
2021-11-24 12:48:17;8992760223015;OREO CHOCOLATE CREAM 133G;1;8000;0;8000;6300;1700;
2021-11-24 12:48:17;089686044249;SUPERMI NUTRIMI STEAK AYAM;1;3500;0;3500;2800;700;
2021-11-24 12:48:17;8996001305041;ROMA SANDWICH CKLT;1;7000;0;7000;5928;1072;
2021-11-24 12:48:17;8993470671752;JOGER STICK DUO KACANG;2;1000;0;2000;1700;300;
2021-11-24 14:19:17;089686021141;INTER MIE SOTO;4;1000;0;4000;3740;260;
2021-11-24 14:19:17;089686021127;INTER MIE KALDU;1;1000;0;1000;813;187;
2021-11-24 14:19:17;9556001047175;NESCAFE ORI 240ML;1;8500;0;8500;7834;666;
2021-11-24 14:23:01;ROTI;ROTI 2000;1;2000;0;2000;1800;200;
2021-11-24 14:23:01;6907992823935;JD SWEETCORN;1;3500;0;3500;3000;500;
2021-11-24 14:23:01;7622300335809;OREO SOFT CAKE;1;2000;0;2000;1641;359;
2021-11-24 14:23:01;6907992823652;JD CHOCOLATE MILKSHAKE;1;6000;0;6000;5200;800;
2021-11-24 14:23:01;8992761164539;NUTRIBOOST ORANGE 300ML;1;6500;0;6500;5300;1200;
2021-11-24 16:19:23;BALON;BALON CABUT;1;1000;0;1000;900;100;
2021-11-24 16:19:23;8997878004327;GULA GULA MILKITA;4;250;0;1000;800;200;
2021-11-24 16:19:23;8886013257400;TWISTKO;1;1000;0;1000;900;100;
2021-11-24 16:19:23;lolipop;lolipop;1;1000;0;1000;850;150;
2021-11-24 16:19:23;6907992824963;JD MILKY CHOCOLATE;2;3000;0;6000;5200;800;
2021-11-24 16:41:49;6907992823669;JD MILKY STRAW;1;3000;0;3000;2600;400;
2021-11-24 16:41:49;8998866106306;EMERON LOVELY GLOW&BRIGTH 100ML;1;4300;0;4300;3800;500;
2021-11-24 16:41:49;8999999559564;LUX BW SOFT ROSE 90ML;1;5000;0;5000;4000;1000;
2021-11-24 16:50:28;8997028590014;ARGUS 220ML;2;500;0;1000;684;316;
2021-11-24 16:50:28;8997018920081;RED BOLD;1;21000;0;21000;19800;1200;
2021-11-24 16:50:28;8886022830243;BATEREI ABC;2;3000;0;6000;3856;2144;
2021-11-24 16:50:46;8994867007161;ROKOK PENA GOLD 20;1;19000;0;19000;17400;1600;
2021-11-24 16:50:46;8998989300261;GUDANG GARAM SURYA 12 FILTER;1;20000;0;20000;18650;1350;
2021-11-24 16:59:24;8998866202619;MIE SEDAAP KOREAN SPICY SOUP;2;2700;0;5400;4644;756;
2021-11-24 16:59:24;8996001402023;TB TORA SUSU;2;1500;0;3000;1866;1134;
2021-11-24 17:52:37;8992730996185;GULA GULA CRISPY;1;2000;0;2000;1500;500;
2021-11-24 17:52:37;8992775610367;Garuda Koro paggang;1;1000;0;1000;828;172;
2021-11-24 17:52:37;8997878004327;GULA GULA MILKITA;4;250;0;1000;800;200;
2021-11-24 17:52:37;8992741952262;GULA GULA YUPI;4;250;0;1000;800;200;
2021-11-24 17:52:37;8996001600399;LE MINERAL 1500ML;1;5000;0;5000;4042;958;
2021-11-24 18:44:06;8993379260767;SABUN LERVIA;1;5000;0;5000;3415;1585;
2021-11-24 18:44:06;8994867000179;ROKOK PENA MILD 16;1;15500;0;15500;14500;1000;
2021-11-24 19:40:50;8997218010230;yohoo;1;1000;0;1000;900;100;
2021-11-24 19:40:50;8994867000179;ROKOK PENA MILD 16;1;15500;0;15500;14500;1000;
2021-11-24 20:36:03;TG;TEH GELAS;1;1000;0;1000;729;271;
2021-11-24 20:36:58;8998866202770;MIE SEDAAP SALERO PADANG;1;2500;0;2500;2362;138;
2021-11-24 21:31:28;8999909002821;MARLBORO BLACK 16;1;23000;0;23000;21850;1150;
2021-11-24 22:01:24;6907992823935;JD SWEETCORN;1;3500;0;3500;3000;500;
2021-11-24 22:01:24;8999909010567;234 DJI SAM SOE 16;1;23000;0;23000;21500;1500;
2021-11-25 09:02:55;KP;KERIPIK PISANG;1;5000;0;5000;5000;0;
2021-11-25 09:02:55;7622300335809;OREO SOFT CAKE;1;2000;0;2000;1641;359;
2021-11-25 09:02:55;8993274532105;BOLU;2;1000;0;2000;1666;334;
2021-11-25 09:02:55;8997218010230;yohoo;1;1000;0;1000;900;100;
2021-11-25 12:02:33;8994867007161;ROKOK PENA GOLD 20;1;19000;0;19000;17400;1600;
2021-11-25 12:04:25;7622210437686;BISKUAT;2;500;0;1000;800;200;
2021-11-25 12:04:25;8992957214307;SAFARI MECES;1;5500;0;5500;4500;1000;
2021-11-25 12:04:25;8995333060772;TERIGU GATOT KACA 500GR;1;5500;0;5500;4564;936;
2021-11-25 12:04:25;8998866202244;EKOMIE BUMBU KALDU AYAM;2;1000;0;2000;1596;404;
2021-11-25 12:04:25;8998866200301;MIE SEDAAP GORENG;1;3000;0;3000;2414;586;
2021-11-25 12:04:25;8998866200561;EKOMIE SUPER 600GR;1;10000;0;10000;8615;1385;
2021-11-25 13:14:14;6907992823966;JD BLUEBERRY;1;3500;0;3500;3000;500;
2021-11-25 13:14:14;8997218010230;yohoo;1;1000;0;1000;900;100;
2021-11-25 13:14:14;8991002105430;KOPI KAPAL API 65G;1;5000;0;5000;4145;855;
2021-11-25 13:26:34;8994867000162;ROKOK PUNDIMAS KRETEK16;1;10000;0;10000;8600;1400;
2021-11-25 13:26:34;8998989110167;SURYA GUDANG GARAM 16 FILTER;1;27000;0;27000;25200;1800;
2021-11-25 13:28:02;089686043204;INDOMIE MIE ACEH;1;2700;0;2700;2452;248;
2021-11-25 13:28:02;ARG;ARGUS DOS 220ML;1;15000;0;15000;13700;1300;
2021-11-25 13:28:02;ROTI;ROTI 2000;1;2000;0;2000;1800;200;
2021-11-25 14:18:28;8994867000179;ROKOK PENA MILD 16;1;15500;0;15500;14500;1000;
2021-11-25 14:18:28;8998989500166;GUDANG GARAM MERAH BESAR 16KS;1;18000;0;18000;17000;1000;
2021-11-25 14:18:28;8999909001909;MAGNUM REVAMP BLACK 12;1;18000;0;18000;16750;1250;
2021-11-25 14:37:04;8992959953136;SWEETY BRONZE L20;1;40000;0;40000;36770;3230;
2021-11-25 14:37:04;lolipop;lolipop;1;1000;0;1000;850;150;
2021-11-25 14:37:04;089686611519;QTELA SINGKONG;1;6000;0;6000;4266;1734;
2021-11-25 14:37:04;8999999059781;SUNLIGHT LIME NEW POUCH 210ML;1;5000;0;5000;4700;300;
2021-11-25 14:54:59;8999999195649;SARIWANGI 25X1.86G;1;6000;0;6000;5202;798;
2021-11-25 14:54:59;8996001301142;ROMA KELAPA;1;8000;0;8000;7035;965;
2021-11-25 14:54:59;8994834003752;TICTIC;1;2000;0;2000;1700;300;
2021-11-25 14:54:59;8991102987639;WFR TANGO LONG VNL 130G;1;5000;0;5000;4350;650;
2021-11-25 14:54:59;8993110071133;sosis rasa ayam;2;1000;0;2000;1800;200;
2021-11-27 10:07:40;4902430745703;DOWNY SUNRISE FRESH 10ML;10;500;0;5000;3930;1070;
2021-11-27 10:07:40;8992770033178;Masako;11;500;0;5500;4950;550;
2021-11-27 10:07:40;711844110083;KECAP ABC 275 ML;1;16000;0;16000;15000;1000;
2021-11-27 10:07:40;8996001600269;LE MINERAL 600ML;1;3000;0;3000;1688;1312;
2021-11-27 14:16:27;8994023000050;MEGKEJU SERBAGUNA 165G;1;13000;0;13000;12000;1000;
2021-11-27 14:26:04;Vita Jelly;Vita Jelly;1;1000;0;1000;766;234;
2021-11-27 14:26:04;8997218010230;yohoo;1;1000;0;1000;900;100;
2021-11-27 14:26:04;8991102987639;WFR TANGO LONG VNL 130G;1;5000;0;5000;4350;650;
2021-11-27 14:26:04;11222;LEM KOREA;1;10000;0;10000;8000;2000;
2021-11-27 14:46:51;8994867007161;ROKOK PENA GOLD 20;1;19000;0;19000;17400;1600;
2021-11-27 14:46:51;TELUR;TELUR;3;1667;0;5001;3498;1503;
2021-11-27 14:46:51;8998866200578;MIE SEDAAP KARI KENTAL;1;2700;0;2700;2423;277;
2021-11-27 14:46:51;8991102714624;Tanggo Kido Drink 115ml;2;3000;0;6000;4000;2000;
2021-11-27 15:07:47;8997218380159;ICHITAN BROWN SUGAR;1;8000;0;8000;6500;1500;
2021-11-27 15:07:47;8993989311699;CLAS MILD 16 FILTER;1;24000;0;24000;21700;2300;
2021-11-27 15:07:47;8999909085114;SAMPOERNA KRETEK HIJAU 12;1;14000;0;14000;11650;2350;
2021-11-27 15:39:35;JD VM;JD VANILLA MILKSHAKE;1;5000;0;5000;4300;700;
2021-11-27 15:39:35;6907992823676;JD PEACH;1;2000;0;2000;1700;300;
2021-11-27 15:39:35;8992730950194;GULA GULA KOIN;2;500;0;1000;800;200;
2021-11-27 15:39:35;7622300761349;OREO MINI CKLT;1;7500;0;7500;6500;1000;
2021-11-27 16:00:25;8992775203422;GARUDA ROSTA OVEN BAWANG 100G;1;8000;0;8000;7322;678;
2021-11-27 16:00:25;8998989300261;GUDANG GARAM SURYA 12 FILTER;1;20000;0;20000;18650;1350;
2021-11-27 18:00:49;8996001600375;LE MINERAL 330ML;1;2000;0;2000;1417;583;
2021-11-27 18:00:49;8997028590014;ARGUS 220ML;4;500;0;2000;1368;632;
2021-11-27 18:08:46;ABC;BATERAI ABC BIRU;2;3000;0;6000;3856;2144;
2021-11-27 18:08:46;8992775002582;DILAN CHOCO;1;2000;0;2000;1503;497;
2021-11-27 18:08:46;8996001302316;MALKIST ABON SCT;2;1000;0;2000;1680;320;
2021-11-27 18:23:32;8999999031602;SARI MURNI 20X1.6G;1;6000;0;6000;5400;600;
2021-11-27 18:23:32;8992761111540;FANTA STRAWBERY SLIM CAM 250ML;1;5000;0;5000;3750;1250;
2021-11-27 18:23:32;8851019210117;POCKY CHOCOLATE FLAVOUR 47G;1;7500;0;7500;5671;1829;
2021-11-27 18:56:01;8998866200301;MIE SEDAAP GORENG;1;3000;0;3000;2414;586;
2021-11-27 18:56:01;8999909002821;MARLBORO BLACK 16;1;23000;0;23000;21850;1150;
2021-11-27 19:28:14;8997011700123;BIJAG BIHUN JAGUNG 300GR;1;6000;0;6000;5100;900;
2021-11-27 19:50:39;8999999555450;VIXAL PEMB PORS BIRU 190ML;1;5000;0;5000;4200;800;
2021-11-27 20:22:55;8992775110157;GARUDA KACANG KULIT;1;5000;0;5000;3925;1075;
2021-11-26 09:24:36;8998866202930;SEDAAP AYAM JERIT CUP;1;5000;0;5000;3825;1175;
2021-11-26 09:24:36;8996001401200;GENTLEGEN;1;18000;0;18000;16000;2000;
2021-11-26 09:24:36;8992775110140;GARUDA KACANG KULIT 160G;1;12000;0;12000;10012;1988;
2021-11-26 09:24:36;8998866888615;GIV BIRU KOTAK 76G;1;2000;0;2000;1820;180;
2021-11-26 10:21:24;8992775203422;GARUDA ROSTA OVEN BAWANG 100G;1;8000;0;8000;7322;678;
2021-11-26 10:21:24;8991188943536;SASA SANTAN KELAPA 65ML;1;3000;0;3000;2437;563;
2021-11-26 10:21:24;8992770033178;Masako;4;500;0;2000;1800;200;
2021-11-26 11:30:23;8991102714624;Tanggo Kido Drink 115ml;1;3000;0;3000;2000;1000;
2021-11-26 11:30:23;8992775002582;DILAN CHOCO;2;2000;0;4000;3006;994;
2021-11-26 12:24:58;8999999059781;SUNLIGHT LIME NEW POUCH 210ML;1;5000;0;5000;4700;300;
2021-11-26 12:24:58;8991188943536;SASA SANTAN KELAPA 65ML;1;3000;0;3000;2437;563;
2021-11-26 12:24:58;8991102714495;TANGO DRINK COKLAT;1;5000;0;5000;3818;1182;
2021-11-26 12:25:24;8991188943369;Sasa 5000;1;5000;0;5000;4091;909;
2021-11-26 12:25:24;8997218010230;yohoo;5;1000;0;5000;4500;500;
2021-11-26 13:21:36;8996001302316;MALKIST ABON SCT;1;1000;0;1000;840;160;
2021-11-26 13:21:36;8998866610278;DAIA VIOLET GUSSET 565G;1;10000;0;10000;8700;1300;
2021-11-26 13:21:36;MOLTO PINK;MOLTO ALL IN ONE 11 ML;10;500;0;5000;4000;1000;
2021-11-26 13:21:36;ARG;ARGUS DOS 220ML;1;15000;0;15000;13700;1300;
2021-11-26 13:21:36;8999999059323;LIFEBUOY TS LEMONFRESH 75G;1;4000;0;4000;3225;775;
2021-11-26 13:30:44;8991909101016;URBAN MILD 16;1;17000;0;17000;15800;1200;
2021-11-26 13:51:34;8998866201520;KOPI TOP TORAJA MURNI;1;11000;0;11000;9600;1400;
2021-11-26 13:51:34;8992931006256;tessa;4;1000;0;4000;3600;400;
2021-11-26 13:59:17;8991102026383;AIR CRYSTALINE 1.5 L;1;5000;0;5000;3471;1529;
2021-11-26 13:59:17;8996200900092;HEROCYN 85GR;1;13000;0;13000;11650;1350;
2021-11-26 13:59:17;8992959117538;SFX COMFORT SLIM WING 20;1;12000;0;12000;10947;1053;
2021-11-26 14:00:17;8992702000018;INDOMILK PUTIH 370G;1;11000;0;11000;9708;1292;
2021-11-26 14:00:17;8991188943536;SASA SANTAN KELAPA 65ML;1;3000;0;3000;2437;563;
2021-11-26 14:00:17;8997012320962;BALADO PEDAS MANIS;1;5000;0;5000;3950;1050;
2021-11-26 14:00:17;8993226365522;GARAM MEJA GYURI 200GR;1;2000;0;2000;1700;300;
2021-11-26 14:11:28;8999909096004;SAMPOERNA 16 FILTER;1;26000;0;26000;23100;2900;
2021-11-26 14:14:48;8999999192150;ROYCO FDS CHICKEN 100GR;1;5000;0;5000;4300;700;
2021-11-26 14:15:48;8998866808248;SOKLIN LAVENDER 490 GRAM;1;18000;0;18000;17000;1000;
2021-11-26 14:15:48;8996001401200;GENTLEGEN;1;18000;0;18000;16000;2000;
2021-11-26 14:36:05;8993110071133;sosis rasa ayam;65;1000;0;65000;58500;6500;
2021-11-26 14:59:00;8998866108126;POSH HIJAB WINTER MAGIC 150ML;1;20000;0;20000;18600;1400;
2021-11-26 14:59:00;8993335529419;Sabun Total de Parfumee Floral Vibes;1;24500;0;24500;22000;2500;
2021-11-26 15:27:23;8999999195649;SARIWANGI 25X1.86G;1;6000;0;6000;5202;798;
2021-11-26 15:27:23;8991102385091;WFR TANGO CKLT 7G;1;10000;0;10000;8169;1831;
2021-11-26 15:37:54;8997021870137;FRESH CARE SPLASH FRUITY 10ML;1;12000;0;12000;10000;2000;
2021-11-26 15:58:51;8995333000822;TERIGU KOMPAS SOFT 500GR;2;6000;0;12000;10408;1592;
2021-11-26 15:58:51;gula;GULA;1;12500;0;12500;11500;1000;
2021-11-26 15:58:51;8886022971298;BATERAI ALKALINE 06;1;12000;0;12000;10557;1443;
2021-11-26 15:58:51;8998989300261;GUDANG GARAM SURYA 12 FILTER;1;20000;0;20000;18650;1350;
2021-11-26 15:58:51;8998989500166;GUDANG GARAM MERAH BESAR 16KS;1;18000;0;18000;17000;1000;
2021-11-26 15:58:51;8999909001909;MAGNUM REVAMP BLACK 12;1;18000;0;18000;16750;1250;
2021-11-26 17:12:17;8998866202619;MIE SEDAAP KOREAN SPICY SOUP;1;2700;0;2700;2322;378;
2021-11-26 17:12:17;7622201430153;OREO CHOCOLATE 38G;1;2000;0;2000;1641;359;
2021-11-28 10:13:32;8992775002582;DILAN CHOCO;1;2000;0;2000;1503;497;
2021-11-28 10:13:32;8992775305003 pcs;Gery Salut Coklat pcs;2;1000;0;2000;1624;376;
2021-11-28 11:09:07;6907992823829;JD MILKY MILK;1;3000;0;3000;2600;400;
2021-11-28 11:09:07;6907992823935;JD SWEETCORN;1;3500;0;3500;3000;500;
2021-11-28 11:09:07;6907992825076;JD WATERMELON APPLE;1;2000;0;2000;1700;300;
2021-11-28 11:31:49;8991188943536;SASA SANTAN KELAPA 65ML;1;3000;0;3000;2437;563;
2021-11-28 11:31:49;ES POTONG;ES POTONG;1;1000;0;1000;500;500;
2021-11-28 11:31:49;ROTI;ROTI 2000;1;2000;0;2000;1800;200;
2021-11-28 11:31:49;BALON GAS;BALON GAS;2;500;0;1000;800;200;
2021-11-28 12:34:02;8999909010567;234 DJI SAM SOE 16;1;23000;0;23000;21500;1500;
2021-11-28 12:57:09;8997231980022;O'JELLY MINI STRAWBERRY;1;3000;0;3000;2250;750;
2021-11-28 12:57:09;8997218010230;yohoo;1;1000;0;1000;900;100;
2021-11-28 12:57:09;6907992823676;JD PEACH;1;2000;0;2000;1700;300;
2021-11-28 12:57:09;ES POTONG;ES POTONG;1;1000;0;1000;500;500;
2021-11-28 14:08:23;8991188943536;SASA SANTAN KELAPA 65ML;1;3000;0;3000;2437;563;
2021-11-28 14:25:53;9999;ISOLASI LAKBAN;1;8000;0;8000;6500;1500;
2021-11-28 14:45:41;8851019210292;POCKY COOKIES & CREAME 47 GR;1;7000;0;7000;5671;1329;
2021-11-28 14:45:41;8998866200578;MIE SEDAAP KARI KENTAL;1;2700;0;2700;2423;277;
2021-11-28 14:45:41;089686043204;INDOMIE MIE ACEH;4;2700;0;10800;9808;992;
2021-11-28 15:26:22;JGR;JOGER CHOCKY PASTA;1;20000;0;20000;18190;1810;
2021-11-28 15:53:27;8998989300261;GUDANG GARAM SURYA 12 FILTER;1;20000;0;20000;18650;1350;
2021-11-28 15:53:27;8994867007161;ROKOK PENA GOLD 20;1;19000;0;19000;17400;1600;
2021-11-28 15:53:27;8999909002821;MARLBORO BLACK 16;1;23000;0;23000;21850;1150;
2021-11-28 15:53:27;6907992825076;JD WATERMELON APPLE;1;2000;0;2000;1700;300;
2021-11-28 15:53:27;8996001440001;TB JAHE SUSU;2;1500;0;3000;1740;1260;
2021-11-28 15:59:45;8991188943536;SASA SANTAN KELAPA 65ML;1;3000;0;3000;2437;563;
2021-11-28 15:59:45;ROTI;ROTI 2000;1;2000;0;2000;1800;200;
2021-11-28 16:32:10;8992222050418;GATSBY NORMAL 38GR;1;5000;0;5000;3850;1150;
2021-11-28 16:52:04;9556001047175;NESCAFE ORI 240ML;1;8500;0;8500;7834;666;
2021-11-28 16:52:04;6907992823966;JD BLUEBERRY;1;3500;0;3500;3000;500;
2021-11-28 16:52:04;7622300335809;OREO SOFT CAKE;1;2000;0;2000;1641;359;
2021-11-28 17:27:47;7622300405588;KEJUCAKE 16G;1;2000;0;2000;1641;359;
2021-11-28 17:27:47;8993989311699;CLAS MILD 16 FILTER;1;24000;0;24000;21700;2300;
2021-11-28 17:27:47;8996001600269;LE MINERAL 600ML;2;3000;0;6000;3376;2624;
2021-11-28 17:27:47;8999909096004;SAMPOERNA 16 FILTER;1;26000;0;26000;23100;2900;
2021-11-28 17:56:25;8992959953044;SWEETY BRONZE XL1;1;3000;0;3000;2311;689;
2021-11-28 17:56:25;8991188943536;SASA SANTAN KELAPA 65ML;1;3000;0;3000;2437;563;
2021-11-28 17:56:25;8998866600521;SOKLIN FLOORCLENER KUNING 400ML;1;6000;0;6000;5025;975;
2021-11-28 19:50:50;8998866200325;MIE SEDAAP SOTO;1;2700;0;2700;2282;418;
2021-11-28 20:21:18;TAMARA;TAMARA;1;1000;0;1000;420;580;
2021-11-28 20:21:18;OSCAR;OSKAR"S;1;1000;0;1000;425;575;
2021-11-28 20:21:18;8992775201473;GARUDA PILUS SAPI PANGGANG 8G;2;500;0;1000;758;242;
2021-11-29 10:22:09;8991102228053;TEH GELAS BOTOL;1;3000;0;3000;1695;1305;
2021-11-29 10:22:09;8997009510055;YOU C1000;1;13000;0;13000;9000;4000;
2021-11-29 10:22:09;8999999556341;MOLTO EDP PINK ROSE 20ML;1;1000;0;1000;800;200;
2021-11-29 10:44:57;gula;GULA;1;12500;0;12500;11500;1000;
2021-11-29 10:44:57;8992959508862;SWEETY SILVER PANTS M8;1;16800;0;16800;15229;1571;
2021-11-29 11:44:40;8994867000179;ROKOK PENA MILD 16;1;15500;0;15500;14500;1000;
2021-11-29 11:44:40;8991004011906;KOPI BORONG;1;10000;0;10000;8333;1667;
2021-11-29 11:44:40;8998866202626;Top Kopi Gula Aren 22gr;3;1000;0;3000;1770;1230;
2021-11-29 12:00:35;8997025914042;ATB MARIE SUSU 185G;1;7000;0;7000;4554;2446;
2021-11-29 12:00:35;8996001312698;MALKIST KOREAN;1;6500;0;6500;5500;1000;
2021-11-29 14:03:30;711844110113;KECAP ABC 135 ML;1;7000;0;7000;6400;600;
2021-11-29 14:03:30;8992753031894;FRISIAN FLAG;1;2000;0;2000;1000;1000;
2021-11-29 14:28:02;8998989300261;GUDANG GARAM SURYA 12 FILTER;1;20000;0;20000;18650;1350;
2021-11-29 14:28:02;8994867007161;ROKOK PENA GOLD 20;1;19000;0;19000;17400;1600;
2021-11-29 14:28:02;KOPIKO;KOPIKO;4;250;0;1000;700;300;
2021-11-29 14:28:02;8991914101513;VIPER KRETEK 12;1;7000;0;7000;5800;1200;
2021-11-29 15:51:44;ROTI;ROTI 2000;1;2000;0;2000;1800;200;
2021-11-29 15:51:44;8991909101016;URBAN MILD 16;1;17000;0;17000;15800;1200;
2021-11-29 15:51:44;123124;KOREK BIASA;1;2000;0;2000;1300;700;
2021-11-29 15:52:17;6907992823591;JD STRAW MILKSHAKE;1;5000;0;5000;4300;700;
2021-11-29 15:52:17;8998866200301;MIE SEDAAP GORENG;1;3000;0;3000;2414;586;
2021-11-29 16:38:50;8999999524722;SUNLIGHT LIME NEW PCH 435ML;1;10000;0;10000;9100;900;
2021-11-29 16:38:50;8998866200561;EKOMIE SUPER 600GR;1;10000;0;10000;8615;1385;
2021-11-29 16:38:50;8997011700123;BIJAG BIHUN JAGUNG 300GR;1;6000;0;6000;5100;900;
2021-11-29 16:59:24;8991102026383;AIR CRYSTALINE 1.5 L;1;5000;0;5000;3471;1529;
2021-11-29 16:59:24;ROTI;ROTI 2000;1;2000;0;2000;1800;200;
2021-11-29 16:59:24;7622201430153;OREO CHOCOLATE 38G;1;2000;0;2000;1641;359;
2021-11-29 17:44:03;8997009510055;YOU C1000;1;13000;0;13000;9000;4000;
2021-11-29 17:44:03;089686021127;INTER MIE KALDU;5;1000;0;5000;4065;935;
2021-11-29 17:44:03;8998866203272;SUKSES AYAM GEPREK;1;4000;0;4000;3046;954;
2021-11-29 17:44:03;8998866202244;EKOMIE BUMBU KALDU AYAM;2;1000;0;2000;1596;404;
2021-11-29 18:30:43;8997028590014;ARGUS 220ML;4;500;0;2000;1368;632;
2021-11-29 18:30:43;Garuda Pilus;Garuda Pilus Rasa Abon Pcs;2;500;0;1000;802;198;
2021-11-29 18:30:43;8991102228053;TEH GELAS BOTOL;1;3000;0;3000;1695;1305;
2021-11-29 18:31:11;ARG;ARGUS DOS 220ML;1;15000;0;15000;13700;1300;
2021-11-29 18:48:28;8992775002582;DILAN CHOCO;1;2000;0;2000;1503;497;
2021-11-29 18:48:28;TBR;TEPUNG BERAS ROSE BRAND;2;8000;0;16000;12300;3700;
2021-11-29 18:49:10;8886008101053;AQUA 600 ML;2;3500;0;7000;4250;2750;
2021-11-29 18:49:10;gula;GULA;3;12500;0;37500;34500;3000;
2021-11-29 20:12:54;8993058105013;EXTRA JOSS;1;12000;0;12000;9773;2227;
2021-11-29 20:12:54;SF GULUNG;SAFFANAH ROTI GULUNG;1;6000;0;6000;5500;500;
2021-11-29 20:12:54;8993110071133;sosis rasa ayam;2;1000;0;2000;1800;200;
2021-11-30 10:13:36;8997028590014;ARGUS 220ML;4;500;0;2000;1368;632;
2021-11-30 10:13:36;PULPEN;PULPEN BIASA;1;2000;0;2000;1500;500;
2021-11-30 10:13:52;8999999529840;CLEAR SHP SPR FRSH APPLE 9 AML;1;10500;0;10500;9300;1200;
2021-11-30 10:40:18;8997018920081;RED BOLD;1;21000;0;21000;19800;1200;
2021-11-30 10:40:18;ARG;ARGUS DOS 220ML;1;15000;0;15000;13700;1300;
2021-11-30 10:40:18;123124;KOREK BIASA;1;2000;0;2000;1300;700;
2021-11-30 10:40:40;ROTI;ROTI 2000;1;2000;0;2000;1800;200;
2021-11-30 10:40:40;ABC;BATERAI ABC BIRU;2;3000;0;6000;3856;2144;
2021-11-30 10:41:15;7622210437686;BISKUAT;2;500;0;1000;800;200;
2021-11-30 10:41:15;SF GULUNG;SAFFANAH ROTI GULUNG;1;6000;0;6000;5500;500;
2021-11-30 12:28:00;KIKO;KIKO;4;1000;0;4000;2000;2000;
2021-11-30 12:28:00;8998989500166;GUDANG GARAM MERAH BESAR 16KS;1;18000;0;18000;17000;1000;
2021-11-30 12:28:00;8999909004221;SAMPOERNA ULTRAMILD 16;1;22000;0;22000;20350;1650;
2021-11-30 12:49:32;8992775002582;DILAN CHOCO;3;2000;0;6000;4509;1491;
2021-11-30 12:49:32;8991002114067;PIKOPI;2;1000;0;2000;1090;910;
2021-11-30 12:50:00;6907992825076;JD WATERMELON APPLE;1;2000;0;2000;1700;300;
2021-11-30 12:50:00;8998989300261;GUDANG GARAM SURYA 12 FILTER;1;20000;0;20000;18650;1350;
2021-11-30 12:50:00;76239878;MARLBORO GOLD;1;32000;0;32000;30600;1400;
2021-11-30 13:42:51;8998866610278;DAIA VIOLET GUSSET 565G;1;10000;0;10000;8700;1300;
2021-11-30 13:42:51;4902430542753;PARFUM DOWNY;3;1000;0;3000;2250;750;
2021-11-30 14:32:01;8991102228053;TEH GELAS BOTOL;1;3000;0;3000;1695;1305;
2021-11-30 14:32:01;8994907000428;KECAP SACHET ABC;2;600;0;1200;1000;200;
2021-11-30 14:32:01;ES POTONG;ES POTONG;2;1000;0;2000;1000;1000;
2021-11-30 14:32:01;6907992825076;JD WATERMELON APPLE;2;2000;0;4000;3400;600;
2021-11-30 14:32:01;8993379200879;SABUN HARMONY MELON 70G;1;2000;0;2000;1652;348;
2021-11-30 15:18:28;BALON GAS;BALON GAS;1;500;0;500;400;100;
2021-11-30 15:18:28;8998989110167;SURYA GUDANG GARAM 16 FILTER;1;27000;0;27000;25200;1800;
2021-11-30 15:45:12;089686043204;INDOMIE MIE ACEH;1;2700;0;2700;2452;248;
2021-11-30 15:45:12;8998866200578;MIE SEDAAP KARI KENTAL;1;2700;0;2700;2423;277;
2021-11-30 15:45:12;8993110071133;sosis rasa ayam;1;1000;0;1000;900;100;
2021-11-30 15:45:12;Vita Jelly;Vita Jelly;2;1000;0;2000;1532;468;
2021-11-30 16:31:49;8996001600399;LE MINERAL 1500ML;1;5000;0;5000;4042;958;
2021-11-30 16:31:49;AMPLOP DOS;AMPLOP DOS;1;20000;0;20000;17500;2500;
2021-11-30 16:31:49;AMPLOP;AMPLOP;4;250;0;1000;700;300;
2021-11-30 16:52:42;8994834003752;TICTIC;1;2000;0;2000;1700;300;
2021-11-30 16:52:42;TERASI;ABC TERASI SCT;3;1500;0;4500;3000;1500;
2021-11-30 16:55:57;8994867000179;ROKOK PENA MILD 16;1;15500;0;15500;14500;1000;
2021-11-30 17:40:19;8997028590014;ARGUS 220ML;10;500;0;5000;3420;1580;
2021-11-30 17:40:45;8998989500166;GUDANG GARAM MERAH BESAR 16KS;1;18000;0;18000;17000;1000;
2021-11-30 17:40:45;8998989110167;SURYA GUDANG GARAM 16 FILTER;1;27000;0;27000;25200;1800;
2021-11-30 17:40:45;8991004011906;KOPI BORONG;1;10000;0;10000;8333;1667;
2021-11-30 17:40:45;8991909101016;URBAN MILD 16;1;17000;0;17000;15800;1200;
2021-11-30 18:27:19;8997028590045;ARGUS BTL 330ML;1;2000;0;2000;1291;709;
2021-11-30 18:27:19;8991002122000;ABC CHOCO MALT COFFE;1;3000;0;3000;2278;722;
2021-11-30 18:27:19;8992775312469;GERY SALUT COKELAT;1;11000;0;11000;9679;1321;
2021-11-30 18:27:19;8991102977647;Tango Choco Tiramisu 20x7 gr;1;10000;0;10000;8200;1800;
2021-11-30 18:37:36;8998989300261;GUDANG GARAM SURYA 12 FILTER;3;20000;0;60000;55950;4050;
2021-11-30 18:37:50;8997028590045;ARGUS BTL 330ML;1;2000;0;2000;1291;709;
2021-11-30 18:37:50;8993989311699;CLAS MILD 16 FILTER;1;24000;0;24000;21700;2300;
2021-11-30 19:29:54;ROTI;ROTI 2000;1;2000;0;2000;1800;200;
2021-11-30 19:29:54;8994867007161;ROKOK PENA GOLD 20;1;19000;0;19000;17400;1600;
2021-11-30 19:29:54;8999909010567;234 DJI SAM SOE 16;1;23000;0;23000;21500;1500;
2021-11-30 19:29:54;8993989311699;CLAS MILD 16 FILTER;2;24000;0;48000;43400;4600;
2021-11-30 19:29:54;8999909002821;MARLBORO BLACK 16;1;23000;0;23000;21850;1150;
2021-11-30 20:20:28;ROTI;ROTI 2000;1;2000;0;2000;1800;200;
2021-11-30 20:20:28;8991102228053;TEH GELAS BOTOL;1;3000;0;3000;1695;1305;
2021-11-30 20:20:28;TG APEL;TEH GELAS APEL;1;2000;0;2000;1178;822;
2021-11-30 20:21:01;8998866203227;MIE SEDAAP AYAM BAKAR LIMAU;1;2700;0;2700;2163;537;
2021-11-30 20:21:01;8997028590014;ARGUS 220ML;2;500;0;1000;684;316;
2021-11-30 21:15:14;8992775002582;DILAN CHOCO;1;2000;0;2000;1503;497;
2021-11-30 22:06:55;8999999008475;SUNLIGHT LIME NEW REF 1600ML;1;35000;0;35000;31955;3045;
2021-11-30 22:06:55;8992959508862;SWEETY SILVER PANTS M8;1;16800;0;16800;15229;1571;
2021-11-30 22:06:55;8992761164546;NUTRIBOOST STRAWBERRY 300ML;1;6500;0;6500;5300;1200;
2021-11-30 22:06:55;ARG;ARGUS DOS 220ML;1;15000;0;15000;13700;1300;
2021-12-01 11:16:53;8992761164546;NUTRIBOOST STRAWBERRY 300ML;1;6500;0;6500;5300;1200;
2021-12-01 11:16:53;8992761166052;FRESTEA MELATI 350ML;2;4500;0;9000;6000;3000;
2021-12-01 11:16:53;9556001047175;NESCAFE ORI 240ML;1;8500;0;8500;7834;666;
2021-12-01 11:47:22;8996001328163;GULA GULA TAMARIN;10;250;0;2500;2000;500;
2021-12-01 11:47:22;8994867000179;ROKOK PENA MILD 16;1;15500;0;15500;14500;1000;
2021-12-01 13:07:26;8996001600269;LE MINERAL 600ML;7;3000;0;21000;11816;9184;
2021-12-01 13:07:26;8992775203422;GARUDA ROSTA OVEN BAWANG 100G;2;8000;0;16000;14644;1356;
2021-12-01 13:07:26;8998866201469;POTABEE REGULER BBQ BEEF 68 GR;2;8000;0;16000;14400;1600;
2021-12-01 13:23:36;8994867007161;ROKOK PENA GOLD 20;1;19000;0;19000;17400;1600;
2021-12-01 14:24:36;711844120037;SAMBAL ABC 135 ML;1;7000;0;7000;5600;1400;
2021-12-01 14:24:36;8998989300261;GUDANG GARAM SURYA 12 FILTER;1;20000;0;20000;18650;1350;
2021-12-01 15:20:54;8997218380074;ICHITAN MILK TEA;1;8000;0;8000;6500;1500;
2021-12-01 15:33:14;8992628026147;BIMOLI 250ML;1;8000;0;8000;6650;1350;
2021-12-01 16:26:39;8992696523067;MILO ACTVGO UHT 180ML;1;5000;0;5000;3719;1281;
2021-12-01 16:26:39;8994834006128;TICTIC PEDAS;1;2000;0;2000;1700;300;
2021-12-01 16:26:39;8886013213208;FRENCH FREIS 2000;1;5000;0;5000;3750;1250;
2021-12-02 16:29:13;8999999053291;LIFEBUOY LEMONFRESH 110G;1;15000;0;15000;14245;755;
2021-12-02 16:29:13;8993335521260;Sabun Total Violet 900gr;1;15000;0;15000;13800;1200;
2021-12-02 16:29:13;8999999030179;PEPSODENT ACTION 123 COMPLETE 75G;3;6700;0;20100;15510;4590;
2021-12-02 16:29:13;8999999390198;SUNLIGHT LIME NEW POUCH 755ML;1;25000;0;25000;22433;2567;
2021-12-02 12:36:53;4902430745703;DOWNY SUNRISE FRESH 10ML;11;500;0;5500;4323;1177;
2021-12-02 12:36:53;8999999524722;SUNLIGHT LIME NEW PCH 435ML;1;10000;0;10000;9100;900;
2021-12-02 15:31:57;SF TAWAR ORI;SAFFANAH TAWAR ORI;1;9000;0;9000;8000;1000;
2021-12-02 15:31:57;8993110071133;sosis rasa ayam;7;1000;0;7000;6300;700;
2021-12-02 15:31:57;8993007001557;INDOMILK SKM 37G;1;1500;0;1500;1081;419;
2021-12-02 16:24:17;8999909004221;SAMPOERNA ULTRAMILD 16;1;22000;0;22000;20350;1650;
2021-12-02 16:46:46;8991102230308;BLASTER PINK;1;5000;0;5000;3106;1894;
2021-12-02 16:46:46;8996001600641;TORA CAPPUCINO;1;3500;0;3500;2750;750;
2021-12-02 17:00:02;SURYA BTG;SURYA BATANG;1;2000;0;2000;1420;580;
2021-12-02 17:00:02;123124;KOREK BIASA;1;2000;0;2000;1300;700;
2021-12-02 18:12:27;8992388111206;MIE ABC SELERA PEDAS-GULAI AYAM PEDAS;2;2500;0;5000;4044;956;
2021-12-02 18:12:27;4902430745703;DOWNY SUNRISE FRESH 10ML;11;500;0;5500;4323;1177;
2021-12-02 18:12:27;TELUR;TELUR;1;2000;0;2000;1166;834;
2021-12-02 18:12:27;8992736524306;Sasa Bumbu Nasi Goreng Barbeque;1;2000;0;2000;1181;819;
2021-12-02 18:13:05;gula;GULA;1;12500;0;12500;11500;1000;
2021-12-02 18:19:50;8993989311279;CLAS MILD 12;1;18000;0;18000;15800;2200;
2021-12-02 18:19:50;8998989300261;GUDANG GARAM SURYA 12 FILTER;1;20000;0;20000;18650;1350;
2021-12-02 18:19:50;8999909004221;SAMPOERNA ULTRAMILD 16;1;22000;0;22000;20350;1650;
2021-12-02 18:39:07;8993335529358;Sabun Oxyklin Cair 750ml;1;21000;0;21000;19200;1800;
2021-12-02 18:39:33;8991102228053;TEH GELAS BOTOL;2;3000;0;6000;3390;2610;
2021-12-02 18:39:33;8998989110167;SURYA GUDANG GARAM 16 FILTER;1;27000;0;27000;25200;1800;
2021-12-02 19:25:52;ARG;ARGUS DOS 220ML;1;15000;0;15000;13700;1300;
2021-12-02 19:29:31;8999909010567;234 DJI SAM SOE 16;1;23000;0;23000;21500;1500;
2021-12-02 19:29:31;8997028590014;ARGUS 220ML;4;500;0;2000;1368;632;
2021-12-02 19:29:31;8998989110167;SURYA GUDANG GARAM 16 FILTER;1;27000;0;27000;25200;1800;
2021-12-02 19:29:31;6907992825076;JD WATERMELON APPLE;2;2000;0;4000;3400;600;
2021-12-02 20:21:17;8998866200882;SUKSESMIE GORENG AYAM KRMS 133GR;1;3500;0;3500;3047;453;
2021-12-02 20:21:17;ROTI;ROTI 2000;1;2000;0;2000;1800;200;
2021-12-02 20:21:17;8996001301142;ROMA KELAPA;1;8000;0;8000;7035;965;
2021-12-02 14:21:52;8999908284907;MY BABY MINYAK TELON 90ML;1;25000;0;25000;22700;2300;
2021-12-02 14:21:52;9556001047175;NESCAFE ORI 240ML;1;8500;0;8500;7834;666;
2021-12-02 14:21:52;KAPAS;KAPAS MEIQIYAH;1;5000;0;5000;4500;500;
2021-12-02 14:23:05;8850007652588;C&C NATURAL BRIGHT 100ML;1;22000;0;22000;19900;2100;
2021-12-02 14:23:05;8998866202244;EKOMIE BUMBU KALDU AYAM;1;1000;0;1000;798;202;
2021-12-02 21:23:27;8999909010567;234 DJI SAM SOE 16;1;23000;0;23000;21500;1500;
2021-12-02 21:23:27;8998989110167;SURYA GUDANG GARAM 16 FILTER;1;27000;0;27000;25200;1800;
2021-12-02 21:24:06;MILKITA;MILKITA;6;250;0;1500;1200;300;
2021-12-02 21:24:06;ROTI;ROTI 2000;1;2000;0;2000;1800;200;
2021-12-02 21:24:06;8992761111519;COCA COLA SLIM CAM 250ML;2;5000;0;10000;7500;2500;
2021-12-02 21:17:04;8994867000094;ROKOK PUNDIMAS FIL16;1;16000;0;16000;14600;1400;
2021-12-02 21:17:04;8992761111519;COCA COLA SLIM CAM 250ML;5;5000;0;25000;18750;6250;
2021-12-02 21:17:04;8998866202923;FLORIDINA COCO;3;3000;0;9000;7500;1500;
2021-12-02 21:17:04;089686727081;DORITOS 55G;1;7000;0;7000;5950;1050;
2021-12-02 22:11:44;ROTI;ROTI 2000;1;2000;0;2000;1800;200;
2021-12-02 22:11:44;9556001047175;NESCAFE ORI 240ML;1;8500;0;8500;7834;666;
2021-12-02 22:11:44;8997028590014;ARGUS 220ML;4;500;0;2000;1368;632;
2021-12-02 22:11:44;8996001600399;LE MINERAL 1500ML;2;5000;0;10000;8084;1916;
2021-12-02 12:12:32;8991111101415;JB POWDER 100G;1;7000;0;7000;6000;1000;
2021-12-02 12:12:32;8998866609043;DAIA SOFTENER GUSSET 565G;1;10000;0;10000;8700;1300;
2021-12-02 12:12:32;8999999030179;PEPSODENT ACTION 123 COMPLETE 75G;1;6700;0;6700;5170;1530;
2021-12-02 12:39:15;8994834006128;TICTIC PEDAS;1;2000;0;2000;1700;300;
2021-12-02 12:39:15;8997011700123;BIJAG BIHUN JAGUNG 300GR;1;6000;0;6000;5100;900;
2021-12-02 12:39:15;KIKO;KIKO;1;1000;0;1000;500;500;
2021-12-02 12:39:15;8994191103638;GULA GULA KARET;2;500;0;1000;800;200;
2021-12-02 20:48:42;8997028590014;ARGUS 220ML;4;500;0;2000;1368;632;
2021-12-02 20:48:42;8998989300261;GUDANG GARAM SURYA 12 FILTER;1;20000;0;20000;18650;1350;
2021-12-03 10:49:57;8992959107607;SFX COMFORT SLIM 1;1;5000;0;5000;4000;1000;
2021-12-03 10:59:09;8994867007161;ROKOK PENA GOLD 20;1;19000;0;19000;17400;1600;
2021-12-03 11:54:35;8998989500166;GUDANG GARAM MERAH BESAR 16KS;1;18000;0;18000;17000;1000;
2021-12-03 11:54:35;8999909002821;MARLBORO BLACK 16;1;23000;0;23000;21850;1150;
2021-12-03 13:21:55;ES POTONG;ES POTONG;1;1000;0;1000;500;500;
2021-12-03 13:21:55;7622210437686;BISKUAT;2;500;0;1000;800;200;
2021-08-13 16:40:19;8992696404441;SUSU BERUANG;1;10000;0;10000;8585;1415;
2021-08-13 16:40:19;8886013257400;TWISTKO;2;1000;0;2000;1800;200;
2021-08-13 16:40:19;8934868015031;REXONA DEO LOTION ICE COOL;1;4500;0;4500;3900;600;
2021-08-13 16:40:19;8991102714860;MILKIDO STRAW;1;3000;0;3000;2153;847;
2021-08-13 16:40:19;8996001440049;ENERGEN;1;1500;0;1500;1200;300;
2021-08-13 16:56:32;ARG;ARGUS DOS 220ML;1;15000;0;15000;13700;1300;
2021-08-13 16:56:32;8992741952262;GULA GULA YUPI;2;250;0;500;400;100;
2021-08-13 16:56:32;6907992823942;JD JUJUBE;1;4500;0;4500;3800;700;
2021-08-13 16:56:32;gula;GULA;1;12500;0;12500;11500;1000;
2021-08-13 17:50:14;089686043051;INDOMIE COTO MAKASSAR;1;3500;0;3500;2600;900;
2021-08-13 17:50:14;MILKITA;MILKITA;14;250;0;3500;2800;700;
2021-08-13 17:50:14;8992761164546;NUTRIBOOST STRAWBERRY 300ML;1;6500;0;6500;5300;1200;
2021-08-13 17:50:42;SLAIM;SLAIM WARNA;3;2000;0;6000;5229;771;
2021-08-13 18:44:21;8998898830125;KKB ENER-G ANGGUR;1;5500;0;5500;4824;676;
2021-08-13 18:44:21;8996001304020;SLAI OLAI NANAS;1;8500;0;8500;7700;800;
2021-08-13 18:44:21;8991102281430;PERMEN MINTZ DUOMINT;1;5000;0;5000;4000;1000;
2021-08-13 18:44:21;089686611878;QTELA TEMPE;1;6000;0;6000;5370;630;
2021-08-13 19:39:11;089686611519;QTELA SINGKONG;1;6000;0;6000;4266;1734;
2021-08-13 19:39:11;8992696404441;SUSU BERUANG;2;10000;0;20000;17170;2830;
2021-08-13 19:39:11;8992730950194;GULA GULA KOIN;2;500;0;1000;800;200;
2021-08-13 20:32:35;8999909010567;234 DJI SAM SOE 16;2;23000;0;46000;43000;3000;
2021-08-13 20:32:35;6907992823867;JD CRUNCHY CHOCOLATE MALT;1;5500;0;5500;4700;800;
2021-08-13 20:32:54;RT MNTG;ROTI SISIR MENTEGA;5;2000;0;10000;8000;2000;
2021-10-05 20:37:45;8886013257400;TWISTKO;2;1000;0;2000;1800;200;
2021-10-05 20:37:45;8998866202923;FLORIDINA COCO;1;3000;0;3000;2500;500;
2021-10-05 20:37:45;8994834006128;TICTIC PEDAS;2;2000;0;4000;3400;600;
2021-09-30 20:40:01;8994867007161;ROKOK PENA GOLD 20;1;19000;0;19000;17400;1600;
2021-09-30 20:40:01;8998989300261;GUDANG GARAM SURYA 12 FILTER;1;20000;0;20000;18650;1350;
2021-09-30 20:40:01;8992761164546;NUTRIBOOST STRAWBERRY 300ML;1;6500;0;6500;5300;1200;
2021-09-30 20:40:01;8992388133345;NU MILK TEA TEH TARIK 330ML;1;6000;0;6000;5125;875;
2021-09-30 20:40:01;8998866202053;POTABEE AYAM BAKAR PEDAS 68GR;1;8000;0;8000;7200;800;
2021-09-30 21:42:08;8997210107877;VORTEX SMART 3 CUKUR;1;5000;0;5000;3750;1250;
2021-09-30 21:42:08;8991188943536;SASA SANTAN KELAPA 65ML;1;3000;0;3000;2437;563;
2021-09-30 21:42:08;8995077609985;Tortilla;1;1000;0;1000;850;150;
2021-09-30 21:42:08;089686021219;INTER MIE GORENG;2;1000;0;2000;1770;230;
2021-09-30 21:42:08;8991002103832;GOOD DAY CHOCOCINNO;3;1500;0;4500;2670;1830;
2021-09-30 15:50:47;8998898830125;KKB ENER-G ANGGUR;1;5500;0;5500;4824;676;
2021-09-30 15:50:47;ARG;ARGUS DOS 220ML;1;15000;0;15000;13700;1300;
2021-09-30 15:50:47;8999999516208;ROYCO FDS CHICKEN NEW 230G;1;10000;0;10000;8415;1585;
2021-09-30 15:50:47;8998866202626;Top Kopi Gula Aren 22gr;2;1500;0;3000;1180;1820;
2021-09-30 15:54:26;8998866202770;MIE SEDAAP SALERO PADANG;1;2500;0;2500;2362;138;
2021-09-30 15:54:26;Vita Jelly;Vita Jelly;1;1000;0;1000;766;234;
2021-09-30 15:54:26;8991102714860;MILKIDO STRAW;1;3000;0;3000;2153;847;
2021-09-30 15:54:26;8997028590014;ARGUS 220ML;3;500;0;1500;1026;474;
2021-09-30 15:54:26;8886001038011;BENG-BENG SCT;1;1500;0;1500;1000;500;
2021-09-30 15:54:27;8991102384841;WFR TANGO LONG CKLT 130G;1;5000;0;5000;4333;667;
2021-09-30 18:11:44;8999999527372;PONDS MEN LIGHT OIL 50G;1;19000;0;19000;17160;1840;
2021-09-30 18:11:44;089686044249;SUPERMI NUTRIMI STEAK AYAM;3;3500;0;10500;8400;2100;
2021-09-30 18:11:44;089686043051;INDOMIE COTO MAKASSAR;4;3500;0;14000;10400;3600;
2021-09-30 18:11:44;089686043433;INDOMIE AYAM GEPREK 85G;3;3000;0;9000;7821;1179;
2021-09-30 18:11:44;QURMA;KURMA KHALAS;1;50000;0;50000;40000;10000;
