date;barcode;name;count;price;discount;total;buy_price;margin;
2021-04-01 11:10:39;8998989110167;SURYA GUDANG GARAM 16 FILTER;1;24000;0;24000;22100;1900;
2021-04-01 11:10:39;8998866610261;POWDET DAIA SOFTENER BAG 290 GR;1;5000;0;5000;4450;550;
2021-04-01 11:11:14;8998989110167;SURYA GUDANG GARAM 16 FILTER;4;24000;0;96000;88400;7600;
2021-04-01 11:16:27;8996001355237;SUPER STAR;1;11000;0;11000;9900;1100;
2021-04-01 11:16:27;8997025914059;HATARI SEE HONG;1;5000;0;5000;4800;200;
2021-04-01 11:16:27;SST;SUPERSTAR;2;1000;0;2000;1832;168;
2021-04-01 11:16:27;SOSIS;SO NICE SAPI;1;1000;0;1000;940;60;
2021-04-01 11:16:27;ff;FULLO BLASTO;2;1000;0;2000;1990;10;
2021-04-01 11:58:48;8999999195656;SARI WANGI 50X1.85;1;10000;0;10000;8700;1300;
2021-04-01 11:58:48;8992628022156;BIMOLI KLASIK TOUCH 1 LT;1;15500;0;15500;14350;1150;
2021-04-01 15:54:26;8998989110167;SURYA GUDANG GARAM 16 FILTER;1;24000;0;24000;22100;1900;
2021-04-01 15:55:44;8998989300261;GUDANG GARAM SURYA 12 FILTER;1;18000;0;18000;16450;1550;
2021-04-01 15:55:44;089686011036;INDOMIE GORENG PEDAS;1;2700;0;2700;2452;248;
2021-04-01 15:55:44;089686043273;INDOMIE SAMBAL RICA;1;2700;0;2700;2452;248;
2021-04-01 15:55:44;BALON;BALON CABUTR;2;1000;0;2000;1800;200;
2021-04-01 16:35:46;8999801700030;SUSU FOYU;1;11500;0;11500;10000;1500;
2021-04-01 16:35:46;8998866501033;MINYAK GORENG SEDAAP POUCH 2L;1;28000;0;28000;27746;254;
2021-04-01 16:36:32;8991102281416;PERMEN MINTZ PPMINT;1;4500;0;4500;4000;500;
2021-04-01 17:03:55;8998989110167;SURYA GUDANG GARAM 16 FILTER;2;24000;0;48000;44200;3800;
2021-04-01 17:11:16;8999999049492;REXONA WMN RO POWDER DRY 45 ML;1;15000;0;15000;13500;1500;
2021-04-01 17:17:57;8997218380074;ICHITAN MILK TEA;1;8000;0;8000;6583;1417;
2021-04-01 17:17:57;089686821086;ICHI OCHA MELATI;1;3000;0;3000;2250;750;
2021-04-01 17:17:57;kp;KALPA;1;2000;0;2000;1666;334;
2021-04-01 17:17:57;YP;YUPI;4;250;0;1000;832;168;
2021-04-01 17:17:57;FUZO;KUACI FUZO;1;1000;0;1000;850;150;
2021-04-01 17:21:42;8992761111533;SPRITE SLIM CAM250ML;1;5000;0;5000;3750;1250;
2021-04-01 17:42:25;8993379210854;SABUN HARMONY APPLE 70G;1;2000;0;2000;1652;348;
2021-04-01 18:30:36;8999999034023;VASELINE MEN ANTI ACNE 50G;1;17000;0;17000;15400;1600;
2021-04-01 19:36:39;8994420107789;SARDEN SAUS TOMAT;1;7000;0;7000;5833;1167;
2021-04-01 19:36:39;8996001414002;TORA BIKA CAPPUCINO;2;1500;0;3000;2454;546;
2021-04-01 19:37:00;8998866201964;MINYAK GORENG SABRINA 2L POUCH;1;28000;0;28000;26753;1247;
2021-04-01 19:37:00;8998866201865;KRISBEE PILLOW CHOCOLAVA 120 GR;1;8000;0;8000;7250;750;
2021-04-01 20:13:52;8995333060772;TERIGU GATOT KACA 500GR;1;4500;0;4500;4065;435;
2021-04-01 20:13:52;8995333032113;TERIGU GATOT KACA 1 KG;1;8500;0;8500;8012;488;
2021-04-01 20:31:19;8991102384841;WFR TANGO LONG CKLT 130G;2;5000;0;10000;7546;2454;
2021-04-01 20:31:19;8991102987639;WFR TANGO LONG VNL 130G;2;5000;0;10000;7546;2454;
2021-04-01 20:31:19;8992753102204;BKM COKLAT 370G;1;11300;0;11300;9500;1800;
2021-04-01 20:31:19;8991102994422;TANGO WALUT CHOCOBNN 18G;1;8200;0;8200;7272;928;
2021-04-01 21:36:57;8998008151065;MIWON 100 GR;1;3300;0;3300;2996;304;
2021-04-02 12:09:49;8997009510055;YOU C1000;1;8000;0;8000;4846;3154;
2021-04-02 12:09:49;8992753031900;BKM SCT PUTIH 40G;1;7500;0;7500;6900;600;
2021-04-02 12:09:49;8998866202060;POTABEE AYAM BAKAR PEDAS 35 GR;1;5000;0;5000;4150;850;
2021-04-02 12:09:49;089686021219;INTER MIE GORENG;4;1000;0;4000;3540;460;
2021-04-02 12:09:49;8996001301142;ROMA KELAPA;1;8000;0;8000;6628;1372;
2021-04-02 12:09:49;8996001305041;ROMA SANDWICH CKLT;1;7000;0;7000;5000;2000;
2021-04-02 12:09:49;GL;GULA 1 LITER;1;11500;0;11500;10500;1000;
2021-04-02 12:09:49;8996001301579;MALKIST CKLT KELAPA PACK;1;6500;0;6500;5400;1100;
2021-04-02 12:09:49;8998866105637;EMERON LOVELY MOIST&BRIGHT 200ML;1;7500;0;7500;6475;1025;
2021-04-02 12:09:49;TUSTEL;TUSUK TELINGA;1;1000;0;1000;833;167;
2021-04-02 12:09:49;8999999502409;ROYCO FDS BEEF 9G;8;500;0;4000;3000;1000;
2021-04-02 12:12:06;SOSIS;SO NICE SAPI;3;1000;0;3000;2820;180;
2021-04-02 12:26:40;BRS5;BERAS BUMN 5KG;1;64000;0;64000;50500;13500;
2021-04-02 12:26:40;8992959953136;SWEETY BRONZE L20;1;40000;0;40000;36770;3230;
2021-04-02 12:27:20;8994867000162;ROKOK PUNDIMAS KRETEK16;1;10000;0;10000;8600;1400;
2021-04-02 13:48:31;8934868015031;REXONA DEO LOTION ICE COOL;1;4500;0;4500;3900;600;
2021-04-02 13:48:31;8996001320051;KOPIKO COFFE CANDY;1;6200;0;6200;5600;600;
2021-04-02 13:48:31;8992761139018;ADES 600ML;1;3500;0;3500;2292;1208;
2021-04-02 14:17:56;8998989300261;GUDANG GARAM SURYA 12 FILTER;1;18000;0;18000;16450;1550;
2021-04-02 14:21:21;089686041705;INDOMIE GORENG JUMBO;1;3500;0;3500;3143;357;
2021-04-02 14:21:21;089686043051;INDOMIE COTO MAKASSAR;1;2800;0;2800;2525;275;
2021-04-02 14:21:21;8999999049447;REXONA WMN RO ADVANCED WHITE 45 ML;1;16500;0;16500;14900;1600;
2021-04-02 14:21:21;8998866202244;EKOMIE BUMBU KALDU AYAM;5;1000;0;5000;3990;1010;
2021-04-02 14:50:04;8997218380135;ICHITAN GREEN TEA;1;8000;0;8000;6583;1417;
2021-04-02 14:50:04;8998866202343;MIE SEDAAP KOREAN SPICY;1;2500;0;2500;2023;477;
2021-04-02 15:05:53;8998866202343;MIE SEDAAP KOREAN SPICY;1;2500;0;2500;2023;477;
2021-04-02 15:13:50;089686043204;INDOMIE MIE ACEH;1;2700;0;2700;2452;248;
2021-04-02 15:13:50;089686011036;INDOMIE GORENG PEDAS;1;2700;0;2700;2452;248;
2021-04-02 15:13:50;8998866202619;MIE SEDAAP KOREAN SPICY SOUP;1;2500;0;2500;2273;227;
2021-04-02 15:13:50;8998866202343;MIE SEDAAP KOREAN SPICY;1;2500;0;2500;2023;477;
2021-04-02 15:54:12;8998866500708;FLORIDINA ORANGE;1;3000;0;3000;2500;500;
2021-04-02 15:54:12;8992753182206;FF MILKY CKLT 180ML;1;4500;0;4500;3250;1250;
2021-04-02 15:54:12;8992753184200;FF MILKY STRY 180ML;1;4500;0;4500;3250;1250;
2021-04-02 15:54:12;8991102987639;WFR TANGO LONG VNL 130G;1;5000;0;5000;3773;1227;
2021-04-02 15:54:12;8991001780133;TWISTER BLACK;1;5000;0;5000;4600;400;
2021-04-02 15:54:12;8991001503107;CHACHA PEANUT 35GR;1;5500;0;5500;4900;600;
2021-04-02 15:54:12;MARS;MARSHMELLOW;1;500;0;500;433;67;
2021-04-02 16:04:18;8998866201841;GOLDA DOLCE LATTE 200ML;1;3000;0;3000;2500;500;
2021-04-02 16:32:08;SST;SUPERSTAR;5;1000;0;5000;4580;420;
2021-04-02 16:32:08;8991001121400;SILVERQUEEN ALMOND 65G;1;15000;0;15000;13200;1800;
2021-04-02 17:14:03;8998989110167;SURYA GUDANG GARAM 16 FILTER;1;24000;0;24000;22100;1900;
2021-04-02 17:43:36;8998866100243;KODOMO TP GRAPE TUBE 45G;1;5200;0;5200;4700;500;
2021-04-02 17:43:36;8999908284907;MY BABY MINYAK TELON 90ML;1;25000;0;25000;22700;2300;
2021-04-02 17:43:36;8991102385336;TANGO WAFFLE MILK;1;8000;0;8000;6212;1788;
2021-04-02 17:43:36;8999999707835;CLOSEUP GREEN 65G;1;7000;0;7000;6000;1000;
2021-04-02 17:43:36;RAINBOW;MINICOCO RAINBOW;7;500;0;3500;3150;350;
2021-04-02 17:43:36;8998009010590;ULTRA CHO 125;2;3000;0;6000;4856;1144;
2021-04-02 17:43:36;KJ;KINDER JOY;2;2000;0;4000;3166;834;
2021-04-02 18:01:43;8993324850449;BABY LOVE COTTON BUDS;1;5000;0;5000;4500;500;
2021-04-02 18:01:43;8996001355985;BENG-BENG SHARE IT;1;27000;0;27000;25000;2000;
2021-04-02 18:01:43;089686048704;SARIMIE GORENG AYAM KCP ISI 2;1;3500;0;3500;3120;380;
2021-04-02 18:01:43;089686017748;SARIMIE GORENG ISI 2;1;3500;0;3500;3120;380;
2021-04-02 18:01:43;8998866501026;MINYAK GORENG SEDAAP POUCH 1 L;1;15000;0;15000;14110;890;
2021-04-02 18:01:43;8997218380074;ICHITAN MILK TEA;1;8000;0;8000;6583;1417;
2021-04-02 18:01:43;8992959508916;SWEETY SILVER PANTS XXL 18;1;54500;0;54500;49546;4954;
2021-04-02 18:01:43;SF BOX;SAFFANAH ROTI BOX;1;12000;0;12000;10500;1500;
2021-04-02 18:36:34;089686043273;INDOMIE SAMBAL RICA;1;2700;0;2700;2452;248;
2021-04-02 18:36:34;8992761139018;ADES 600ML;1;3500;0;3500;2292;1208;
2021-04-02 18:36:34;8998989300261;GUDANG GARAM SURYA 12 FILTER;1;18000;0;18000;16450;1550;
2021-04-02 18:37:15;8998866501033;MINYAK GORENG SEDAAP POUCH 2L;1;28000;0;28000;27746;254;
2021-04-02 18:46:59;8996001600399;LE MINERAL 1500ML;1;5000;0;5000;4042;958;
2021-04-02 19:04:10;8995333032113;TERIGU GATOT KACA 1 KG;1;8500;0;8500;8012;488;
2021-04-02 19:04:10;8998866501033;MINYAK GORENG SEDAAP POUCH 2L;1;28000;0;28000;27746;254;
2021-04-02 19:19:53;8997009510055;YOU C1000;1;8000;0;8000;4846;3154;
2021-04-02 19:19:53;8998009010590;ULTRA CHO 125;1;3000;0;3000;2428;572;
2021-04-02 19:22:37;8996001312353;MALKIST KELAPA KOPYOR;1;6700;0;6700;5400;1300;
2021-04-02 19:22:37;8998989110167;SURYA GUDANG GARAM 16 FILTER;1;24000;0;24000;22100;1900;
2021-04-02 19:22:37;SF SOSIS;SAFFANAH ROTI SOSIS;1;6000;0;6000;5500;500;
2021-04-02 19:22:37;8991002103764;GOOD DAY CAPPUCINO 10X25G;1;1500;0;1500;1395;105;
2021-04-02 19:37:46;YP;YUPI;8;250;0;2000;1664;336;
2021-04-02 19:37:46;8992742360844;POLITEX SABUT STENLESS;2;4000;0;8000;4400;3600;
2021-04-02 20:08:02;8998989300261;GUDANG GARAM SURYA 12 FILTER;1;18000;0;18000;16450;1550;
2021-04-03 11:15:26;8998866803694;SOKLIN SOFTERGENT PURPLE BAG 770 & PIRING;1;18000;0;18000;16680;1320;
2021-04-03 11:15:26;8999999531492;MOLTO GLAMOUR;1;5000;0;5000;4800;200;
2021-04-03 11:15:26;BTS;BIMURA TARO SEAWEED 250G;1;10000;0;10000;9300;700;
2021-04-03 11:15:26;SF SOSIS;SAFFANAH ROTI SOSIS;5;6000;0;30000;27500;2500;
2021-04-03 11:15:26;8998866501033;MINYAK GORENG SEDAAP POUCH 2L;2;28000;0;56000;55492;508;
2021-04-03 11:15:26;BALON;BALON CABUTR;1;1000;0;1000;900;100;
2021-04-03 11:15:26;ff;FULLO BLASTO;1;1000;0;1000;995;5;
2021-04-03 11:15:26;8999999524838;SUNLIGHT MINT POUCH 755ML;1;17000;0;17000;15400;1600;
2021-04-03 11:15:26;8999999500665;RINSO MOLTO ROSE FRESH PWD 1,8KG;1;44700;0;44700;40726;3974;
2021-04-03 11:15:26;8993176110074;MINYAK KAYU PUTIH 60ML;1;20000;0;20000;17333;2667;
2021-04-03 11:15:26;8999999526856;MOLTO ALL IN ONE BLUE 11ML;1;5500;0;5500;4800;700;
2021-04-03 11:15:26;8934868015024;REXONA DEO LOTION FREE SPIRIT 9G;1;4500;0;4500;3900;600;
2021-04-03 11:15:26;8992222050418;GATSBY NORMAL 38GR;1;5000;0;5000;3850;1150;
2021-04-03 11:15:26;8998866603553;SOKLIN FLOORCLENER UNGU 900ML;1;14000;0;14000;12436;1564;
2021-04-03 11:15:26;8996001305003;SARI GANDUM SANDWICH;1;6000;0;6000;5100;900;
2021-04-03 11:15:26;8992388133345;NU MILK TEA TEH TARIK 330ML;1;6000;0;6000;5125;875;
2021-04-03 11:31:53;8996001600399;LE MINERAL 1500ML;1;5000;0;5000;4042;958;
2021-04-03 12:46:09;SF TAWAR KUPAS;SAFFANAH ROTI TAWAR KUPAS;1;10000;0;10000;9000;1000;
2021-04-03 13:07:05;8997009510055;YOU C1000;1;8000;0;8000;4846;3154;
2021-04-03 14:13:12;8998866600101;CREAM EKONOMI LEMON 455G;1;5500;0;5500;4750;750;
2021-04-03 14:13:12;8993379200855;SABUN HARMONY STRAWBERRY 70G;1;2000;0;2000;1652;348;
2021-04-03 14:36:00;8997218380074;ICHITAN MILK TEA;1;8000;0;8000;6583;1417;
2021-04-03 14:36:00;8992761002022;SPRITE PET 390ML;1;5500;0;5500;4300;1200;
2021-04-03 14:38:06;GL;GULA 1 LITER;1;11500;0;11500;10500;1000;
2021-04-03 15:30:34;8998989300261;GUDANG GARAM SURYA 12 FILTER;1;18000;0;18000;16450;1550;
2021-04-03 15:38:55;8992959971109;SFX COMFORT SLIM 36CM 12+1;1;16500;0;16500;15152;1348;
2021-04-03 15:46:07;8992761145033;FANTA STRAW PET 250ML;1;3500;0;3500;2417;1083;
2021-04-03 15:46:07;8992761122331;FRESTEA APPEL 500ML;1;6500;0;6500;4708;1792;
2021-04-03 15:54:34;8992761166205;FRESTEA GREEN HONEY 350ML;1;4500;0;4500;3000;1500;
2021-04-03 17:21:40;8992761166212;FRESTEA APPLE 350ML;1;4500;0;4500;3000;1500;
2021-04-03 17:21:40;8997009510055;YOU C1000;1;8000;0;8000;4846;3154;
2021-04-03 17:21:40;8991001780133;TWISTER BLACK;1;5000;0;5000;4600;400;
2021-04-03 17:21:40;SF TAWAR COKLAT;SAFFANAH ROTI TAWAR COKLAT;1;13500;0;13500;12000;1500;
2021-04-03 17:21:40;8994834003752;TICTIC;1;2000;0;2000;1700;300;
2021-04-03 17:21:40;8998866201483;POTABEE REGULER GRILLED SEAWEED 35GR;1;5000;0;5000;4150;850;
2021-04-03 17:21:40;8998866201469;POTABEE REGULER BBQ BEEF 68 GR;1;8000;0;8000;7200;800;
2021-04-03 17:22:38;MADU;MADU FLORES;1;135000;0;135000;130000;5000;
2021-04-03 17:22:38;8998989110167;SURYA GUDANG GARAM 16 FILTER;2;24000;0;48000;44200;3800;
2021-04-03 19:47:46;BTS;BIMURA TARO SEAWEED 250G;2;10000;0;20000;18600;1400;
2021-04-03 19:47:46;8991102385060;TANGO WAFFLE CHOX;1;8000;0;8000;6212;1788;
2021-04-03 19:47:46;8998866102605;KODOMO TB REG 2IN1;1;7500;0;7500;6600;900;
2021-04-03 19:47:46;SF TAWAR ORI;SAFFANAH TAWAR ORI;1;9000;0;9000;8000;1000;
2021-04-03 19:47:46;8999999524722;SUNLIGHT LIME NEW PCH 435ML;1;10000;0;10000;9100;900;
2021-04-03 19:47:46;8992959117569;SFX DS REG FLOW NW 8;1;4000;0;4000;3530;470;
2021-04-03 19:47:46;8992946511790;SHINZUI 85G;1;5000;0;5000;3475;1525;
2021-04-03 19:47:46;8992736980164;SASA TEPUNG KENTUCKY 80G;1;3000;0;3000;2181;819;
2021-04-03 19:47:46;8998866501033;MINYAK GORENG SEDAAP POUCH 2L;1;28000;0;28000;27746;254;
2021-04-03 19:47:46;8994834003752;TICTIC;3;2000;0;6000;5100;900;
2021-04-03 19:47:46;8991102385091;WFR TANGO CKLT 7G;1;8300;0;8300;7455;845;
2021-04-03 19:47:46;8991102385336;TANGO WAFFLE MILK;1;8000;0;8000;6212;1788;
2021-04-03 19:47:46;SF TAWAR COKLAT;SAFFANAH ROTI TAWAR COKLAT;1;13500;0;13500;12000;1500;
2021-04-03 19:47:46;8999999549138;CLEAR HIJAB AD SHP HF TMT 160ML;1;25000;0;25000;23870;1130;
2021-04-03 19:47:46;089686043051;INDOMIE COTO MAKASSAR;2;2800;0;5600;5050;550;
2021-04-03 19:47:46;6907992823904;JD CRUNCHY CHOCOLATE VAN;1;8000;0;8000;6800;1200;
2021-04-07 10:23:51;SF TAWAR KUPAS;SAFFANAH ROTI TAWAR KUPAS;1;10000;0;10000;9000;1000;
2021-04-07 10:23:51;8992753102204;BKM COKLAT 370G;1;11300;0;11300;9500;1800;
2021-04-07 10:45:47;8997028590014;ARGUS 220ML;4;500;0;2000;1208;792;
2021-04-07 10:45:47;8998866200851;NOODLE SEDAAP MIE BAKSO SPESIAL CUP 77 GR;1;4500;0;4500;3650;850;
2021-04-07 10:47:36;8994834003752;TICTIC;1;2000;0;2000;1700;300;
2021-04-07 10:47:36;6907992823676;JD PEACH;2;2000;0;4000;3400;600;
2021-04-07 10:53:12;6907992823935;JD SWEETCORN;1;3500;0;3500;3000;500;
2021-04-07 11:17:25;BTS;BIMURA TARO SEAWEED 250G;1;10000;0;10000;9300;700;
2021-04-07 11:17:25;8992946511790;SHINZUI 85G;1;5000;0;5000;3475;1525;
2021-04-07 11:35:27;GL;GULA 1 LITER;1;11500;0;11500;10500;1000;
2021-04-07 11:36:19;8998989500166;GUDANG GARAM MERAH BESAR 16KS;1;17000;0;17000;15300;1700;
2021-04-07 12:55:20;8992761164539;NUTRIBOOST ORANGE 300ML;2;6500;0;13000;10600;2400;
2021-04-07 12:55:20;8992761145026;SPRITE PET 250ML;3;3500;0;10500;7251;3249;
2021-04-07 14:41:49;YP;YUPI;10;250;0;2500;2080;420;
2021-04-07 14:41:49;8992696404441;BEAR BRAND 189ML;1;8500;0;8500;7887;613;
2021-04-07 14:41:49;8994834005923;SPIX 1000;1;1000;0;1000;850;150;
2021-04-07 14:41:49;TG;TEH GELAS;1;1000;0;1000;729;271;
2021-04-07 14:41:49;TUSTEL;TUSUK TELINGA;1;1000;0;1000;833;167;
2021-04-07 14:41:49;YOUTOP;YOUTOP;1;1000;0;1000;875;125;
2021-04-07 14:57:39;GL;GULA 1 LITER;2;11500;0;23000;21000;2000;
2021-04-07 14:59:35;ff;FULLO BLASTO;3;1000;0;3000;2985;15;
2021-04-07 14:59:35;PRG;PARAGO;8;500;0;4000;3200;800;
2021-04-07 15:05:54;8996001600269;LE MINERAL 600ML;1;3000;0;3000;1688;1312;
2021-04-07 15:42:05;8999999042646;RINSO MOLTO ROSE FRESH LIQ 40ML;1;5500;0;5500;4817;683;
2021-04-07 15:42:05;8998866202343;MIE SEDAAP KOREAN SPICY;2;2500;0;5000;4046;954;
2021-04-07 15:42:05;089686010107;INDOMIE KALDU AYAM;2;2500;0;5000;4300;700;
2021-04-07 16:17:50;6921101219235;YAKUAT JELLY;1;2000;0;2000;1750;250;
2021-04-07 16:17:50;6907992823676;JD PEACH;1;2000;0;2000;1700;300;
2021-04-07 16:45:31;8993365140356;MADU KURMA TJ 150G;3;14800;0;44400;40290;4110;
2021-04-07 16:45:31;8999999001209;LIFEBUOY BW MILDCARE LD REFF 450 ML;1;25000;0;25000;22110;2890;
2021-04-07 16:51:29;8997028590014;ARGUS 220ML;4;500;0;2000;1208;792;
2021-04-07 16:51:47;8996001600375;LE MINERAL 330ML;1;2000;0;2000;1417;583;
2021-04-07 16:51:47;9556001025272;NESCAFE LATTE 240ML;1;8500;0;8500;7437;1063;
2021-04-07 17:42:01;8999999519872;DOVE DEO WMN RO POMEGRANATE 40 ML;1;16500;0;16500;15000;1500;
2021-04-07 17:42:01;8998866606158;NUVO ACTIVE COOL 110G;2;3000;0;6000;5200;800;
2021-04-07 17:42:01;SF TAWAR COKLAT;SAFFANAH ROTI TAWAR COKLAT;2;13500;0;27000;24000;3000;
2021-04-07 17:43:54;SF TAWAR ORI;SAFFANAH TAWAR ORI;1;9000;0;9000;8000;1000;
2021-04-07 17:43:54;GL;GULA 1 LITER;1;11500;0;11500;10500;1000;
2021-04-07 17:45:42;089686021219;INTER MIE GORENG;1;1000;0;1000;885;115;
2021-04-07 17:45:42;8998866202770;MIE SEDAAP SALERO PADANG;3;2500;0;7500;7086;414;
2021-04-07 17:45:42;8998866200578;MIE SEDAAP KARI KENTAL;1;2500;0;2500;2263;237;
2021-04-07 18:43:04;ARG;ARGUS 220ML;1;14500;0;14500;12500;2000;
2021-04-07 18:43:04;8998866501026;MINYAK GORENG SEDAAP POUCH 1 L;1;15000;0;15000;14110;890;
2021-04-07 18:43:04;bb;BENG-BENG;2;1500;0;3000;2900;100;
2021-04-07 19:15:02;bb;BENG-BENG;1;1500;0;1500;1450;50;
2021-04-07 19:15:15;8998866201964;MINYAK GORENG SABRINA 2L POUCH;1;27500;0;27500;26753;747;
2021-04-07 19:16:22;8992775001653;GERY SALUT CHOCOLATE COCONUT;1;2000;0;2000;1476;524;
2021-04-07 19:35:24;8997028590014;ARGUS 220ML;4;500;0;2000;1208;792;
2021-04-07 19:48:09;8991001121615;SILVERQUEEN NUT;1;15000;0;15000;13200;1800;
2021-04-07 20:13:11;8998989300261;GUDANG GARAM SURYA 12 FILTER;1;18000;0;18000;16450;1550;
2021-04-07 21:00:03;8993989311279;CLAS MILD 12;1;17000;0;17000;15700;1300;
2021-04-07 21:14:52;8991002105409;KOPI KAPAL API;1;20000;0;20000;18888;1112;
2021-04-07 21:30:34;8994867007161;ROKOK PENA GOLD 20;1;17000;0;17000;15000;2000;
2021-04-07 21:30:34;8996001305126;ARDEN;1;18000;0;18000;16300;1700;
2021-04-07 21:30:34;001;PASEO SMART FACIAL SF 250S GT;1;10000;0;10000;9500;500;
2021-04-07 21:30:34;8996001301142;ROMA KELAPA;1;8000;0;8000;6628;1372;
2021-04-07 21:30:34;8991115012021;BB STRAWBERRY CREAM;1;8500;0;8500;7600;900;
2021-04-07 21:30:34;8991102228053;TEH GELAS BOTOL;1;3000;0;3000;1922;1078;
2021-04-07 21:30:34;8992388133345;NU MILK TEA TEH TARIK 330ML;1;6000;0;6000;5125;875;
2021-04-07 21:30:34;8996001305041;ROMA SANDWICH CKLT;1;7000;0;7000;5000;2000;
2021-04-07 21:30:34;SNTN;SANTAN BUBUK;1;2500;0;2500;1500;1000;
2021-04-07 21:30:34;8998989300261;GUDANG GARAM SURYA 12 FILTER;2;18000;0;36000;32900;3100;
2021-04-07 21:30:34;8991102384841;WFR TANGO LONG CKLT 130G;1;5000;0;5000;3773;1227;
2021-04-07 21:30:34;8992761166038;MMP ORANGE 300ML;1;5000;0;5000;3750;1250;
2021-04-07 21:30:34;8992761145019;COCA COLA PET 250ML;1;3500;0;3500;2417;1083;
2021-04-07 21:30:34;8992761139018;ADES 600ML;2;3500;0;7000;4584;2416;
2021-04-07 21:30:34;8998866202770;MIE SEDAAP SALERO PADANG;2;2500;0;5000;4724;276;
2021-04-07 21:30:34;ARG;ARGUS 220ML;1;14500;0;14500;12500;2000;
2021-04-07 21:30:34;ff;FULLO BLASTO;1;1000;0;1000;995;5;
2021-04-07 21:30:34;SF TAWAR ORI;SAFFANAH TAWAR ORI;1;9000;0;9000;8000;1000;
2021-04-07 21:30:34;8997018250218;JAHE MERAH;1;1000;0;1000;833;167;
2021-04-07 21:30:34;8998866202343;MIE SEDAAP KOREAN SPICY;1;2500;0;2500;2023;477;
2021-04-07 21:30:34;8998866202619;MIE SEDAAP KOREAN SPICY SOUP;1;2500;0;2500;2273;227;
2021-04-07 21:45:35;8998989500166;GUDANG GARAM MERAH BESAR 16KS;3;17000;0;51000;45900;5100;
2021-04-07 21:45:35;SOSIS;SO NICE SAPI;1;1000;0;1000;940;60;
2021-04-07 21:45:35;8997021870892;HOT IN CREAM STRONG 120G;1;18500;0;18500;17000;1500;
2021-04-07 21:45:35;8991004011906;KOPI BORONG;1;10000;0;10000;8333;1667;
2021-04-07 21:45:35;8994834003752;TICTIC;1;2000;0;2000;1700;300;
2021-04-07 21:45:35;089686041705;INDOMIE GORENG JUMBO;1;3500;0;3500;3143;357;
2021-04-07 21:45:35;8999999059781;SUNLIGHT LIME NEW POUCH 210ML;1;5000;0;5000;4300;700;
2021-04-07 21:45:35;8886013213208;FRENCH FREIS 2000;1;5000;0;5000;3750;1250;
2021-04-07 21:45:35;6907992825069;JD FRUITY;1;5000;0;5000;4400;600;
2021-04-07 21:45:35;8999999034726;PONDS MEN WHITE BOOST 50G;1;18500;0;18500;17160;1340;
2021-04-07 21:45:35;8991102385336;TANGO WAFFLE MILK;1;8000;0;8000;6212;1788;
2021-04-07 21:45:35;8996001440049;ENERGEN;4;1500;0;6000;4800;1200;
2021-04-07 21:45:35;8996001304143;SLAI OLAI NANAS;1;12000;0;12000;9900;2100;
2021-04-07 21:45:35;8999999552473;PEPSODENT ACTION123 SIWAK 65G;1;6200;0;6200;5600;600;
2021-04-07 21:45:35;8991102384841;WFR TANGO LONG CKLT 130G;1;5000;0;5000;3773;1227;
2021-04-07 21:45:35;8997218380135;ICHITAN GREEN TEA;1;8000;0;8000;6583;1417;
2021-04-07 21:45:35;8993007003063;ENAAK 500G;1;11000;0;11000;9625;1375;
2021-04-07 21:45:35;8998866200882;SUKSESMIE GORENG AYAM KRMS 133GR;1;3500;0;3500;3047;453;
2021-04-07 21:45:35;089686021141;INTER MIE SOTO;1;1000;0;1000;854;146;
2021-04-07 21:45:35;8998866202619;MIE SEDAAP KOREAN SPICY SOUP;1;2500;0;2500;2273;227;
2021-04-07 21:45:35;TG APEL;TEH GELAS APEL;1;2000;0;2000;1178;822;
2021-04-07 21:45:35;8993470279651;JOGER CHOCKY BAR;1;1000;0;1000;867;133;
2021-04-07 21:45:35;JGR SHN;JOGER SHINY SACHET;1;500;0;500;437;63;
2021-04-07 21:45:35;8996001370063;CHOKI-CHOKI;1;18200;0;18200;16500;1700;
2021-04-07 21:45:35;8851019210193;POCKY CHOCO BANANA 47G;1;7300;0;7300;5671;1629;
2021-04-07 21:45:35;8992775001660;WAFER CREAM COKLAT TABUR KEJU;1;19000;0;19000;17721;1279;
2021-04-07 21:45:35;8992696404441;BEAR BRAND 189ML;1;8500;0;8500;7887;613;
2021-04-07 21:45:35;BALON;BALON CABUTR;2;1000;0;2000;1800;200;
2021-04-07 21:45:35;8992946511790;SHINZUI 85G;1;5000;0;5000;3475;1525;
2021-04-07 21:45:35;8999999024772;VASELINE HW PERFECT 10 100 ML;1;19000;0;19000;17600;1400;
2021-04-07 21:45:35;8991111109121;JB POWDER BLOSSOM 75+25G;1;6000;0;6000;5430;570;
2021-04-07 21:45:35;8998989300261;GUDANG GARAM SURYA 12 FILTER;2;18000;0;36000;32900;3100;
2021-04-07 21:45:35;123124;KOREK BIASA;1;2000;0;2000;1800;200;
2021-04-07 21:50:14;8997027300089;NOMOS;1;4000;0;4000;2963;1037;
2021-04-07 21:50:14;8999909096004;SAMPOERNA 16 FILTER;1;24000;0;24000;23000;1000;
2021-04-07 21:50:14;ff;FULLO BLASTO;1;1000;0;1000;995;5;
2021-04-07 21:50:14;11;PASEO SMART FHSTD PERF 6P 12S;1;5000;0;5000;4264;736;
2021-04-07 21:50:14;8998866609487;SOKLIN SOFTERGEN 280G;1;5000;0;5000;4425;575;
2021-04-07 21:50:14;8998866604512;FRES&NATURAL SOAP VIOLET 65G;2;1800;0;3600;2850;750;
2021-04-07 21:50:14;8998866501033;MINYAK GORENG SEDAAP POUCH 2L;1;28000;0;28000;27746;254;
2021-04-07 22:03:09;BTS;BIMURA TARO SEAWEED 250G;1;10000;0;10000;9300;700;
2021-04-07 22:03:09;8993989311279;CLAS MILD 12;1;17000;0;17000;15700;1300;
2021-04-07 22:03:09;8996001600269;LE MINERAL 600ML;1;3000;0;3000;1688;1312;
2021-04-07 22:03:09;8992761111533;SPRITE SLIM CAM250ML;2;5000;0;10000;7500;2500;
2021-04-07 22:03:09;HT;HOT-HOT;1;500;0;500;350;150;
2021-04-07 22:03:09;8994834005923;SPIX 1000;7;1000;0;7000;5950;1050;
2021-04-07 22:03:09;SOSIS;SO NICE SAPI;3;1000;0;3000;2820;180;
2021-04-07 22:03:09;8992696404441;BEAR BRAND 189ML;1;8500;0;8500;7887;613;
2021-04-07 22:03:09;8997009510055;YOU C1000;2;8000;0;16000;9692;6308;
2021-04-07 22:03:09;8997218380135;ICHITAN GREEN TEA;1;8000;0;8000;6583;1417;
2021-04-07 22:03:09;089686021219;INTER MIE GORENG;3;1000;0;3000;2655;345;
2021-04-07 22:03:09;8996001312278;MALKIST KEJU MANIS;1;6500;0;6500;5400;1100;
2021-04-07 22:03:09;YP;YUPI;2;250;0;500;416;84;
2021-04-07 22:03:09;kp;KALPA;2;2000;0;4000;3332;668;
2021-04-07 22:03:09;VTM;VITAMIN;6;500;0;3000;2550;450;
2021-04-07 22:03:09;8993226365522;GARAM MEJA GYURI 200GR;2;2000;0;4000;3400;600;
2021-04-07 22:03:09;8992717781001;NATA DE COCO;3;13000;0;39000;36249;2751;
2021-04-07 22:03:09;8993007003063;ENAAK 500G;2;11000;0;22000;19250;2750;
2021-04-07 22:03:09;8994021000915;CINCAO;6;3000;0;18000;11748;6252;
2021-04-07 22:03:09;8997011700345;MIE KERING LANGIT BIRU;1;23000;0;23000;21000;2000;
2021-04-07 22:03:09;YOUTOP;YOUTOP;1;1000;0;1000;875;125;
2021-04-07 22:03:09;8993379152017;SABUN CUCI SURYA 200G;1;3000;0;3000;2281;719;
2021-04-07 22:03:09;6921101219235;YAKUAT JELLY;1;2000;0;2000;1750;250;
2021-04-07 22:03:09;8998989300261;GUDANG GARAM SURYA 12 FILTER;1;18000;0;18000;16450;1550;
2021-04-07 22:03:09;ff;FULLO BLASTO;1;1000;0;1000;995;5;
2021-04-07 22:03:09;8994867000179;ROKOK PENA MILD 16;1;14500;0;14500;13000;1500;
2021-04-07 22:03:09;MARS;MARSHMELLOW;1;500;0;500;433;67;
2021-04-07 22:03:09;8998009010590;ULTRA CHO 125;1;3000;0;3000;2428;572;
2021-04-07 22:03:09;6907992823652;JD CHOCOLATE MILKSHAKE;3;6000;0;18000;15600;2400;
2021-04-07 22:03:09;8991102989312;WFR TANGO SBJ 7G;1;8300;0;8300;7455;845;
2021-04-07 22:03:09;8992870311091;SALONPAS;1;6000;0;6000;4806;1194;
2021-04-07 22:10:00;SOSIS;SO NICE SAPI;2;1000;0;2000;1880;120;
2021-04-07 22:10:00;6921101219235;YAKUAT JELLY;2;2000;0;4000;3500;500;
2021-04-07 22:10:00;8998866202770;MIE SEDAAP SALERO PADANG;4;2500;0;10000;9448;552;
2021-04-07 22:10:00;8991102385060;TANGO WAFFLE CHOX;1;8000;0;8000;6212;1788;
2021-04-07 22:10:00;8991102385336;TANGO WAFFLE MILK;1;8000;0;8000;6212;1788;
2021-04-07 22:10:00;JGR;JOGER CHOCKY PASTA;1;20000;0;20000;18190;1810;
2021-04-07 22:10:00;PUL;PULPEN;5;1500;0;7500;4165;3335;
2021-04-07 22:10:00;6907992825069;JD FRUITY;1;5000;0;5000;4400;600;
2021-04-07 22:10:00;8996001603376;ENERGEN KURMA;1;2000;0;2000;1500;500;
2021-04-07 22:10:00;VTM;VITAMIN;1;500;0;500;425;75;
2021-04-07 22:10:00;8998866202244;EKOMIE BUMBU KALDU AYAM;1;1000;0;1000;798;202;
2021-04-07 22:10:00;8996001305126;ARDEN;1;18000;0;18000;16300;1700;
2021-04-07 22:10:00;8999999524722;SUNLIGHT LIME NEW PCH 435ML;1;10000;0;10000;9100;900;
2021-04-07 22:10:00;GL;GULA 1 LITER;2;11500;0;23000;21000;2000;
2021-04-07 22:10:00;8999999401221;RINSO ANTI NODA CLASSIC 430G;1;10800;0;10800;9806;994;
2021-04-07 22:10:00;8998989300261;GUDANG GARAM SURYA 12 FILTER;1;18000;0;18000;16450;1550;
2021-04-07 22:29:31;MOBIL;GULA GULA HP;1;2000;0;2000;1700;300;
2021-04-07 22:29:31;8998989110167;SURYA GUDANG GARAM 16 FILTER;1;24000;0;24000;22100;1900;
2021-04-07 22:29:31;8996001305041;ROMA SANDWICH CKLT;1;7000;0;7000;5000;2000;
2021-04-07 22:29:31;8998989500166;GUDANG GARAM MERAH BESAR 16KS;1;17000;0;17000;15300;1700;
2021-04-07 22:29:31;8998866202671;NOODLE SEDAAP MIE KOREAN SPICY SOUP CUP;1;5000;0;5000;4002;998;
2021-04-07 22:29:31;089686048704;SARIMIE GORENG AYAM KCP ISI 2;1;3500;0;3500;3120;380;
2021-04-07 22:29:31;8999999559045;SUNLIGHT LIME CREAM 110G;1;2000;0;2000;1800;200;
2021-04-07 22:29:31;8998866202404;NOODLE SEDAAP MIE KOREAN SPICY CHICKEN CUP;1;5000;0;5000;4002;998;
2021-04-07 22:29:31;8992628020152;BIMOLI POUCH 2L;1;30000;0;30000;28983;1017;
2021-04-07 22:29:31;8996001600399;LE MINERAL 1500ML;1;5000;0;5000;4042;958;
2021-04-07 22:29:31;SOSIS;SO NICE SAPI;2;1000;0;2000;1880;120;
2021-04-07 22:29:31;8998866202244;EKOMIE BUMBU KALDU AYAM;5;1000;0;5000;3990;1010;
2021-04-07 22:29:31;8993176110074;MINYAK KAYU PUTIH 60ML;1;20000;0;20000;17333;2667;
2021-04-07 22:29:31;SONICE;SONICE SOSIS AYAM;1;24000;0;24000;23500;500;
2021-04-07 22:29:31;8998866202732;MILKU STROBERI 200ML;1;3000;0;3000;2375;625;
2021-04-07 22:29:31;GL;GULA 1 LITER;1;11500;0;11500;10500;1000;
2021-04-07 22:29:31;8999999037765;PEPSODENT WHITE 225G;1;12000;0;12000;10750;1250;
2021-04-07 22:29:31;8999999529550;CLEAR COMPLETE SOFT CARE 80ML;1;11200;0;11200;10120;1080;
2021-04-07 22:29:31;8991102022347;SIKAT GIGI FORMULA RIPPLE;1;5000;0;5000;4583;417;
2021-04-07 22:29:31;8991102384841;WFR TANGO LONG CKLT 130G;2;5000;0;10000;7546;2454;
2021-04-07 22:29:31;8993083929806;BISKITOP COKLAT;1;30000;0;30000;27000;3000;
2021-04-07 22:29:31;001;PASEO SMART FACIAL SF 250S GT;1;10000;0;10000;9500;500;
2021-04-07 22:29:31;BTS;BIMURA TARO SEAWEED 250G;1;10000;0;10000;9300;700;
2021-04-07 22:29:31;8992705045122;AGAR-AGAR SATELIT HIJAU;1;3500;0;3500;2604;896;
2021-04-07 22:29:31;8992705035123;AGAR-AGAR SATELIT COKLAT;1;3500;0;3500;2604;896;
2021-04-07 22:29:31;8992705025124;AGAR-AGAR SATELIT MERAH;1;3500;0;3500;2604;896;
2021-04-07 22:29:31;8998866610087;JAVANA ORIGINAL 350ML;1;3000;0;3000;2150;850;
2021-04-07 22:29:31;8992696405486;DNCO FULL CREAM 400G;1;42000;0;42000;39537;2463;
2021-04-07 22:29:31;8996001305003;SARI GANDUM SANDWICH;1;6000;0;6000;5100;900;
2021-04-07 22:29:31;8998866200301;MIE SEDAAP GORENG;3;2500;0;7500;6069;1431;
2021-04-07 22:29:31;8992761122331;FRESTEA APPEL 500ML;1;6500;0;6500;4708;1792;
2021-04-07 22:29:31;JGR SHN;JOGER SHINY SACHET;1;500;0;500;437;63;
2021-04-07 22:29:31;089686043051;INDOMIE COTO MAKASSAR;2;2800;0;5600;5050;550;
2021-04-07 22:29:31;8999999059316;LIFEBOUY TS MILDCARE 75G;1;3000;0;3000;2500;500;
2021-04-07 22:29:31;8995333032113;TERIGU GATOT KACA 1 KG;1;8500;0;8500;8012;488;
2021-04-07 22:29:31;FUZO;KUACI FUZO;1;1000;0;1000;850;150;
2021-04-07 22:29:31;8999999195656;SARI WANGI 50X1.85;1;10000;0;10000;8700;1300;
2021-04-07 22:29:31;8994834003752;TICTIC;1;2000;0;2000;1700;300;
2021-04-07 22:29:31;8998866202060;POTABEE AYAM BAKAR PEDAS 35 GR;1;5000;0;5000;4150;850;
2021-04-07 22:29:31;8999999048167;SUNSILK SHP BLACK SHINE 9ML;1;10500;0;10500;9300;1200;
2021-04-07 22:29:31;8997028590014;ARGUS 220ML;2;500;0;1000;604;396;
2021-04-07 22:29:31;ff;FULLO BLASTO;3;1000;0;3000;2985;15;
2021-04-07 22:39:36;8998866202695;KOPI MAYOR;2;6000;0;12000;9000;3000;
2021-04-07 22:39:36;8993379152017;SABUN CUCI SURYA 200G;1;3000;0;3000;2281;719;
2021-04-07 22:39:36;SF TAWAR ORI;SAFFANAH TAWAR ORI;1;9000;0;9000;8000;1000;
2021-04-07 22:39:36;8992702000018;INDOMILK 370G;1;10000;0;10000;9020;980;
2021-04-07 22:39:36;8992388133017;NU MILK TEA ORI 330ML;1;5000;0;5000;5125;-125;
2021-04-07 22:39:36;8886013213208;FRENCH FREIS 2000;1;5000;0;5000;3750;1250;
2021-04-07 22:39:36;BTS;BIMURA TARO SEAWEED 250G;1;10000;0;10000;9300;700;
2021-04-07 22:39:36;SF BOX;SAFFANAH ROTI BOX;1;12000;0;12000;10500;1500;
2021-04-07 22:39:36;GL;GULA 1 LITER;2;11500;0;23000;21000;2000;
2021-04-07 22:39:36;8997009510116;LEMON WATER;1;7000;0;7000;5694;1306;
2021-04-07 22:39:36;8992761164546;NUTRIBOOST STRAWBERRY 300ML;1;6500;0;6500;5300;1200;
2021-04-11 11:44:43;GL;GULA 1 LITER;2;11500;0;23000;21000;2000;
2021-04-11 11:44:43;8999801700030;SUSU FOYU;3;11500;0;34500;31350;3150;
2021-04-11 11:44:43;8997021300092;LARISSA BAWANG 250GR;1;5500;0;5500;5125;375;
2021-04-11 11:44:43;8992770061034;SAJIKU;2;2000;0;4000;3000;1000;
2021-04-11 11:44:43;089686440287;OPOR AYAM;2;5000;0;10000;9000;1000;
2021-04-11 11:44:43;8850507002968;A1 KING TRUCK;1;16500;0;16500;15500;1000;
2021-04-11 11:44:43;BALON;BALON CABUTR;3;1000;0;3000;2700;300;
2021-04-11 12:09:22;8992959508848;SWEETY SILVER PANTS L 18;1;41500;0;41500;37728;3772;
2021-04-11 12:15:32;089686821086;ICHI OCHA MELATI;1;3000;0;3000;2250;750;
2021-04-11 12:15:32;8998866609487;SOKLIN SOFTERGEN 280G;1;5000;0;5000;4425;575;
2021-04-11 12:15:32;8999999045265;RINSO MOLTO ROSE FRESH PWD 770GR;1;21600;0;21600;19338;2262;
2021-04-11 12:15:32;8999999524722;SUNLIGHT LIME NEW PCH 435ML;1;10000;0;10000;9100;900;
2021-04-11 12:15:32;001;PASEO SMART FACIAL SF 250S GT;1;10000;0;10000;9500;500;
2021-04-11 12:15:32;8998989300261;GUDANG GARAM SURYA 12 FILTER;1;18000;0;18000;16450;1550;
2021-04-11 12:15:32;123124;KOREK BIASA;1;2000;0;2000;1800;200;
2021-04-11 12:15:32;089686834055;FREISS JERUK;1;11000;0;11000;8750;2250;
2021-04-11 12:15:32;8993989311279;CLAS MILD 12;1;17000;0;17000;15700;1300;
2021-04-11 12:15:32;GL;GULA 1 LITER;1;11500;0;11500;10500;1000;
2021-04-11 12:15:32;8992775310212;GERY PASTA COKELAT;1;18000;0;18000;16029;1971;
2021-04-11 12:15:32;8998866202237;NOODLE SEDAAP TASTY AYAM GEPREK 124 GR;1;5000;0;5000;4167;833;
2021-04-11 12:15:32;KJ;KINDER JOY;1;2000;0;2000;1583;417;
2021-04-11 12:15:32;8995333060703;TERIGU KOMPAS 1KG;1;10500;0;10500;9816;684;
2021-04-11 12:15:32;HT;HOT-HOT;2;500;0;1000;700;300;
2021-04-11 12:16:11;8999999059309;LIFEBOUY TS TOTAL 10 DG 75G;2;3000;0;6000;5000;1000;
2021-04-11 12:16:11;8997028590014;ARGUS 220ML;1;500;0;500;302;198;
2021-04-11 12:31:47;JGR SHN;JOGER SHINY SACHET;2;500;0;1000;874;126;
2021-04-11 12:31:47;8998989300261;GUDANG GARAM SURYA 12 FILTER;1;18000;0;18000;16450;1550;
2021-04-11 12:31:47;MARS;MARSHMELLOW;4;500;0;2000;1732;268;
2021-04-11 12:31:47;8993989311279;CLAS MILD 12;1;17000;0;17000;15700;1300;
2021-04-11 12:31:47;8996001355237;SUPER STAR;1;11000;0;11000;9900;1100;
2021-04-11 12:31:47;8999999045265;RINSO MOLTO ROSE FRESH PWD 770GR;1;21600;0;21600;19338;2262;
2021-04-11 12:31:47;8999999524722;SUNLIGHT LIME NEW PCH 435ML;1;10000;0;10000;9100;900;
2021-04-11 12:31:47;8993007003063;ENAAK 500G;1;11000;0;11000;9625;1375;
2021-04-11 12:31:47;8999999195649;SARI WANGI 25X1.86G;1;6000;0;6000;5050;950;
2021-04-11 12:31:47;SF TAWAR ORI;SAFFANAH TAWAR ORI;1;9000;0;9000;8000;1000;
2021-04-11 12:31:47;8991004011906;KOPI BORONG;1;10000;0;10000;8333;1667;
2021-04-11 12:31:47;8992388101085;NU GREEN TEA ORIGINAL 330ML;1;3500;0;3500;2854;646;
2021-04-11 12:31:47;SS;SUPER SNAPS;1;1500;0;1500;1333;167;
2021-04-11 12:31:47;TG;TEH GELAS;1;1000;0;1000;729;271;
2021-04-11 12:31:47;8992694247255;ZWITSAL BATH NAT HAIR&BODY 200ML;1;20500;0;20500;18810;1690;
2021-04-11 12:31:47;8999909010567;234 16 FILTER;1;22000;0;22000;21500;500;
2021-04-11 12:31:47;9556001004673;MILO NESTLE MALAYSIA ACTIVE GO;1;85000;0;85000;80000;5000;
2021-04-11 12:32:40;6907992823652;JD CHOCOLATE MILKSHAKE;2;6000;0;12000;10400;1600;
2021-04-11 12:59:58;8998866200578;MIE SEDAAP KARI KENTAL;2;2500;0;5000;4526;474;
2021-04-11 12:59:58;8998866613729;EMERON LOVELY NTRL 100ML;1;3500;0;3500;2900;600;
2021-04-11 12:59:58;8998866808729;ROYALE SOFT WHITE;1;5000;0;5000;4500;500;
2021-04-11 12:59:58;8999999531478;MOLTO BLACK PURPLE;1;5500;0;5500;4800;700;
2021-04-11 12:59:58;8998989500128;GUDANG GARAM MERAH KECIL 12KS;2;13000;0;26000;23800;2200;
2021-04-11 12:59:58;8999999706180;PEPSODENT WHITE 190GR;2;10000;0;20000;18700;1300;
2021-04-11 12:59:58;8886013213208;FRENCH FREIS 2000;2;5000;0;10000;7500;2500;
2021-04-11 12:59:58;001;PASEO SMART FACIAL SF 250S GT;1;10000;0;10000;9500;500;
2021-04-11 12:59:58;8999801700030;SUSU FOYU;3;11500;0;34500;31350;3150;
2021-04-11 12:59:58;8998866606158;NUVO ACTIVE COOL 110G;2;3000;0;6000;5200;800;
2021-04-11 12:59:58;8999999526863;MOLTO ALL IN ONE PINK 11ML;1;5500;0;5500;4800;700;
2021-04-11 12:59:58;8998866201841;GOLDA DOLCE LATTE 200ML;1;3000;0;3000;2500;500;
2021-04-11 12:59:58;8999999502393;ROYCO FDS CHICKEN 8G;1;5000;0;5000;4500;500;
2021-04-11 12:59:58;8992736980164;SASA TEPUNG KENTUCKY 80G;2;3000;0;6000;4362;1638;
2021-04-11 12:59:58;8992736025162;SASA TEPUNG PISANG GORENG;1;5000;0;5000;4455;545;
2021-04-11 12:59:58;8992742360844;POLYTEX SABUT STENLESS;2;4000;0;8000;4400;3600;
2021-04-11 12:59:58;8992761139018;ADES 600ML;1;3500;0;3500;2292;1208;
2021-04-11 12:59:58;VTM;VITAMIN;1;500;0;500;425;75;
2021-04-11 12:59:58;8997018250218;JAHE MERAH;2;1000;0;2000;1666;334;
2021-04-11 12:59:58;8994834005923;SPIX 1000;5;1000;0;5000;4250;750;
2021-04-11 12:59:58;8999999558086;RINSO MOLTO FERFUME ESSENSE PWD 44G;6;1000;0;6000;4830;1170;
2021-04-11 12:59:58;8997028590014;ARGUS 220ML;4;500;0;2000;1208;792;
2021-04-11 12:59:58;8998866202770;MIE SEDAAP SALERO PADANG;1;2500;0;2500;2362;138;
2021-04-11 12:59:58;8991102987639;WFR TANGO LONG VNL 130G;1;5000;0;5000;3773;1227;
2021-04-11 12:59:58;8992775001653;GERY SALUT CHOCOLATE COCONUT;1;2000;0;2000;1476;524;
2021-04-11 12:59:58;8998989300261;GUDANG GARAM SURYA 12 FILTER;1;18000;0;18000;16450;1550;
2021-04-11 12:59:58;8998866608718;DAIA SOFTENER PINK;1;5000;0;5000;4450;550;
2021-04-11 12:59:58;MOLTO PINK;MOLTO ALL IN ONE 11 ML;4;500;0;2000;1600;400;
2021-04-11 12:59:58;8995333060703;TERIGU KOMPAS 1KG;1;10500;0;10500;9816;684;
2021-04-11 12:59:58;GL;GULA 1 LITER;2;11500;0;23000;21000;2000;
2021-04-11 12:59:58;8991004011906;KOPI BORONG;1;10000;0;10000;8333;1667;
2021-04-11 12:59:58;089686043051;INDOMIE COTO MAKASSAR;2;2800;0;5600;5050;550;
2021-04-11 12:59:58;089686010107;INDOMIE KALDU AYAM;2;2500;0;5000;4300;700;
2021-04-11 12:59:58;8996001302323;MALKIST ABON;1;6500;0;6500;4800;1700;
2021-04-11 12:59:58;8996001301579;MALKIST CKLT KELAPA PACK;1;6500;0;6500;5400;1100;
2021-04-11 12:59:58;8996001305041;ROMA SANDWICH CKLT;1;7000;0;7000;5000;2000;
2021-04-11 12:59:58;8996001301142;ROMA KELAPA;1;8000;0;8000;6628;1372;
2021-04-11 12:59:58;8996001312353;MALKIST KELAPA KOPYOR;1;6700;0;6700;5400;1300;
2021-04-11 12:59:58;8992775312469;GERY SALUT COKELAT;1;11000;0;11000;9983;1017;
2021-04-11 12:59:58;089686821086;ICHI OCHA MELATI;1;3000;0;3000;2250;750;
2021-04-11 13:01:42;8997021870892;HOT IN CREAM STRONG 120G;1;18500;0;18500;17000;1500;
2021-04-11 13:01:42;089686400816;SAMBAL EXTRA PEDAS 135ML;1;5500;0;5500;4950;550;
2021-04-11 13:01:42;8998866608008;KECAP MANIS SEDAAP BOTOL 135 ML;1;6500;0;6500;5875;625;
2021-04-11 14:01:56;MRC;MERICA LADA;6;1000;0;6000;5334;666;
2021-04-11 14:01:56;8996001305041;ROMA SANDWICH CKLT;1;7000;0;7000;5000;2000;
2021-04-11 14:01:56;8996001301142;ROMA KELAPA;1;8000;0;8000;6628;1372;
2021-04-11 14:01:56;8991102281430;PERMEN MINTZ DUOMINT;1;4500;0;4500;4000;500;
2021-04-11 14:01:56;001;PASEO SMART FACIAL SF 250S GT;1;10000;0;10000;9500;500;
2021-04-11 14:01:56;8992959117613;SFX DAUN SIRIH WING 1;1;5000;0;5000;4130;870;
2021-04-11 14:01:56;8998866604963;POWDET DAIA LEMON 290GR;1;5000;0;5000;4450;550;
2021-04-11 14:01:56;8999999059781;SUNLIGHT LIME NEW POUCH 210ML;1;5000;0;5000;4300;700;
2021-04-11 14:01:56;8992702000063;INDOMILK COKLAT 370G;1;10000;0;10000;9020;980;
2021-04-11 14:01:56;8992696404441;BEAR BRAND 189ML;1;8500;0;8500;7887;613;
2021-04-11 14:01:56;8999999030186;PEPSODENT ACTION 123 COMPLETE 190G;1;14000;0;14000;13200;800;
2021-04-11 14:01:56;8999999526856;MOLTO ALL IN ONE BLUE 11ML;1;5500;0;5500;4800;700;
2021-04-11 14:01:56;8999999017804;CITRA BW NATURAL WHITE LD 400ML;1;21000;0;21000;19000;2000;
2021-04-11 14:01:56;8998866200325;MIE SEDAAP SOTO;4;2500;0;10000;7808;2192;
2021-04-11 14:01:56;8998866200301;MIE SEDAAP GORENG;2;2500;0;5000;4046;954;
2021-04-11 14:01:56;8998866603546;SOKLIN FLOORCLENER UNGU 450ML;1;7000;0;7000;6385;615;
2021-04-11 14:05:02;8994867007161;ROKOK PENA GOLD 20;1;17000;0;17000;15000;2000;
2021-04-11 14:05:02;8999909096004;SAMPOERNA 16 FILTER;1;24000;0;24000;23000;1000;
2021-04-11 15:12:41;8994834005923;SPIX 1000;2;1000;0;2000;1700;300;
2021-04-11 15:12:41;8992761139018;ADES 600ML;1;3500;0;3500;2292;1208;
2021-04-11 15:12:41;8998866501026;MINYAK GORENG SEDAAP POUCH 1 L;3;15000;0;45000;42330;2670;
2021-04-11 15:12:41;089686010824;INDOMIE GORENG SPESIAL;3;2700;0;8100;7356;744;
2021-04-11 15:12:41;089686017748;SARIMIE GORENG ISI 2;2;3500;0;7000;6240;760;
2021-04-11 15:12:41;JGR SHN;JOGER SHINY SACHET;1;500;0;500;437;63;
2021-04-11 15:12:41;HT;HOT-HOT;2;500;0;1000;700;300;
2021-04-11 15:12:41;SOSIS;SO NICE SAPI;2;1000;0;2000;1880;120;
2021-04-11 15:12:41;SF TAWAR ORI;SAFFANAH TAWAR ORI;1;9000;0;9000;8000;1000;
2021-04-11 15:12:41;9556001047175;NESCAFE ORI 240ML;1;8500;0;8500;7337;1163;
2021-04-11 15:12:41;SF SOSIS;SAFFANAH ROTI SOSIS;2;6000;0;12000;11000;1000;
2021-04-11 15:12:41;089686021219;INTER MIE GORENG;4;1000;0;4000;3540;460;
2021-04-11 15:12:41;8997028590014;ARGUS 220ML;5;500;0;2500;1510;990;
2021-04-11 15:12:41;6907992825069;JD FRUITY;1;5000;0;5000;4400;600;
2021-04-11 15:12:41;8998866610087;JAVANA ORIGINAL 350ML;1;3000;0;3000;2150;850;
2021-04-11 15:12:41;8996001318430;BETTER 1000;1;1000;0;1000;820;180;
2021-04-11 15:42:59;8997013790092;BIMURA KERUPUK BAWANG 25G;1;1000;0;1000;874;126;
2021-04-11 15:42:59;6907992823652;JD CHOCOLATE MILKSHAKE;3;6000;0;18000;15600;2400;
2021-04-11 15:42:59;089686010107;INDOMIE KALDU AYAM;1;2500;0;2500;2150;350;
2021-04-11 15:42:59;089686011036;INDOMIE GORENG PEDAS;1;2700;0;2700;2452;248;
2021-04-11 15:42:59;8998866613699;EMERON LOVELY COOLBRIGHT 100ML;1;4300;0;4300;3800;500;
2021-04-11 15:42:59;8998866108126;POSH HIJAB WINTER MAGIC 150ML;1;19500;0;19500;17500;2000;
2021-04-11 15:42:59;8998866201841;GOLDA DOLCE LATTE 200ML;1;3000;0;3000;2500;500;
2021-04-11 15:42:59;JGR SHN;JOGER SHINY SACHET;4;500;0;2000;1748;252;
2021-04-11 15:42:59;8999999059781;SUNLIGHT LIME NEW POUCH 210ML;1;5000;0;5000;4300;700;
2021-04-11 15:42:59;8996001600375;LE MINERAL 330ML;2;2000;0;4000;2834;1166;
2021-04-11 15:42:59;8999909010567;234 16 FILTER;2;22000;0;44000;43000;1000;
2021-04-11 15:42:59;11222;LEM KOREA;1;9000;0;9000;8000;1000;
2021-04-11 15:42:59;8995102703534;TERASI DUO 6 GR;1;4000;0;4000;3720;280;
2021-04-11 15:42:59;8994867000179;ROKOK PENA MILD 16;1;14500;0;14500;13000;1500;
2021-04-11 15:42:59;8998866608756;SOKLIN SOFTENER TWILIGHT BLUE 14SCH;1;5000;0;5000;4560;440;
2021-04-11 15:42:59;8998866202343;MIE SEDAAP KOREAN SPICY;2;2500;0;5000;4046;954;
2021-04-11 15:42:59;8998866200301;MIE SEDAAP GORENG;3;2500;0;7500;6069;1431;
2021-04-11 15:42:59;089686021127;INTER MIE KALDU;1;1000;0;1000;813;187;
2021-04-11 15:42:59;089686021141;INTER MIE SOTO;2;1000;0;2000;1708;292;
2021-04-11 15:42:59;8997028590014;ARGUS 220ML;14;500;0;7000;4228;2772;
2021-04-11 15:42:59;8997013790108;BIMURA KACANG TELUR 25G;1;1000;0;1000;875;125;
2021-04-11 15:42:59;089686043051;INDOMIE COTO MAKASSAR;1;2800;0;2800;2525;275;
2021-04-11 15:42:59;8999801700030;SUSU FOYU;1;11500;0;11500;10450;1050;
2021-04-11 15:42:59;GL;GULA 1 LITER;1;11500;0;11500;10500;1000;
2021-04-11 15:42:59;8992736980164;SASA TEPUNG KENTUCKY 80G;1;3000;0;3000;2181;819;
2021-04-11 15:42:59;8995333000822;TERIGU KOMPAS SOFT 500GR;1;5500;0;5500;4967;533;
2021-04-11 15:42:59;8999999401238;RINSO ANTI NODA 770G;1;21200;0;21200;19338;1862;
2021-04-11 15:42:59;8999999518998;RINSO MOLTO PERFUME ESSENSE 770GR;1;21300;0;21300;19338;1962;
2021-04-11 15:42:59;8993560026066;DETTOL COOL;1;20000;0;20000;18524;1476;
2021-04-11 15:42:59;8998866603546;SOKLIN FLOORCLENER UNGU 450ML;1;7000;0;7000;6385;615;
2021-04-11 15:42:59;MG;MINYAK GOSOK SAFERTABAT;1;28000;0;28000;25000;3000;
2021-04-11 15:42:59;8999909096004;SAMPOERNA 16 FILTER;1;24000;0;24000;23000;1000;
2021-04-11 15:42:59;8991102987639;WFR TANGO LONG VNL 130G;1;5000;0;5000;3773;1227;
2021-04-11 15:42:59;8999999526863;MOLTO ALL IN ONE PINK 11ML;1;5500;0;5500;4800;700;
2021-04-11 15:42:59;8994867006997;ROKOK PENA BOLD 20BTG;1;17000;0;17000;15000;2000;
2021-04-11 15:42:59;SF TAWAR ORI;SAFFANAH TAWAR ORI;1;9000;0;9000;8000;1000;
2021-04-11 15:42:59;8992753102204;BKM COKLAT 370G;1;11300;0;11300;9500;1800;
2021-04-11 15:42:59;8999999059323;LIFEBOUY LEMONFRESH DG 75G;1;3000;0;3000;2500;500;
2021-04-11 15:42:59;8999999560584;LUX TS VELVET JASMINE 110G;1;4000;0;4000;3100;900;
2021-04-11 15:42:59;8994834005923;SPIX 1000;2;1000;0;2000;1700;300;
2021-04-11 15:42:59;SOSIS;SO NICE SAPI;1;1000;0;1000;940;60;
2021-04-11 15:42:59;8998989300261;GUDANG GARAM SURYA 12 FILTER;1;18000;0;18000;16450;1550;
2021-04-11 15:42:59;8994834003752;TICTIC;1;2000;0;2000;1700;300;
2021-04-11 15:42:59;8992959953334;SWEETY BRONZE XL42;1;80000;0;80000;75455;4545;
2021-04-11 15:42:59;8999909000544;MARLBORO F BLACK;1;29001;0;29001;27800;1201;
2021-04-11 15:42:59;HT;HOT-HOT;1;500;0;500;350;150;
2021-04-11 15:42:59;8993226365522;GARAM MEJA GYURI 200GR;1;2000;0;2000;1700;300;
2021-04-11 15:42:59;8997009510116;LEMON WATER;1;7000;0;7000;5694;1306;
2021-04-11 15:42:59;8998866201377;KRISBEE FRIES KENTANG GORENG 68 GR;1;5500;0;5500;4620;880;
2021-04-11 15:42:59;8998866201711;KRISBEE KRUNCHY JAGUNG BAKAR MENTEGA 75 GR;1;5500;0;5500;4400;1100;
2021-04-11 15:42:59;8998866693578;SOKLIN FLOORCLENER PINK 900ML;1;14000;0;14000;12436;1564;
2021-04-11 15:42:59;8996001355237;SUPER STAR;1;11000;0;11000;9900;1100;
2021-04-11 15:42:59;8996001351901;ZUPER KEJU SUSU;1;17000;0;17000;15500;1500;
2021-04-11 15:42:59;8998866609029;DAIA PUTIH GUSSWET 565G;2;10000;0;20000;17400;2600;
2021-04-11 15:42:59;8998866610278;DAIA VIOLET GUSSET 565G;1;10000;0;10000;8700;1300;
2021-04-11 15:42:59;8995333060772;TERIGU GATOT KACA 500GR;6;4500;0;27000;24390;2610;
2021-04-11 15:42:59;8998866200882;SUKSESMIE GORENG AYAM KRMS 133GR;6;3500;0;21000;18282;2718;
2021-04-11 15:42:59;089686041705;INDOMIE GORENG JUMBO;4;3500;0;14000;12572;1428;
2021-04-11 15:42:59;8999999504656;SARI MURNI 20X1.8G;1;5000;0;5000;4200;800;
2021-04-11 16:06:01;8992761122331;FRESTEA APPEL 500ML;1;6500;0;6500;4708;1792;
2021-04-11 16:21:25;089686021127;INTER MIE KALDU;1;1000;0;1000;813;187;
2021-04-11 16:21:25;8999999707859;CLOSEUP GREEN 160G;1;15000;0;15000;13600;1400;
2021-04-11 16:21:25;8993365131538;MADU TJ MURNI 150G;1;14800;0;14800;13430;1370;
2021-04-11 17:11:29;8992388133345;NU MILK TEA TEH TARIK 330ML;1;6000;0;6000;5125;875;
2021-04-11 17:11:29;8992696404441;BEAR BRAND 189ML;1;8500;0;8500;7887;613;
2021-04-11 17:11:29;SF GULUNG;SAFFANAH ROTI GULUNG;1;6000;0;6000;5500;500;
2021-04-11 18:12:07;8992761002039;FANTA STRAWBERRY PET 390 ML;1;5500;0;5500;4300;1200;
2021-04-11 18:12:47;8992761002039;FANTA STRAWBERRY PET 390 ML;1;5500;0;5500;4300;1200;
2021-04-11 18:13:23;8992761166038;MMP ORANGE 300ML;2;5000;0;10000;7500;2500;
2021-04-11 18:21:27;8993072153595;LARISST COTTON 35G;1;5000;0;5000;3300;1700;
2021-04-11 18:58:30;8992761139018;ADES 600ML;1;3500;0;3500;2292;1208;
2021-04-11 18:58:30;JGR SHN;JOGER SHINY SACHET;3;500;0;1500;1311;189;
2021-04-11 19:04:28;GL;GULA 1 LITER;2;11500;0;23000;21000;2000;
2021-04-11 19:41:14;8997009510116;LEMON WATER;1;7000;0;7000;5694;1306;
2021-04-11 20:28:23;8994867000162;ROKOK PUNDIMAS KRETEK16;2;10000;0;20000;17200;2800;
2021-04-11 20:41:55;8991102380805;FULLO  CKL PCK 8G;1;10000;0;10000;9000;1000;
2021-04-11 20:41:55;8991001121400;SILVERQUEEN ALMOND 65G;1;15000;0;15000;13200;1800;
2021-04-11 20:41:55;KJ;KINDER JOY;3;2000;0;6000;4749;1251;
2021-04-11 21:35:15;8992761166038;MMP ORANGE 300ML;2;5000;0;10000;7500;2500;
2021-04-11 21:45:24;8992761166038;MMP ORANGE 300ML;1;5000;0;5000;3750;1250;
2021-04-11 21:47:11;8992761111519;COCA COLA SLIM CAM 250ML;5;5000;0;25000;18750;6250;
2021-04-11 21:47:11;8992761111540;FANTA STRAWBERY SLIM CAM 250ML;5;5000;0;25000;18750;6250;
2021-04-11 21:47:11;8992761111533;SPRITE SLIM CAM250ML;5;5000;0;25000;18750;6250;
2021-04-11 22:09:10;8992761145026;SPRITE PET 250ML;1;3500;0;3500;2417;1083;
2021-04-11 22:09:20;8999909010567;234 16 FILTER;2;22000;0;44000;43000;1000;
2021-04-12 10:37:41;8999999706111;PEPSODENT WHITE 25G;1;2000;0;2000;1450;550;
2021-04-12 10:37:41;8998866103985;CIPT SIKP;1;3000;0;3000;2552;448;
2021-04-12 10:45:30;8998009010590;ULTRA CHO 125;1;3000;0;3000;2428;572;
2021-04-12 10:45:30;ff;FULLO BLASTO;2;1000;0;2000;1990;10;
2021-04-12 10:45:30;kp;KALPA;1;2000;0;2000;1666;334;
2021-04-12 11:30:43;8992761166205;FRESTEA GREEN HONEY 350ML;1;4500;0;4500;3000;1500;
2021-04-12 11:30:43;VTM;VITAMIN;1;500;0;500;425;75;
2021-04-12 12:12:56;8996001355237;SUPER STAR;1;11000;0;11000;9900;1100;
2021-04-12 12:12:56;COKLAT;COKLAT COIN;3;500;0;1500;1200;300;
2021-04-12 12:12:56;MARS;MARSHMELLOW;2;500;0;1000;866;134;
2021-04-12 12:12:56;JGR SHN;JOGER SHINY SACHET;1;500;0;500;437;63;
2021-04-12 12:27:19;8998989500128;GUDANG GARAM MERAH KECIL 12KS;1;13000;0;13000;11900;1100;
2021-04-12 12:27:19;6907992823676;JD PEACH;2;2000;0;4000;3400;600;
2021-04-12 13:12:22;8999909096004;SAMPOERNA 16 FILTER;1;24000;0;24000;23000;1000;
2021-04-12 13:58:11;8998866201933;MINYAK GORENG SEDAAP 5 L;1;72000;0;72000;70230;1770;
2021-04-12 14:00:36;8992717781001;NATA DE COCO;2;13000;0;26000;24166;1834;
2021-04-12 14:00:36;711844130128;ABC SAUS TOMAT 275 ML;1;10000;0;10000;8800;1200;
2021-04-12 14:00:36;711844120419;SAMBAL ABC 275 ML;1;12000;0;12000;10800;1200;
2021-04-12 14:33:02;8992761166205;FRESTEA GREEN HONEY 350ML;1;4500;0;4500;3000;1500;
2021-04-12 15:25:21;8992959117583;SFX DS REG FLOW WING 20;1;5000;0;5000;4288;712;
2021-04-12 15:25:55;8996001350423;ZUPER KEJU;1;9200;0;9200;8360;840;
2021-04-12 16:21:52;8886013213208;FRENCH FREIS 2000;1;5000;0;5000;3750;1250;
2021-04-12 16:21:52;8998866693608;SOKLIN FLOORCLENER HIJAU 900ML;1;14000;0;14000;12436;1564;
2021-04-12 16:21:52;8992702000018;INDOMILK 370G;1;10000;0;10000;9020;980;
2021-04-12 16:21:52;8991001780492;SELAMAT COKLAT;1;13000;0;13000;11800;1200;
2021-04-12 16:21:52;8998866100717;MAMALIME POUCH 780ML;1;15500;0;15500;13850;1650;
2021-04-12 16:39:12;8998866200813;NOODLE SEDAAP MIE GORENG CUP 85 GR;1;5000;0;5000;3917;1083;
2021-04-12 16:55:47;8998866201469;POTABEE REGULER BBQ BEEF 68 GR;1;8000;0;8000;7200;800;
2021-04-12 16:55:47;6907992823867;JD CRUNCHY CHOCOLATE MALT;1;5500;0;5500;4700;800;
2021-04-12 16:55:47;TG;TEH GELAS;2;1000;0;2000;1458;542;
2021-04-12 16:56:39;JGR SHN;JOGER SHINY SACHET;1;500;0;500;437;63;
2021-04-12 17:39:09;GL;GULA 1 LITER;2;11500;0;23000;21000;2000;
2021-04-12 17:39:09;BALON;BALON CABUT;1;1000;0;1000;900;100;
2021-04-12 17:39:09;6921101219235;YAKUAT JELLY;1;2000;0;2000;1750;250;
2021-04-12 18:18:02;SOSIS;SO NICE SAPI;1;1000;0;1000;940;60;
2021-04-12 18:18:02;8994834005923;SPIX 1000;1;1000;0;1000;850;150;
2021-04-12 18:18:02;8996200900092;HEROCYN 85GR;1;13000;0;13000;11650;1350;
2021-04-12 18:18:02;SF SOSIS;SAFFANAH ROTI SOSIS;1;6000;0;6000;5500;500;
2021-04-12 18:18:02;6907992825069;JD FRUITY;1;5000;0;5000;4400;600;
2021-04-12 18:18:02;8998989110167;SURYA GUDANG GARAM 16 FILTER;1;24000;0;24000;22100;1900;
2021-04-12 18:20:13;8998866202671;NOODLE SEDAAP MIE KOREAN SPICY SOUP CUP;2;5000;0;10000;8004;1996;
2021-04-12 18:34:16;8992761145026;SPRITE PET 250ML;1;3500;0;3500;2417;1083;
2021-04-12 18:34:16;COKLAT;COKLAT COIN;1;500;0;500;400;100;
2021-04-12 19:12:50;8998989300261;GUDANG GARAM SURYA 12 FILTER;1;18000;0;18000;16450;1550;
2021-04-12 19:12:50;kp;KALPA;1;2000;0;2000;1666;334;
2021-04-12 20:22:51;8998989500166;GUDANG GARAM MERAH BESAR 16KS;2;17000;0;34000;30600;3400;
2021-04-12 20:24:43;8998009010590;ULTRA CHO 125;1;3000;0;3000;2428;572;
2021-04-12 20:24:43;8992696404441;BEAR BRAND 189ML;1;8500;0;8500;7887;613;
2021-04-12 20:24:43;089686021219;INTER MIE GORENG;3;1000;0;3000;2655;345;
2021-04-12 20:38:02;SF TAWAR PND;SAFFANAH TAWAR PANDAN;1;9500;0;9500;8500;1000;
2021-04-12 20:38:02;8998866102605;KODOMO TB REG 2IN1;1;7500;0;7500;6600;900;
2021-04-12 21:19:15;8992761145019;COCA COLA PET 250ML;2;3500;0;7000;4834;2166;
2021-04-12 21:19:15;8992761166212;FRESTEA APPLE 350ML;1;4500;0;4500;3000;1500;
2021-04-12 21:19:15;8998866500708;FLORIDINA ORANGE;1;3000;0;3000;2500;500;
2021-04-12 22:28:22;GL;GULA 1 LITER;1;11500;0;11500;10500;1000;
2021-04-12 22:29:20;GL;GULA 1 LITER;5;11500;0;57500;52500;5000;
2021-04-12 22:29:20;9556001047175;NESCAFE ORI 240ML;1;8500;0;8500;7337;1163;
2021-04-12 22:29:20;8991102384841;WFR TANGO LONG CKLT 130G;1;5000;0;5000;3773;1227;
2021-04-12 22:29:43;9556001025272;NESCAFE LATTE 240ML;1;8500;0;8500;7437;1063;
2021-04-12 22:29:43;8994834005923;SPIX 1000;1;1000;0;1000;850;150;
2021-04-12 22:31:46;ARG;ARGUS 220ML;10;14500;0;145000;125000;20000;
2021-04-13 11:27:39;8999801700030;SUSU FOYU;1;11500;0;11500;10450;1050;
2021-04-13 11:27:39;8992933214116;NUTRIJELL MELON;1;6000;0;6000;5041;959;
2021-04-13 11:27:39;8992933213119;NUTRIJELL LECI;1;6000;0;6000;5041;959;
2021-04-13 11:27:39;9556001004673;MILO NESTLE MALAYSIA ACTIVE GO;1;85000;0;85000;80000;5000;
2021-04-13 11:27:39;8998866200325;MIE SEDAAP SOTO;2;2500;0;5000;3904;1096;
2021-04-13 13:29:30;9556040040038;SUSU F&N;1;33000;0;33000;30000;3000;
2021-04-13 13:29:30;8992696404441;BEAR BRAND 189ML;1;8500;0;8500;7887;613;
2021-04-13 13:29:30;SF BOX;SAFFANAH ROTI BOX;1;12000;0;12000;10500;1500;
2021-04-13 13:29:30;6907992823591;JD STRAW MILKSHAKE;1;5000;0;5000;4300;700;
2021-04-13 13:29:30;8995333032113;TERIGU GATOT KACA 1 KG;1;8500;0;8500;8012;488;
2021-04-13 13:29:30;8997028590014;ARGUS 220ML;4;500;0;2000;1208;792;
2021-04-13 13:29:30;8992736980164;SASA TEPUNG KENTUCKY 80G;1;3000;0;3000;2181;819;
2021-04-13 13:29:30;8997018250218;JAHE MERAH;1;1000;0;1000;833;167;
2021-04-13 13:29:30;GL;GULA 1 LITER;1;11500;0;11500;10500;1000;
2021-04-13 13:29:30;HT;HOT-HOT;1;500;0;500;350;150;
2021-04-13 13:29:30;BRS;BERAS BUMN 10KG;1;128000;0;128000;100000;28000;
2021-04-13 13:29:30;8991102385091;WFR TANGO CKLT 7G;1;8300;0;8300;7455;845;
2021-04-13 13:29:30;8992761145026;SPRITE PET 250ML;1;3500;0;3500;2417;1083;
2021-04-13 13:29:30;8990800020013;MENTOS MINT HALAL IND;1;5700;0;5700;5150;550;
2021-04-13 14:29:32;8999801700030;SUSU FOYU;1;11500;0;11500;10450;1050;
2021-04-13 14:29:32;8997018720018;SIRUP DHT;1;23000;0;23000;20958;2042;
2021-04-13 14:29:32;8998866607315;SOKLIN SOFTERGENT SAKURA 770G & PIRING;1;18000;0;18000;16680;1320;
2021-04-13 14:29:32;8997211400038;SANTAN COCONUT CREAM;1;4000;0;4000;3000;1000;
2021-04-13 14:29:32;8998008151065;MIWON 100 GR;1;3300;0;3300;2996;304;
2021-04-13 14:29:32;8992628605151;AMANDA MARGARINE;1;5000;0;5000;3806;1194;
2021-04-13 14:34:48;089686021219;INTER MIE GORENG;4;1000;0;4000;3540;460;
2021-04-13 15:03:11;8997211400038;SANTAN COCONUT CREAM;2;4000;0;8000;6000;2000;
2021-04-13 15:03:11;SNTN;SANTAN BUBUK;1;2500;0;2500;1500;1000;
2021-04-13 15:55:35;8997018720018;SIRUP DHT;1;23000;0;23000;20958;2042;
2021-04-13 15:58:22;ARG;ARGUS 220ML;10;14500;0;145000;125000;20000;
2021-04-13 16:23:38;8994867000162;ROKOK PUNDIMAS KRETEK16;1;10000;0;10000;8600;1400;
2021-04-13 16:58:59;8992753101207;BENDERA KENTAL MANIS 370G;1;11500;0;11500;9700;1800;
2021-04-13 16:58:59;8999999052959;PONDS WHITE BEAUTY FACIAL FOAM 50G;1;17000;0;17000;15600;1400;
2021-04-13 16:58:59;8999999538453;SUNSILK SHP SOFT AND  SMOOTH 55 ML;1;5000;0;5000;3750;1250;
2021-04-13 16:58:59;8999999549565;PONDS ROSE MICELLAR WTR 100ML;1;25000;0;25000;22800;2200;
2021-04-13 17:00:33;001;PASEO SMART FACIAL SF 250S GT;1;10000;0;10000;9500;500;
2021-04-13 17:00:33;9556040040038;SUSU F&N;1;33000;0;33000;30000;3000;
2021-04-13 17:00:33;8993007003063;ENAAK 500G;1;11000;0;11000;9625;1375;
2021-04-14 11:25:59;TGL;TEH GELAS DOS;1;20000;0;20000;17496;2504;
2021-04-14 11:40:06;GL;GULA 1 LITER;6;11500;0;69000;63000;6000;
2021-04-14 11:40:06;8998866608459;POWDET DAIA PUTIH BAG 290GR;1;5000;0;5000;4450;550;
2021-04-14 11:40:06;8998866888615;GIV BIRU KOTAK 76G;2;2000;0;4000;3640;360;
2021-04-14 11:40:06;SF SOSIS;SAFFANAH ROTI SOSIS;1;6000;0;6000;5500;500;
2021-04-14 11:55:50;8998989300261;GUDANG GARAM SURYA 12 FILTER;1;18000;0;18000;16450;1550;
2021-04-14 11:55:50;SF SOSIS;SAFFANAH ROTI SOSIS;1;6000;0;6000;5500;500;
2021-04-14 11:55:50;8999999537180;CLEAR SHP LEMON FRESH 9 ML;1;10500;0;10500;9300;1200;
2021-04-14 11:55:50;8998866202664;POTABEE WAGYU BEEF STEAK 68 GR;1;8000;0;8000;7200;800;
2021-04-14 11:55:50;8998866202060;POTABEE AYAM BAKAR PEDAS 35 GR;2;5000;0;10000;8300;1700;
2021-04-14 11:55:50;8886013213208;FRENCH FREIS 2000;1;5000;0;5000;3750;1250;
2021-04-14 11:55:50;8998866202671;NOODLE SEDAAP MIE KOREAN SPICY SOUP CUP;1;5000;0;5000;4002;998;
2021-04-14 11:55:50;8999999007768;FAIR&LOVELY MULTIVITAMIN  CREAM 9 ML;1;4500;0;4500;3200;1300;
2021-04-14 12:02:07;8999999706111;PEPSODENT WHITE 25G;1;2000;0;2000;1450;550;
2021-04-14 12:02:07;8992725910400;LISTERINE COOLMINT 100ML;1;7500;0;7500;6800;700;
2021-04-14 12:02:07;8991111101507;JB POWDER BLOSSOM 50G;1;3500;0;3500;3000;500;
2021-04-14 12:02:07;8998866106504;EMERON LOVELY NAT PINK;1;3500;0;3500;2900;600;
2021-04-14 12:02:07;8991111101316;JB OIL 50ML;1;9500;0;9500;8700;800;
2021-04-14 12:04:53;8992717900310;KARA SUN;1;2500;0;2500;2000;500;
2021-04-14 12:21:12;bb;BENG-BENG;2;1500;0;3000;2900;100;
2021-04-14 12:21:12;8992775001653;GERY SALUT CHOCOLATE COCONUT;1;2000;0;2000;1476;524;
2021-04-14 12:27:34;8997018720018;SIRUP DHT;1;23000;0;23000;20958;2042;
2021-04-14 12:27:34;8996001603376;ENERGEN KURMA;10;2000;0;20000;15000;5000;
2021-04-14 12:27:34;6291100212866;KURMA KHALAS;1;85000;0;85000;80000;5000;
2021-04-14 12:27:34;8996001440087;ENERGEN KACANG HIJAU;10;1500;0;15000;11500;3500;
2021-04-14 12:27:34;8998866200325;MIE SEDAAP SOTO;10;2500;0;25000;19520;5480;
2021-04-14 12:30:38;ARG;ARGUS 220ML;2;14500;0;29000;25000;4000;
2021-04-14 13:59:01;089686010107;INDOMIE KALDU AYAM;5;2500;0;12500;10750;1750;
2021-04-14 13:59:01;089686010824;INDOMIE GORENG SPESIAL;5;2700;0;13500;12260;1240;
2021-04-14 13:59:36;8995333032113;TERIGU GATOT KACA 1 KG;1;8500;0;8500;8012;488;
2021-04-14 13:59:36;8992753031900;BKM SCT PUTIH 40G;1;7500;0;7500;6900;600;
2021-04-14 14:25:12;001;PASEO SMART FACIAL SF 250S GT;1;10000;0;10000;9500;500;
2021-04-14 14:33:37;8999999706111;PEPSODENT WHITE 25G;1;2000;0;2000;1450;550;
2021-04-14 14:33:37;8998866106498;EMERON  LOVELY NTRL VT 100ML;1;3500;0;3500;2900;600;
2021-04-14 14:33:37;8998866610742;NOVO FAMILY PINK 76G;1;2000;0;2000;1820;180;
2021-04-14 14:33:37;8998866103985;CIPT SIKP;1;3000;0;3000;2552;448;
2021-04-14 14:33:37;8991111101507;JB POWDER BLOSSOM 50G;1;3500;0;3500;3000;500;
2021-04-14 14:33:37;089686043273;INDOMIE SAMBAL RICA;1;2700;0;2700;2452;248;
2021-04-14 14:33:37;8992775001042;PILUS GARUDA MI GORENG;1;5500;0;5500;4713;787;
2021-04-14 14:33:37;8992775311325;GERY SNACK&SEREAL 100G;1;7000;0;7000;5892;1108;
2021-04-14 14:35:05;8992761002015;COCA COLA PET 390ML;1;5500;0;5500;4333;1167;
2021-04-14 15:31:37;8998866501033;MINYAK GORENG SEDAAP POUCH 2L;1;28000;0;28000;27746;254;
2021-04-14 16:42:55;8998866201964;MINYAK GORENG SABRINA 2L POUCH;1;27500;0;27500;26753;747;
2021-04-14 16:52:38;001;PASEO SMART FACIAL SF 250S GT;1;10000;0;10000;9500;500;
2021-04-14 18:07:17;8996001301579;MALKIST CKLT KELAPA PACK;1;6500;0;6500;5400;1100;
2021-04-14 18:07:17;8996001302323;MALKIST ABON;1;6500;0;6500;4800;1700;
2021-04-14 18:08:50;8999801700030;SUSU FOYU;1;11500;0;11500;10450;1050;
2021-04-14 18:08:50;8994834005923;SPIX 1000;5;1000;0;5000;4250;750;
2021-04-14 18:09:41;8994834005923;SPIX 1000;1;1000;0;1000;850;150;
2021-04-14 18:12:31;8992761166212;FRESTEA APPLE 350ML;1;4500;0;4500;3000;1500;
2021-04-14 18:12:31;8994834005923;SPIX 1000;3;1000;0;3000;2550;450;
2021-04-14 18:12:31;HT;HOT-HOT;1;500;0;500;350;150;
2021-04-14 18:18:18;8992753102204;BKM COKLAT 370G;1;11300;0;11300;9500;1800;
2021-04-14 18:18:18;8999801700030;SUSU FOYU;2;11500;0;23000;20900;2100;
2021-04-14 18:18:18;8992628010139;BIMOLI 5L;1;75000;0;75000;72100;2900;
2021-04-14 18:25:29;711844610095;LARISSA UDANG 500 GR;2;11000;0;22000;19580;2420;
2021-04-14 19:37:00;GL;GULA 1 LITER;3;11500;0;34500;31500;3000;
2021-04-14 19:37:00;8998866201865;KRISBEE PILLOW CHOCOLAVA 120 GR;1;8000;0;8000;7250;750;
2021-04-14 21:11:41;8992761145019;COCA COLA PET 250ML;1;3500;0;3500;2417;1083;
2021-04-14 21:11:41;PRG;PARAGO;3;500;0;1500;1200;300;
2021-04-14 21:47:12;8998989300261;GUDANG GARAM SURYA 12 FILTER;2;18000;0;36000;32900;3100;
2021-04-14 21:47:12;8994834005923;SPIX 1000;2;1000;0;2000;1700;300;
2021-04-14 21:59:47;8998989110167;SURYA GUDANG GARAM 16 FILTER;2;24000;0;48000;44200;3800;
2021-04-14 21:59:47;8886013213208;FRENCH FREIS 2000;1;5000;0;5000;3750;1250;
2021-04-14 21:59:47;8992388133017;NU MILK TEA ORI 330ML;1;6000;0;6000;5125;875;
2021-04-14 22:01:26;8886013213208;FRENCH FREIS 2000;1;5000;0;5000;3750;1250;
2021-04-14 22:01:26;8851019210117;POCKY CHOCOLATE 47G;1;7300;0;7300;5671;1629;
2021-04-14 22:01:26;8991001770301;SELAMAT CLACK VANILA;1;13000;0;13000;11800;1200;
2021-04-14 22:01:26;8991001502933;CHACHA TUBE;2;7500;0;15000;12800;2200;
2021-04-15 13:56:17;8996001320051;KOPIKO COFFE CANDY;1;6200;0;6200;5600;600;
2021-04-15 15:24:43;001;PASEO SMART FACIAL SF 250S GT;1;10000;0;10000;9500;500;
2021-04-15 15:33:10;8996001600269;LE MINERAL 600ML;1;3000;0;3000;1688;1312;
2021-04-15 15:33:10;8998866603546;SOKLIN FLOORCLENER UNGU 450ML;1;7000;0;7000;6385;615;
2021-04-15 15:33:10;8993470279651;JOGER CHOCKY BAR;3;1000;0;3000;2601;399;
2021-04-15 15:33:10;8997021300092;LARISSA BAWANG 250GR;2;5500;0;11000;10250;750;
2021-04-15 15:33:10;711844610064;LARISSA SINGKONG 250GR;1;5000;0;5000;4545;455;
2021-04-15 15:33:10;8997002060168;KRP SINGKOG PDS PANDA DUO;1;8000;0;8000;7300;700;
2021-04-15 15:33:10;8992753102303;BKM SCT CKLT 40G;2;7500;0;15000;13800;1200;
2021-04-15 15:33:10;711844610095;LARISSA UDANG 500 GR;1;11000;0;11000;9790;1210;
2021-04-15 15:33:10;089686041705;INDOMIE GORENG JUMBO;2;3500;0;7000;6286;714;
2021-04-15 15:33:10;8993007000680;INDOMILK 1L;1;16500;0;16500;14792;1708;
2021-04-15 15:33:10;8998898830125;KKB ENER-G ANGGUR;4;5500;0;22000;19296;2704;
2021-04-15 15:33:10;8999999524722;SUNLIGHT LIME NEW PCH 435ML;1;10000;0;10000;9100;900;
2021-04-15 15:33:10;8999999037765;PEPSODENT WHITE 225G;1;12000;0;12000;10750;1250;
2021-04-15 15:33:10;8999999030179;PEPSODENT ACTION 123 COMPLETE 75G;1;6700;0;6700;5170;1530;
2021-04-15 15:33:10;18998866103982;CIPTADENT TB CRYSTAL CLEAN MED;1;3000;0;3000;2585;415;
2021-04-15 15:33:10;8998866888622;GIV MERAH KOTAK 76G;1;2000;0;2000;1820;180;
2021-04-15 15:57:29;8999999045616;MOLTO AIO PINK SCH;6;1000;0;6000;4800;1200;
2021-04-15 15:57:29;8993176110135;MINYAK TELON LANG 30ML;1;10000;0;10000;8167;1833;
2021-04-15 15:57:29;8992694247255;ZWITSAL BATH NAT HAIR&BODY 200ML;1;20500;0;20500;18810;1690;
2021-04-15 15:57:29;8996001350850;SUPER STAR SNAPS;1;16300;0;16300;14800;1500;
2021-04-15 15:57:29;8992775312469;GERY SALUT COKELAT;1;11000;0;11000;9983;1017;
2021-04-15 15:57:29;8998866608725;DAIA SOFTENER BAG 850G;1;18000;0;18000;15627;2373;
2021-04-15 16:01:28;8998866107495;ZINC HAIRFALL TREATH SHT 10ML;1;5000;0;5000;4500;500;
2021-04-15 16:01:28;8999999042646;RINSO MOLTO ROSE FRESH LIQ 40ML;1;5000;0;5000;4817;183;
2021-04-15 16:19:13;8993379254469;SABUN LERVIA 90G;1;3500;0;3500;2966;534;
2021-04-15 16:19:13;8999999036492;LUX BW PINK SOFT BTL 100ML;1;10000;0;10000;8690;1310;
2021-04-15 16:50:29;8991102281430;PERMEN MINTZ DUOMINT;1;4500;0;4500;4000;500;
2021-04-15 17:58:42;8992761139018;ADES 600ML;3;3500;0;10500;6876;3624;
2021-04-15 17:58:42;8996001600269;LE MINERAL 600ML;1;3000;0;3000;1688;1312;
2021-04-15 17:59:39;8999909000377;SAMPOERNA AVOLUTION;1;30000;0;30000;28450;1550;
2021-04-15 18:00:36;8998989300261;GUDANG GARAM SURYA 12 FILTER;1;18000;0;18000;16450;1550;
2021-04-15 18:00:36;123124;KOREK BIASA;1;2000;0;2000;1800;200;
2021-04-15 18:21:52;8998866202671;NOODLE SEDAAP MIE KOREAN SPICY SOUP CUP;2;5000;0;10000;8004;1996;
2021-04-15 18:21:52;089686043051;INDOMIE COTO MAKASSAR;1;2800;0;2800;2525;275;
2021-04-15 18:21:52;JGR SHN;JOGER SHINY SACHET;1;500;0;500;437;63;
2021-04-15 18:21:52;bb;BENG-BENG;1;1500;0;1500;1450;50;
2021-04-15 18:33:14;8996001600269;LE MINERAL 600ML;1;3000;0;3000;1688;1312;
2021-04-15 19:02:23;8997028590014;ARGUS 220ML;2;500;0;1000;604;396;
2021-04-15 19:02:23;JGR SHN;JOGER SHINY SACHET;2;500;0;1000;874;126;
2021-04-15 21:28:19;8998989300261;GUDANG GARAM SURYA 12 FILTER;1;18000;0;18000;16450;1550;
2021-04-15 21:50:04;8999909096004;SAMPOERNA 16 FILTER;1;24000;0;24000;23000;1000;
2021-04-15 21:59:27;8992959953082;SWEETY BRONZE L8;1;17000;0;17000;15380;1620;
2021-04-15 22:09:43;8999999520151;PEPSODENT TB FAMILY SOFT;1;2100;0;2100;1900;200;
2021-04-15 22:09:43;8999999706111;PEPSODENT WHITE 25G;1;2000;0;2000;1450;550;
2021-04-15 22:30:00;6907992823904;JD CRUNCHY CHOCOLATE VAN;1;8000;0;8000;6800;1200;
2021-04-15 22:30:00;6907992823867;JD CRUNCHY CHOCOLATE MALT;1;5500;0;5500;4700;800;
2021-04-15 22:30:00;6907992823843;JD MOCHA CRISPY;1;5000;0;5000;4400;600;
2021-04-15 22:31:08;SOSIS;SO NICE SAPI;2;1000;0;2000;1880;120;
2021-04-15 22:31:08;8991111101408;JB POWSER 50G;1;3500;0;3500;3000;500;
2021-04-15 22:31:08;8992759120264;LARISST 220;1;10000;0;10000;9200;800;
2021-04-15 22:31:08;8992761164539;NUTRIBOOST ORANGE 300ML;1;6500;0;6500;5300;1200;
2021-04-15 22:32:26;8999999048266;SUNSILK SHP SOFT&SMTH 170ML;1;19900;0;19900;18150;1750;
2021-04-16 11:39:58;8992628020152;BIMOLI POUCH 2L;1;30000;0;30000;29000;1000;
2021-04-16 11:39:58;GL;GULA 1 LITER;2;11500;0;23000;21000;2000;
2021-04-16 11:39:58;711844150027;ABC NANAS;1;15000;0;15000;12241;2759;
2021-04-16 11:39:58;8995333060703;TERIGU KOMPAS 1KG;1;10500;0;10500;9816;684;
2021-04-16 11:39:58;8993083929806;BISKITOP COKLAT;1;30000;0;30000;27000;3000;
2021-04-16 11:47:33;GL;GULA 1 LITER;15;11500;0;172500;157500;15000;
2021-04-16 11:58:28;8999801700030;SUSU FOYU;3;11500;0;34500;31350;3150;
2021-04-16 11:58:28;JGR;JOGER CHOCKY PASTA;1;20000;0;20000;18190;1810;
2021-04-16 11:58:28;8998899995120;BAYGON TEA BLOSSOM;1;38000;0;38000;35000;3000;
2021-04-16 11:58:28;711844150027;ABC NANAS;3;15000;0;45000;36723;8277;
2021-04-16 11:58:28;8998866202619;MIE SEDAAP KOREAN SPICY SOUP;2;2500;0;5000;4546;454;
2021-04-16 11:58:28;8850507001152;MOTU ATV;1;10000;0;10000;8000;2000;
2021-04-16 11:58:28;8998866693660;SOKLIN FLOORCLENER KUNING 900ML;1;14000;0;14000;12436;1564;
2021-04-16 11:58:28;8999999528881;CITRA HBL NAT GLOWING WHITE UV;1;20000;0;20000;17703;2297;
2021-04-16 12:01:46;8992761164546;NUTRIBOOST STRAWBERRY 300ML;1;6500;0;6500;5300;1200;
2021-04-16 12:03:01;8995333060703;TERIGU KOMPAS 1KG;2;10500;0;21000;19632;1368;
2021-04-16 12:38:54;8999999027056;LIFEBUOY ANTI KETOMBE 9ML;1;5000;0;5000;4500;500;
2021-04-16 12:38:54;8999999045623;MOLTO AIO BLUE SCH;5;1000;0;5000;4000;1000;
2021-04-16 12:38:54;8999999558062;RINSO ANTI NODA CLASSIC PWD 44G;5;1000;0;5000;4025;975;
2021-04-16 12:38:54;8999999050009;SUNLIGHT LIME NEW POUCH 95ML;2;2000;0;4000;3200;800;
2021-04-16 12:38:54;8999999059781;SUNLIGHT LIME NEW POUCH 210ML;3;5000;0;15000;12900;2100;
2021-04-16 12:38:54;711844610095;LARISSA UDANG 500 GR;1;11000;0;11000;9790;1210;
2021-04-16 12:38:54;8992628022156;BIMOLI KLASIK TOUCH 1 LT;1;15500;0;15500;14350;1150;
2021-04-16 12:38:54;001;PASEO SMART FACIAL SF 250S GT;1;10000;0;10000;9500;500;
2021-04-16 12:38:54;8999999017804;CITRA BW NATURAL WHITE LD 400ML;1;21000;0;21000;19000;2000;
2021-04-16 12:38:54;8992770034175;MASAKO 100GR;1;5000;0;5000;3500;1500;
2021-04-16 12:38:54;8995333060703;TERIGU KOMPAS 1KG;1;10500;0;10500;9816;684;
2021-04-16 12:38:54;GL;GULA 1 LITER;1;11500;0;11500;10500;1000;
2021-04-16 12:56:59;GL;GULA 1 LITER;4;11500;0;46000;42000;4000;
2021-04-16 12:56:59;8999999502393;ROYCO FDS CHICKEN 8G;1;5000;0;5000;4500;500;
2021-04-16 13:29:06;8992959953334;SWEETY BRONZE XL42;1;80000;0;80000;75455;4545;
2021-04-16 14:29:50;8998899995120;BAYGON TEA BLOSSOM;1;38000;0;38000;35000;3000;
2021-04-16 14:29:50;8997002060168;KRP SINGKOG PDS PANDA DUO;2;8000;0;16000;14600;1400;
2021-04-16 14:29:50;8995333032113;TERIGU GATOT KACA 1 KG;2;8500;0;17000;16024;976;
2021-04-16 14:29:50;8998866202312;NOODLE SEDAAP TASTY BAKMI AYAM 129 GR;2;5000;0;10000;8334;1666;
2021-04-16 15:29:50;8998866611718;EKONOMI PENCUCI PIRING  LIQ 780ML;1;12000;0;12000;10900;1100;
2021-04-16 15:29:50;8998866107495;ZINC HAIRFALL TREATH SHT 10ML;2;5000;0;10000;9000;1000;
2021-04-16 15:29:50;8993072153595;LARISST COTTON 35G;1;5000;0;5000;3300;1700;
2021-04-16 15:29:50;8999909003439;MARLBORO CRAFTED 12;2;8000;0;16000;10874;5126;
2021-04-16 15:29:50;123124;KOREK BIASA;1;2000;0;2000;1800;200;
2021-04-16 16:54:33;089686834253;FREISS MELON;1;16000;0;16000;14200;1800;
2021-04-16 17:17:14;8996001301579;MALKIST CKLT KELAPA PACK;2;6500;0;13000;10800;2200;
2021-04-16 17:17:14;8992775211434;PILUS GARUDA SAPI PANGGANG;1;5500;0;5500;4713;787;
2021-04-16 17:17:14;8992775211410;PILUS GARUDA PEDAS;1;5500;0;5500;4713;787;
2021-04-16 17:17:14;089686061079;POP MIE MINI AY BAWANG RL;2;3000;0;6000;5404;596;
2021-04-16 17:17:14;8991001780126;SELAMAT CKLAT 60G;4;5000;0;20000;17200;2800;
2021-04-16 17:31:30;8992222091961;PUCELLE MIST COL SPRAY 75ML;1;13000;0;13000;11650;1350;
2021-04-16 17:39:42;8994867000162;ROKOK PUNDIMAS KRETEK16;1;10000;0;10000;8600;1400;
2021-04-16 17:45:15;8996001320136;KOPIKO CAPP CANDY;1;6200;0;6200;5600;600;
2021-04-16 17:48:05;9556040040038;SUSU F&N;1;33000;0;33000;30000;3000;
2021-04-16 17:48:05;8993470671752;JOGER STICK DUO KACANG;1;1000;0;1000;850;150;
2021-04-16 18:05:44;8998866202237;NOODLE SEDAAP TASTY AYAM GEPREK 124 GR;2;5000;0;10000;8334;1666;
2021-04-16 19:27:01;8999999706449;CLOSEUP ICY WHITE 65G;1;9000;0;9000;7865;1135;
2021-04-16 19:38:59;8996001320136;KOPIKO CAPP CANDY;1;6200;0;6200;5600;600;
2021-04-16 21:03:30;8998866610087;JAVANA ORIGINAL 350ML;1;3000;0;3000;2150;850;
2021-04-16 21:30:55;8998866200882;SUKSESMIE GORENG AYAM KRMS 133GR;1;3500;0;3500;3047;453;
2021-04-16 21:30:55;8994834005923;SPIX 1000;6;1000;0;6000;5100;900;
2021-04-16 21:35:43;8992761147143;SPRITE WATERLYMON 425ML;3;5500;0;16500;12900;3600;
2021-04-16 21:35:43;8992761164539;NUTRIBOOST ORANGE 300ML;1;6500;0;6500;5300;1200;
2021-04-16 21:35:43;8992761164546;NUTRIBOOST STRAWBERRY 300ML;1;6500;0;6500;5300;1200;
2021-04-16 21:44:38;8993571003827;CAP 19 BEDAK SALICYL MENTHOL 100G;2;8000;0;16000;14000;2000;
2021-04-16 21:44:38;8996001301579;MALKIST CKLT KELAPA PACK;2;6500;0;13000;10800;2200;
2021-04-16 21:44:38;8992761145026;SPRITE PET 250ML;1;3500;0;3500;2417;1083;
2021-04-16 22:33:46;9556001025272;NESCAFE LATTE 240ML;1;8500;0;8500;7437;1063;
2021-04-16 22:33:46;8993470279651;JOGER CHOCKY BAR;1;1000;0;1000;867;133;
2021-04-16 22:34:11;123;BETREI JAM;1;5500;0;5500;5000;500;
2021-04-17 11:45:31;SF TAWAR ORI;SAFFANAH TAWAR ORI;1;9000;0;9000;8000;1000;
2021-04-17 11:45:31;8992957214307;SAFARI MECES;1;5500;0;5500;4500;1000;
2021-04-17 11:45:31;8999908284907;MY BABY MINYAK TELON 90ML;1;25000;0;25000;22700;2300;
2021-04-17 11:45:56;SOSIS;SO NICE SAPI;1;1000;0;1000;940;60;
2021-04-17 11:45:56;8998989500166;GUDANG GARAM MERAH BESAR 16KS;1;17000;0;17000;15300;1700;
2021-04-17 12:45:32;8998866200578;MIE SEDAAP KARI KENTAL;2;2500;0;5000;4526;474;
2021-04-17 13:23:22;JGR SHN;JOGER SHINY SACHET;1;500;0;500;437;63;
2021-04-17 13:23:22;COKLAT;COKLAT COIN;1;500;0;500;400;100;
2021-04-17 13:23:22;MARS;MARSHMELLOW;2;500;0;1000;866;134;
2021-04-17 13:23:22;8997218380074;ICHITAN MILK TEA;1;8000;0;8000;6583;1417;
2021-04-17 13:50:52;8998008151065;MIWON 100 GR;4;3300;0;13200;11984;1216;
2021-04-17 13:50:52;8992753102204;BKM COKLAT 370G;2;11300;0;22600;19000;3600;
2021-04-17 13:58:53;8997231980022;O'JELLY MINI STRAWBERRY;1;3000;0;3000;2250;750;
2021-04-17 13:58:53;TUSTEL;TUSUK TELINGA;1;1000;0;1000;833;167;
2021-04-17 13:58:53;SOSIS;SO NICE SAPI;2;1000;0;2000;1880;120;
2021-04-17 13:58:53;8994037703749;WENIS JERUK;1;8000;0;8000;6500;1500;
2021-04-17 16:42:53;089686834307;FREISS LECI;1;11000;0;11000;8750;2250;
2021-04-17 16:42:53;8999999059781;SUNLIGHT LIME NEW POUCH 210ML;1;5000;0;5000;4300;700;
2021-04-17 16:58:38;GL;GULA 1 LITER;10;11500;0;115000;105000;10000;
2021-04-17 17:01:54;8992959053232;CONFIDENCE CLLASIC NIGHT M8;1;42000;0;42000;38182;3818;
2021-04-17 17:03:39;8992775211410;PILUS GARUDA PEDAS;1;5500;0;5500;4713;787;
2021-04-17 17:03:39;8996001301142;ROMA KELAPA;1;8000;0;8000;6628;1372;
2021-04-17 17:03:39;8996001600399;LE MINERAL 1500ML;1;5000;0;5000;4042;958;
2021-04-17 17:50:04;711844610095;LARISSA UDANG 500 GR;4;11000;0;44000;39160;4840;
2021-04-17 17:50:04;8998989500166;GUDANG GARAM MERAH BESAR 16KS;1;17000;0;17000;15300;1700;
2021-04-17 18:57:04;8992775001660;WAFER CREAM COKLAT TABUR KEJU;1;19000;0;19000;17721;1279;
2021-04-17 18:57:04;8992761145026;SPRITE PET 250ML;1;3500;0;3500;2417;1083;
2021-04-17 18:57:04;8851019210117;POCKY CHOCOLATE 47G;1;7300;0;7300;5671;1629;
2021-04-17 20:08:31;8998866201520;KOPI TOP TORAJA MURNI;1;11000;0;11000;9600;1400;
2021-04-17 20:12:20;8992761145026;SPRITE PET 250ML;2;3500;0;7000;4834;2166;
2021-04-17 20:57:39;8998866201520;KOPI TOP TORAJA MURNI;1;11000;0;11000;9600;1400;
2021-04-17 20:58:16;8997028590014;ARGUS 220ML;2;500;0;1000;604;396;
2021-04-17 21:03:36;8999909000544;MARLBORO F BLACK;1;29001;0;29001;27800;1201;
2021-04-17 21:03:36;123124;KOREK BIASA;1;2000;0;2000;1800;200;
2021-04-18 11:58:40;8992696404441;BEAR BRAND 189ML;1;8500;0;8500;7887;613;
2021-04-18 11:58:40;BTS;BIMURA TARO SEAWEED 250G;1;10000;0;10000;9300;700;
2021-04-18 11:58:40;8998866610278;DAIA VIOLET GUSSET 565G;1;10000;0;10000;8700;1300;
2021-04-18 11:58:40;711844140059;ABC SAUS TIRAM 135 ML;1;8500;0;8500;7750;750;
2021-04-18 11:58:40;GL;GULA 1 LITER;10;11500;0;115000;105000;10000;
2021-04-18 11:58:40;8998866501033;MINYAK GORENG SEDAAP POUCH 2L;4;28000;0;112000;110984;1016;
2021-04-18 11:58:40;089686010107;INDOMIE KALDU AYAM;10;2500;0;25000;21500;3500;
2021-04-18 12:56:35;089686021127;INTER MIE KALDU;1;1000;0;1000;813;187;
2021-04-18 12:56:35;8993470411433;JOGER CLASSIC;1;1000;0;1000;850;150;
2021-04-18 12:56:35;8997028590014;ARGUS 220ML;2;500;0;1000;604;396;
2021-04-18 13:51:54;9999;ISOLASI LAKBAN;1;8000;0;8000;6500;1500;
2021-04-18 13:51:54;001;PASEO SMART FACIAL SF 250S GT;2;10000;0;20000;19000;1000;
2021-04-18 15:20:15;8999801700030;SUSU FOYU;1;11500;0;11500;10450;1050;
2021-04-18 15:20:15;JGR SHN;JOGER SHINY SACHET;1;500;0;500;437;63;
2021-04-18 16:03:46;8998866501033;MINYAK GORENG SEDAAP POUCH 2L;1;28000;0;28000;27746;254;
2021-04-18 16:17:06;8998989300261;GUDANG GARAM SURYA 12 FILTER;1;18000;0;18000;16450;1550;
2021-04-18 16:17:06;8996001301142;ROMA KELAPA;1;8000;0;8000;6628;1372;
2021-04-18 16:58:23;8993365121539;MADU TJ SUPER 150G;1;16800;0;16800;15220;1580;
2021-04-18 17:55:38;8998989300261;GUDANG GARAM SURYA 12 FILTER;1;18000;0;18000;16450;1550;
2021-04-18 18:58:05;8997231980022;O'JELLY MINI STRAWBERRY;2;3000;0;6000;4500;1500;
2021-04-18 21:29:20;6921101219235;YAKUAT JELLY;1;2000;0;2000;1750;250;
2021-04-18 21:39:08;8991004011906;KOPI BORONG;1;10000;0;10000;8333;1667;
2021-04-18 21:39:53;8991188943536;SASA SANTAN KELAPA 65ML;1;3000;0;3000;2437;563;
2021-04-18 22:03:14;8997231980022;O'JELLY MINI STRAWBERRY;1;3000;0;3000;2250;750;
2021-04-18 22:03:14;8994420107789;SARDEN SAUS TOMAT;1;7000;0;7000;5833;1167;
2021-04-18 22:03:14;TG APEL;TEH GELAS APEL;1;2000;0;2000;1178;822;
2021-04-18 22:03:14;ff;FULLO BLASTO;1;1000;0;1000;995;5;
2021-04-18 22:03:14;SF TAWAR COKLAT;SAFFANAH ROTI TAWAR COKLAT;1;13500;0;13500;12000;1500;
2021-04-19 11:18:03;8996001320136;KOPIKO CAPP CANDY;1;6200;0;6200;5600;600;
2021-04-19 11:18:03;8994021000915;CINCAO;3;3000;0;9000;5874;3126;
2021-04-19 11:18:03;8999999059316;LIFEBOUY TS MILDCARE 75G;3;3000;0;9000;7500;1500;
2021-04-19 11:18:03;8999999531508;MOLTO HYGIENE SC 10ML;2;500;0;1000;960;40;
2021-04-19 14:56:19;8992775712603;MYTEA POCI OOLONG;1;5000;0;5000;4410;590;
2021-04-19 15:06:39;8997231980022;O'JELLY MINI STRAWBERRY;1;3000;0;3000;2250;750;
2021-04-19 16:28:13;8998989500166;GUDANG GARAM MERAH BESAR 16KS;2;17000;0;34000;30600;3400;
2021-04-19 16:28:13;GL;GULA 1 LITER;1;11500;0;11500;10500;1000;
2021-04-19 16:39:05;8992775110140;GARUDA KACANG KULIT 160G;1;12000;0;12000;10012;1988;
2021-04-19 16:39:05;8998866202343;MIE SEDAAP KOREAN SPICY;1;2500;0;2500;2023;477;
2021-04-19 16:58:01;8997009510116;LEMON WATER;1;7000;0;7000;5694;1306;
2021-04-19 17:18:28;089686834055;FREISS JERUK;1;11000;0;11000;8750;2250;
2021-04-19 17:18:28;GL;GULA 1 LITER;2;11500;0;23000;21000;2000;
2021-04-19 17:18:28;8999999504656;SARI MURNI 20X1.8G;1;5000;0;5000;4200;800;
2021-04-19 17:38:19;8998989300261;GUDANG GARAM SURYA 12 FILTER;1;18000;0;18000;16450;1550;
2021-04-19 18:11:37;8992761164539;NUTRIBOOST ORANGE 300ML;1;6500;0;6500;5300;1200;
2021-04-19 18:11:37;8992761164546;NUTRIBOOST STRAWBERRY 300ML;1;6500;0;6500;5300;1200;
2021-04-19 18:18:40;8999909010567;234 16 FILTER;1;22000;0;22000;21500;500;
2021-04-19 18:19:54;8998989500128;GUDANG GARAM MERAH KECIL 12KS;1;13000;0;13000;11900;1100;
2021-04-19 18:57:45;8999999531492;MOLTO GLAMOUR;1;5000;0;5000;4800;200;
2021-04-19 18:57:45;8998989300261;GUDANG GARAM SURYA 12 FILTER;1;18000;0;18000;16450;1550;
2021-04-19 18:57:45;123124;KOREK BIASA;1;2000;0;2000;1800;200;
2021-04-19 18:59:01;TUSTEL;TUSUK TELINGA;1;1000;0;1000;833;167;
2021-04-19 19:19:10;8991102281416;PERMEN MINTZ PPMINT;1;4500;0;4500;4000;500;
2021-04-19 19:22:45;kp;KALPA;1;2000;0;2000;1666;334;
2021-04-19 21:08:27;8999999524722;SUNLIGHT LIME NEW PCH 435ML;1;10000;0;10000;9100;900;
2021-04-19 21:20:30;8996001318911;BETTER ISI 4;1;2000;0;2000;1700;300;
2021-04-19 21:20:30;089686043051;INDOMIE COTO MAKASSAR;1;2800;0;2800;2525;275;
2021-04-19 21:20:30;8997018250218;JAHE MERAH;2;1000;0;2000;1666;334;
2021-04-19 21:25:22;34678;SENDAL JEPIT;1;15000;0;15000;13500;1500;
2021-04-19 21:25:22;8998866613262;SUKSESMIE SOTO 111 GR;1;3500;0;3500;2770;730;
2021-04-19 21:28:31;8996001600375;LE MINERAL 330ML;1;2000;0;2000;1417;583;
2021-04-19 21:28:31;9556001174659;MILO ACT GO 240ML;1;8500;0;8500;7437;1063;
2021-04-19 21:28:31;8998866201483;POTABEE REGULER GRILLED SEAWEED 35GR;1;5000;0;5000;4150;850;
2021-04-19 21:34:56;8991102281416;PERMEN MINTZ PPMINT;1;4500;0;4500;4000;500;
2021-04-19 22:29:35;8991102228053;TEH GELAS BOTOL;1;3000;0;3000;1695;1305;
2021-04-19 22:29:35;BRS;BERAS BUMN 10KG;1;128000;0;128000;100000;28000;
2021-04-20 12:51:53;GLK;GULATA 50KG;1;620000;0;620000;592000;28000;
2021-04-20 12:51:53;8998866501026;MINYAK GORENG SEDAAP POUCH 1 L;12;15000;0;180000;169320;10680;
2021-04-20 12:58:11;GL;GULA 1 LITER;1;11500;0;11500;10500;1000;
2021-04-20 12:58:11;8998866607315;SOKLIN SOFTERGENT SAKURA 770G & PIRING;1;18000;0;18000;16680;1320;
2021-04-20 12:58:11;kp;KALPA;1;2000;0;2000;1666;334;
2021-04-20 12:58:11;8999999559533;LIFEBUOY BW TOTAL 10 90ML;1;5000;0;5000;4000;1000;
2021-04-20 12:58:11;8992959509005;SWEETY SILVER PANTS XL26;1;61500;0;61500;55910;5590;
2021-04-20 12:58:11;8992775203422;GARUDA ROSTA OVEN 100G;1;8000;0;8000;7322;678;
2021-04-20 12:58:11;8850507000094;POLICE BONCHA;1;2000;0;2000;800;1200;
2021-04-20 12:58:11;8997231980022;O'JELLY MINI STRAWBERRY;1;3000;0;3000;2250;750;
2021-04-20 12:58:11;8992696523081;MILO UHT 110ML;1;2500;0;2500;1962;538;
2021-04-20 12:58:11;8995102703534;TERASI DUO 6 GR;2;4000;0;8000;7440;560;
2021-04-20 12:58:11;089686044249;SUPERMI NUTRIMI STEAK AYAM;4;3500;0;14000;11200;2800;
2021-04-20 12:59:10;8996001600269;LE MINERAL 600ML;1;3000;0;3000;1688;1312;
2021-04-20 12:59:10;089686044249;SUPERMI NUTRIMI STEAK AYAM;2;3500;0;7000;5600;1400;
2021-04-20 14:21:43;8996001318430;BETTER 1000;3;1000;0;3000;2460;540;
2021-04-20 14:22:18;8991102228053;TEH GELAS BOTOL;1;3000;0;3000;1695;1305;
2021-04-20 15:31:49;8999999042639;RINSO ANTI NODA CLS LIQ 40ML;1;1000;0;1000;805;195;
2021-04-20 15:31:49;8998866608718;DAIA SOFTENER PINK;1;5000;0;5000;4450;550;
2021-04-20 15:31:49;8998866107495;ZINC HAIRFALL TREATH SHT 10ML;1;5000;0;5000;4500;500;
2021-04-20 15:31:49;8998989300261;GUDANG GARAM SURYA 12 FILTER;1;18000;0;18000;16450;1550;
2021-04-20 15:31:49;8998866611718;EKONOMI PENCUCI PIRING  LIQ 780ML;1;12000;0;12000;10900;1100;
2021-04-20 16:24:17;8992628022156;BIMOLI KLASIK TOUCH 1 LT;1;15500;0;15500;14350;1150;
2021-04-20 16:41:40;9556001004673;MILO NESTLE MALAYSIA ACTIVE GO;1;85000;0;85000;80000;5000;
2021-04-20 17:50:25;8992736025162;SASA TEPUNG PISANG GORENG;1;5000;0;5000;4455;545;
2021-04-20 18:34:26;8993058105013;EXTRA JOSS;1;12000;0;12000;9773;2227;
2021-04-20 19:16:30;8998989500166;GUDANG GARAM MERAH BESAR 16KS;2;17000;0;34000;30600;3400;
2021-04-20 19:16:30;8998989300261;GUDANG GARAM SURYA 12 FILTER;1;18000;0;18000;16450;1550;
2021-04-20 21:42:11;089686021127;INTER MIE KALDU;2;1000;0;2000;1626;374;
2021-04-20 21:42:11;089686043051;INDOMIE COTO MAKASSAR;1;2800;0;2800;2525;275;
2021-04-20 21:42:11;8998866202312;NOODLE SEDAAP TASTY BAKMI AYAM 129 GR;1;5000;0;5000;4167;833;
2021-04-20 21:56:29;8886013213208;FRENCH FREIS 2000;1;5000;0;5000;3750;1250;
2021-04-20 22:42:08;8992696404441;BEAR BRAND 189ML;1;8500;0;8500;7887;613;
2021-04-20 22:42:08;6907992823935;JD SWEETCORN;1;3500;0;3500;3000;500;
2021-04-21 12:41:24;BTS;BIMURA TARO SEAWEED 250G;1;10000;0;10000;9300;700;
2021-04-21 12:41:24;8991102385091;WFR TANGO CKLT 7G;1;8300;0;8300;7455;845;
2021-04-21 12:41:24;8991001780492;SELAMAT COKLAT;1;13000;0;13000;11800;1200;
2021-04-21 12:41:24;8998866500708;FLORIDINA ORANGE;2;3000;0;6000;5000;1000;
2021-04-21 12:42:37;8998866610261;DAIA VIOLET GUSSET BAG 290 GR;1;5000;0;5000;4450;550;
2021-04-21 12:42:37;MOLTO PINK;MOLTO ALL IN ONE 11 ML;2;500;0;1000;800;200;
2021-04-21 13:00:47;8992959953082;SWEETY BRONZE L8;1;17000;0;17000;15380;1620;
2021-04-21 13:03:56;8998989500166;GUDANG GARAM MERAH BESAR 16KS;1;17000;0;17000;15300;1700;
2021-04-21 13:11:12;8850507002951;BONCHA EGG SQUISHY;2;12000;0;24000;21682;2318;
2021-04-21 13:11:12;6907992825069;JD FRUITY;1;5000;0;5000;4400;600;
2021-04-21 13:11:12;8996001600269;LE MINERAL 600ML;1;3000;0;3000;1688;1312;
2021-04-21 13:11:12;8993274532105;BOLU;1;1000;0;1000;833;167;
2021-04-21 13:11:12;PRG;PARAGO;1;500;0;500;400;100;
2021-04-21 13:11:12;8992696404441;BEAR BRAND 189ML;1;8500;0;8500;7887;613;
2021-04-21 13:11:12;9556001174659;MILO ACT GO 240ML;1;8500;0;8500;7437;1063;
2021-04-21 13:11:12;6921101219235;YAKUAT JELLY;1;2000;0;2000;1750;250;
2021-04-21 13:13:42;8999999558062;RINSO ANTI NODA CLASSIC PWD 44G;5;1000;0;5000;4025;975;
2021-04-21 13:13:42;8998866608312;GIV PAPAYA KOTAK 76GR;1;2000;0;2000;1820;180;
2021-04-21 13:13:42;8992866707488;ZINC;1;5000;0;5000;4000;1000;
2021-04-21 13:32:04;8999909982000;SAMPOERNA 12 FILTER;1;18000;0;18000;16200;1800;
2021-04-21 13:32:04;8994021000915;CINCAO;2;3000;0;6000;3916;2084;
2021-04-21 14:00:49;8999909982000;SAMPOERNA 12 FILTER;1;18000;0;18000;16200;1800;
2021-04-21 15:49:52;8998866501033;MINYAK GORENG SEDAAP POUCH 2L;1;28000;0;28000;27746;254;
2021-04-21 16:31:18;8999999534097;PEPSODENT PGB FCM 75G;1;5000;0;5000;3850;1150;
2021-04-21 16:31:18;8992993524477;COLATTA FINEZA COMPOUND DARK 250G;1;18500;0;18500;17179;1321;
2021-04-21 17:55:15;BTS;BIMURA TARO SEAWEED 250G;1;10000;0;10000;9300;700;
2021-04-21 17:55:15;8992736980164;SASA TEPUNG KENTUCKY 80G;1;3000;0;3000;2181;819;
2021-04-21 18:05:07;123124;KOREK BIASA;1;2000;0;2000;1800;200;
2021-04-21 18:05:07;6907992823676;JD PEACH;1;2000;0;2000;1700;300;
2021-04-21 18:05:07;6907992823959;JD HAWTHORN BERRY;1;2000;0;2000;1700;300;
2021-04-21 18:05:07;8993989311699;CLAS MILD 16 FILTER;1;23000;0;23000;21700;1300;
2021-04-21 18:08:42;8996001600269;LE MINERAL 600ML;3;3000;0;9000;5064;3936;
2021-04-21 18:08:42;8996001600375;LE MINERAL 330ML;1;2000;0;2000;1417;583;
2021-04-21 21:25:59;8998989300261;GUDANG GARAM SURYA 12 FILTER;1;18000;0;18000;16450;1550;
2021-04-21 21:25:59;8994834005923;SPIX 1000;2;1000;0;2000;1700;300;
2021-04-21 22:31:43;COKLAT;COKLAT COIN;11;500;0;5500;4400;1100;
2021-04-21 22:31:43;8991001503114;CHACHA MILK CHOCOLATE 35G;1;5500;0;5500;4900;600;
2021-04-21 22:32:54;8992696422650;NESCAFE FRENCH VANILLA;1;5000;0;5000;4099;901;
2021-04-21 22:32:54;6907992825045;JD CRUNCHY MATCHA CHEESE;1;8000;0;8000;7000;1000;
2021-04-21 22:32:54;8998989110167;SURYA GUDANG GARAM 16 FILTER;2;24000;0;48000;44200;3800;
2021-04-21 22:32:54;BMO;BERAS MERAH ORGANIK;1;25000;0;25000;23500;1500;
2021-04-22 12:54:19;8998866202725;MILKU COKLAT PREMIUM 200ML;1;3000;0;3000;2375;625;
2021-04-22 12:54:19;8998866202732;MILKU STROBERI 200ML;1;3000;0;3000;2375;625;
2021-04-22 12:54:19;bb;BENG-BENG;1;1500;0;1500;1450;50;
2021-04-22 12:54:19;kp;KALPA;1;2000;0;2000;1666;334;
2021-04-22 12:56:17;8714700524002;MAIZENAKU;1;5000;0;5000;4200;800;
2021-04-22 12:56:17;8998866201469;POTABEE REGULER BBQ BEEF 68 GR;1;8000;0;8000;7200;800;
2021-04-22 12:56:17;8997011700123;BIHUN JAGUNG 300GR;1;6000;0;6000;4979;1021;
2021-04-22 12:56:17;8992222091961;PUCELLE MIST COL SPRAY 75ML;1;13000;0;13000;11650;1350;
2021-04-22 13:07:39;8996001318911;BETTER ISI 4;1;2000;0;2000;1700;300;
2021-04-22 13:18:49;8991111109121;JB POWDER BLOSSOM 75+25G;1;6000;0;6000;5430;570;
2021-04-22 13:18:49;MARS;MARSHMELLOW;1;500;0;500;433;67;
2021-04-22 13:18:49;089686010107;INDOMIE KALDU AYAM;1;2500;0;2500;2150;350;
2021-04-22 14:55:06;8992933211115;NUTRIJELL STRAWBERRY;2;6000;0;12000;10082;1918;
2021-04-22 14:55:06;GL;GULA 1 LITER;1;11500;0;11500;10500;1000;
2021-04-22 16:04:58;8991004011906;KOPI BORONG;1;10000;0;10000;8333;1667;
2021-04-22 16:04:58;8998866200646;KOPI TOP MURNI;1;11000;0;11000;9600;1400;
2021-04-22 16:04:58;8997011700123;BIHUN JAGUNG 300GR;1;6000;0;6000;4979;1021;
2021-04-22 16:08:20;KJ;KINDER JOY;1;2000;0;2000;1583;417;
2021-04-22 16:08:20;HT;HOT-HOT;2;500;0;1000;700;300;
2021-04-22 17:04:10;GL;GULA 1 LITER;6;11500;0;69000;63000;6000;
2021-04-22 17:23:15;8992775001653;GERY SALUT CHOCOLATE COCONUT;2;2000;0;4000;2952;1048;
2021-04-22 17:23:15;8998866108102;POSH GREEN BLOSSOM 150;1;19500;0;19500;17500;2000;
2021-04-22 17:23:15;8999999059309;LIFEBOUY TS TOTAL 10 DG 75G;1;3000;0;3000;2500;500;
2021-04-22 17:23:15;8992759120264;LARISST 220;1;10000;0;10000;9200;800;
2021-04-22 17:23:15;8992761145026;SPRITE PET 250ML;2;3500;0;7000;4834;2166;
2021-04-22 17:23:15;8994834006128;TICTIC PEDAS;1;2000;0;2000;1700;300;
2021-04-22 17:23:15;089686043204;INDOMIE MIE ACEH;1;2700;0;2700;2452;248;
2021-04-22 17:23:15;8996001355237;SUPER STAR;1;11000;0;11000;9900;1100;
2021-04-22 17:23:15;8996001305041;ROMA SANDWICH CKLT;1;7000;0;7000;5000;2000;
2021-04-22 17:54:13;6907992823829;JD MILKY MILK;2;3000;0;6000;5200;800;
2021-04-22 17:57:35;8998866202244;EKOMIE BUMBU KALDU AYAM;5;1000;0;5000;3990;1010;
2021-04-22 18:00:28;SF TAWAR KUPAS;SAFFANAH ROTI TAWAR KUPAS;1;10000;0;10000;9000;1000;
2021-04-22 18:12:28;8998866201841;GOLDA DOLCE LATTE 200ML;1;3000;0;3000;2500;500;
2021-04-22 18:12:28;ff;FULLO BLASTO;1;1000;0;1000;995;5;
2021-04-22 18:13:47;8998989110167;SURYA GUDANG GARAM 16 FILTER;1;24000;0;24000;22100;1900;
2021-04-22 18:13:47;8992761164539;NUTRIBOOST ORANGE 300ML;1;6500;0;6500;5300;1200;
2021-04-22 18:13:47;8992761145026;SPRITE PET 250ML;1;3500;0;3500;2417;1083;
2021-04-22 18:19:56;8998989300261;GUDANG GARAM SURYA 12 FILTER;1;18000;0;18000;16450;1550;
2021-04-22 19:42:13;8998866202312;NOODLE SEDAAP TASTY BAKMI AYAM 129 GR;1;5000;0;5000;4167;833;
2021-04-22 19:42:13;8998866202237;NOODLE SEDAAP TASTY AYAM GEPREK 124 GR;1;5000;0;5000;4167;833;
2021-04-22 19:48:32;8998866202237;NOODLE SEDAAP TASTY AYAM GEPREK 124 GR;1;5000;0;5000;4167;833;
2021-04-22 21:51:17;8999999516208;ROYCO FDS CHICKEN NEW 230G;3;10000;0;30000;27000;3000;
2021-04-22 21:51:37;8998009010590;ULTRA CHO 125;1;3000;0;3000;2428;572;
2021-04-22 22:01:25;089686021219;INTER MIE GORENG;4;1000;0;4000;3540;460;
2021-04-22 22:01:25;HT;HOT-HOT;2;500;0;1000;700;300;
2021-04-22 22:01:25;TL;TELUR;3;1500;0;4500;3900;600;
2021-04-22 22:01:56;8997013790108;BIMURA KACANG TELUR 25G;2;1000;0;2000;1750;250;
2021-04-22 22:01:56;JGR SHN;JOGER SHINY SACHET;2;500;0;1000;874;126;
2021-04-22 22:02:21;8992959953037;SWEETY BRONZE L1;1;3000;0;3000;2671;329;
2021-04-22 22:03:28;8997009510055;YOU C1000;1;10000;0;10000;9166;834;
2021-04-22 22:06:31;8992775211434;PILUS GARUDA SAPI PANGGANG;1;5500;0;5500;4713;787;
2021-04-22 22:06:31;8997009510055;YOU C1000;2;10000;0;20000;18332;1668;
2021-04-22 22:06:31;8992696404441;BEAR BRAND 189ML;1;8500;0;8500;7887;613;
2021-04-22 22:06:31;8992775110157;GARUDA KACANG KULIT;1;5000;0;5000;3925;1075;
2021-04-22 22:09:47;8998866201469;POTABEE REGULER BBQ BEEF 68 GR;1;8000;0;8000;7200;800;
2021-04-22 22:09:47;ARG;ARGUS 220ML;1;14500;0;14500;12500;2000;
2021-04-22 22:21:34;8996001312445;MALKIST CAPPUCINO;1;6500;0;6500;5400;1100;
2021-04-22 22:21:34;089686010107;INDOMIE KALDU AYAM;1;2500;0;2500;2150;350;
2021-04-22 22:21:34;8999999529710;CLEAR COOL SPORT MNTL 160ML;1;24800;0;24800;22700;2100;
2021-04-22 22:21:34;8994420107789;SARDEN SAUS TOMAT;1;7000;0;7000;5833;1167;
2021-04-22 22:23:11;8998989110167;SURYA GUDANG GARAM 16 FILTER;2;24000;0;48000;44200;3800;
2021-04-23 12:14:19;8992628010139;BIMOLI 5L;1;75000;0;75000;72100;2900;
2021-04-23 13:49:26;8997012321204;MAXX BUMBU BALADO;1;5000;0;5000;4100;900;
2021-04-23 13:49:26;6291100212866;KURMA KHALAS;1;60000;0;60000;55000;5000;
2021-04-23 13:49:26;8991004011906;KOPI BORONG;1;10000;0;10000;8333;1667;
2021-04-23 13:52:08;SWAL;SENDAL SWALLOW;1;18000;0;18000;16500;1500;
2021-04-23 14:48:11;8999999524722;SUNLIGHT LIME NEW PCH 435ML;1;10000;0;10000;9100;900;
2021-04-23 15:06:05;8992759120264;LARISST 220;1;10000;0;10000;9200;800;
2021-04-23 15:35:23;8999999558079;RINSO MOLTO ROSE FRESH PWD 44G;6;1000;0;6000;4830;1170;
2021-04-23 16:27:34;GL;GULA 1 LITER;1;11500;0;11500;10500;1000;
2021-04-23 16:27:34;8995333060703;TERIGU KOMPAS 1KG;1;10500;0;10500;9816;684;
2021-04-23 16:28:43;8992959117583;SFX DS REG FLOW WING 20;1;5000;0;5000;4288;712;
2021-04-23 16:28:43;8992761145019;COCA COLA PET 250ML;2;3500;0;7000;4834;2166;
2021-04-23 16:28:43;COKLAT;COKLAT COIN;2;500;0;1000;800;200;
2021-04-23 16:29:48;8994834003752;TICTIC;1;2000;0;2000;1700;300;
2021-04-23 16:41:18;ABC;BATERAI ABC BIRU;1;8500;0;8500;7500;1000;
2021-04-23 16:41:18;8993058105013;EXTRA JOSS;1;12000;0;12000;9773;2227;
2021-04-23 16:54:15;8998866611725;EKONOMI PENCUCI PIRING  LIQ 290ML;1;5000;0;5000;4200;800;
2021-04-23 17:10:30;8998989300261;GUDANG GARAM SURYA 12 FILTER;1;18000;0;18000;16450;1550;
2021-04-23 17:10:30;8997013790108;BIMURA KACANG TELUR 25G;1;1000;0;1000;875;125;
2021-04-23 17:10:30;8994834005923;SPIX 1000;1;1000;0;1000;850;150;
2021-04-23 17:55:17;8997018720018;SIRUP DHT;1;23000;0;23000;20958;2042;
2021-04-23 17:55:17;8992753100101;BKM FULL CREAM GOLD 370;1;15000;0;15000;14000;1000;
2021-04-23 18:01:09;8993989311699;CLAS MILD 16 FILTER;1;23000;0;23000;21700;1300;
2021-04-23 18:01:09;123124;KOREK BIASA;1;2000;0;2000;1800;200;
2021-04-23 18:06:04;8996001600269;LE MINERAL 600ML;2;3000;0;6000;3376;2624;
2021-04-23 18:06:04;8998866202725;MILKU COKLAT PREMIUM 200ML;1;3000;0;3000;2375;625;
2021-04-23 18:34:30;8992959953044;SWEETY BRONZE XL1;1;2500;0;2500;2250;250;
2021-04-23 18:34:30;8997231980022;O'JELLY MINI STRAWBERRY;1;3000;0;3000;2250;750;
2021-04-23 18:34:30;8996001440049;ENERGEN;1;1500;0;1500;1200;300;
2021-04-23 18:34:30;8998866202725;MILKU COKLAT PREMIUM 200ML;1;3000;0;3000;2375;625;
2021-04-24 11:58:17;HT;HOT-HOT;2;500;0;1000;700;300;
2021-04-24 11:58:17;VTM;VITAMIN;2;500;0;1000;850;150;
2021-04-24 12:43:58;8999999524722;SUNLIGHT LIME NEW PCH 435ML;1;10000;0;10000;9100;900;
2021-04-24 12:43:58;GL;GULA 1 LITER;1;11500;0;11500;10500;1000;
2021-04-24 12:43:58;8999999031602;SARI MURNI 20X1.6G;1;6000;0;6000;5400;600;
2021-04-24 12:43:58;8998989500166;GUDANG GARAM MERAH BESAR 16KS;1;17000;0;17000;15300;1700;
2021-04-24 13:52:08;8998866100717;MAMALIME POUCH 780ML;1;15500;0;15500;13850;1650;
2021-04-24 14:47:58;8997231980022;O'JELLY MINI STRAWBERRY;1;3000;0;3000;2250;750;
2021-04-24 14:47:58;GL;GULA 1 LITER;1;11500;0;11500;10500;1000;
2021-04-24 14:47:58;COKLAT;COKLAT COIN;1;500;0;500;400;100;
2021-04-24 14:54:01;TG APEL;TEH GELAS APEL;1;2000;0;2000;1178;822;
2021-04-24 14:54:01;8886013257400;TWISTKO;1;1000;0;1000;900;100;
2021-04-24 14:54:01;8997231980022;O'JELLY MINI STRAWBERRY;1;3000;0;3000;2250;750;
2021-04-24 14:54:01;COKLAT;COKLAT COIN;2;500;0;1000;800;200;
2021-04-24 15:20:56;8999801700030;SUSU FOYU;1;11500;0;11500;10450;1050;
2021-04-24 15:20:56;8995333032113;TERIGU GATOT KACA 1 KG;1;8500;0;8500;8012;488;
2021-04-24 15:20:56;8997018720018;SIRUP DHT;1;23000;0;23000;20958;2042;
2021-04-24 16:01:54;8998866501033;MINYAK GORENG SEDAAP POUCH 2L;1;28000;0;28000;27746;254;
2021-04-24 16:01:54;JGR SHN;JOGER SHINY SACHET;2;500;0;1000;874;126;
2021-04-24 16:24:25;8998866200837;NOODLE SEDAAPMIE SOTO CUP 81 GR;1;4500;0;4500;3650;850;
2021-04-24 16:24:25;HT;HOT-HOT;1;500;0;500;350;150;
2021-04-24 16:36:35;8991102987639;WFR TANGO LONG VNL 130G;1;5000;0;5000;3773;1227;
2021-04-24 16:36:35;8996001301142;ROMA KELAPA;1;8000;0;8000;6628;1372;
2021-04-24 16:49:26;8999999555122;MOLTO K-ROMANCE 20ML;1;1000;0;1000;800;200;
2021-04-24 16:49:26;8992979190986;TOTAL PUTIH SOFTENER;1;13000;0;13000;11532;1468;
2021-04-24 16:49:26;8998989300261;GUDANG GARAM SURYA 12 FILTER;1;18000;0;18000;16450;1550;
2021-04-24 16:49:26;089686010824;INDOMIE GORENG SPESIAL;2;2700;0;5400;4904;496;
2021-04-24 16:49:26;8998866202237;NOODLE SEDAAP TASTY AYAM GEPREK 124 GR;1;5000;0;5000;4167;833;
2021-04-24 16:49:26;6907992823904;JD CRUNCHY CHOCOLATE VAN;1;8000;0;8000;6800;1200;
2021-04-24 16:49:26;6907992823676;JD PEACH;1;2000;0;2000;1700;300;
2021-04-24 16:49:26;8991102714495;TANGO DRINK COKLAT;1;5000;0;5000;3818;1182;
2021-04-24 16:49:26;8991102228053;TEH GELAS BOTOL;1;3000;0;3000;1695;1305;
2021-04-24 16:49:26;8999999559533;LIFEBUOY BW TOTAL 10 90ML;1;5000;0;5000;4000;1000;
2021-04-24 16:49:26;8997011700123;BIHUN JAGUNG 300GR;1;6000;0;6000;4979;1021;
2021-04-24 16:49:26;8991001780126;SELAMAT CKLAT 60G;1;5000;0;5000;4300;700;
2021-04-24 16:49:26;8992933214116;NUTRIJELL MELON;2;6000;0;12000;10082;1918;
2021-04-24 17:49:03;GL;GULA 1 LITER;1;11500;0;11500;10500;1000;
2021-04-24 17:49:03;8999909096004;SAMPOERNA 16 FILTER;1;24000;0;24000;23000;1000;
2021-04-24 17:49:03;123124;KOREK BIASA;1;2000;0;2000;1800;200;
2021-04-24 18:31:31;GL;GULA 1 LITER;1;11500;0;11500;10500;1000;
2021-04-24 18:31:31;8992761145026;SPRITE PET 250ML;1;3500;0;3500;2417;1083;
2021-04-24 18:31:31;8992628010139;BIMOLI 5L;1;75000;0;75000;72100;2900;
2021-04-24 18:58:34;GL;GULA 1 LITER;2;11500;0;23000;21000;2000;
2021-04-24 18:58:34;8998989300261;GUDANG GARAM SURYA 12 FILTER;1;18000;0;18000;16450;1550;
2021-04-24 18:58:34;123124;KOREK BIASA;1;2000;0;2000;1800;200;
2021-04-24 18:59:08;8991102987639;WFR TANGO LONG VNL 130G;1;5000;0;5000;3773;1227;
2021-04-24 19:44:10;GL;GULA 1 LITER;2;11500;0;23000;21000;2000;
2021-04-24 19:51:14;8992222050418;GATSBY NORMAL 38GR;1;5000;0;5000;3850;1150;
2021-04-24 19:51:14;8998866201841;GOLDA DOLCE LATTE 200ML;1;3000;0;3000;2500;500;
2021-04-24 20:24:05;8999909010567;234 16 FILTER;1;22000;0;22000;21500;500;
2021-04-24 20:24:29;123124;KOREK BIASA;1;2000;0;2000;1800;200;
2021-04-24 21:50:44;8991001780133;TWISTER BLACK;1;5000;0;5000;4600;400;
2021-04-24 21:50:44;8998866201841;GOLDA DOLCE LATTE 200ML;1;3000;0;3000;2500;500;
2021-04-24 21:50:44;SF TAWAR ORI;SAFFANAH TAWAR ORI;1;9000;0;9000;8000;1000;
2021-04-25 11:58:06;8998866201483;POTABEE REGULER GRILLED SEAWEED 35GR;1;5000;0;5000;4150;850;
2021-04-25 11:58:06;8996001304136;SLAI OLAI BLUEBERRY;1;12000;0;12000;9900;2100;
2021-04-25 11:58:06;8998866610261;DAIA VIOLET GUSSET BAG 290 GR;1;5000;0;5000;4450;550;
2021-04-25 12:06:55;8996001318911;BETTER ISI 4;1;2000;0;2000;1700;300;
2021-04-25 13:01:58;8997021870052;FRESH CARE GREEN TEA 10ML;1;12000;0;12000;10000;2000;
2021-04-25 13:08:18;8992775002155;CHOCOLATOS DRINK;1;4000;0;4000;3520;480;
2021-04-25 13:08:18;8886013257400;TWISTKO;2;1000;0;2000;1800;200;
2021-04-25 13:08:18;8992696523067;MILO ACTVGO UHT 180ML;1;4500;0;4500;3515;985;
2021-04-25 13:08:18;8998866610261;DAIA VIOLET GUSSET BAG 290 GR;1;5000;0;5000;4450;550;
2021-04-25 13:08:18;8999999531508;MOLTO HYGIENE SC 10ML;2;500;0;1000;960;40;
2021-04-25 13:08:18;8999999059323;LIFEBOUY LEMONFRESH DG 75G;1;3000;0;3000;2500;500;
2021-04-25 13:08:18;MARS;MARSHMELLOW;1;500;0;500;433;67;
2021-04-25 13:08:18;JGR SHN;JOGER SHINY SACHET;1;500;0;500;437;63;
2021-04-25 13:08:18;ff;FULLO BLASTO;1;1000;0;1000;995;5;
2021-04-25 13:08:18;8992696521797SCT;MILO UHT ACT GO 22G;1;2000;0;2000;1412;588;
2021-04-25 13:08:18;8998866202060;POTABEE AYAM BAKAR PEDAS 35 GR;1;5000;0;5000;4150;850;
2021-04-25 13:25:49;8994834005923;SPIX 1000;2;1000;0;2000;1700;300;
2021-04-25 13:25:49;8998989300261;GUDANG GARAM SURYA 12 FILTER;1;18000;0;18000;16450;1550;
2021-04-25 13:57:52;8992933211115;NUTRIJELL STRAWBERRY;1;6000;0;6000;5041;959;
2021-04-25 14:00:37;8999999531508;MOLTO HYGIENE SC 10ML;4;500;0;2000;1920;80;
2021-04-25 14:00:37;8999999558086;RINSO MOLTO FERFUME ESSENSE PWD 44G;3;1000;0;3000;2415;585;
2021-04-25 14:59:43;8998866201865;KRISBEE PILLOW CHOCOLAVA 120 GR;1;8000;0;8000;7250;750;
2021-04-25 14:59:43;8991102987639;WFR TANGO LONG VNL 130G;1;5000;0;5000;3773;1227;
2021-04-25 14:59:43;8997013790108;BIMURA KACANG TELUR 25G;2;1000;0;2000;1750;250;
2021-04-25 15:46:48;ARG;ARGUS 220ML;5;14500;0;72500;62500;10000;
2021-04-25 15:49:25;8998866613569;SOFTENER SKL BLS FINE 14SHT;1;5000;0;5000;4560;440;
2021-04-25 15:49:25;8993379152017;SABUN CUCI SURYA 200G;1;3000;0;3000;2281;719;
2021-04-25 15:49:25;8996200900092;HEROCYN 85GR;1;13000;0;13000;11650;1350;
2021-04-25 15:51:07;8992979130012;TOTAL LEMON SOFTENER;1;13000;0;13000;11532;1468;
2021-04-25 15:51:07;8998866202404;NOODLE SEDAAP MIE KOREAN SPICY CHICKEN CUP;1;5000;0;5000;4002;998;
2021-04-25 16:29:02;8995333000822;TERIGU KOMPAS SOFT 500GR;1;5500;0;5500;4967;533;
2021-04-25 16:29:02;8993379152017;SABUN CUCI SURYA 200G;1;3000;0;3000;2281;719;
2021-04-25 16:56:33;8993379152017;SABUN CUCI SURYA 200G;1;3000;0;3000;2281;719;
2021-04-25 16:56:33;GL;GULA 1 LITER;3;11500;0;34500;31500;3000;
2021-04-25 16:56:33;8998989110167;SURYA GUDANG GARAM 16 FILTER;1;24000;0;24000;22100;1900;
2021-04-25 16:56:33;8998866608305;GIV BENGKOANG KOTAK 76G;1;2000;0;2000;1820;180;
2021-04-25 16:56:33;8998866804516;GIV LEMON KOTAK 76G;1;2000;0;2000;1820;180;
2021-04-25 18:08:34;8998989300261;GUDANG GARAM SURYA 12 FILTER;1;18000;0;18000;16450;1550;
2021-04-25 18:08:34;8992761166205;FRESTEA GREEN HONEY 350ML;1;4500;0;4500;3000;1500;
2021-04-25 18:08:34;8992761122331;FRESTEA APPEL 500ML;1;6500;0;6500;4708;1792;
2021-04-25 18:09:01;8998989300261;GUDANG GARAM SURYA 12 FILTER;1;18000;0;18000;16450;1550;
2021-04-25 18:09:01;8998989100120;GUDANG GARAM MINI;1;18000;0;18000;16600;1400;
2021-04-25 18:16:30;123124;KOREK BIASA;1;2000;0;2000;1800;200;
2021-04-25 18:16:30;089686043051;INDOMIE COTO MAKASSAR;1;2800;0;2800;2525;275;
2021-04-25 22:17:17;8996001600269;LE MINERAL 600ML;1;3000;0;3000;1688;1312;
2021-04-25 22:17:17;8997028590014;ARGUS 220ML;1;500;0;500;302;198;
2021-04-25 22:17:17;JGR SHN;JOGER SHINY SACHET;1;500;0;500;437;63;
2021-04-25 22:17:31;8992761002039;FANTA STRAWBERRY PET 390 ML;1;5500;0;5500;4300;1200;
2021-04-25 22:26:48;ARG;ARGUS 220ML;1;14500;0;14500;12500;2000;
2021-04-25 22:26:48;8992388133017;NU MILK TEA ORI 330ML;1;6000;0;6000;5125;875;
2021-04-25 22:26:48;8886013213208;FRENCH FREIS 2000;1;5000;0;5000;3750;1250;
2021-04-26 13:29:02;8992984850615;PEWARNA HIJAU TUA;1;6000;0;6000;5000;1000;
2021-04-26 13:35:53;8999999710880;PEPSODENT ACTION123 HERBAL 75G;1;7500;0;7500;6650;850;
2021-04-26 13:35:53;8999999706081;PEPSODENT WHITE 75G;1;5000;0;5000;3850;1150;
2021-04-26 13:35:53;8999999500399;LUX TS CAMELLIA WHITE;2;3500;0;7000;5600;1400;
2021-04-26 13:35:53;8998866609173;SOKLIN LIQUID SOFTERGENT POUCH 400ML;2;8500;0;17000;15430;1570;
2021-04-26 14:45:51;6907992825069;JD FRUITY;1;5000;0;5000;4400;600;
2021-04-26 15:01:26;8995102703534;TERASI DUO 6 GR;1;4000;0;4000;3720;280;
2021-04-26 15:01:26;8999999042592;RINSO MOLTO PERFUME ESSENSE LIQ 4OML;1;5500;0;5500;4817;683;
2021-04-26 15:01:26;8998866613569;SOFTENER SKL BLS FINE 14SHT;1;5000;0;5000;4560;440;
2021-04-26 15:01:26;8998866608749;SOFTENER SKL BLS TW VIOLET 14SCT;1;5000;0;5000;4560;440;
2021-04-26 15:21:24;8993470279651;JOGER CHOCKY BAR;30;1000;0;30000;26010;3990;
2021-04-26 15:30:33;BTS;BIMURA TARO SEAWEED 250G;1;10000;0;10000;9300;700;
2021-04-26 15:30:33;TL;TELUR;6;1500;0;9000;7800;1200;
2021-04-26 15:31:54;8999999057640;MOLTO EDP BLK PURPLE 20ML;5;1000;0;5000;4000;1000;
2021-04-26 15:31:54;BTS;BIMURA TARO SEAWEED 250G;1;10000;0;10000;9300;700;
2021-04-26 16:29:39;8997231980022;O'JELLY MINI STRAWBERRY;1;3000;0;3000;2250;750;
2021-04-26 16:42:42;089686043051;INDOMIE COTO MAKASSAR;3;2800;0;8400;7575;825;
2021-04-26 16:42:42;089686010107;INDOMIE KALDU AYAM;4;2500;0;10000;8600;1400;
2021-04-26 16:42:42;8998009010569;ULTRA CHO 200;4;5000;0;20000;15320;4680;
2021-04-26 17:11:02;GL;GULA 1 LITER;4;11500;0;46000;42000;4000;
2021-04-26 17:11:29;GL;GULA 1 LITER;4;11500;0;46000;42000;4000;
2021-04-26 17:17:31;8997231980022;O'JELLY MINI STRAWBERRY;1;3000;0;3000;2250;750;
2021-04-26 17:17:31;BAYFLAST;BAYPLAST;2;500;0;1000;700;300;
2021-04-26 18:02:42;8996001600375;LE MINERAL 330ML;1;2000;0;2000;1417;583;
2021-04-26 18:02:42;CLUB;AIR CLUB;1;3000;0;3000;1452;1548;
2021-04-26 18:05:33;8997007780689;JIZZY MINERAL;1;3000;0;3000;1187;1813;
2021-04-26 18:05:33;8993989311699;CLAS MILD 16 FILTER;1;23000;0;23000;21700;1300;
2021-04-26 18:05:33;123124;KOREK BIASA;1;2000;0;2000;1800;200;
2021-04-26 18:12:18;8993989311279;CLAS MILD 12;1;17000;0;17000;15700;1300;
2021-04-26 18:12:18;123124;KOREK BIASA;1;2000;0;2000;1800;200;
2021-04-26 18:12:18;089686821086;ICHI OCHA MELATI;2;3000;0;6000;4500;1500;
2021-04-26 18:12:18;8992775001783;GERY SALUT MALKIST;1;6500;0;6500;5516;984;
2021-04-26 18:12:18;8992984920110;CUKA DAPUR DUA BELIBIS;1;4500;0;4500;3250;1250;
2021-04-26 18:57:12;8997021870076;FRESH CARE SANDAL WOOD 10ML;1;12000;0;12000;10000;2000;
2021-04-26 18:57:12;8998989300261;GUDANG GARAM SURYA 12 FILTER;1;18000;0;18000;16450;1550;
2021-04-26 19:18:54;8998989500166;GUDANG GARAM MERAH BESAR 16KS;1;17000;0;17000;15300;1700;
2021-04-26 19:21:42;GL;GULA 1 LITER;1;11500;0;11500;10500;1000;
2021-04-26 19:25:45;6907992823959;JD HAWTHORN BERRY;1;2000;0;2000;1700;300;
2021-04-26 19:46:01;6907992825076;JD WATERMELON APPLE;1;2000;0;2000;1700;300;
2021-04-26 20:10:18;HT;HOT-HOT;2;500;0;1000;700;300;
2021-04-26 20:10:18;8993072153595;LARISST COTTON 35G;1;5000;0;5000;3300;1700;
2021-04-26 20:10:18;6907992825076;JD WATERMELON APPLE;1;2000;0;2000;1700;300;
2021-04-26 20:10:18;6907992823676;JD PEACH;1;2000;0;2000;1700;300;
2021-04-26 20:11:15;MARS;MARSHMELLOW;4;500;0;2000;1732;268;
2021-04-26 20:25:31;6907992824963;JD MILKY CHOCOLATE;3;3000;0;9000;7800;1200;
2021-04-26 20:25:31;6921101219235;YAKUAT JELLY;1;2000;0;2000;1750;250;
2021-04-26 20:25:31;6907992823669;JD MILKY STRAW;1;3000;0;3000;2600;400;
2021-04-26 20:46:47;8999999559557;LUX BW MAGICAL ORCHID 85ML;1;5000;0;5000;4000;1000;
2021-04-26 21:01:39;089686021141;INTER MIE SOTO;2;1000;0;2000;1708;292;
2021-04-26 21:02:49;TG MARKISA;TEH GELAS MARKISA;1;2000;0;2000;1178;822;
2021-04-26 21:02:49;PRG;PARAGO;2;500;0;1000;800;200;
2021-04-26 21:05:00;PRG;PARAGO;1;500;0;500;400;100;
2021-04-26 21:05:00;HT;HOT-HOT;1;500;0;500;350;150;
2021-04-26 21:08:12;8996001600399;LE MINERAL 1500ML;1;5000;0;5000;4042;958;
2021-04-26 21:32:30;8998989121163;SURYA PRO MERAH;1;20000;0;20000;18600;1400;
2021-04-26 21:32:30;089686011036;INDOMIE GORENG PEDAS;1;2700;0;2700;2452;248;
2021-04-26 21:36:54;GL;GULA 1 LITER;1;11500;0;11500;10500;1000;
2021-04-26 21:36:54;8992747180225;VIXAL PEMB PORS BIRU 720ML;1;18000;0;18000;16940;1060;
2021-04-26 21:36:54;8998866679572;SOKLIN LANTAI MERAH 780ML;1;12000;0;12000;10020;1980;
2021-04-26 21:36:54;8992775001042;PILUS GARUDA MI GORENG;1;5000;0;5000;4810;190;
2021-04-26 21:56:55;ABC;BATERAI ABC BIRU;1;8500;0;8500;7500;1000;
2021-04-26 21:58:09;8998866106504;EMERON LOVELY NAT PINK;1;3500;0;3500;2900;600;
2021-04-26 21:58:09;8998866202312;NOODLE SEDAAP TASTY BAKMI AYAM 129 GR;1;5000;0;5000;4167;833;
2021-04-26 21:58:09;TUSTEL;TUSUK TELINGA;1;1000;0;1000;833;167;
2021-04-26 21:58:09;HT;HOT-HOT;1;500;0;500;350;150;
2021-04-26 22:13:10;GL;GULA 1 LITER;2;11500;0;23000;21000;2000;
2021-04-26 22:31:36;8998866501033;MINYAK GORENG SEDAAP POUCH 2L;1;28000;0;28000;27746;254;
2021-04-26 22:31:36;089686010107;INDOMIE KALDU AYAM;1;2500;0;2500;2150;350;
2021-04-26 22:31:36;8997231980022;O'JELLY MINI STRAWBERRY;1;3000;0;3000;2250;750;
2021-04-26 22:31:36;089686043204;INDOMIE MIE ACEH;1;2700;0;2700;2452;248;
2021-04-26 22:31:36;8992388112401;MIE ABC SELERA PEDAS- GORENG AYAM PEDAS LIMAU;2;2600;0;5200;4736;464;
2021-04-26 22:31:36;8998866200301;MIE SEDAAP GORENG;1;2500;0;2500;2023;477;
2021-04-26 22:31:36;089686043273;INDOMIE SAMBAL RICA;1;2700;0;2700;2452;248;
2021-04-26 22:31:36;089686011036;INDOMIE GORENG PEDAS;1;2700;0;2700;2452;248;
2021-04-26 22:31:36;kp;KALPA;1;2000;0;2000;1666;334;
2021-04-26 22:31:36;TL;TELUR;3;1500;0;4500;3900;600;
2021-04-27 12:28:57;8997007780689;JIZZY MINERAL;1;3000;0;3000;1187;1813;
2021-04-27 12:28:57;8998866200820;NOODLE SEDAAP MIE AYAM BAWANG TLR CUP 77 GR;2;4500;0;9000;7300;1700;
2021-04-27 13:54:14;8998866201841;GOLDA DOLCE LATTE 200ML;1;3000;0;3000;2500;500;
2021-04-27 14:58:14;6907992825069;JD FRUITY;1;5000;0;5000;4400;600;
2021-04-27 15:31:33;8997018720018;SIRUP DHT;1;23000;0;23000;20958;2042;
2021-04-27 15:44:16;8997021300092;LARISSA BAWANG 250GR;1;5500;0;5500;5125;375;
2021-04-27 15:44:16;TL;TELUR;6;1500;0;9000;7800;1200;
2021-04-27 15:45:14;8998866808729;ROYALE SOFT WHITE;1;5000;0;5000;4500;500;
2021-04-27 16:01:35;8998866200837;NOODLE SEDAAPMIE SOTO CUP 81 GR;1;4500;0;4500;3650;850;
2021-04-27 16:01:35;PRG;PARAGO;1;500;0;500;400;100;
2021-04-27 16:32:16;8992775001042;PILUS GARUDA MI GORENG;1;5000;0;5000;4810;190;
2021-04-27 16:32:16;8992775211434;PILUS GARUDA SAPI PANGGANG;1;5500;0;5500;4713;787;
2021-04-27 16:32:16;8998866611237;FRES&NATURAL DARKBLUE 100ML;1;11500;0;11500;10310;1190;
2021-04-27 16:43:50;8995333032113;TERIGU GATOT KACA 1 KG;1;8500;0;8500;8012;488;
2021-04-27 16:43:50;6921101219235;YAKUAT JELLY;1;2000;0;2000;1750;250;
2021-04-27 16:43:50;8999999559861;AXE DARK POCKET FRAG 17ML;1;10000;0;10000;8000;2000;
2021-04-27 16:47:57;8999999558079;RINSO MOLTO ROSE FRESH PWD 44G;6;1000;0;6000;4830;1170;
2021-04-27 17:00:29;8998866107099;WET WIPES KODOMO BABY 50SHT CLSSC;1;15000;0;15000;13650;1350;
2021-04-27 17:05:44;CLUB;AIR CLUB;1;3000;0;3000;1452;1548;
2021-04-27 17:05:44;8997007780689;JIZZY MINERAL;1;3000;0;3000;1187;1813;
2021-04-27 17:05:44;8991001780126;SELAMAT CKLAT 60G;1;5000;0;5000;4300;700;
2021-04-27 17:05:44;8992775913000GT;CHOCOLATOS CKLT DRINK;1;18000;0;18000;15862;2138;
2021-04-27 17:05:44;8992775000250GT;CHOCOLATOS MATCHA DRINK;1;18000;0;18000;15862;2138;
2021-04-27 17:05:44;8999999544416;MOLTO CARE;1;20000;0;20000;18570;1430;
2021-04-27 17:05:44;8999999706180;PEPSODENT WHITE 190GR;1;10000;0;10000;9350;650;
2021-04-27 17:05:44;SF TAWAR COKLAT;SAFFANAH ROTI TAWAR COKLAT;1;13500;0;13500;12000;1500;
2021-04-27 17:05:44;8992761136185;FANTA 1L;1;10000;0;10000;9000;1000;
2021-04-27 17:07:44;8992753631209;OMELA 370;1;9500;0;9500;8400;1100;
2021-04-27 17:54:20;8999999195649;SARI WANGI 25X1.86G;1;6000;0;6000;5050;950;
2021-04-27 17:54:20;8998989300261;GUDANG GARAM SURYA 12 FILTER;2;18000;0;36000;32900;3100;
2021-04-27 17:54:20;8991188943062;SASA 250G;2;10000;0;20000;17000;3000;
2021-04-27 18:05:19;8993007003063;ENAAK 500G;1;11000;0;11000;9625;1375;
2021-04-27 18:05:19;8991002103764;GOOD DAY CAPPUCINO 10X25G;1;1500;0;1500;1395;105;
2021-04-27 18:05:19;JGR SHN;JOGER SHINY SACHET;1;500;0;500;437;63;
2021-04-27 18:07:51;8993989311699;CLAS MILD 16 FILTER;1;23000;0;23000;21700;1300;
2021-04-27 18:07:51;123124;KOREK BIASA;1;2000;0;2000;1800;200;
2021-04-27 18:07:51;8994867006997;ROKOK PENA BOLD 20BTG;1;17000;0;17000;15000;2000;
2021-04-27 18:11:26;8992761147143;SPRITE WATERLYMON 425ML;1;5500;0;5500;4300;1200;
2021-04-27 18:55:12;8998989500166;GUDANG GARAM MERAH BESAR 16KS;3;17000;0;51000;45900;5100;
2021-04-27 18:55:12;8993274532105;BOLU;2;1000;0;2000;1666;334;
2021-04-27 19:37:24;8999999526856;MOLTO ALL IN ONE BLUE 11ML;1;5500;0;5500;4800;700;
2021-04-27 19:37:24;8998866609043;DAIA SOFTENER GUSSET 565G;1;10000;0;10000;8700;1300;
2021-04-27 19:37:24;8996001338056;TAMARIN;1;6000;0;6000;5100;900;
2021-04-27 19:47:07;MARS;MARSHMELLOW;4;500;0;2000;1732;268;
2021-04-27 21:03:09;8998009040023;TEH KOTAK;1;5000;0;5000;2827;2173;
2021-04-27 21:05:13;8998866202725;MILKU COKLAT PREMIUM 200ML;1;3000;0;3000;2375;625;
2021-04-27 21:05:13;8886013257400;TWISTKO;1;1000;0;1000;900;100;
2021-04-27 21:05:13;HT;HOT-HOT;3;500;0;1500;1050;450;
2021-04-27 21:05:13;COKLAT;COKLAT COIN;3;500;0;1500;1200;300;
2021-04-27 21:05:21;MARS;MARSHMELLOW;2;500;0;1000;866;134;
2021-04-27 21:08:40;8998989100120;GUDANG GARAM MINI;1;18000;0;18000;16600;1400;
2021-04-27 21:08:40;MARS;MARSHMELLOW;2;500;0;1000;866;134;
2021-04-27 21:08:40;PRG;PARAGO;2;500;0;1000;800;200;
2021-04-27 21:13:40;JGR SHN;JOGER SHINY SACHET;2;500;0;1000;874;126;
2021-04-27 21:19:05;MARS;MARSHMELLOW;4;500;0;2000;1732;268;
2021-04-27 21:20:01;RB;RED BOLD;1;19000;0;19000;17900;1100;
2021-04-27 21:50:32;8998009010590;ULTRA CHO 125;1;3000;0;3000;2428;572;
2021-04-27 21:53:54;8993989311279;CLAS MILD 12;1;17000;0;17000;15700;1300;
2021-04-27 21:53:54;8993989311699;CLAS MILD 16 FILTER;1;23000;0;23000;21700;1300;
2021-04-27 21:54:11;GL;GULA 1 LITER;5;11500;0;57500;52500;5000;
2021-04-27 21:57:00;6907992824963;JD MILKY CHOCOLATE;1;3000;0;3000;2600;400;
2021-04-27 21:57:00;6907992823652;JD CHOCOLATE MILKSHAKE;1;6000;0;6000;5200;800;
2021-04-28 11:19:36;8996001318911;BETTER ISI 4;1;2000;0;2000;1700;300;
2021-04-28 11:19:36;8996001318430;BETTER 1000;1;1000;0;1000;820;180;
2021-04-28 12:38:30;8998866610087;JAVANA ORIGINAL 350ML;1;3000;0;3000;2150;850;
2021-04-28 12:38:30;BTS;BIMURA TARO SEAWEED 250G;2;10000;0;20000;18600;1400;
2021-04-28 12:38:30;8991102387286SCT;TANGO LONG CKLT 47G;1;2000;0;2000;1551;449;
2021-04-28 12:39:02;8992717900310;KARA SUN;2;2500;0;5000;4000;1000;
2021-04-28 12:39:02;8999909096004;SAMPOERNA 16 FILTER;1;24000;0;24000;23000;1000;
2021-04-28 15:00:28;8998866202053;POTABEE AYAM BAKAR PEDAS 68GR;1;8000;0;8000;7200;800;
2021-04-28 15:00:28;8992696521629;DNCO COKLT UHT 180ML;1;5000;0;5000;3533;1467;
2021-04-28 15:00:28;8992696425316;NESCAFE BLACK;1;5000;0;5000;4099;901;
2021-04-28 15:00:28;8992696419742;NESCAFE COFFE CREAM;1;5000;0;5000;4099;901;
2021-04-28 15:00:28;8991102714631;TANGO TETRA CKLT;1;5000;0;5000;4545;455;
2021-04-28 15:00:28;8992696422650;NESCAFE FRENCH VANILLA;1;5000;0;5000;4099;901;
2021-04-28 15:16:07;8996001301142;ROMA KELAPA;1;8000;0;8000;6628;1372;
2021-04-28 15:16:07;8998866608558;SOKLIN SOFTERGENT BIRU 770G & PIRING;1;18000;0;18000;16055;1945;
2021-04-28 15:16:07;8995333000822;TERIGU KOMPAS SOFT 500GR;1;5500;0;5500;4967;533;
2021-04-28 15:16:07;TBM;NESTA TBM;1;5000;0;5000;4000;1000;
2021-04-28 15:16:07;8997011700123;BIHUN JAGUNG 300GR;1;6000;0;6000;4979;1021;
2021-04-28 15:36:38;8998866107495;ZINC HAIRFALL TREATH SHT 10ML;1;5000;0;5000;4500;500;
2021-04-28 15:36:38;8998866808729;ROYALE SOFT WHITE;1;5000;0;5000;4500;500;
2021-04-28 15:36:38;8998866608749;SOFTENER SKL BLS TW VIOLET 14SCT;1;5000;0;5000;4560;440;
2021-04-28 16:44:58;8992959053331;CONFIDENCE CLASSIC NIGHT L7;1;42000;0;42000;38182;3818;
2021-04-28 17:07:20;8999999008475;SUNLIGHT LIME NEW REF 1600ML;1;33000;0;33000;29800;3200;
2021-04-28 17:07:21;8998009020186;BUAVITA GUAVA 250ML;2;7000;0;14000;12166;1834;
2021-04-28 17:07:21;8998866501033;MINYAK GORENG SEDAAP POUCH 2L;1;28000;0;28000;27746;254;
2021-04-28 17:22:29;P;PAKET RAMADHAN 50 RIBU;1;50000;0;50000;50000;0;
2021-04-28 17:26:51;8999999195649;SARI WANGI 25X1.86G;1;6000;0;6000;5050;950;
2021-04-28 17:26:51;8992761136185;FANTA 1L;1;10000;0;10000;9000;1000;
2021-04-28 17:26:51;8998866501026;MINYAK GORENG SEDAAP POUCH 1 L;1;15000;0;15000;14110;890;
2021-04-28 17:26:51;8995333032113;TERIGU GATOT KACA 1 KG;1;8500;0;8500;8012;488;
2021-04-28 17:26:51;GL;GULA 1 LITER;1;11500;0;11500;10500;1000;
2021-04-28 18:13:48;8998989300261;GUDANG GARAM SURYA 12 FILTER;1;18000;0;18000;16450;1550;
2021-04-28 18:13:48;8997028590014;ARGUS 220ML;4;500;0;2000;1208;792;
2021-04-28 18:13:48;123124;KOREK BIASA;1;2000;0;2000;1800;200;
2021-04-28 18:13:48;8996001600399;LE MINERAL 1500ML;2;5000;0;10000;8084;1916;
2021-04-28 18:16:35;8991001780133;TWISTER BLACK;1;5000;0;5000;4600;400;
2021-04-28 18:41:30;8999099920714;SGM 1+ VANILA 900;2;80000;0;160000;157020;2980;
2021-04-28 18:41:30;8999099920691;SGM 1+ MADU 1000G;3;85000;0;255000;235530;19470;
2021-04-28 19:24:01;BTS;BIMURA TARO SEAWEED 250G;1;10000;0;10000;9300;700;
2021-04-28 19:24:01;8998866200301;MIE SEDAAP GORENG;2;2500;0;5000;4046;954;
2021-04-28 19:24:01;TL;TELUR;6;1500;0;9000;7800;1200;
2021-04-28 19:32:37;8998989300261;GUDANG GARAM SURYA 12 FILTER;1;18000;0;18000;16450;1550;
2021-04-28 19:32:37;8997013790108;BIMURA KACANG TELUR 25G;1;1000;0;1000;875;125;
2021-04-28 19:32:37;BTS;BIMURA TARO SEAWEED 250G;1;10000;0;10000;9300;700;
2021-04-28 19:36:49;8995333000822;TERIGU KOMPAS SOFT 500GR;1;5500;0;5500;4967;533;
2021-04-28 19:36:49;8991102022347;SIKAT GIGI FORMULA RIPPLE;1;5000;0;5000;4583;417;
2021-04-28 19:44:32;TUSTEL;TUSUK TELINGA;1;1000;0;1000;833;167;
2021-04-28 19:52:56;8992959509005;SWEETY SILVER PANTS XL26;1;61500;0;61500;55910;5590;
2021-04-28 19:52:56;8999801700030;SUSU FOYU;1;11500;0;11500;10450;1050;
2021-04-28 19:52:56;8992628020152;BIMOLI POUCH 2L;1;30000;0;30000;29000;1000;
2021-04-28 19:52:56;711844120419;SAMBAL ABC 275 ML;1;12000;0;12000;10800;1200;
2021-04-28 19:59:31;8997013790108;BIMURA KACANG TELUR 25G;1;1000;0;1000;875;125;
2021-04-28 19:59:31;8994834005923;SPIX 1000;1;1000;0;1000;850;150;
2021-04-28 20:44:08;8998989300261;GUDANG GARAM SURYA 12 FILTER;1;18000;0;18000;16450;1550;
2021-04-28 20:44:08;001;PASEO SMART FACIAL SF 250S GT;1;10000;0;10000;9500;500;
2021-04-28 20:56:05;ABC SPW;BATERAI ABC SPW;1;4500;0;4500;3893;607;
2021-04-28 20:56:05;8992628020152;BIMOLI POUCH 2L;1;30000;0;30000;29000;1000;
2021-04-28 21:06:09;MARS;MARSHMELLOW;2;500;0;1000;866;134;
2021-04-28 21:10:27;089686043273;INDOMIE SAMBAL RICA;1;2700;0;2700;2452;248;
2021-04-28 21:10:27;8992761145019;COCA COLA PET 250ML;1;3500;0;3500;2417;1083;
2021-04-28 21:15:59;8993989311699;CLAS MILD 16 FILTER;1;23000;0;23000;21700;1300;
2021-04-28 21:45:52;8992388112401;MIE ABC SELERA PEDAS- GORENG AYAM PEDAS LIMAU;2;2600;0;5200;4736;464;
2021-04-28 21:45:52;PRG;PARAGO;1;500;0;500;400;100;
2021-04-28 21:45:52;MARS;MARSHMELLOW;1;500;0;500;433;67;
2021-04-28 21:59:09;8998866202725;MILKU COKLAT PREMIUM 200ML;1;3000;0;3000;2375;625;
2021-04-28 21:59:09;KJ;KINDER JOY;2;2000;0;4000;3166;834;
2021-04-28 21:59:09;ff;FULLO BLASTO;2;1000;0;2000;1990;10;
2021-04-28 21:59:09;bb;BENG-BENG;1;1500;0;1500;1450;50;
2021-04-28 22:12:47;089686017748;SARIMIE GORENG ISI 2;2;3500;0;7000;6240;760;
2021-04-28 22:30:20;089686049053;SARIMI PUAS;1;3000;0;3000;2400;600;
2021-04-29 11:51:29;8991102989428GT;TANGO CKLT 24G GT;2;7500;0;15000;12184;2816;
2021-04-29 11:51:29;8991102385091;WFR TANGO CKLT 7G;1;8300;0;8300;7455;845;
2021-04-29 11:51:29;8991102989312;WFR TANGO SBJ 7G;1;8300;0;8300;7455;845;
2021-04-29 11:51:29;8995333060772;TERIGU GATOT KACA 500GR;3;4500;0;13500;12195;1305;
2021-04-29 11:51:29;8998866202237;NOODLE SEDAAP TASTY AYAM GEPREK 124 GR;1;5000;0;5000;4167;833;
2021-04-29 11:51:29;8998866202312;NOODLE SEDAAP TASTY BAKMI AYAM 129 GR;1;5000;0;5000;4167;833;
2021-04-29 11:51:29;8992753031900;BKM SCT PUTIH 40G;4;7500;0;30000;27600;2400;
2021-04-29 11:51:29;8998866609029;DAIA PUTIH GUSSWET 565G;1;10000;0;10000;8700;1300;
2021-04-29 11:51:29;8998866609043;DAIA SOFTENER GUSSET 565G;1;10000;0;10000;8700;1300;
2021-04-29 11:51:29;8998866610278;DAIA VIOLET GUSSET 565G;1;10000;0;10000;8700;1300;
2021-04-29 11:51:29;8998866202770;MIE SEDAAP SALERO PADANG;5;2500;0;12500;11810;690;
2021-04-29 13:12:46;8998866501033;MINYAK GORENG SEDAAP POUCH 2L;1;28000;0;28000;27746;254;
2021-04-29 15:09:45;8998866501033;MINYAK GORENG SEDAAP POUCH 2L;1;28000;0;28000;27746;254;
2021-04-29 15:09:45;8999801700054;SUSU FOYU 1 KG;1;22000;0;22000;20104;1896;
2021-04-29 15:09:45;8995333032113;TERIGU GATOT KACA 1 KG;1;8500;0;8500;8012;488;
2021-04-29 15:09:45;8997018720018;SIRUP DHT;1;23000;0;23000;20958;2042;
2021-04-29 15:12:02;089686021127;INTER MIE KALDU;2;1000;0;2000;1626;374;
2021-04-29 15:12:02;8992753100101;BKM FULL CREAM GOLD 370;1;15000;0;15000;14000;1000;
2021-04-29 15:12:02;8992761145026;SPRITE PET 250ML;1;3500;0;3500;2417;1083;
2021-04-29 15:12:02;8997013790092;BIMURA KERUPUK BAWANG 25G;2;1000;0;2000;1748;252;
2021-04-29 15:12:02;MARS;MARSHMELLOW;1;500;0;500;433;67;
2021-04-29 15:12:02;8997211400038;SANTAN COCONUT CREAM;1;4000;0;4000;3000;1000;
2021-04-29 15:25:46;8999908204202;MY BABY MINYAK TELON 60ML;1;18000;0;18000;16900;1100;
2021-04-29 16:16:12;8992984920110;CUKA DAPUR DUA BELIBIS;2;4500;0;9000;6500;2500;
2021-04-29 16:34:23;8992959508893;SWEETY SILVER PANTS S 9;1;14500;0;14500;13107;1393;
2021-04-29 16:36:31;089686834307;FREISS LECI;1;11000;0;11000;8750;2250;
2021-04-29 17:04:23;089686021127;INTER MIE KALDU;1;1000;0;1000;813;187;
2021-04-29 17:04:36;089686021127;INTER MIE KALDU;4;1000;0;4000;3252;748;
2021-04-29 17:05:19;9556040040038;SUSU F&N;1;33000;0;33000;30000;3000;
2021-04-29 17:05:19;8992775002735;CHOCOLATOS SUSU COKELAT;1;4000;0;4000;3520;480;
2021-04-29 17:06:22;8992761136185;FANTA 1L;1;10000;0;10000;9000;1000;
2021-04-29 17:06:22;GL;GULA 1 LITER;1;11500;0;11500;10500;1000;
2021-04-29 17:06:22;8999999195649;SARI WANGI 25X1.86G;1;6000;0;6000;5050;950;
2021-04-29 17:06:22;8995333032113;TERIGU GATOT KACA 1 KG;1;8500;0;8500;8012;488;
2021-04-29 17:06:22;8998866501026;MINYAK GORENG SEDAAP POUCH 1 L;1;15000;0;15000;14110;890;
2021-04-29 17:08:06;11222;LEM KOREA;1;9000;0;9000;8000;1000;
2021-04-29 17:32:51;GL;GULA 1 LITER;4;11500;0;46000;42000;4000;
2021-04-29 17:35:23;8851019210117;POCKY CHOCOLATE 47G;2;7300;0;14600;11342;3258;
2021-04-29 17:51:16;8998989300261;GUDANG GARAM SURYA 12 FILTER;1;18000;0;18000;16450;1550;
2021-04-29 17:56:30;089686043051;INDOMIE COTO MAKASSAR;1;2800;0;2800;2525;275;
2021-04-29 17:56:30;089686021219;INTER MIE GORENG;2;1000;0;2000;1770;230;
2021-04-29 17:56:30;8993989311699;CLAS MILD 16 FILTER;1;23000;0;23000;21700;1300;
2021-04-29 18:02:37;8995150101696;M+SUSU ORIGINAL;1;5000;0;5000;4000;1000;
2021-04-29 18:48:25;8991102281430;PERMEN MINTZ DUOMINT;1;4500;0;4500;4000;500;
2021-04-29 19:10:37;8997009510116;LEMON WATER;1;7000;0;7000;5694;1306;
2021-04-29 21:21:57;8992388112401;MIE ABC SELERA PEDAS- GORENG AYAM PEDAS LIMAU;1;2600;0;2600;2368;232;
2021-04-29 21:21:57;JGR SHN;JOGER SHINY SACHET;1;500;0;500;437;63;
2021-04-29 21:29:49;089686043273;INDOMIE SAMBAL RICA;3;2700;0;8100;7356;744;
2021-04-29 21:29:49;8992761002022;SPRITE PET 390ML;1;5500;0;5500;4300;1200;
2021-04-29 21:29:49;8999909096004;SAMPOERNA 16 FILTER;1;24000;0;24000;23000;1000;
2021-04-29 21:53:57;8994420100018;SARDEN SAUS PEDAS;1;7000;0;7000;5833;1167;
2021-04-29 21:53:57;089686021127;INTER MIE KALDU;3;1000;0;3000;2439;561;
2021-04-29 21:53:57;TL;TELUR;3;1500;0;4500;3900;600;
2021-04-29 21:56:37;8992775311486;CHOCOLATOS DARK 16G;1;18000;0;18000;15173;2827;
2021-04-29 21:56:37;8992775305164;MALKIST GREEN TEA;1;6500;0;6500;5500;1000;
2021-04-29 21:56:37;8996001305003;SARI GANDUM SANDWICH;1;6000;0;6000;5100;900;
2021-04-29 21:56:37;8991102989381;TANGO LONG BUBBLEGUM 130G;1;5000;0;5000;4345;655;
2021-04-29 21:56:37;8998009020186;BUAVITA GUAVA 250ML;1;7000;0;7000;6083;917;
2021-04-29 21:56:37;8992775110157;GARUDA KACANG KULIT;1;5000;0;5000;3925;1075;
2021-04-29 21:56:37;089686021219;INTER MIE GORENG;1;1000;0;1000;885;115;
2021-04-29 22:29:46;8999999719418;VASELINE HW UV LIGHTENING 200ML;1;24200;0;24200;21853;2347;
2021-04-29 22:29:46;8999999558062;RINSO ANTI NODA CLASSIC PWD 44G;1;5000;0;5000;4830;170;
2021-04-30 11:28:49;8993470411433;JOGER CLASSIC;28;1000;0;28000;23800;4200;
2021-04-30 13:07:10;8998866200837;NOODLE SEDAAPMIE SOTO CUP 81 GR;3;4500;0;13500;10950;2550;
2021-04-30 13:07:10;HT;HOT-HOT;2;500;0;1000;700;300;
2021-04-30 13:07:10;MARS;MARSHMELLOW;1;500;0;500;433;67;
2021-04-30 13:07:10;8997013790092;BIMURA KERUPUK BAWANG 25G;2;1000;0;2000;1748;252;
2021-04-30 14:06:07;GL;GULA 1 LITER;1;11500;0;11500;10500;1000;
2021-04-30 14:06:07;COKLAT;COKLAT COIN;1;500;0;500;400;100;
2021-04-30 14:50:51;8992761139018;ADES 600ML;1;3500;0;3500;2292;1208;
2021-04-30 15:10:22;8992628010139;BIMOLI 5L;1;75000;0;75000;72100;2900;
2021-04-30 15:10:22;8999801700054;SUSU FOYU 1 KG;1;22000;0;22000;20104;1896;
2021-04-30 17:36:49;8992761111540;FANTA STRAWBERY SLIM CAM 250ML;1;5000;0;5000;3750;1250;
2021-04-30 17:36:49;8998989110167;SURYA GUDANG GARAM 16 FILTER;1;24000;0;24000;22100;1900;
2021-04-30 17:36:49;8998989300261;GUDANG GARAM SURYA 12 FILTER;1;18000;0;18000;16450;1550;
2021-04-30 18:01:47;8998989300261;GUDANG GARAM SURYA 12 FILTER;1;18000;0;18000;16450;1550;
2021-04-30 18:20:47;8992761139018;ADES 600ML;1;3500;0;3500;2292;1208;
2021-04-30 18:20:47;8996001600375;LE MINERAL 330ML;3;2000;0;6000;4251;1749;
2021-04-30 18:34:58;711844120433;SAMBAL ABC 600 ML;1;22000;0;22000;20300;1700;
2021-04-30 19:52:19;SWAL;SENDAL SWALLOW;1;18000;0;18000;16500;1500;
2021-04-30 19:52:35;8999909982000;SAMPOERNA 12 FILTER;1;18000;0;18000;16200;1800;
2021-04-30 20:15:42;8998866201483;POTABEE REGULER GRILLED SEAWEED 35GR;1;5000;0;5000;4150;850;
2021-04-30 20:15:42;8999999524722;SUNLIGHT LIME NEW PCH 435ML;1;10000;0;10000;9100;900;
2021-04-30 20:15:42;8992770034151;MASAKO 250GR;1;10000;0;10000;8000;2000;
2021-04-30 20:15:42;8999999049423;REXONA MEN RO SPORT DEFENSE 45 ML;1;15000;0;15000;13550;1450;
2021-04-30 20:15:42;8992775110157;GARUDA KACANG KULIT;1;5000;0;5000;3925;1075;
2021-04-30 20:15:42;8991102303309;WFR TANGO SBJ 176G;1;10000;0;10000;8694;1306;
2021-04-30 20:38:03;8998989500166;GUDANG GARAM MERAH BESAR 16KS;2;17000;0;34000;30600;3400;
2021-04-30 20:38:03;6907992823904;JD CRUNCHY CHOCOLATE VAN;2;8000;0;16000;13600;2400;
2021-04-30 21:00:11;089686021141;INTER MIE SOTO;1;1000;0;1000;854;146;
2021-04-30 21:00:11;089686021219;INTER MIE GORENG;1;1000;0;1000;885;115;
2021-04-30 21:02:55;089686011036;INDOMIE GORENG PEDAS;1;2700;0;2700;2452;248;
2021-04-30 21:02:55;089686021219;INTER MIE GORENG;2;1000;0;2000;1770;230;
2021-04-30 21:03:27;6907992823829;JD MILKY MILK;1;3000;0;3000;2600;400;
2021-04-30 21:03:27;6907992825076;JD WATERMELON APPLE;1;2000;0;2000;1700;300;
2021-04-30 21:03:27;8997231980022;O'JELLY MINI STRAWBERRY;1;3000;0;3000;2250;750;
2021-04-30 21:05:32;089686044249;SUPERMI NUTRIMI STEAK AYAM;1;3500;0;3500;2800;700;
2021-04-30 21:24:18;8998866201469;POTABEE REGULER BBQ BEEF 68 GR;1;8000;0;8000;7200;800;
2021-04-30 21:24:18;8991102308861;FULLO BLASTO;1;16000;0;16000;14545;1455;
2021-04-30 21:24:18;8998866202664;POTABEE WAGYU BEEF STEAK 68 GR;1;8000;0;8000;7200;800;
2021-04-30 21:25:36;8997231980022;O'JELLY MINI STRAWBERRY;1;3000;0;3000;2250;750;
2021-04-30 21:26:14;8997231980022;O'JELLY MINI STRAWBERRY;1;3000;0;3000;2250;750;
2021-04-30 21:48:05;8998866612173;SOKLIN SOFTERGENT 770G & PIRING;1;18000;0;18000;16055;1945;
2021-04-30 21:48:05;001;PASEO SMART FACIAL SF 250S GT;1;10000;0;10000;9500;500;
2021-04-30 21:56:45;089686021219;INTER MIE GORENG;1;1000;0;1000;885;115;
2021-04-30 21:56:45;8997013790108;BIMURA KACANG TELUR 25G;1;1000;0;1000;875;125;
2021-04-30 21:56:45;8997013790092;BIMURA KERUPUK BAWANG 25G;1;1000;0;1000;874;126;
2021-04-30 22:00:28;089686021219;INTER MIE GORENG;3;1000;0;3000;2655;345;
2021-04-30 22:00:28;TL;TELUR;2;1500;0;3000;2600;400;
2021-04-30 22:01:19;8992775305164;MALKIST GREEN TEA;1;6500;0;6500;5500;1000;
2021-04-30 22:01:19;8992775311325;GERY SNACK&SEREAL 100G;1;7000;0;7000;6012;988;
2021-04-30 22:29:05;6921101219235;YAKUAT JELLY;1;2000;0;2000;1750;250;
2021-04-30 22:37:35;8992761164539;NUTRIBOOST ORANGE 300ML;1;6500;0;6500;5300;1200;
2021-04-30 22:37:35;8993470672827;SAKU-SAKU SAPI PANGGANG;1;2000;0;2000;1530;470;
2021-04-30 22:37:35;8993470672858;SAKU-SAKU RASA BALADO;1;2000;0;2000;1530;470;
2021-05-01 11:03:13;8992959107515;SFX NON WING 23CM 8;1;4000;0;4000;3288;712;
2021-05-01 11:03:13;8997027300089;NOMOS;1;4000;0;4000;2963;1037;
2021-05-01 11:03:13;8997013790092;BIMURA KERUPUK BAWANG 25G;1;1000;0;1000;874;126;
2021-05-01 11:03:13;089686021141;INTER MIE SOTO;1;1000;0;1000;854;146;
2021-05-01 11:03:13;089686021219;INTER MIE GORENG;1;1000;0;1000;885;115;
2021-05-01 11:03:13;8997028590014;ARGUS 220ML;2;500;0;1000;604;396;
2021-05-01 11:15:00;HT;HOT-HOT;2;500;0;1000;700;300;
2021-05-01 11:15:00;MARS;MARSHMELLOW;1;500;0;500;433;67;
2021-05-01 11:15:00;8991102989428SCT;TANGO CKLT 24G SCT;1;1000;0;1000;609;391;
2021-05-01 11:47:01;GL;GULA 1 LITER;15;11500;0;172500;157500;15000;
2021-05-01 11:47:01;8991102384841;WFR TANGO LONG CKLT 130G;1;5000;0;5000;4345;655;
2021-05-01 11:47:01;8991102987639;WFR TANGO LONG VNL 130G;1;5000;0;5000;3773;1227;
2021-05-01 13:04:27;GL;GULA 1 LITER;1;11500;0;11500;10500;1000;
2021-05-01 13:05:46;8998866202770;MIE SEDAAP SALERO PADANG;1;2500;0;2500;2362;138;
2021-05-01 13:05:46;8998866200578;MIE SEDAAP KARI KENTAL;1;2500;0;2500;2263;237;
2021-05-01 13:05:46;8998866200301;MIE SEDAAP GORENG;1;2500;0;2500;2023;477;
2021-05-01 13:05:46;8998866200325;MIE SEDAAP SOTO;1;2500;0;2500;1952;548;
2021-05-01 14:46:00;089686011036;INDOMIE GORENG PEDAS;1;2700;0;2700;2452;248;
2021-05-01 15:21:46;GL;GULA 1 LITER;1;11500;0;11500;10500;1000;
2021-05-01 15:28:28;TL;TELUR;6;1500;0;9000;7800;1200;
2021-05-01 15:28:28;8998866501026;MINYAK GORENG SEDAAP POUCH 1 L;1;15000;0;15000;14110;890;
2021-05-01 15:28:28;8998009010569;ULTRA CHO 200;1;5000;0;5000;3830;1170;
2021-05-01 15:28:28;8998866201889;KRISBEE PILLOW STRAWBERRY ICE CREAM 120GR;1;8000;0;8000;7250;750;
2021-05-01 15:28:28;RBB;ROSE BRAND;1;9000;0;9000;8000;1000;
2021-05-01 15:28:28;6907992823843;JD MOCHA CRISPY;1;5000;0;5000;4400;600;
2021-05-01 16:23:56;8995102703534;TERASI DUO 6 GR;1;4000;0;4000;3720;280;
2021-05-01 20:20:16;8991002103764;GOOD DAY CAPPUCINO 10X25G;2;1500;0;3000;2790;210;
2021-05-01 20:20:16;089686021141;INTER MIE SOTO;3;1000;0;3000;2562;438;
2021-05-01 20:20:16;089686021219;INTER MIE GORENG;1;1000;0;1000;885;115;
2021-05-01 20:54:28;8992761145019;COCA COLA PET 250ML;1;3500;0;3500;2417;1083;
2021-05-01 21:15:17;8993274532105;BOLU;4;1000;0;4000;3332;668;
2021-05-01 21:15:17;6907992823829;JD MILKY MILK;1;3000;0;3000;2600;400;
2021-05-01 21:16:29;8991102022347;SIKAT GIGI FORMULA RIPPLE;1;5000;0;5000;4583;417;
2021-05-01 21:16:29;8998866888622;GIV MERAH KOTAK 76G;1;2000;0;2000;1820;180;
2021-05-01 21:16:29;6907992825076;JD WATERMELON APPLE;1;2000;0;2000;1700;300;
2021-05-01 21:16:29;6907992823959;JD HAWTHORN BERRY;1;2000;0;2000;1700;300;
2021-05-01 21:16:29;MARS;MARSHMELLOW;2;500;0;1000;866;134;
2021-05-01 21:38:38;089686021219;INTER MIE GORENG;3;1000;0;3000;2655;345;
2021-05-01 21:38:38;8994420100018;SARDEN SAUS PEDAS;1;7000;0;7000;5833;1167;
2021-05-01 22:52:28;089686010190;INDOMIE KARI AYAM;1;2800;0;2800;2522;278;
2021-05-02 11:55:50;8991102213189;BLASTER UNGU;1;5000;0;5000;3106;1894;
2021-05-02 12:16:48;8998866613729;EMERON LOVELY NTRL 100ML;1;3500;0;3500;2900;600;
2021-05-02 12:53:05;8997009510116;LEMON WATER;1;7000;0;7000;5694;1306;
2021-05-02 12:53:05;8994834005923;SPIX 1000;2;1000;0;2000;1700;300;
2021-05-02 12:53:05;8886013257400;TWISTKO;1;1000;0;1000;900;100;
2021-05-02 14:08:36;8992959074206;HN PANTS S20;1;25000;0;25000;22576;2424;
2021-05-02 14:08:36;8998866601436;PODET DAIA BUNGA BAG 850GR & PIRING;1;18000;0;18000;15627;2373;
2021-05-02 14:08:36;8992959610107;HN PANTS L 48;1;77000;0;77000;72425;4575;
2021-05-02 14:08:36;P;PAKET RAMADHAN 50 RIBU;2;50000;0;100000;100000;0;
2021-05-02 14:08:36;BMO;BERAS MERAH ORGANIK;1;25000;0;25000;23500;1500;
2021-05-02 14:08:36;GL;GULA 1 LITER;1;11500;0;11500;10500;1000;
2021-05-02 14:08:36;8992696521797GT;MILO ACT GO SCT 22G;1;17500;0;17500;15536;1964;
2021-05-02 14:08:36;8998009040023;TEH KOTAK;1;5000;0;5000;2827;2173;
2021-05-02 14:58:15;8998866200646;KOPI TOP MURNI;1;11000;0;11000;9600;1400;
2021-05-02 15:22:09;8992761164546;NUTRIBOOST STRAWBERRY 300ML;1;6500;0;6500;5300;1200;
2021-05-02 15:22:09;8991102387286SCT;TANGO LONG CKLT 47G;1;2000;0;2000;1551;449;
2021-05-02 15:22:09;8993989311699;CLAS MILD 16 FILTER;1;23000;0;23000;21700;1300;
2021-05-02 15:30:26;8999999514648;LUX BWSAKURA BLOOM LD REFF 450 ML;1;25000;0;25000;22110;2890;
2021-05-02 15:30:26;8999999048501;SUNSILK RFR ANTI DDRF 170ML;1;22200;0;22200;20020;2180;
2021-05-02 15:30:26;8993072254056;MELROSE COTTON BUDS KCL;1;3000;0;3000;2450;550;
2021-05-02 15:30:26;TK;TOPUN KOTAN;1;14000;0;14000;13000;1000;
2021-05-02 15:52:16;8991102384841;WFR TANGO LONG CKLT 130G;1;5000;0;5000;4345;655;
2021-05-02 15:52:16;8991102987639;WFR TANGO LONG VNL 130G;1;5000;0;5000;3773;1227;
2021-05-02 15:52:16;8991102989381;TANGO LONG BUBBLEGUM 130G;1;5000;0;5000;4345;655;
2021-05-02 15:52:16;8992775610008;TING-TING GARUDA 2.5G;1;7500;0;7500;6296;1204;
2021-05-02 16:18:05;8998866501033;MINYAK GORENG SEDAAP POUCH 2L;1;28000;0;28000;27746;254;
2021-05-02 16:28:28;8992628010139;BIMOLI 5L;1;75000;0;75000;72100;2900;
2021-05-02 17:27:30;8997018720018;SIRUP DHT;1;23000;0;23000;20958;2042;
2021-05-02 17:27:30;8997218380074;ICHITAN MILK TEA;1;8000;0;8000;6583;1417;
2021-05-02 18:01:04;8998989300261;GUDANG GARAM SURYA 12 FILTER;1;18000;0;18000;16450;1550;
2021-05-02 18:01:04;123124;KOREK BIASA;1;2000;0;2000;1800;200;
2021-05-02 18:01:42;8991102387286SCT;TANGO LONG CKLT 47G;1;2000;0;2000;1551;449;
2021-05-02 18:03:34;8998989300261;GUDANG GARAM SURYA 12 FILTER;1;18000;0;18000;16450;1550;
2021-05-02 19:10:25;8992388101085;NU GREEN TEA ORIGINAL 330ML;1;3500;0;3500;2854;646;
2021-05-02 19:10:25;8997231980022;O'JELLY MINI STRAWBERRY;1;3000;0;3000;2250;750;
2021-05-02 19:10:25;TG MARKISA;TEH GELAS MARKISA;1;2000;0;2000;1178;822;
2021-05-02 19:17:33;8998989300261;GUDANG GARAM SURYA 12 FILTER;1;18000;0;18000;16450;1550;
2021-05-02 19:23:04;8992761139018;ADES 600ML;2;3500;0;7000;4584;2416;
2021-05-02 19:27:51;8998866611718;EKONOMI PENCUCI PIRING  LIQ 780ML;1;12000;0;12000;10900;1100;
2021-05-02 20:57:25;8997009510055;YOU C1000;1;10000;0;10000;9166;834;
2021-05-02 21:00:21;8994420100018;SARDEN SAUS PEDAS;1;7000;0;7000;5833;1167;
2021-05-02 21:00:21;089686021219;INTER MIE GORENG;5;1000;0;5000;4425;575;
2021-05-02 21:00:21;8999999558079;RINSO MOLTO ROSE FRESH PWD 44G;5;1000;0;5000;4025;975;
2021-05-02 21:00:21;089686043051;INDOMIE COTO MAKASSAR;1;2800;0;2800;2525;275;
2021-05-02 21:14:46;8999909003439;MARLBORO CRAFTED 12;1;8000;0;8000;5437;2563;
2021-05-02 21:14:46;8997231980022;O'JELLY MINI STRAWBERRY;1;3000;0;3000;2250;750;
2021-05-02 21:14:46;HT;HOT-HOT;2;500;0;1000;700;300;
2021-05-02 21:17:22;6907992823829;JD MILKY MILK;1;3000;0;3000;2600;400;
2021-05-02 21:17:22;6907992824963;JD MILKY CHOCOLATE;1;3000;0;3000;2600;400;
2021-05-02 21:34:37;8997018250218;JAHE MERAH;2;1000;0;2000;1666;334;
2021-05-02 21:34:37;SMC;BIMURA MAKARONI CINCIN 250G;1;10000;0;10000;9300;700;
2021-05-02 21:34:37;TLR;TELUR;1;43000;0;43000;39000;4000;
2021-05-02 21:36:11;BMO;BERAS MERAH ORGANIK;1;25000;0;25000;23500;1500;
2021-05-02 21:41:10;8997231980022;O'JELLY MINI STRAWBERRY;2;3000;0;6000;4500;1500;
2021-05-02 21:41:10;MARS;MARSHMELLOW;4;500;0;2000;1732;268;
2021-05-02 21:51:55;BALON;BALON CABUT;2;1000;0;2000;1800;200;
2021-05-02 21:51:55;KJ;KINDER JOY;1;2000;0;2000;1583;417;
2021-05-02 22:17:30;8991001502933;CHACHA TUBE;2;7500;0;15000;12800;2200;
2021-05-02 22:18:46;8992957220117;COKLAT BERUANG;1;2000;0;2000;1700;300;
2021-05-02 22:18:46;8992957220087;COKLAT SINGA;1;2000;0;2000;1700;300;
2021-05-02 22:31:30;8992761166052;FRESTEA MELATI 350ML;1;4500;0;4500;3000;1500;
2021-05-02 22:31:30;8996001600399;LE MINERAL 1500ML;1;5000;0;5000;4042;958;
2021-05-02 22:36:21;8997231980022;O'JELLY MINI STRAWBERRY;1;3000;0;3000;2250;750;
2021-05-03 10:34:32;8991102989428GT;TANGO CKLT 24G GT;2;7500;0;15000;12184;2816;
2021-05-03 10:34:32;8991102994422;TANGO WALUT CHOCOBNN 18G;1;9000;0;9000;8661;339;
2021-05-03 10:34:32;8992753102303;BKM SCT CKLT 40G;2;7500;0;15000;13800;1200;
2021-05-03 10:37:56;MOBIL;GULA GULA HP;2;2000;0;4000;3400;600;
2021-05-03 11:02:12;8997013790108;BIMURA KACANG TELUR 25G;1;1000;0;1000;875;125;
2021-05-03 11:02:12;8998866618298;DAIA CLEAN&FRESH HJB 320GR;1;5000;0;5000;4450;550;
2021-05-03 11:58:35;8991111102832;JB POWDER BEDTIME 300G;1;14500;0;14500;13120;1380;
2021-05-03 11:58:35;8992753102204;BKM COKLAT 370G;1;11300;0;11300;9500;1800;
2021-05-03 11:58:35;089686017748;SARIMIE GORENG ISI 2;1;3500;0;3500;3120;380;
2021-05-03 11:58:35;8998866200882;SUKSESMIE GORENG AYAM KRMS 133GR;1;3500;0;3500;3047;453;
2021-05-03 11:58:35;8996001305041;ROMA SANDWICH CKLT;1;7000;0;7000;5000;2000;
2021-05-03 12:00:12;8998866202770;MIE SEDAAP SALERO PADANG;1;2500;0;2500;2362;138;
2021-05-03 12:00:12;JGR SHN;JOGER SHINY SACHET;1;500;0;500;437;63;
2021-05-03 14:01:13;BC;BONIBOL COKELAT;1;85000;0;85000;70000;15000;
2021-05-03 14:07:10;6907992823652;JD CHOCOLATE MILKSHAKE;1;6000;0;6000;5200;800;
2021-05-03 14:07:10;8997028590014;ARGUS 220ML;4;500;0;2000;1208;792;
2021-05-03 14:09:28;8997028590014;ARGUS 220ML;4;500;0;2000;1208;792;
2021-05-03 14:09:28;089686021141;INTER MIE SOTO;3;1000;0;3000;2562;438;
2021-05-03 14:18:21;8992933219111;NUTRIJELL CINCAU;1;6000;0;6000;5000;1000;
2021-05-03 14:18:21;8992933214116;NUTRIJELL MELON;1;6000;0;6000;5041;959;
2021-05-03 14:18:21;8992933218114;NUTRIJELL GRAPE;1;6000;0;6000;4950;1050;
2021-05-03 14:28:39;8998866202343;MIE SEDAAP KOREAN SPICY;1;2500;0;2500;2023;477;
2021-05-03 14:40:51;8996001600375;LE MINERAL 330ML;1;2000;0;2000;1417;583;
2021-05-03 14:40:51;MARS;MARSHMELLOW;1;500;0;500;433;67;
2021-05-03 14:43:17;8998866501033;MINYAK GORENG SEDAAP POUCH 2L;1;28000;0;28000;27746;254;
2021-05-03 15:00:46;JGR SHN;JOGER SHINY SACHET;2;500;0;1000;874;126;
2021-05-03 15:14:02;8997028590014;ARGUS 220ML;4;500;0;2000;1208;792;
2021-05-03 15:47:43;9556001004673;MILO NESTLE MALAYSIA ACTIVE GO;1;85000;0;85000;80000;5000;
2021-05-03 16:16:04;MARS;MARSHMELLOW;10;500;0;5000;4330;670;
2021-05-03 16:16:15;MARS;MARSHMELLOW;1;500;0;500;433;67;
2021-05-03 16:16:15;HT;HOT-HOT;1;500;0;500;350;150;
2021-05-03 16:25:33;8999801700054;SUSU FOYU 1 KG;1;22000;0;22000;20104;1896;
2021-05-03 16:52:52;GL;GULA 1 LITER;1;11500;0;11500;10500;1000;
2021-05-03 17:36:21;8992628010139;BIMOLI 5L;1;75000;0;75000;72100;2900;
2021-05-03 18:02:16;8992761139018;ADES 600ML;1;3500;0;3500;2292;1208;
2021-05-03 18:38:34;711844120037;SAMBAL ABC 135 ML;1;7000;0;7000;5600;1400;
2021-05-03 18:38:34;8999999048488;SUNSILK SHP REFRESH ANTI DDRF 70+21ML;1;10000;0;10000;9075;925;
2021-05-03 19:15:09;8997231980022;O'JELLY MINI STRAWBERRY;1;3000;0;3000;2250;750;
2021-05-03 19:15:09;8993274532105;BOLU;1;1000;0;1000;833;167;
2021-05-03 19:26:55;8996001370063;CHOKI-CHOKI;1;18200;0;18200;16500;1700;
2021-05-03 19:29:23;8997231980022;O'JELLY MINI STRAWBERRY;2;3000;0;6000;4500;1500;
2021-05-03 19:30:18;8998866610278;DAIA VIOLET GUSSET 565G;1;10000;0;10000;8700;1300;
2021-05-03 19:35:08;8992628010139;BIMOLI 5L;1;75000;0;75000;72100;2900;
2021-05-03 19:37:21;8997231980022;O'JELLY MINI STRAWBERRY;2;3000;0;6000;4500;1500;
2021-05-03 19:43:58;8993058105013;EXTRA JOSS;1;12000;0;12000;9773;2227;
2021-05-03 19:47:47;8998898830125;KKB ENER-G ANGGUR;1;5500;0;5500;4824;676;
2021-05-03 20:20:21;8994867007161;ROKOK PENA GOLD 20;1;17000;0;17000;15000;2000;
2021-05-03 20:20:21;8997231980022;O'JELLY MINI STRAWBERRY;3;3000;0;9000;6750;2250;
2021-05-03 20:27:50;8997021870052;FRESH CARE GREEN TEA 10ML;1;12000;0;12000;10000;2000;
2021-05-03 20:27:50;6907992823843;JD MOCHA CRISPY;1;5000;0;5000;4400;600;
2021-05-03 20:56:23;8991102213189;BLASTER UNGU;1;5000;0;5000;3106;1894;
2021-05-03 20:56:23;8992761145019;COCA COLA PET 250ML;1;3500;0;3500;2417;1083;
2021-05-03 20:59:10;BALON;BALON CABUT;3;1000;0;3000;2700;300;
2021-05-03 20:59:10;PRG;PARAGO;2;500;0;1000;800;200;
2021-05-03 20:59:10;JGR SHN;JOGER SHINY SACHET;2;500;0;1000;874;126;
2021-05-03 21:13:01;8991102987639;WFR TANGO LONG VNL 130G;1;5000;0;5000;3773;1227;
2021-05-03 21:13:01;711844150003;ABC ORANGE;1;12000;0;12000;9900;2100;
2021-05-03 21:13:01;8993072153595;LARISST COTTON 35G;1;5000;0;5000;3300;1700;
2021-05-03 21:14:21;6907992823829;JD MILKY MILK;1;3000;0;3000;2600;400;
2021-05-03 21:19:36;8992696523081;MILO UHT 110ML;1;2500;0;2500;1962;538;
2021-05-03 21:19:36;8886013257400;TWISTKO;1;1000;0;1000;900;100;
2021-05-03 21:19:36;MOBIL;GULA GULA HP;1;2000;0;2000;1700;300;
2021-05-03 21:42:44;8993989311279;CLAS MILD 12;1;17000;0;17000;15700;1300;
2021-05-03 21:45:21;8998866610711;NOVO ACTIVE CLEAN 110G;1;3000;0;3000;2600;400;
2021-05-03 21:45:21;8992694242502;ZWITZAL SOAP CALSSIC 70G;1;3800;0;3800;3410;390;
2021-05-03 21:45:21;8992959953037;SWEETY BRONZE L1;1;3000;0;3000;2671;329;
2021-05-03 21:46:47;8998866202244;EKOMIE BUMBU KALDU AYAM;5;1000;0;5000;3990;1010;
2021-05-03 22:09:12;089686021127;INTER MIE KALDU;2;1000;0;2000;1626;374;
2021-05-03 22:09:12;089686021219;INTER MIE GORENG;1;1000;0;1000;885;115;
2021-05-03 22:09:12;089686021141;INTER MIE SOTO;1;1000;0;1000;854;146;
2021-05-03 22:09:12;8998866202244;EKOMIE BUMBU KALDU AYAM;1;1000;0;1000;798;202;
2021-05-03 22:14:21;089686011036;INDOMIE GORENG PEDAS;2;2700;0;5400;4904;496;
2021-05-03 22:14:21;089686044249;SUPERMI NUTRIMI STEAK AYAM;1;3500;0;3500;2800;700;
2021-05-03 22:44:39;8997013790108;BIMURA KACANG TELUR 25G;1;1000;0;1000;875;125;
2021-05-03 22:44:39;MARS;MARSHMELLOW;2;500;0;1000;866;134;
2021-05-04 11:14:26;8995333060703;TERIGU KOMPAS 1KG;4;10500;0;42000;39264;2736;
2021-05-04 11:14:26;8992993523098;COLATTA CHOCO CHIPS 150G;1;11000;0;11000;9885;1115;
2021-05-04 11:14:26;8992993260351;COLATTA COMPOUND DARK 250G;1;18500;0;18500;16714;1786;
2021-05-04 11:25:35;8992946512223;SHINZUI;1;4000;0;4000;2500;1500;
2021-05-04 11:25:35;8999999706111;PEPSODENT WHITE 25G;1;2000;0;2000;1450;550;
2021-05-04 11:28:15;8991102387286SCT;TANGO LONG CKLT 47G;1;2000;0;2000;1551;449;
2021-05-04 11:28:15;089686646047;SUNMARIE;1;7000;0;7000;6626;374;
2021-05-04 11:31:45;MARS;MARSHMELLOW;1;500;0;500;433;67;
2021-05-04 11:33:14;8997028590014;ARGUS 220ML;1;500;0;500;302;198;
2021-05-04 11:33:58;8997028590014;ARGUS 220ML;1;500;0;500;302;198;
2021-05-04 11:34:52;8997028590014;ARGUS 220ML;1;500;0;500;302;198;
2021-05-04 11:35:17;8997028590014;ARGUS 220ML;1;500;0;500;302;198;
2021-05-04 11:36:38;8997028590014;ARGUS 220ML;1;500;0;500;302;198;
2021-05-04 12:29:14;8999999502409;ROYCO FDS BEEF 9G;1;500;0;500;375;125;
2021-05-04 12:29:14;8991102387286SCT;TANGO LONG CKLT 47G;1;2000;0;2000;1551;449;
2021-05-04 12:55:57;8992957352153;CHOCO CHIPS 45G;1;4500;0;4500;2850;1650;
2021-05-04 12:55:57;8992770034151;MASAKO 250GR;1;10000;0;10000;8000;2000;
2021-05-04 12:55:57;711844110083;KECAP ABC 275 ML;1;14500;0;14500;13400;1100;
2021-05-04 12:55:57;8999999706180;PEPSODENT WHITE 190GR;1;10000;0;10000;9350;650;
2021-05-04 12:55:57;8999999059781;SUNLIGHT LIME NEW POUCH 210ML;1;5000;0;5000;4300;700;
2021-05-04 15:43:02;8999999049409;REXONA MEN ICE COOL 45 ML;1;15000;0;15000;13550;1450;
2021-05-04 15:43:02;8994867007161;ROKOK PENA GOLD 20;1;17000;0;17000;15000;2000;
2021-05-04 15:51:04;GL;GULA 1 LITER;1;11500;0;11500;10500;1000;
2021-05-04 16:00:21;8999801700054;SUSU FOYU 1 KG;1;22000;0;22000;20104;1896;
2021-05-04 16:07:19;8993176110081;MINYAK KAYU PUTIH 30ML;1;12000;0;12000;9091;2909;
2021-05-04 16:41:00;BAYFLAST;BAYPLAST;2;500;0;1000;700;300;
2021-05-04 16:54:32;8998866200561;EKOMIE SUPER 600GR;2;10000;0;20000;17230;2770;
2021-05-04 17:18:24;8992959971109;SFX COMFORT SLIM 36CM 12+1;1;16500;0;16500;15152;1348;
2021-05-04 17:19:46;8999909003439;MARLBORO CRAFTED 12;1;8000;0;8000;5437;2563;
2021-05-04 17:42:00;6907992823973;JD PINEAPPLE;1;5000;0;5000;4300;700;
2021-05-04 17:42:00;6907992823607;JD CHOCO CAPTAIN;1;5500;0;5500;4700;800;
2021-05-04 17:42:00;8998989500166;GUDANG GARAM MERAH BESAR 16KS;2;17000;0;34000;30600;3400;
2021-05-04 17:43:08;8998989300261;GUDANG GARAM SURYA 12 FILTER;1;18500;0;18500;17200;1300;
2021-05-04 17:43:08;089686400816;SAMBAL EXTRA PEDAS 135ML;1;5500;0;5500;4950;550;
2021-05-04 17:49:59;8998866200882;SUKSESMIE GORENG AYAM KRMS 133GR;1;3500;0;3500;3047;453;
2021-05-04 17:49:59;8992775000250SCT;CHOCOLATOS MATCHA DRINK SCT;3;2000;0;6000;4758;1242;
2021-05-04 17:51:03;8998989110167;SURYA GUDANG GARAM 16 FILTER;1;24000;0;24000;22100;1900;
2021-05-04 17:55:04;8992957214307;SAFARI MECES;2;5500;0;11000;9000;2000;
2021-05-04 19:23:48;6921101219235;YAKUAT JELLY;1;2000;0;2000;1750;250;
2021-05-04 19:38:51;8998989300261;GUDANG GARAM SURYA 12 FILTER;1;18500;0;18500;17200;1300;
2021-05-04 21:01:23;BALON;BALON CABUT;4;1000;0;4000;3600;400;
2021-05-04 21:01:23;JGR SHN;JOGER SHINY SACHET;2;500;0;1000;874;126;
2021-05-04 21:01:23;YOUTOP;YOUTOP;1;1000;0;1000;875;125;
2021-05-04 21:01:23;COKLAT;COKLAT COIN;2;500;0;1000;800;200;
2021-05-04 21:11:27;bb;BENG-BENG;1;1500;0;1500;1450;50;
2021-05-04 21:11:27;8994834003752;TICTIC;3;2000;0;6000;5100;900;
2021-05-04 21:33:50;8992775110140;GARUDA KACANG KULIT 160G;1;12000;0;12000;10012;1988;
2021-05-04 21:39:20;8999999003067;VASELINE SPF24 100ML;1;19500;0;19500;17600;1900;
2021-05-04 21:46:10;BALON;BALON CABUT;6;1000;0;6000;5400;600;
2021-05-04 21:55:41;8991102384841;WFR TANGO LONG CKLT 130G;1;5000;0;5000;4345;655;
2021-05-04 21:55:41;8992761111540;FANTA STRAWBERY SLIM CAM 250ML;1;5000;0;5000;3750;1250;
2021-05-04 21:55:41;8998989110167;SURYA GUDANG GARAM 16 FILTER;1;24000;0;24000;22100;1900;
2021-05-04 22:02:25;8991001770301;SELAMAT CLACK VANILA;1;13000;0;13000;11800;1200;
2021-05-04 22:02:25;8992775110140;GARUDA KACANG KULIT 160G;1;12000;0;12000;10012;1988;
2021-05-05 11:03:37;8992775000250SCT;CHOCOLATOS MATCHA DRINK SCT;6;2000;0;12000;9516;2484;
2021-05-05 11:03:37;8992775913000GT;CHOCOLATOS CKLT DRINK;1;18000;0;18000;15862;2138;
2021-05-05 14:35:48;KURMA;KURMA;1;60000;0;60000;55000;5000;
2021-05-05 14:35:48;8999999195656;SARI WANGI 50X1.85;1;10000;0;10000;9500;500;
2021-05-05 14:35:48;8992753102204;BKM COKLAT 370G;1;11300;0;11300;9500;1800;
2021-05-05 14:35:48;8992753100101;BKM FULL CREAM GOLD 370;1;15000;0;15000;14000;1000;
2021-05-05 14:38:09;8999999001193;LIFEBUOY BW TOTAL10 LD REFF 450 ML;1;25000;0;25000;22110;2890;
2021-05-05 14:40:49;8998866202930;SEDAAP AYAM JERIT CUP;1;4500;0;4500;3738;762;
2021-05-05 14:40:49;MARS;MARSHMELLOW;2;500;0;1000;866;134;
2021-05-05 14:40:49;089686044249;SUPERMI NUTRIMI STEAK AYAM;1;3500;0;3500;2800;700;
2021-05-05 14:40:49;8994834006128;TICTIC PEDAS;1;2000;0;2000;1700;300;
2021-05-05 16:22:30;089686061024;POP MIE MINI SOTO RL;1;3000;0;3000;2702;298;
2021-05-05 16:22:30;8994834005923;SPIX 1000;1;1000;0;1000;850;150;
2021-05-05 16:22:30;8998009010569;ULTRA CHO 200;1;5000;0;5000;3830;1170;
2021-05-05 16:24:47;8886013257400;TWISTKO;5;1000;0;5000;4500;500;
2021-05-05 16:32:18;8991102230308;BLASTER PINK;1;5000;0;5000;3106;1894;
2021-05-05 16:47:15;8992775913000SCT;CHOCOLATOS CKLT DRINK SCT;2;2000;0;4000;3172;828;
2021-05-05 16:47:15;8999801700030;SUSU FOYU;1;11500;0;11500;10450;1050;
2021-05-05 17:50:09;8992775913000SCT;CHOCOLATOS CKLT DRINK SCT;1;2000;0;2000;1586;414;
2021-05-05 17:50:09;JGR SHN;JOGER SHINY SACHET;6;500;0;3000;2622;378;
2021-05-05 17:58:20;001;PASEO SMART FACIAL SF 250S GT;1;10000;0;10000;9500;500;
2021-05-05 17:58:20;8998989300261;GUDANG GARAM SURYA 12 FILTER;1;18500;0;18500;17200;1300;
2021-05-05 17:58:20;JGR SHN;JOGER SHINY SACHET;3;500;0;1500;1311;189;
2021-05-05 17:59:24;8998989300261;GUDANG GARAM SURYA 12 FILTER;1;18500;0;18500;17200;1300;
2021-05-05 18:04:12;8999801700054;SUSU FOYU 1 KG;1;22000;0;22000;20104;1896;
2021-05-05 18:29:47;8992761166212;FRESTEA APPLE 350ML;1;4500;0;4500;3000;1500;
2021-05-05 18:29:47;BMCC;BIMURA POTATO CINCIN 250G;1;10000;0;10000;9300;700;
2021-05-05 18:29:47;8998866107457;POSH SUMMER LOVE 150ML;1;19500;0;19500;17500;2000;
2021-05-05 18:29:47;MARS;MARSHMELLOW;2;500;0;1000;866;134;
2021-05-05 18:30:36;8994834005923;SPIX 1000;1;1000;0;1000;850;150;
2021-05-05 18:30:36;8886013257400;TWISTKO;2;1000;0;2000;1800;200;
2021-05-05 19:19:04;8991002105409;KOPI KAPAL API;1;20000;0;20000;18888;1112;
2021-05-05 19:19:04;8991004011906;KOPI BORONG;1;10000;0;10000;8333;1667;
2021-05-05 19:37:44;8992761111540;FANTA STRAWBERY SLIM CAM 250ML;1;5000;0;5000;3750;1250;
2021-05-05 19:37:44;BMCC;BIMURA POTATO CINCIN 250G;1;10000;0;10000;9300;700;
2021-05-05 19:41:28;8993072153595;LARISST COTTON 35G;1;5000;0;5000;3300;1700;
2021-05-05 19:41:28;8999999059781;SUNLIGHT LIME NEW POUCH 210ML;1;5000;0;5000;4300;700;
2021-05-05 20:12:31;8998989300230;SIGNATURE BESAR;1;20000;0;20000;18600;1400;
2021-05-05 20:29:46;ABC;BATERAI ABC BIRU;1;8500;0;8500;7500;1000;
2021-05-05 20:50:19;8992775913000SCT;CHOCOLATOS CKLT DRINK SCT;7;2000;0;14000;11102;2898;
2021-05-05 20:50:19;8992775211410;PILUS GARUDA PEDAS;1;5000;0;5000;4886;114;
2021-05-05 21:04:16;6907992823652;JD CHOCOLATE MILKSHAKE;1;6000;0;6000;5200;800;
2021-05-05 21:04:16;HT;HOT-HOT;2;500;0;1000;700;300;
2021-05-05 21:04:16;JGR SHN;JOGER SHINY SACHET;2;500;0;1000;874;126;
2021-05-05 22:14:41;6907992823829;JD MILKY MILK;1;3000;0;3000;2600;400;
2021-05-05 22:14:41;8997231980022;O'JELLY MINI STRAWBERRY;1;3000;0;3000;2250;750;
2021-05-05 22:14:41;8997231980015;O'JELLY MINI APPLE;1;3000;0;3000;2250;750;
2021-05-05 22:14:41;SMC;BIMURA MAKARONI CINCIN 250G;1;10000;0;10000;9300;700;
2021-05-06 12:34:39;8998989300261;GUDANG GARAM SURYA 12 FILTER;1;18500;0;18500;17200;1300;
2021-05-06 12:34:39;8994023000050;MEGKEJU SERBAGUNA 165G;1;12000;0;12000;10339;1661;
2021-05-06 12:34:39;8992696521797SCT;MILO UHT ACT GO 22G;1;2000;0;2000;1412;588;
2021-05-06 12:34:39;8886013257400;TWISTKO;2;1000;0;2000;1800;200;
2021-05-06 12:34:39;8998866202244;EKOMIE BUMBU KALDU AYAM;1;1000;0;1000;798;202;
2021-05-06 12:34:39;TUSTEL;TUSUK TELINGA;1;1000;0;1000;833;167;
2021-05-06 12:34:39;TL;TELUR;15;1500;0;22500;19500;3000;
2021-05-06 12:34:39;8992696520103;DNCO CKLT FORT SCH 39G;2;3000;0;6000;5294;706;
2021-05-06 12:35:11;089686011036;INDOMIE GORENG PEDAS;1;2700;0;2700;2452;248;
2021-05-06 12:36:07;8992993250048;BENDICO COCOA POWDER 90G;1;18000;0;18000;16203;1797;
2021-05-06 12:37:42;8992775001042;PILUS GARUDA MI GORENG;1;5000;0;5000;4810;190;
2021-05-06 12:37:42;8998866609180;SOKLIN SOFTERGENT POUCH 750ML;1;18000;0;18000;16435;1565;
2021-05-06 12:43:26;001;PASEO SMART FACIAL SF 250S GT;1;10000;0;10000;9500;500;
2021-05-06 12:49:20;8998989110167;SURYA GUDANG GARAM 16 FILTER;1;24000;0;24000;22100;1900;
2021-05-06 13:20:51;089686043273;INDOMIE SAMBAL RICA;2;2700;0;5400;4904;496;
2021-05-06 13:20:51;8992761139018;ADES 600ML;1;3500;0;3500;2292;1208;
2021-05-06 13:20:51;MARS;MARSHMELLOW;2;500;0;1000;866;134;
2021-05-06 14:27:04;8998866608756;SOKLIN SOFTENER TWILIGHT BLUE 14SCH;1;5000;0;5000;4560;440;
2021-05-06 14:27:38;8992628010139;BIMOLI 5L;1;75000;0;75000;72100;2900;
2021-05-06 15:46:55;8998866501033;MINYAK GORENG SEDAAP POUCH 2L;1;28000;0;28000;27746;254;
2021-05-06 16:19:06;BDG;BELLAROSA DANTE GOLD;1;95000;0;95000;85000;10000;
2021-05-06 16:22:46;8850507001152;MOTU ATV;1;10000;0;10000;8000;2000;
2021-05-06 16:38:02;8992696521629;DNCO COKLT UHT 180ML;1;5000;0;5000;3533;1467;
2021-05-06 16:38:02;8996001355817;BENG-BENG MAXX;1;27000;0;27000;24500;2500;
2021-05-06 16:38:02;8999999195656;SARI WANGI 50X1.85;1;10000;0;10000;9500;500;
2021-05-06 16:43:48;8993365121539;MADU TJ SUPER 150G;1;16800;0;16800;15220;1580;
2021-05-06 16:43:48;8992696521797GT;MILO ACT GO SCT 22G;1;17500;0;17500;15536;1964;
2021-05-06 16:43:48;ABC SPW;BATERAI ABC SPW;1;4500;0;4500;3893;607;
2021-05-06 16:44:50;8996001302323;MALKIST ABON;1;6500;0;6500;4800;1700;
2021-05-06 16:47:37;8999999195656;SARI WANGI 50X1.85;1;10000;0;10000;9500;500;
2021-05-06 16:47:37;8997018720018;SIRUP DHT;1;23000;0;23000;20958;2042;
2021-05-06 16:47:37;GL;GULA 1 LITER;2;11500;0;23000;21000;2000;
2021-05-06 16:47:37;8998866202930;SEDAAP AYAM JERIT CUP;1;4500;0;4500;3738;762;
2021-05-06 17:31:25;8999999048280;SUNSILK SHP RFR ANTI DDRF 9 ML;1;10500;0;10500;9300;1200;
2021-05-06 17:54:29;8996001600399;LE MINERAL 1500ML;1;5000;0;5000;4042;958;
2021-05-06 18:03:23;8998989300261;GUDANG GARAM SURYA 12 FILTER;1;18500;0;18500;17200;1300;
2021-05-06 18:09:47;6907992824963;JD MILKY CHOCOLATE;4;3000;0;12000;10400;1600;
2021-05-06 18:09:47;8997007780689;JIZZY MINERAL;1;3000;0;3000;1187;1813;
2021-05-06 18:22:45;8991001780140;TWISTER CHOCO;1;5000;0;5000;4600;400;
2021-05-06 18:22:45;8992761145019;COCA COLA PET 250ML;1;3500;0;3500;2417;1083;
2021-05-06 19:21:07;8999909982000;SAMPOERNA 12 FILTER;1;18000;0;18000;16000;2000;
2021-05-06 19:21:07;123124;KOREK BIASA;1;2000;0;2000;1800;200;
2021-05-06 19:21:07;8993058105013;EXTRA JOSS;1;12000;0;12000;9773;2227;
2021-05-06 19:41:03;089686021219;INTER MIE GORENG;5;1000;0;5000;4425;575;
2021-05-06 19:41:03;8999999524722;SUNLIGHT LIME NEW PCH 435ML;1;10000;0;10000;9100;900;
2021-05-06 19:41:03;8999999045623;MOLTO AIO BLUE SCH;6;1000;0;6000;4800;1200;
2021-05-06 19:41:03;089686048704;SARIMIE GORENG AYAM KCP ISI 2;1;3500;0;3500;3120;380;
2021-05-06 19:41:03;8992979130012;TOTAL LEMON SOFTENER;1;13000;0;13000;11532;1468;
2021-05-06 19:41:03;8999999048280;SUNSILK SHP RFR ANTI DDRF 9 ML;1;10500;0;10500;9300;1200;
2021-05-06 19:41:03;8999999706661;PEPSODENT TB DBL CARE SENSITIVE;1;11500;0;11500;10400;1100;
2021-05-06 19:41:03;8999999059781;SUNLIGHT LIME NEW POUCH 210ML;1;5000;0;5000;4300;700;
2021-05-06 19:41:03;8992759120264;LARISST 220;1;10000;0;10000;9200;800;
2021-05-06 19:41:03;8998866501033;MINYAK GORENG SEDAAP POUCH 2L;1;28000;0;28000;27746;254;
2021-05-06 19:41:03;8995333060703;TERIGU KOMPAS 1KG;1;10500;0;10500;9816;684;
2021-05-06 19:41:03;8993379254469;SABUN LERVIA 90G;1;5000;0;5000;3077;1923;
2021-05-06 19:41:03;8998866602549;NUVO FAMILY BIRU 76G;4;2000;0;8000;7280;720;
2021-05-06 19:41:03;8993226365522;GARAM MEJA GYURI 200GR;1;2000;0;2000;1700;300;
2021-05-06 19:41:03;8999999502409;ROYCO FDS BEEF 9G;6;500;0;3000;2250;750;
2021-05-06 19:41:03;TLR;TELUR;1;43000;0;43000;39000;4000;
2021-05-06 21:06:50;8996001355985;BENG-BENG SHARE IT;1;27000;0;27000;25000;2000;
2021-05-06 21:06:50;8992775913000SCT;CHOCOLATOS CKLT DRINK SCT;3;2000;0;6000;4758;1242;
2021-05-06 21:06:50;8994834005923;SPIX 1000;1;1000;0;1000;850;150;
2021-05-06 21:06:50;8991102989534;TANGO VANILA 24G;2;1000;0;2000;1218;782;
2021-05-06 21:18:43;8992775913000SCT;CHOCOLATOS CKLT DRINK SCT;1;2000;0;2000;1586;414;
2021-05-06 21:18:43;6907992823829;JD MILKY MILK;1;3000;0;3000;2600;400;
2021-05-06 21:18:43;8993470672858;SAKU-SAKU RASA BALADO;1;2000;0;2000;1530;470;
2021-05-06 21:52:26;8999909000377;SAMPOERNA AVOLUTION;1;30000;0;30000;28450;1550;
2021-05-06 21:57:35;8998866202770;MIE SEDAAP SALERO PADANG;1;2500;0;2500;2362;138;
2021-05-06 21:57:35;COKLAT;COKLAT COIN;1;500;0;500;400;100;
2021-05-06 21:58:46;8992775001042;PILUS GARUDA MI GORENG;1;5000;0;5000;4810;190;
2021-05-06 21:58:46;8998866202404;NOODLE SEDAAP MIE KOREAN SPICY CHICKEN CUP;1;5000;0;5000;4002;998;
2021-05-06 22:17:46;711844150003;ABC ORANGE;1;12000;0;12000;9900;2100;
2021-05-07 11:42:04;8992775913000SCT;CHOCOLATOS CKLT DRINK SCT;1;2000;0;2000;1586;414;
2021-05-07 11:52:06;8992933211115;NUTRIJELL STRAWBERRY;2;6000;0;12000;10082;1918;
2021-05-07 11:52:06;8992933241112;NUTRIJELL COKLAT;2;7000;0;14000;12832;1168;
2021-05-07 11:52:06;8992933219111;NUTRIJELL CINCAU;2;6000;0;12000;10000;2000;
2021-05-07 11:52:06;8992933214116;NUTRIJELL MELON;2;6000;0;12000;10082;1918;
2021-05-07 11:52:06;8992933218114;NUTRIJELL GRAPE;2;6000;0;12000;9900;2100;
2021-05-07 11:52:06;8992628020152;BIMOLI POUCH 2L;1;30000;0;30000;29000;1000;
2021-05-07 11:52:06;18992628503171;SIMAS 5KG;1;78000;0;78000;76100;1900;
2021-05-07 11:52:06;001;PASEO SMART FACIAL SF 250S GT;1;10000;0;10000;9500;500;
2021-05-07 11:52:06;8999999390198;SUNLIGHT LIME NEW POUCH 755ML;1;17000;0;17000;15400;1600;
2021-05-07 11:57:57;089686043273;INDOMIE SAMBAL RICA;1;2700;0;2700;2452;248;
2021-05-07 12:08:16;089686044249;SUPERMI NUTRIMI STEAK AYAM;1;3500;0;3500;2800;700;
2021-05-07 12:08:16;8992959953198;SWEETY BRONZE  XL2 6+2;1;60000;0;60000;54091;5909;
2021-05-07 12:08:16;8998866610261;DAIA VIOLET GUSSET BAG 290 GR;1;5000;0;5000;4450;550;
2021-05-07 12:08:16;8994023000050;MEGKEJU SERBAGUNA 165G;1;12000;0;12000;10339;1661;
2021-05-07 12:08:16;8993154790021;DELLA CHA;5;2000;0;10000;8570;1430;
2021-05-07 12:08:16;8998866200882;SUKSESMIE GORENG AYAM KRMS 133GR;2;3500;0;7000;6094;906;
2021-05-07 12:13:12;TG;TEH GELAS;2;1000;0;2000;1458;542;
2021-05-07 12:13:12;8994834005923;SPIX 1000;1;1000;0;1000;850;150;
2021-05-07 12:13:12;8993470672827;SAKU-SAKU SAPI PANGGANG;1;2000;0;2000;1530;470;
2021-05-07 12:16:28;001;PASEO SMART FACIAL SF 250S GT;1;10000;0;10000;9500;500;
2021-05-07 12:16:28;711844150003;ABC ORANGE;2;12000;0;24000;19800;4200;
2021-05-07 12:16:28;GL;GULA 1 LITER;1;11500;0;11500;10500;1000;
2021-05-07 12:18:19;GL;GULA 1 LITER;5;11500;0;57500;52500;5000;
2021-05-07 16:23:27;8992959117583;SFX DS REG FLOW WING 20;1;5000;0;5000;4288;712;
2021-05-07 16:23:27;8998866202725;MILKU COKLAT PREMIUM 200ML;1;3000;0;3000;2375;625;
2021-05-07 16:23:27;8992753031900;BKM SCT PUTIH 40G;1;7500;0;7500;6900;600;
2021-05-07 16:27:44;8999999519865;DOVE DEO WMN RO CUCUMBER  40 ML;1;16500;0;16500;15000;1500;
2021-05-07 16:27:44;8996001600597;KOPIKO LUCKY DAY;1;5000;0;5000;4283;717;
2021-05-07 16:27:44;8997213203118;INLITE 12W;1;46000;0;46000;42000;4000;
2021-05-07 16:27:44;8997213203095;INLITE 7W;1;34000;0;34000;31000;3000;
2021-05-07 16:44:44;8999999042592;RINSO MOLTO PERFUME ESSENSE LIQ 4OML;1;5500;0;5500;4817;683;
2021-05-07 16:44:44;8998989110167;SURYA GUDANG GARAM 16 FILTER;1;24000;0;24000;22100;1900;
2021-05-07 16:49:03;GL;GULA 1 LITER;3;11500;0;34500;31500;3000;
2021-05-07 16:55:41;8993083929806;BISKITOP COKLAT;1;30000;0;30000;27000;3000;
2021-05-07 17:04:17;8992775002735;CHOCOLATOS SUSU COKELAT;1;4000;0;4000;3520;480;
2021-05-07 17:06:45;8992959953075;SWEETY BRONZE M9;1;17000;0;17000;15190;1810;
2021-05-07 17:13:07;GL;GULA 1 LITER;5;11500;0;57500;52500;5000;
2021-05-07 17:13:21;8998989110167;SURYA GUDANG GARAM 16 FILTER;1;24000;0;24000;22100;1900;
2021-05-08 12:17:59;8992761136161;COCACOLA 1L;1;10000;0;10000;9000;1000;
2021-05-08 12:17:59;8998866202725;MILKU COKLAT PREMIUM 200ML;1;3000;0;3000;2375;625;
2021-05-08 12:17:59;8992696520103;DNCO CKLT FORT SCH 39G;1;3000;0;3000;2647;353;
2021-05-08 12:17:59;8996001600269;LE MINERAL 600ML;1;3000;0;3000;1688;1312;
2021-05-08 12:17:59;8998866202732;MILKU STROBERI 200ML;1;3000;0;3000;2375;625;
2021-05-08 12:17:59;8992775110157;GARUDA KACANG KULIT;1;5000;0;5000;3925;1075;
2021-05-08 12:19:36;8992993260351;COLATTA COMPOUND DARK 250G;1;18500;0;18500;16714;1786;
2021-05-08 12:37:45;8999999706180;PEPSODENT WHITE 190GR;1;10000;0;10000;9350;650;
2021-05-08 12:37:45;8992222091961;PUCELLE MIST COL SPRAY 75ML;1;13000;0;13000;11650;1350;
2021-05-08 12:37:45;8992979120013;TOTAL BUNGA SOFTENER;1;13000;0;13000;11532;1468;
2021-05-08 12:37:45;001;PASEO SMART FACIAL SF 250S GT;1;10000;0;10000;9500;500;
2021-05-08 12:37:45;8999999552527;ZWITSAL KIDS BB CLN&FRSH BLUE 280 ML;1;21500;0;21500;19855;1645;
2021-05-08 12:37:45;8997002060168;KRP SINGKOG PDS PANDA DUO;1;8000;0;8000;7300;700;
2021-05-08 12:37:45;8992959117583;SFX DS REG FLOW WING 20;1;5000;0;5000;4288;712;
2021-05-08 12:37:45;8999801700030;SUSU FOYU;5;11500;0;57500;52250;5250;
2021-05-08 12:37:45;8991188943543;SASA SANTAN KELAPA 200ML;1;9500;0;9500;8400;1100;
2021-05-08 12:37:45;8991002103764;GOOD DAY CAPPUCINO 10X25G;10;1500;0;15000;13950;1050;
2021-05-08 12:37:45;8714700524002;MAIZENAKU;1;5000;0;5000;4200;800;
2021-05-08 12:37:45;8994023000050;MEGKEJU SERBAGUNA 165G;1;12000;0;12000;10339;1661;
2021-05-08 12:37:45;KT;KUNING TELUR;1;2500;0;2500;2000;500;
2021-05-08 12:48:08;711844150027;ABC NANAS;1;15000;0;15000;12241;2759;
2021-05-08 12:51:31;8994935000049;MINYAK GORENG DAMAI 5L;1;75000;0;75000;73780;1220;
2021-05-08 13:04:09;8886013257400;TWISTKO;1;1000;0;1000;900;100;
2021-05-08 13:04:09;MOBIL;GULA GULA HP;1;2000;0;2000;1700;300;
2021-05-08 13:04:09;KJ;KINDER JOY;1;2000;0;2000;1583;417;
2021-05-08 13:06:25;8998866200561;EKOMIE SUPER 600GR;3;10000;0;30000;25845;4155;
2021-05-08 13:06:25;8995333060703;TERIGU KOMPAS 1KG;1;10500;0;10500;9816;684;
2021-05-08 13:19:46;8999999529703;CLEAR MEN COOL SPORT MTHL 80ML;1;11000;0;11000;10000;1000;
2021-05-08 14:12:06;711844110113;KECAP ABC 135 ML;1;7000;0;7000;6400;600;
2021-05-08 14:59:36;8999999007768;FAIR&LOVELY MULTIVITAMIN  CREAM 9 ML;2;4500;0;9000;6400;2600;
2021-05-08 15:02:57;711844150027;ABC NANAS;2;15000;0;30000;24482;5518;
2021-05-08 15:12:30;8992761145019;COCA COLA PET 250ML;1;3500;0;3500;2417;1083;
2021-05-08 15:14:53;GL;GULA 1 LITER;1;11500;0;11500;10500;1000;
2021-05-08 15:44:57;GL;GULA 1 LITER;4;11500;0;46000;42000;4000;
2021-05-08 15:44:57;8999801700054;SUSU FOYU 1 KG;1;22000;0;22000;20104;1896;
2021-05-08 16:02:46;8994834006128;TICTIC PEDAS;1;2000;0;2000;1700;300;
2021-05-08 16:55:07;8999999048280;SUNSILK SHP RFR ANTI DDRF 9 ML;1;10500;0;10500;9300;1200;
2021-05-08 16:58:53;8998989500166;GUDANG GARAM MERAH BESAR 16KS;1;17000;0;17000;15300;1700;
2021-05-08 17:08:35;8992770084064;SAJIKU TEPUNG BUMBU 240G;1;7000;0;7000;6000;1000;
2021-05-08 17:22:46;8995333000822;TERIGU KOMPAS SOFT 500GR;1;5500;0;5500;4967;533;
2021-05-08 17:43:12;001;PASEO SMART FACIAL SF 250S GT;1;10000;0;10000;9500;500;
2021-05-08 17:45:26;8992753184002;FF MILKY STRW 115G;1;3000;0;3000;2178;822;
2021-05-08 17:45:26;8992753182008;FF MILKY CKLT 115ML;3;3000;0;9000;6537;2463;
2021-05-08 19:31:14;8998989300261;GUDANG GARAM SURYA 12 FILTER;1;18500;0;18500;17200;1300;
2021-05-08 19:31:14;8992775311325;GERY SNACK&SEREAL 100G;1;7000;0;7000;6012;988;
2021-05-08 19:31:14;8997231980022;O'JELLY MINI STRAWBERRY;1;3000;0;3000;2250;750;
2021-05-08 19:31:14;8993470672827;SAKU-SAKU SAPI PANGGANG;1;2000;0;2000;1530;470;
2021-05-08 19:31:14;8993470672858;SAKU-SAKU RASA BALADO;1;2000;0;2000;1530;470;
2021-05-08 19:31:14;8994834005923;SPIX 1000;1;1000;0;1000;850;150;
2021-05-08 19:32:11;GL;GULA 1 LITER;5;11500;0;57500;52500;5000;
2021-05-08 19:39:01;8996001600269;LE MINERAL 600ML;1;3000;0;3000;1688;1312;
2021-05-08 19:39:01;8992761139018;ADES 600ML;1;3500;0;3500;2292;1208;
2021-05-08 19:39:01;8992761166052;FRESTEA MELATI 350ML;1;4500;0;4500;3000;1500;
2021-05-08 19:39:01;8990800004563;MENTOS 40X50 BUAH IND;1;5700;0;5700;5150;550;
2021-05-08 19:46:30;001;PASEO SMART FACIAL SF 250S GT;1;10000;0;10000;9500;500;
2021-05-08 19:49:01;8997231980015;O'JELLY MINI APPLE;1;3000;0;3000;2250;750;
2021-05-08 19:49:01;8997231980022;O'JELLY MINI STRAWBERRY;1;3000;0;3000;2250;750;
2021-05-08 19:49:01;8997028590014;ARGUS 220ML;2;500;0;1000;604;396;
2021-05-08 20:10:23;8996001600399;LE MINERAL 1500ML;1;5000;0;5000;4042;958;
2021-05-08 20:21:55;8992761139018;ADES 600ML;1;3500;0;3500;2292;1208;
2021-05-08 20:21:55;8992761166212;FRESTEA APPLE 350ML;1;4500;0;4500;3000;1500;
2021-05-08 20:21:55;HT;HOT-HOT;2;500;0;1000;700;300;
2021-05-08 21:01:32;8997231980022;O'JELLY MINI STRAWBERRY;2;3000;0;6000;4500;1500;
2021-05-08 21:01:32;8996001318911;BETTER ISI 4;1;2000;0;2000;1700;300;
2021-05-08 21:25:27;MARS;MARSHMELLOW;2;500;0;1000;866;134;
2021-05-08 21:45:51;8997231980022;O'JELLY MINI STRAWBERRY;2;3000;0;6000;4500;1500;
2021-05-08 21:45:51;8998866200325;MIE SEDAAP SOTO;1;2500;0;2500;1952;548;
2021-05-08 21:45:51;6907992823652;JD CHOCOLATE MILKSHAKE;1;6000;0;6000;5200;800;
2021-05-08 21:47:03;6907992823652;JD CHOCOLATE MILKSHAKE;2;6000;0;12000;10400;1600;
2021-05-08 21:47:03;6907992823591;JD STRAW MILKSHAKE;1;5000;0;5000;4300;700;
2021-05-08 21:47:03;JD VM;JD VANILLA MILKSHAKE;1;5000;0;5000;4300;700;
2021-05-08 21:47:03;8992770061034;SAJIKU;2;2000;0;4000;3000;1000;
2021-05-08 21:47:28;8998009040023;TEH KOTAK;1;5000;0;5000;2827;2173;
2021-05-08 21:52:23;PTK;MINI NAIL CLIPPER BESAR THREE SEVEN;1;7000;0;7000;6000;1000;
2021-05-08 21:52:23;089686010107;INDOMIE KALDU AYAM;2;2500;0;5000;4300;700;
2021-05-08 21:52:23;089686011494;INDOMIE SOTO PADANG;1;2600;0;2600;2317;283;
2021-05-08 21:52:24;089686043051;INDOMIE COTO MAKASSAR;1;2800;0;2800;2525;275;
2021-05-08 21:52:24;YOUTOP;YOUTOP;1;1000;0;1000;875;125;
2021-05-08 22:09:33;8992696523067;MILO ACTVGO UHT 180ML;1;4500;0;4500;3515;985;
2021-05-08 22:09:33;8993379200879;SABUN HARMONY MELON 70G;1;2000;0;2000;1652;348;
2021-05-08 22:09:33;8992761164546;NUTRIBOOST STRAWBERRY 300ML;1;6500;0;6500;5300;1200;
2021-05-08 22:22:51;D;TEH PUCUK HARUM 350ML;1;67200;0;67200;55536;11664;
2021-05-08 22:25:18;089686043051;INDOMIE COTO MAKASSAR;1;2800;0;2800;2525;275;
2021-05-08 22:25:18;TL;TELUR;1;1500;0;1500;1300;200;
2021-05-08 22:51:50;089686611878;QTELA TEMPE;1;6000;0;6000;5370;630;
2021-05-08 22:51:50;8996001600146;TEH PUCUK HARUM 350ML;1;3000;0;3000;2314;686;
2021-05-08 22:51:50;8997025914042;ATB MARIE SUSU 185G;1;7000;0;7000;4554;2446;
2021-05-08 22:51:50;8997025410063;BRITISH PROPOLIS;1;250000;0;250000;180000;70000;
2021-05-08 22:53:47;711844610095;LARISSA UDANG 500 GR;2;11000;0;22000;19580;2420;
2021-05-08 22:53:47;8994935000049;MINYAK GORENG DAMAI 5L;1;75000;0;75000;73780;1220;
2021-05-09 11:37:12;8991001780140;TWISTER CHOCO;2;5000;0;10000;9200;800;
2021-05-09 11:38:01;KURMA;KURMA;1;60000;0;60000;55000;5000;
2021-05-09 11:38:01;8998989300261;GUDANG GARAM SURYA 12 FILTER;1;18500;0;18500;17200;1300;
2021-05-09 11:38:01;089686611519;QTELA SINGKONG;1;5000;0;5000;4266;734;
2021-05-09 12:40:24;8996001402023SCT;TB TORA SUSU SCT;3;1500;0;4500;2544;1956;
2021-05-09 12:40:24;8991102230308;BLASTER PINK;1;5000;0;5000;3106;1894;
2021-05-09 12:40:24;8992752112013;MIZONE;1;5000;0;5000;3800;1200;
2021-05-09 13:18:20;8997021870076;FRESH CARE SANDAL WOOD 10ML;1;12000;0;12000;10000;2000;
2021-05-09 13:41:56;8998989300261;GUDANG GARAM SURYA 12 FILTER;1;18500;0;18500;17200;1300;
2021-05-09 13:41:56;8992761145019;COCA COLA PET 250ML;1;3500;0;3500;2417;1083;
2021-05-09 14:21:15;8998866202053;POTABEE AYAM BAKAR PEDAS 68GR;1;8000;0;8000;7200;800;
2021-05-09 14:21:15;8998866201377;KRISBEE FRIES KENTANG GORENG 68 GR;1;5500;0;5500;4620;880;
2021-05-09 14:21:15;8992761139018;ADES 600ML;1;3500;0;3500;2292;1208;
2021-05-09 14:21:15;089686611519;QTELA SINGKONG;1;5000;0;5000;4266;734;
2021-05-09 14:21:15;8886013213208;FRENCH FREIS 2000;1;5000;0;5000;3750;1250;
2021-05-09 15:11:55;8999999390198;SUNLIGHT LIME NEW POUCH 755ML;1;17000;0;17000;15400;1600;
2021-05-09 15:11:55;8998866200646;KOPI TOP MURNI;1;11000;0;11000;9600;1400;
2021-05-09 15:17:25;8999999529284;MOLTO EDP FRENCH LILY SC 10ML;1;5500;0;5500;4800;700;
2021-05-09 15:17:25;8999801700030;SUSU FOYU;1;11500;0;11500;10450;1050;
2021-05-09 15:17:25;ROYCO;ROYCO RASA AYAM;3;500;0;1500;1125;375;
2021-05-09 15:17:25;8999999556341;MOLTO EDP PINK ROSE 20ML;2;1000;0;2000;1600;400;
2021-05-09 15:17:25;8999909096004;SAMPOERNA 16 FILTER;1;24000;0;24000;23000;1000;
2021-05-09 15:17:25;8992761002015;COCA COLA PET 390ML;1;5500;0;5500;4333;1167;
2021-05-09 16:06:53;8991102213189;BLASTER UNGU;1;5000;0;5000;3106;1894;
2021-05-09 16:28:28;8998866611718;EKONOMI PENCUCI PIRING  LIQ 780ML;1;12000;0;12000;10900;1100;
2021-05-09 16:28:28;BTS;BIMURA TARO SEAWEED 250G;1;10000;0;10000;9300;700;
2021-05-09 16:44:18;ARG;ARGUS 220ML;4;14500;0;58000;50000;8000;
2021-05-09 17:22:10;8998989110167;SURYA GUDANG GARAM 16 FILTER;1;24000;0;24000;22100;1900;
2021-05-09 17:22:10;8996001600610;TORA MILKY LATTE 180ML;1;3500;0;3500;2750;750;
2021-05-09 17:27:18;8998866608749;SOFTENER SKL BLS TW VIOLET 14SCT;1;5000;0;5000;4560;440;
2021-05-09 17:51:14;8992628022156;BIMOLI KLASIK TOUCH 1 LT;1;15500;0;15500;14350;1150;
2021-05-09 17:51:14;8998989300261;GUDANG GARAM SURYA 12 FILTER;1;18500;0;18500;17200;1300;
2021-05-09 17:51:45;8998898830125;KKB ENER-G ANGGUR;1;5500;0;5500;4824;676;
2021-05-09 17:51:45;8999801700030;SUSU FOYU;1;11500;0;11500;10450;1050;
2021-05-09 17:54:46;8996001355985;BENG-BENG SHARE IT;1;27000;0;27000;25000;2000;
2021-05-09 17:54:46;8992222050418;GATSBY NORMAL 38GR;1;5000;0;5000;3850;1150;
2021-05-09 17:55:07;8992775913000SCT;CHOCOLATOS CKLT DRINK SCT;2;2000;0;4000;3172;828;
2021-05-09 17:55:48;6907992823867;JD CRUNCHY CHOCOLATE MALT;1;5500;0;5500;4700;800;
2021-05-09 17:58:50;8999999045920;LIFEBUOY TS TOTAL 10 110GR;2;4000;0;8000;7000;1000;
2021-05-09 17:58:50;8999999533717;CITRA TS FRESH WHITE 70G;1;2200;0;2200;1900;300;
2021-05-09 18:06:51;8992761166212;FRESTEA APPLE 350ML;1;4500;0;4500;3000;1500;
2021-05-09 18:08:05;TG;TEH GELAS;1;1000;0;1000;729;271;
2021-05-09 18:17:15;8992761166229;FRESTEA MARKISA 350ML;2;4500;0;9000;6000;3000;
2021-05-09 18:17:15;8992761164546;NUTRIBOOST STRAWBERRY 300ML;1;6500;0;6500;5300;1200;
2021-05-09 18:31:33;8993058105013;EXTRA JOSS;1;12000;0;12000;9773;2227;
2021-05-09 18:53:31;8993176110081;MINYAK KAYU PUTIH 30ML;1;12000;0;12000;9091;2909;
2021-05-09 18:53:49;8992761111540;FANTA STRAWBERY SLIM CAM 250ML;1;5000;0;5000;3750;1250;
2021-05-09 18:53:49;8992761139018;ADES 600ML;1;3500;0;3500;2292;1208;
2021-05-09 18:53:49;MARS;MARSHMELLOW;1;500;0;500;433;67;
2021-05-09 19:10:56;8991102281416;PERMEN MINTZ PPMINT;1;4500;0;4500;4000;500;
2021-05-09 19:12:08;8999909000971;MAGNUM MILD 20;1;24000;0;24000;22750;1250;
2021-05-09 19:24:06;8997231980022;O'JELLY MINI STRAWBERRY;1;3000;0;3000;2250;750;
2021-05-09 19:25:22;8998866501033;MINYAK GORENG SEDAAP POUCH 2L;1;28000;0;28000;27746;254;
2021-05-09 19:25:22;089686021219;INTER MIE GORENG;3;1000;0;3000;2655;345;
2021-05-09 19:25:22;8993226365522;GARAM MEJA GYURI 200GR;1;2000;0;2000;1700;300;
2021-05-09 19:36:37;8992775913000SCT;CHOCOLATOS CKLT DRINK SCT;1;2000;0;2000;1586;414;
2021-05-09 19:56:47;8991004011906;KOPI BORONG;1;10000;0;10000;8333;1667;
2021-05-09 19:56:47;8999999001179;LIFEBUOY BW COOLFRESH LD REFF 450 ML;1;25000;0;25000;22110;2890;
2021-05-09 19:56:47;8998866610261;DAIA VIOLET GUSSET BAG 290 GR;1;5000;0;5000;4450;550;
2021-05-09 19:56:47;6907992823829;JD MILKY MILK;1;3000;0;3000;2600;400;
2021-05-09 19:56:47;8997231980015;O'JELLY MINI APPLE;1;3000;0;3000;2250;750;
2021-05-09 19:56:47;PRG;PARAGO;2;500;0;1000;800;200;
2021-05-09 19:58:37;ARG;ARGUS 220ML;1;14500;0;14500;12500;2000;
2021-05-09 19:58:37;JGR SHN;JOGER SHINY SACHET;1;500;0;500;437;63;
2021-05-09 19:58:37;8998866108102;POSH GREEN BLOSSOM 150;1;19500;0;19500;17500;2000;
2021-05-09 20:02:11;8991102281430;PERMEN MINTZ DUOMINT;2;4500;0;9000;8000;1000;
2021-05-09 20:09:15;8997231980022;O'JELLY MINI STRAWBERRY;1;3000;0;3000;2250;750;
2021-05-09 20:15:36;JGR SHN;JOGER SHINY SACHET;2;500;0;1000;874;126;
2021-05-09 20:27:34;8997231980022;O'JELLY MINI STRAWBERRY;2;3000;0;6000;4500;1500;
2021-05-09 20:27:34;8997231980015;O'JELLY MINI APPLE;1;3000;0;3000;2250;750;
2021-05-09 20:30:57;BG;BERAS GURIH PASAR RAME;1;60000;0;60000;56000;4000;
2021-05-09 20:30:57;8993176110135;MINYAK TELON LANG 30ML;1;10000;0;10000;8167;1833;
2021-05-09 20:30:57;8991102308861;FULLO BLASTO;1;16000;0;16000;14545;1455;
2021-05-09 20:36:08;8850007014546;JB PODER ACTIVE FRESH 300G;1;14000;0;14000;13120;880;
2021-05-09 20:37:05;8992959953082;SWEETY BRONZE L8;1;17000;0;17000;15380;1620;
2021-05-09 20:37:05;8997021870090;FRESH CARE LAVENDER 10ML;1;12000;0;12000;10000;2000;
2021-05-09 21:04:16;089686011036;INDOMIE GORENG PEDAS;1;2700;0;2700;2452;248;
2021-05-09 21:04:16;8998989500128;GUDANG GARAM MERAH KECIL 12KS;3;13000;0;39000;35700;3300;
2021-05-09 21:04:16;8851019210193;POCKY CHOCO BANANA 47G;1;7300;0;7300;5671;1629;
2021-05-09 21:04:16;MARS;MARSHMELLOW;4;500;0;2000;1732;268;
2021-05-09 21:06:01;8998989300261;GUDANG GARAM SURYA 12 FILTER;1;18500;0;18500;17200;1300;
2021-05-09 21:06:01;8993470279651;JOGER CHOCKY BAR;1;1000;0;1000;867;133;
2021-05-09 21:06:01;8997009510055;YOU C1000;1;10000;0;10000;9166;834;
2021-05-09 21:07:50;8998989110167;SURYA GUDANG GARAM 16 FILTER;1;24000;0;24000;22100;1900;
2021-05-09 21:07:50;8997231980015;O'JELLY MINI APPLE;1;3000;0;3000;2250;750;
2021-05-09 21:07:50;8992761166038;MMP ORANGE 300ML;1;5000;0;5000;3750;1250;
2021-05-09 21:07:50;9556001025272;NESCAFE LATTE 240ML;1;8500;0;8500;7834;666;
2021-05-09 21:14:51;8999909096004;SAMPOERNA 16 FILTER;1;24000;0;24000;23000;1000;
2021-05-09 21:27:03;RB;RED BOLD;1;19000;0;19000;17900;1100;
2021-05-09 21:27:03;8996001600597;KOPIKO LUCKY DAY;1;5000;0;5000;4283;717;
2021-05-09 21:27:23;8993470279651;JOGER CHOCKY BAR;1;1000;0;1000;867;133;
2021-05-09 22:34:00;8994834005923;SPIX 1000;1;1000;0;1000;850;150;
2021-05-10 11:14:03;123124;KOREK BIASA;1;2000;0;2000;1800;200;
2021-05-10 11:14:03;8998989300261;GUDANG GARAM SURYA 12 FILTER;1;18500;0;18500;17200;1300;
2021-05-10 11:46:27;711844110083;KECAP ABC 275 ML;1;14500;0;14500;13400;1100;
2021-05-10 11:46:27;8999999528843;CITRA PEARLY WHITE  60ML;1;6200;0;6200;5625;575;
2021-05-10 11:46:27;8999999045616;MOLTO AIO PINK SCH;2;1000;0;2000;1600;400;
2021-05-10 11:46:27;8999999538453;SUNSILK SHP SOFT AND  SMOOTH 55 ML;1;5000;0;5000;3750;1250;
2021-05-10 12:13:03;8998989300261;GUDANG GARAM SURYA 12 FILTER;1;18500;0;18500;17200;1300;
2021-05-10 12:13:03;8991102989428SCT;TANGO CKLT 24G SCT;1;1000;0;1000;609;391;
2021-05-10 12:13:03;HT;HOT-HOT;1;500;0;500;350;150;
2021-05-10 12:45:52;8998989300261;GUDANG GARAM SURYA 12 FILTER;1;18500;0;18500;17200;1300;
2021-05-10 12:45:52;089686041705;INDOMIE GORENG JUMBO;1;3500;0;3500;3143;357;
2021-05-10 12:45:52;8996001600221;KOPIKO 78;1;5000;0;5000;4283;717;
2021-05-10 13:29:36;8998866202244;EKOMIE BUMBU KALDU AYAM;6;1000;0;6000;4788;1212;
2021-05-10 13:29:36;8998866804516;GIV LEMON KOTAK 76G;2;2000;0;4000;3640;360;
2021-05-10 13:46:26;8996001301142;ROMA KELAPA;1;8000;0;8000;6628;1372;
2021-05-10 13:46:26;8998866200301;MIE SEDAAP GORENG;2;2500;0;5000;4046;954;
2021-05-10 15:17:26;8999801700030;SUSU FOYU;1;11500;0;11500;10450;1050;
2021-05-10 15:17:26;8994935000049;MINYAK GORENG DAMAI 5L;1;75000;0;75000;73780;1220;
2021-05-10 15:17:26;8992753102204;BKM COKLAT 370G;1;11300;0;11300;9500;1800;
2021-05-10 15:17:26;8999999504656;SARI MURNI 20X1.8G;1;5000;0;5000;4200;800;
2021-05-10 15:17:47;BAYFLAST;BAYPLAST;4;500;0;2000;1400;600;
2021-05-10 15:22:08;8998866501033;MINYAK GORENG SEDAAP POUCH 2L;1;28000;0;28000;27746;254;
2021-05-10 15:22:59;8992761139018;ADES 600ML;1;3500;0;3500;2292;1208;
2021-05-10 15:22:59;8998866200882;SUKSESMIE GORENG AYAM KRMS 133GR;1;3500;0;3500;3047;453;
2021-05-10 15:22:59;8992775712603;MYTEA POCI OOLONG;1;5000;0;5000;4410;590;
2021-05-10 15:22:59;HT;HOT-HOT;1;500;0;500;350;150;
2021-05-10 15:22:59;6907992825076;JD WATERMELON APPLE;1;2000;0;2000;1700;300;
2021-05-10 15:34:21;8992775211410;PILUS GARUDA PEDAS;1;5000;0;5000;4886;114;
2021-05-10 15:37:24;8996001338056;TAMARIN;1;6000;0;6000;5100;900;
2021-05-10 15:37:24;8992959953044;SWEETY BRONZE XL1;1;2500;0;2500;2250;250;
2021-05-10 15:37:24;8998866200301;MIE SEDAAP GORENG;2;2500;0;5000;4046;954;
2021-05-10 15:37:58;HT;HOT-HOT;1;500;0;500;350;150;
2021-05-10 16:16:16;089686043204;INDOMIE MIE ACEH;1;2700;0;2700;2452;248;
2021-05-10 16:16:16;8998866200301;MIE SEDAAP GORENG;1;2500;0;2500;2023;477;
2021-05-10 16:16:29;6907992824963;JD MILKY CHOCOLATE;1;3000;0;3000;2600;400;
2021-05-10 16:43:56;8998866501033;MINYAK GORENG SEDAAP POUCH 2L;2;28000;0;56000;55492;508;
2021-05-10 17:15:32;9556001004673;MILO NESTLE MALAYSIA ACTIVE GO;1;85000;0;85000;80000;5000;
2021-05-10 17:32:27;8997009510055;YOU C1000;1;10000;0;10000;9166;834;
2021-05-10 18:18:28;8998989300261;GUDANG GARAM SURYA 12 FILTER;1;18500;0;18500;17200;1300;
2021-05-10 18:18:28;8997009510116;LEMON WATER;1;7000;0;7000;5694;1306;
2021-05-10 18:18:28;JGR SHN;JOGER SHINY SACHET;6;500;0;3000;2622;378;
2021-05-10 18:18:28;123124;KOREK BIASA;1;2000;0;2000;1800;200;
2021-05-10 18:18:28;8997231980022;O'JELLY MINI STRAWBERRY;1;3000;0;3000;2250;750;
2021-05-10 18:18:28;bb;BENG-BENG;1;1500;0;1500;1450;50;
2021-05-10 18:18:28;HT;HOT-HOT;1;500;0;500;350;150;
2021-05-10 18:27:05;8992761139018;ADES 600ML;1;3500;0;3500;2292;1208;
2021-05-10 18:27:05;8886013257400;TWISTKO;1;1000;0;1000;900;100;
2021-05-10 18:27:05;8994834005923;SPIX 1000;2;1000;0;2000;1700;300;
2021-05-10 19:13:36;8999999519735;PEPSODENT TB BAMBOO SALT;1;13200;0;13200;11990;1210;
2021-05-10 19:13:36;8993560026103;DETTOL SKINCARE;1;20000;0;20000;18524;1476;
2021-05-10 19:13:36;8998866107099;WET WIPES KODOMO BABY 50SHT CLSSC;1;15000;0;15000;13650;1350;
2021-05-10 19:13:36;8992775001042;PILUS GARUDA MI GORENG;1;5000;0;5000;4810;190;
2021-05-10 19:13:36;8850007090267;JB BATH MILK 400ML (REFILL);1;24500;0;24500;23390;1110;
2021-05-10 19:13:36;8994834005923;SPIX 1000;4;1000;0;4000;3400;600;
2021-05-10 19:13:36;8850507002197;TOK TAK FRUIT CANDY;1;7500;0;7500;6250;1250;
2021-05-10 19:18:09;8850507002197;TOK TAK FRUIT CANDY;1;7500;0;7500;6250;1250;
2021-05-10 19:18:09;8997231980022;O'JELLY MINI STRAWBERRY;1;3000;0;3000;2250;750;
2021-05-10 19:35:47;8996001600146;TEH PUCUK HARUM 350ML;1;3000;0;3000;2314;686;
2021-05-10 19:37:20;8998866201865;KRISBEE PILLOW CHOCOLAVA 120 GR;1;8000;0;8000;7250;750;
2021-05-10 19:37:20;8992775315057;GERY SALUT MALKIST COKLAT;1;6500;0;6500;5516;984;
2021-05-10 19:37:20;8998009010231;ULTRA CHO 250;2;6000;0;12000;9568;2432;
2021-05-10 19:37:20;KJ;KINDER JOY;2;2000;0;4000;3166;834;
2021-05-10 19:39:30;8997231980022;O'JELLY MINI STRAWBERRY;1;3000;0;3000;2250;750;
2021-05-10 19:52:57;8992761166212;FRESTEA APPLE 350ML;1;4500;0;4500;3000;1500;
2021-05-10 19:52:57;8992775211410;PILUS GARUDA PEDAS;1;5000;0;5000;4886;114;
2021-05-10 19:52:57;8886013257400;TWISTKO;2;1000;0;2000;1800;200;
2021-05-10 20:27:27;001;PASEO SMART FACIAL SF 250S GT;1;10000;0;10000;9500;500;
2021-05-10 21:16:51;GL;GULA 1 LITER;4;11500;0;46000;42000;4000;
2021-05-10 21:47:38;8994834005923;SPIX 1000;2;1000;0;2000;1700;300;
2021-05-10 22:34:32;8997009510055;YOU C1000;1;10000;0;10000;9166;834;
2021-05-10 22:34:32;8992696404441;BEAR BRAND 189ML;1;9000;0;9000;7887;1113;
2021-05-11 12:00:49;8992628020152;BIMOLI POUCH 2L;1;30000;0;30000;29000;1000;
2021-05-11 12:00:49;TBR;TEPUNG BERAS;1;8000;0;8000;8000;0;
2021-05-11 12:00:49;TK;TEPUNG KETAN;2;13000;0;26000;26000;0;
2021-05-11 12:00:49;8995333060703;TERIGU KOMPAS 1KG;2;10500;0;21000;19632;1368;
2021-05-11 12:00:49;GL;GULA 1 LITER;2;11500;0;23000;21000;2000;
2021-05-11 12:00:49;711844150003;ABC ORANGE;2;12000;0;24000;19800;4200;
2021-05-11 12:12:15;089686060027;POP MIE AYAM JUMBO;1;4500;0;4500;3833;667;
2021-05-11 12:12:15;8992761145019;COCA COLA PET 250ML;1;3500;0;3500;2417;1083;
2021-05-11 12:12:15;8998866201452;POTABEE REGULER BBQ BEEF 35GR;1;5000;0;5000;4150;850;
2021-05-11 12:17:31;NC;NAURA COKELAT;1;85000;0;85000;75000;10000;
2021-05-11 12:17:31;711844150027;ABC NANAS;3;13000;0;39000;36723;2277;
2021-05-11 12:17:31;711844150003;ABC ORANGE;3;12000;0;36000;29700;6300;
2021-05-11 12:17:31;8991102384841;WFR TANGO LONG CKLT 130G;1;5000;0;5000;4345;655;
2021-05-11 12:17:31;8998989300261;GUDANG GARAM SURYA 12 FILTER;1;18500;0;18500;17200;1300;
2021-05-11 12:45:50;TG;TEH GELAS;1;1000;0;1000;729;271;
2021-05-11 12:47:15;TORT;TORTILA;1;1000;0;1000;1000;0;
2021-05-11 12:48:52;711844610095;LARISSA UDANG 500 GR;3;11000;0;33000;29370;3630;
2021-05-11 12:48:52;8999999195656;SARI WANGI 50X1.85;1;10000;0;10000;9500;500;
2021-05-11 12:48:52;8999999195649;SARI WANGI 25X1.86G;1;6000;0;6000;5050;950;
2021-05-11 12:49:12;TG;TEH GELAS;1;1000;0;1000;729;271;
2021-05-11 12:49:12;TORT;TORTILA;1;1000;0;1000;1000;0;
2021-05-11 12:58:24;8714700524002;MAIZENAKU;1;5000;0;5000;4200;800;
2021-05-11 13:06:47;8994867006997;ROKOK PENA BOLD 20BTG;1;17000;0;17000;15000;2000;
2021-05-11 13:20:47;8999999027261;LIFEBUOY BW LEMONFRESH LD REFF 450 ML;1;25000;0;25000;22110;2890;
2021-05-11 13:20:47;PTK;MINI NAIL CLIPPER BESAR THREE SEVEN;1;7000;0;7000;6000;1000;
2021-05-11 13:20:47;PTKK;MINI NAIL CLIPPER  KECIL THREE SEVEN;1;5000;0;5000;4500;500;
2021-05-11 13:20:47;8718291777199;PHILIPS 8W;1;41000;0;41000;38000;3000;
2021-05-11 15:04:31;8993226112508;GARAM REFINA;1;3000;0;3000;2461;539;
2021-05-11 15:04:31;8993226365522;GARAM MEJA GYURI 200GR;1;2000;0;2000;1700;300;
2021-05-11 16:03:26;6907992825076;JD WATERMELON APPLE;2;2000;0;4000;3400;600;
2021-05-11 17:17:21;MOBIL;GULA GULA HP;1;2000;0;2000;1700;300;
2021-05-11 17:30:06;LT;LIPSTIK HANASUI;1;27000;0;27000;27000;0;
2021-05-11 17:30:06;8999999016128;RINSO MOLTO ROSE FRESH 750ML;1;15000;0;15000;12507;2493;
2021-05-11 17:30:06;8993324850449;BABY LOVE COTTON BUDS;1;5000;0;5000;4500;500;
2021-05-11 17:30:06;8998866106979;CIPTADENT TB CHARCOAL PROTEC;1;6000;0;6000;5250;750;
2021-05-11 17:30:06;8999999557447;PEPSODENT ACTION123 SIWAK 110G;1;9000;0;9000;8000;1000;
2021-05-11 17:30:06;8999999555450;VIXAL PEMB PORS BIRU 190ML;1;5000;0;5000;4200;800;
2021-05-11 17:30:06;8886020001126;SWALLOW KAMP WHITE 150G;1;14000;0;14000;13000;1000;
2021-05-11 17:30:06;8850507002197;TOK TAK FRUIT CANDY;1;7500;0;7500;6250;1250;
2021-05-11 18:02:00;8996001410042SCT;TB TORA MOKA SCT;3;1500;0;4500;2610;1890;
2021-05-11 18:05:20;8992761139018;ADES 600ML;2;3500;0;7000;4584;2416;
2021-05-11 18:05:20;8994834005923;SPIX 1000;1;1000;0;1000;850;150;
2021-05-11 18:11:15;76164217;MARLBORO MERAH;1;30000;0;30000;27700;2300;
2021-05-11 18:11:15;123124;KOREK BIASA;1;2000;0;2000;1800;200;
2021-05-11 18:13:27;123124;KOREK BIASA;1;2000;0;2000;1800;200;
2021-05-11 18:13:27;8993989311279;CLAS MILD 12;1;17000;0;17000;15700;1300;
2021-05-11 18:13:27;HT;HOT-HOT;2;500;0;1000;700;300;
2021-05-11 18:32:28;8996001410042SCT;TB TORA MOKA SCT;2;1500;0;3000;1740;1260;
2021-05-11 18:32:28;8998866501033;MINYAK GORENG SEDAAP POUCH 2L;1;28000;0;28000;27746;254;
2021-05-11 18:32:28;GL;GULA 1 LITER;1;11500;0;11500;10500;1000;
2021-05-11 18:32:28;8998866202695;KOPI MAYOR;1;6000;0;6000;4500;1500;
2021-05-11 18:33:26;JGR SHN;JOGER SHINY SACHET;3;500;0;1500;1311;189;
2021-05-11 18:45:24;8998989300261;GUDANG GARAM SURYA 12 FILTER;1;18500;0;18500;17200;1300;
2021-05-11 18:45:24;KJ;KINDER JOY;1;2000;0;2000;1583;417;
2021-05-11 18:46:54;8998989500128;GUDANG GARAM MERAH KECIL 12KS;1;13000;0;13000;11900;1100;
2021-05-11 18:54:18;8997011700123;BIHUN JAGUNG 300GR;1;6000;0;6000;4979;1021;
2021-05-11 18:54:18;7118441101378;KECAP ABC 520 ML;2;19000;0;38000;35600;2400;
2021-05-11 18:54:18;8993335523363;TOTAL ALMEERA 250G;4;5000;0;20000;16400;3600;
2021-05-11 19:09:32;001;PASEO SMART FACIAL SF 250S GT;1;10000;0;10000;9500;500;
2021-05-11 20:14:19;6907992823829;JD MILKY MILK;3;3000;0;9000;7800;1200;
2021-05-11 20:14:19;6907992823669;JD MILKY STRAW;1;3000;0;3000;2600;400;
2021-05-11 20:14:19;6907992825076;JD WATERMELON APPLE;1;2000;0;2000;1700;300;
2021-05-11 20:14:19;MARS;MARSHMELLOW;2;500;0;1000;866;134;
2021-05-11 20:14:19;8997231980022;O'JELLY MINI STRAWBERRY;2;3000;0;6000;4500;1500;
2021-05-11 20:47:49;8886013257400;TWISTKO;1;1000;0;1000;900;100;
2021-05-11 20:47:49;8992628010139;BIMOLI 5L;1;77000;0;77000;75862;1138;
2021-05-11 20:47:49;8993058105013;EXTRA JOSS;1;12000;0;12000;9773;2227;
2021-05-11 21:16:04;8997231980022;O'JELLY MINI STRAWBERRY;2;3000;0;6000;4500;1500;
2021-05-11 21:16:04;089686049053;SARIMI PUAS;1;3000;0;3000;2400;600;
2021-05-11 21:19:19;8994834005923;SPIX 1000;1;1000;0;1000;850;150;
2021-05-11 21:19:19;8997231980022;O'JELLY MINI STRAWBERRY;1;3000;0;3000;2250;750;
2021-05-11 21:20:37;8998866600521;SOKLIN FLOORCLENER KUNING 400ML;1;6000;0;6000;5025;975;
2021-05-11 21:20:37;8999999538439;CLEAR SHP CSC UNISEX 55ML;1;4200;0;4200;3750;450;
2021-05-11 21:20:37;8994867000179;ROKOK PENA MILD 16;1;14500;0;14500;13000;1500;
2021-05-11 21:27:35;8992761139018;ADES 600ML;2;3500;0;7000;4584;2416;
2021-05-11 21:27:35;089686611878;QTELA TEMPE;1;6000;0;6000;5370;630;
2021-05-11 21:27:35;8996001318430;BETTER 1000;1;1000;0;1000;820;180;
2021-05-11 21:27:35;8992761164539;NUTRIBOOST ORANGE 300ML;1;6500;0;6500;5300;1200;
2021-05-11 21:27:35;8997009510017;YOU C1000 LEMON;1;10000;0;10000;9166;834;
2021-05-11 21:27:35;HT;HOT-HOT;1;500;0;500;350;150;
2021-05-11 21:30:12;8999909010567;234 16 FILTER;1;22000;0;22000;21500;500;
2021-05-11 21:35:02;8993989311279;CLAS MILD 12;1;17000;0;17000;15700;1300;
2021-05-11 21:35:02;8996001440087;ENERGEN KACANG HIJAU;1;1500;0;1500;1150;350;
2021-05-11 21:35:02;8996001440049;ENERGEN;1;1500;0;1500;1200;300;
2021-05-11 21:54:25;6907992823966;JD BLUEBERRY;1;3500;0;3500;3000;500;
2021-05-11 21:54:25;6907992823935;JD SWEETCORN;1;3500;0;3500;3000;500;
2021-05-11 22:36:28;8991102213189;BLASTER UNGU;1;5000;0;5000;3106;1894;
2021-05-11 22:37:22;8991102384841;WFR TANGO LONG CKLT 130G;1;5000;0;5000;4345;655;
2021-05-11 22:37:22;089686611519;QTELA SINGKONG;3;5000;0;15000;12798;2202;
2021-05-11 22:43:31;8998989300261;GUDANG GARAM SURYA 12 FILTER;1;18500;0;18500;17200;1300;
2021-05-12 14:14:07;8992696404441;BEAR BRAND 189ML;1;9000;0;9000;7887;1113;
2021-05-12 14:14:07;8997009510055;YOU C1000;1;10000;0;10000;9166;834;
2021-05-12 14:14:07;8999999045913;LIFEBUOY MILDCARE 110GR;1;15000;0;15000;14245;755;
2021-05-12 14:14:07;8999999045265;RINSO MOLTO ROSE FRESH PWD 770GR;1;21600;0;21600;19338;2262;
2021-05-12 14:14:07;8998866202930;SEDAAP AYAM JERIT CUP;1;4500;0;4500;3738;762;
2021-05-12 14:14:07;ARG;ARGUS 220ML;2;14500;0;29000;25000;4000;
2021-05-12 14:14:07;8998866612173;SOKLIN SOFTERGENT 770G & PIRING;1;18000;0;18000;16055;1945;
2021-05-12 14:14:07;8991102213189;BLASTER UNGU;1;5000;0;5000;3106;1894;
2021-05-12 14:14:07;HT;HOT-HOT;1;500;0;500;350;150;
2021-05-12 14:14:07;8998866200837;NOODLE SEDAAPMIE SOTO CUP 81 GR;1;4500;0;4500;3650;850;
2021-05-12 15:03:43;8996001410042SCT;TB TORA MOKA SCT;3;1500;0;4500;2610;1890;
2021-05-12 15:21:59;11;PASEO SMART FHSTD PERF 6P 12S;1;5000;0;5000;4264;736;
2021-05-12 15:24:13;BB;PASEO SMARTY FACIAL TRAVEL PACK 50S GT;1;3000;0;3000;1980;1020;
2021-05-12 15:38:15;8991102230308;BLASTER PINK;1;5000;0;5000;3106;1894;
2021-05-12 15:47:21;8999999059781;SUNLIGHT LIME NEW POUCH 210ML;1;5000;0;5000;4300;700;
2021-05-12 16:18:34;001;PASEO SMART FACIAL SF 250S GT;1;10000;0;10000;9500;500;
2021-05-12 16:18:34;089686044249;SUPERMI NUTRIMI STEAK AYAM;1;3500;0;3500;2800;700;
2021-05-12 16:18:34;089686011036;INDOMIE GORENG PEDAS;1;2700;0;2700;2452;248;
2021-05-12 16:18:34;8886013213208;FRENCH FREIS 2000;1;5000;0;5000;3750;1250;
2021-05-12 16:21:09;8992628010139;BIMOLI 5L;1;77000;0;77000;75862;1138;
2021-05-12 17:24:03;8998866201377;KRISBEE FRIES KENTANG GORENG 68 GR;1;5500;0;5500;4620;880;
2021-05-12 17:58:18;6907992823874;JD CRUNCHY CHOCO BLUEBERRY;1;5500;0;5500;4700;800;
2021-05-12 18:00:44;8992761139018;ADES 600ML;3;3500;0;10500;6876;3624;
2021-05-12 18:00:44;8886013257400;TWISTKO;1;1000;0;1000;900;100;
2021-05-12 18:00:44;8994834005923;SPIX 1000;1;1000;0;1000;850;150;
2021-05-12 18:00:44;089686021219;INTER MIE GORENG;1;1000;0;1000;885;115;
2021-05-12 18:00:44;JGR SHN;JOGER SHINY SACHET;1;500;0;500;437;63;
2021-05-12 18:19:44;8991102213189;BLASTER UNGU;1;5000;0;5000;3106;1894;
2021-05-12 18:20:01;8992761166212;FRESTEA APPLE 350ML;1;4500;0;4500;3000;1500;
2021-05-12 18:27:24;8992696419742;NESCAFE COFFE CREAM;1;5000;0;5000;4099;901;
2021-05-12 18:27:24;JD VM;JD VANILLA MILKSHAKE;1;5000;0;5000;4300;700;
2021-05-12 18:27:24;8992696521797SCT;MILO UHT ACT GO 22G;5;2000;0;10000;7060;2940;
2021-05-12 18:27:24;8996001600146;TEH PUCUK HARUM 350ML;1;3000;0;3000;2314;686;
2021-05-12 18:27:24;8886020001294;SWALLOW KAMP WARNA 150G;1;14000;0;14000;13200;800;
2021-05-12 18:27:24;8997011700345;MIE KERING LANGIT BIRU;1;23000;0;23000;21000;2000;
2021-05-12 18:27:24;8992993525740;HAAN PUDING MANGGO POUCH 145G;2;8000;0;16000;14370;1630;
2021-05-12 18:27:24;8992957352153;CHOCO CHIPS 45G;1;4500;0;4500;2850;1650;
2021-05-12 18:50:04;089686021219;INTER MIE GORENG;1;1000;0;1000;885;115;
2021-05-12 19:01:14;8992761136161;COCACOLA 1L;1;10000;0;10000;9000;1000;
2021-05-12 19:01:14;8992761136178;SPRITE 1L;1;10000;0;10000;9000;1000;
2021-05-12 19:02:17;8992696523067;MILO ACTVGO UHT 180ML;4;4500;0;18000;14060;3940;
2021-05-12 19:12:56;8999999559854;AXE BLACK POCKET FRAG 17ML;1;10000;0;10000;8000;2000;
2021-05-12 19:28:21;8850507002968;A1 KING TRUCK;1;16500;0;16500;15500;1000;
2021-05-12 19:28:21;6921101219235;YAKUAT JELLY;1;2000;0;2000;1750;250;
2021-05-12 19:28:21;8991102714631;TANGO TETRA CKLT;1;5000;0;5000;4545;455;
2021-05-12 19:28:21;8992761122331;FRESTEA APPEL 500ML;1;6500;0;6500;4708;1792;
2021-05-12 19:40:18;9556001025272;NESCAFE LATTE 240ML;1;8500;0;8500;7834;666;
2021-05-12 19:40:18;8997021870090;FRESH CARE LAVENDER 10ML;1;12000;0;12000;10000;2000;
2021-05-12 19:42:28;8992761136178;SPRITE 1L;2;10000;0;20000;18000;2000;
2021-05-12 19:42:28;8992761136185;FANTA 1L;1;10000;0;10000;9000;1000;
2021-05-12 19:47:19;8997231980022;O'JELLY MINI STRAWBERRY;1;3000;0;3000;2250;750;
2021-05-12 19:47:19;6907992823829;JD MILKY MILK;2;3000;0;6000;5200;800;
2021-05-12 19:47:19;6907992825076;JD WATERMELON APPLE;1;2000;0;2000;1700;300;
2021-05-12 19:47:19;8992775002155;CHOCOLATOS DRINK;1;4000;0;4000;3520;480;
2021-05-12 19:47:19;8996001600146;TEH PUCUK HARUM 350ML;1;3000;0;3000;2314;686;
2021-05-12 19:47:19;PRG;PARAGO;2;500;0;1000;800;200;
2021-05-12 19:48:34;8997231980022;O'JELLY MINI STRAWBERRY;4;3000;0;12000;9000;3000;
2021-05-12 19:49:07;8991102213189;BLASTER UNGU;2;5000;0;10000;6212;3788;
2021-05-12 19:49:46;089686611878;QTELA TEMPE;1;6000;0;6000;5370;630;
2021-05-12 19:55:38;8997009510116;LEMON WATER;1;7000;0;7000;5694;1306;
2021-05-12 20:00:00;089686611878;QTELA TEMPE;3;6000;0;18000;16110;1890;
2021-05-12 20:27:51;8992761139018;ADES 600ML;1;3500;0;3500;2292;1208;
2021-05-12 20:27:51;711844150003;ABC ORANGE;1;12000;0;12000;9900;2100;
2021-05-12 20:27:51;8997226412019;EMINA CHEESE 165G;1;17000;0;17000;15000;2000;
2021-05-12 20:34:15;8998866202732;MILKU STROBERI 200ML;1;3000;0;3000;2375;625;
2021-05-12 21:05:35;8992759120264;LARISST 220;1;10000;0;10000;9200;800;
2021-05-12 21:05:35;089686611878;QTELA TEMPE;1;6000;0;6000;5370;630;
2021-05-12 21:05:35;6907992823652;JD CHOCOLATE MILKSHAKE;1;6000;0;6000;5200;800;
2021-05-12 21:05:35;GL;GULA 1 LITER;1;11500;0;11500;10500;1000;
2021-05-12 21:19:22;ARG;ARGUS 220ML;2;14500;0;29000;25000;4000;
2021-05-12 21:57:46;8992761166212;FRESTEA APPLE 350ML;1;4500;0;4500;3000;1500;
2021-05-12 21:57:46;8992775002735;CHOCOLATOS SUSU COKELAT;1;4000;0;4000;3520;480;
2021-05-12 22:02:44;001;PASEO SMART FACIAL SF 250S GT;2;10000;0;20000;19000;1000;
2021-05-16 12:49:23;8994834003752;TICTIC;2;2000;0;4000;3400;600;
2021-05-16 12:49:23;8998866201377;KRISBEE FRIES KENTANG GORENG 68 GR;2;5500;0;11000;9240;1760;
2021-05-16 12:49:23;8886013213208;FRENCH FREIS 2000;1;5000;0;5000;3750;1250;
2021-05-16 12:49:23;8991001121400;SILVERQUEEN ALMOND 65G;1;15000;0;15000;13200;1800;
2021-05-16 12:49:23;8991001780065;TWISTER BLACK 140G;1;13000;0;13000;11700;1300;
2021-05-16 12:49:23;8991188943062;SASA 250G;1;10000;0;10000;8500;1500;
2021-05-16 12:49:23;ARG;ARGUS 220ML;2;14500;0;29000;25000;4000;
2021-05-16 12:49:23;6921101219235;YAKUAT JELLY;1;2000;0;2000;1750;250;
2021-05-16 12:49:23;8999909010567;234 16 FILTER;1;22000;0;22000;21500;500;
2021-05-16 12:49:23;8998009010590;ULTRA CHO 125;1;3000;0;3000;2428;572;
2021-05-16 12:49:23;6907992823867;JD CRUNCHY CHOCOLATE MALT;1;5500;0;5500;4700;800;
2021-05-16 12:49:23;MARS;MARSHMELLOW;1;500;0;500;433;67;
2021-05-16 12:49:23;8997231980022;O'JELLY MINI STRAWBERRY;1;3000;0;3000;2250;750;
2021-05-16 12:49:23;6907992823966;JD BLUEBERRY;1;3500;0;3500;3000;500;
2021-05-16 12:49:23;8992957220087;COKLAT SINGA;1;2000;0;2000;1700;300;
2021-05-16 12:49:23;8992957220063;COKLAT BANGO;1;2000;0;2000;1700;300;
2021-05-16 12:49:23;8998866202725;MILKU COKLAT PREMIUM 200ML;1;3000;0;3000;2375;625;
2021-05-16 12:49:23;PRG;PARAGO;1;500;0;500;400;100;
2021-05-16 12:49:23;bb;BENG-BENG;1;1500;0;1500;1450;50;
2021-05-16 12:49:23;8994834006128;TICTIC PEDAS;1;2000;0;2000;1700;300;
2021-05-16 12:49:23;SMC;BIMURA MAKARONI CINCIN 250G;1;10000;0;10000;9300;700;
2021-05-16 12:49:23;8991102385060;TANGO WAFFLE CHOX;1;9000;0;9000;8498;502;
2021-05-16 12:49:23;8997025911058;HATARI SHP KELAPA;1;6000;0;6000;4911;1089;
2021-05-16 12:49:23;089686834253;FREISS MELON;1;16000;0;16000;14200;1800;
2021-05-16 12:49:23;8999999023997;CITRA BW FRESH WHITE 220ML;1;12000;0;12000;10700;1300;
2021-05-16 12:49:23;8999999007768;FAIR&LOVELY MULTIVITAMIN  CREAM 9 ML;2;4500;0;9000;6400;2600;
2021-05-16 13:26:28;089686611519;QTELA SINGKONG;2;5000;0;10000;8532;1468;
2021-05-16 13:26:28;8992979130012;TOTAL LEMON SOFTENER;1;13000;0;13000;11532;1468;
2021-05-16 13:26:28;089686043617;INDOMIE MIEGHRTTI;1;2700;0;2700;2452;248;
2021-05-16 13:26:28;8992388133345;NU MILK TEA TEH TARIK 330ML;1;6000;0;6000;5125;875;
2021-05-16 13:26:28;8992775002735;CHOCOLATOS SUSU COKELAT;1;4000;0;4000;3520;480;
2021-05-16 13:26:28;089686049053;SARIMI PUAS;1;3000;0;3000;2400;600;
2021-05-16 13:26:28;8999999524807;SUNLIGHT HABBATUSSAUDA POUCH 755ML;1;17000;0;17000;15400;1600;
2021-05-16 13:26:28;8998989500128;GUDANG GARAM MERAH KECIL 12KS;2;14000;0;28000;26000;2000;
2021-05-16 13:26:28;6907992823843;JD MOCHA CRISPY;3;5000;0;15000;13200;1800;
2021-05-16 13:26:28;8991115012021;BB STRAWBERRY CREAM;1;8500;0;8500;7600;900;
2021-05-16 13:26:28;8999909982000;SAMPOERNA 12 FILTER;1;18000;0;18000;16000;2000;
2021-05-16 13:26:28;8998866201490;POTABEE REGULER GRILLED SEAWED 68 GR;2;8000;0;16000;14400;1600;
2021-05-16 13:26:28;8998866201469;POTABEE REGULER BBQ BEEF 68 GR;1;8000;0;8000;7200;800;
2021-05-16 13:26:28;8998009010569;ULTRA CHO 200;3;5000;0;15000;11490;3510;
2021-05-16 13:26:28;8999909010567;234 16 FILTER;2;22000;0;44000;43000;1000;
2021-05-16 13:26:28;8998666003089SCT;TB GILUX MIX SCT;5;1000;0;5000;4000;1000;
2021-05-16 13:26:28;123124;KOREK BIASA;1;2000;0;2000;1800;200;
2021-05-16 13:26:28;TL;TELUR;8;1500;0;12000;10400;1600;
2021-05-16 13:26:28;089686010107;INDOMIE KALDU AYAM;1;2500;0;2500;2150;350;
2021-05-16 13:26:28;089686021127;INTER MIE KALDU;4;1000;0;4000;3252;748;
2021-05-16 13:26:28;8992628010139;BIMOLI 5L;2;77000;0;154000;151724;2276;
2021-05-16 13:26:28;8993058105013;EXTRA JOSS;1;12000;0;12000;9773;2227;
2021-05-16 13:26:28;8994867007161;ROKOK PENA GOLD 20;1;17000;0;17000;15000;2000;
2021-05-16 13:26:28;8992761164539;NUTRIBOOST ORANGE 300ML;1;6500;0;6500;5300;1200;
2021-05-16 13:26:28;8992761164546;NUTRIBOOST STRAWBERRY 300ML;1;6500;0;6500;5300;1200;
2021-05-16 13:26:28;8992870311091;SALONPAS;1;6000;0;6000;4806;1194;
2021-05-16 13:26:28;8996001350423;ZUPER KEJU;1;9200;0;9200;8360;840;
2021-05-16 13:26:28;8992696521797SCT;MILO UHT ACT GO 22G;3;2000;0;6000;4236;1764;
2021-05-16 13:26:28;089686043051;INDOMIE COTO MAKASSAR;3;2800;0;8400;7575;825;
2021-05-16 13:26:28;8996001600399;LE MINERAL 1500ML;2;5000;0;10000;8084;1916;
2021-05-16 13:26:28;8998866604963;POWDET DAIA LEMON 290GR;1;5000;0;5000;4450;550;
2021-05-16 13:26:28;089686017748;SARIMIE GORENG ISI 2;2;3500;0;7000;6240;760;
2021-05-16 13:26:28;TG;TEH GELAS;1;1000;0;1000;729;271;
2021-05-16 13:26:28;8999999059781;SUNLIGHT LIME NEW POUCH 210ML;1;5000;0;5000;4300;700;
2021-05-16 13:26:28;8991111111995;C&C TONER 100ML;1;14000;0;14000;12900;1100;
2021-05-16 13:26:28;8992806145417;SCOTCH BRITE;1;3500;0;3500;2407;1093;
2021-05-16 13:26:28;8992222091961;PUCELLE MIST COL SPRAY 75ML;1;13000;0;13000;11650;1350;
2021-05-16 13:26:28;8993072153595;LARISST COTTON 35G;1;5000;0;5000;3300;1700;
2021-05-16 13:26:28;8998866202770;MIE SEDAAP SALERO PADANG;10;2500;0;25000;23620;1380;
2021-05-16 13:26:28;8991102994422;TANGO WALUT CHOCOBNN 18G;1;9000;0;9000;8661;339;
2021-05-16 13:26:28;8998866200578;MIE SEDAAP KARI KENTAL;5;2500;0;12500;11315;1185;
2021-05-16 13:26:28;8996001355817;BENG-BENG MAXX;1;27000;0;27000;24500;2500;
2021-05-16 13:26:28;8998866202237;NOODLE SEDAAP TASTY AYAM GEPREK 124 GR;2;5000;0;10000;8334;1666;
2021-05-16 13:26:28;8992775001615;CHOCOLATOS SWEET CHEESE;1;18000;0;18000;15483;2517;
2021-05-16 13:26:28;8997009510055;YOU C1000;1;10000;0;10000;9166;834;
2021-05-16 13:26:28;711844610095;LARISSA UDANG 500 GR;1;11000;0;11000;9790;1210;
2021-05-16 13:26:28;8991188943536;SASA SANTAN KELAPA 65ML;3;3000;0;9000;7311;1689;
2021-05-16 13:26:28;8991111112398;C&C OIL CONTROL FILM FLORAL 15;1;10000;0;10000;8010;1990;
2021-05-16 13:26:28;ARG;ARGUS 220ML;6;14500;0;87000;75000;12000;
2021-05-16 13:26:28;8998866200646;KOPI TOP MURNI;1;11000;0;11000;9600;1400;
2021-05-16 13:26:28;8934868015024;REXONA DEO LOTION FREE SPIRIT 9G;1;4500;0;4500;3900;600;
2021-05-16 13:26:28;8999909096004;SAMPOERNA 16 FILTER;1;24000;0;24000;23000;1000;
2021-05-16 13:26:28;711844150027;ABC NANAS;1;13000;0;13000;12241;759;
2021-05-16 13:27:14;8998989300261;GUDANG GARAM SURYA 12 FILTER;2;18500;0;37000;34400;2600;
2021-05-16 14:59:37;GL;GULA 1 LITER;1;11500;0;11500;10500;1000;
2021-05-16 14:59:37;8992761002022;SPRITE PET 390ML;1;5500;0;5500;4300;1200;
2021-05-16 15:33:12;8995102703534;TERASI DUO 6 GR;1;4000;0;4000;3720;280;
2021-05-16 15:47:11;8992946512223;SHINZUI;1;4000;0;4000;2500;1500;
2021-05-16 15:47:11;8998866611152;CREAM EKONOMI VIOLET 455G;1;5500;0;5500;4750;750;
2021-05-16 15:47:11;6907992823829;JD MILKY MILK;1;3000;0;3000;2600;400;
2021-05-16 15:47:38;8850507000094;POLICE BONCHA;1;2000;0;2000;800;1200;
2021-05-16 15:58:46;8994834003752;TICTIC;3;2000;0;6000;5100;900;
2021-05-16 15:58:46;8994834006128;TICTIC PEDAS;2;2000;0;4000;3400;600;
2021-05-16 15:58:46;8992761122331;FRESTEA APPEL 500ML;1;6500;0;6500;4708;1792;
2021-05-16 15:58:46;6907992823652;JD CHOCOLATE MILKSHAKE;1;6000;0;6000;5200;800;
2021-05-16 15:59:04;HT;HOT-HOT;1;500;0;500;350;150;
2021-05-16 16:07:55;8992696404441;BEAR BRAND 189ML;1;9000;0;9000;7887;1113;
2021-05-16 16:21:02;8992959953020;SWEETY BRONZE M1;2;3000;0;6000;5342;658;
2021-05-16 17:05:22;6907992824963;JD MILKY CHOCOLATE;1;3000;0;3000;2600;400;
2021-05-16 17:05:22;8886013257400;TWISTKO;1;1000;0;1000;900;100;
2021-05-16 17:05:22;6907992823966;JD BLUEBERRY;1;3500;0;3500;3000;500;
2021-05-16 17:05:22;6907992823829;JD MILKY MILK;1;3000;0;3000;2600;400;
2021-05-16 17:05:22;8994834005923;SPIX 1000;3;1000;0;3000;2550;450;
2021-05-16 17:05:22;8991001503114;CHACHA MILK CHOCOLATE 35G;1;5500;0;5500;4900;600;
2021-05-16 17:40:43;8997025911058;HATARI SHP KELAPA;1;6000;0;6000;4911;1089;
2021-05-16 17:40:59;8992696404441;BEAR BRAND 189ML;2;9000;0;18000;15774;2226;
2021-05-16 17:53:31;6907992823904;JD CRUNCHY CHOCOLATE VAN;1;8000;0;8000;6800;1200;
2021-05-16 18:28:25;6921101219235;YAKUAT JELLY;1;2000;0;2000;1750;250;
2021-05-16 18:28:25;8997025911058;HATARI SHP KELAPA;1;6000;0;6000;4911;1089;
2021-05-16 18:28:25;8998866500708;FLORIDINA ORANGE;1;3000;0;3000;2500;500;
2021-05-16 18:28:25;8999908389008;HEMAVITON C1000;1;8000;0;8000;6000;2000;
2021-05-16 18:28:51;8991102384841;WFR TANGO LONG CKLT 130G;1;5000;0;5000;4345;655;
2021-05-16 18:28:51;8991102987639;WFR TANGO LONG VNL 130G;1;5000;0;5000;3773;1227;
2021-05-16 18:31:42;8994834005923;SPIX 1000;1;1000;0;1000;850;150;
2021-05-16 18:31:42;VTM;VITAMIN;2;500;0;1000;850;150;
2021-05-16 18:47:09;8998866202404;NOODLE SEDAAP MIE KOREAN SPICY CHICKEN CUP;1;5000;0;5000;4002;998;
2021-05-16 18:55:39;8998866202930;SEDAAP AYAM JERIT CUP;1;4500;0;4500;3738;762;
2021-05-16 18:59:19;TL;TELUR;3;1500;0;4500;3900;600;
2021-05-16 18:59:19;HT;HOT-HOT;1;500;0;500;350;150;
2021-05-16 19:26:43;8993989311279;CLAS MILD 12;1;17000;0;17000;15700;1300;
2021-05-16 19:32:26;8997231980022;O'JELLY MINI STRAWBERRY;2;3000;0;6000;4500;1500;
2021-05-16 19:32:26;VTM;VITAMIN;2;500;0;1000;850;150;
2021-05-16 20:00:49;8999099920691;SGM 1+ MADU 1000G;1;85000;0;85000;78510;6490;
2021-05-16 20:29:11;089686060126;POP MIE BASO JUMBO;1;4500;0;4500;3833;667;
2021-05-16 20:31:21;GL;GULA 1 LITER;4;11500;0;46000;42000;4000;
2021-05-16 20:31:21;6921101219235;YAKUAT JELLY;1;2000;0;2000;1750;250;
2021-05-16 20:31:21;8886013213208;FRENCH FREIS 2000;1;5000;0;5000;3750;1250;
2021-05-16 21:36:41;8999999042646;RINSO MOLTO ROSE FRESH LIQ 40ML;1;5000;0;5000;4817;183;
2021-05-16 21:36:41;8998866608756;SOKLIN SOFTENER TWILIGHT BLUE 14SCH;1;5000;0;5000;4560;440;
2021-05-16 21:37:31;8998866201827;JAVANA GULA BATU 350ML;1;3000;0;3000;2150;850;
2021-05-16 21:40:52;8991102989428SCT;TANGO CKLT 24G SCT;1;1000;0;1000;609;391;
2021-05-16 22:17:51;089686044249;SUPERMI NUTRIMI STEAK AYAM;1;3500;0;3500;2800;700;
2021-05-16 22:17:51;089686010343;INDOMIE SOTO MIE;1;2600;0;2600;2367;233;
2021-05-16 22:17:51;089686010824;INDOMIE GORENG SPESIAL;1;2700;0;2700;2452;248;
2021-05-16 22:27:32;8998009020186;BUAVITA GUAVA 250ML;1;7000;0;7000;6083;917;
2021-05-16 22:27:32;089686611519;QTELA SINGKONG;1;5000;0;5000;4266;734;
2021-05-16 22:27:32;8996001600146;TEH PUCUK HARUM 350ML;1;3000;0;3000;2314;686;
2021-05-16 22:28:27;8991102989428SCT;TANGO CKLT 24G SCT;2;1000;0;2000;1218;782;
2021-05-16 22:45:58;8991689668006;SWALLOW;1;3500;0;3500;3500;0;
2021-05-16 22:45:58;8992933241112;NUTRIJELL COKLAT;2;7000;0;14000;12832;1168;
2021-05-16 22:45:58;8992993525740;HAAN PUDING MANGGO POUCH 145G;1;8000;0;8000;7185;815;
2021-05-16 22:45:58;8992992102423;WIPPY CREAM 200G;2;28000;0;56000;51980;4020;
2021-05-16 22:45:58;8998866200882;SUKSESMIE GORENG AYAM KRMS 133GR;2;3500;0;7000;6094;906;
2021-05-16 22:47:27;8992870311091;SALONPAS;1;6000;0;6000;4806;1194;
2021-05-16 22:47:27;HT;HOT-HOT;1;500;0;500;350;150;
2021-05-16 22:58:35;8998866200578;MIE SEDAAP KARI KENTAL;2;2500;0;5000;4526;474;
2021-05-16 22:58:35;8998866202619;MIE SEDAAP KOREAN SPICY SOUP;1;2500;0;2500;2273;227;
2021-05-17 17:24:28;8991102230308;BLASTER PINK;1;5000;0;5000;3106;1894;
2021-05-17 19:02:04;8999999034061;ZWITSAL BAT NAT HAIR&BODY  300ML;1;28700;0;28700;26125;2575;
2021-05-17 19:02:04;8999908284907;MY BABY MINYAK TELON 90ML;1;25000;0;25000;22700;2300;
2021-05-17 19:02:04;8998989110167;SURYA GUDANG GARAM 16 FILTER;1;25000;0;25000;23200;1800;
2021-05-17 19:02:04;8998866200882;SUKSESMIE GORENG AYAM KRMS 133GR;1;3500;0;3500;3047;453;
2021-05-17 19:08:26;8999999059781;SUNLIGHT LIME NEW POUCH 210ML;1;5000;0;5000;4300;700;
2021-05-17 19:08:26;8992628605151;AMANDA MARGARINE;1;5000;0;5000;3806;1194;
2021-05-17 19:08:26;8992957352153;CHOCO CHIPS 45G;1;4500;0;4500;2850;1650;
2021-05-17 19:08:26;8992761166038;MMP ORANGE 300ML;1;5000;0;5000;3750;1250;
2021-05-17 19:08:26;HT;HOT-HOT;4;500;0;2000;1400;600;
2021-05-17 19:08:26;6907992823843;JD MOCHA CRISPY;1;5000;0;5000;4400;600;
2021-05-17 19:08:26;6907992823669;JD MILKY STRAW;1;3000;0;3000;2600;400;
2021-05-17 19:08:26;8998866202343;MIE SEDAAP KOREAN SPICY;1;2500;0;2500;2023;477;
2021-05-17 19:08:26;8992775311615;CHOCOLATOS;1;12000;0;12000;9983;2017;
2021-05-17 19:08:26;BTS;BIMURA TARO SEAWEED 250G;2;10000;0;20000;18600;1400;
2021-05-17 19:09:05;8992959953105;SWEETY BRONZE XXL6;1;16000;0;16000;15230;770;
2021-05-17 19:13:09;8998866200882;SUKSESMIE GORENG AYAM KRMS 133GR;2;3500;0;7000;6094;906;
2021-05-17 19:13:09;VTM;VITAMIN;1;500;0;500;425;75;
2021-05-17 19:13:09;8991102281430;PERMEN MINTZ DUOMINT;1;4500;0;4500;4000;500;
2021-05-17 19:13:09;8991102281416;PERMEN MINTZ PPMINT;1;4500;0;4500;4000;500;
2021-05-17 19:13:09;8991102989381;TANGO LONG BUBBLEGUM 130G;1;5000;0;5000;4345;655;
2021-05-17 19:13:09;8992775913000SCT;CHOCOLATOS CKLT DRINK SCT;1;2000;0;2000;1586;414;
2021-05-17 19:13:09;8999999534097;PEPSODENT PGB FCM 75G;1;5000;0;5000;3850;1150;
2021-05-17 19:13:09;8998989500128;GUDANG GARAM MERAH KECIL 12KS;1;14000;0;14000;13000;1000;
2021-05-17 19:13:09;RB;RED BOLD;1;19000;0;19000;17900;1100;
2021-05-17 19:13:09;8998866200844;NOODLE SEDAAP MIE KARI SPESIAL CUP 81 GR;1;4500;0;4500;3650;850;
2021-05-17 19:13:09;8998866200837;NOODLE SEDAAPMIE SOTO CUP 81 GR;1;4500;0;4500;3650;850;
2021-05-17 19:13:09;8992959953082;SWEETY BRONZE L8;1;17000;0;17000;15380;1620;
2021-05-17 19:32:29;8992761166212;FRESTEA APPLE 350ML;1;4500;0;4500;3000;1500;
2021-05-17 19:32:29;JGR SHN;JOGER SHINY SACHET;1;500;0;500;437;63;
2021-05-17 19:33:17;8998866200882;SUKSESMIE GORENG AYAM KRMS 133GR;2;3500;0;7000;6094;906;
2021-05-17 19:37:21;8997231980022;O'JELLY MINI STRAWBERRY;1;3000;0;3000;2250;750;
2021-05-17 19:37:21;8992775001653;GERY SALUT CHOCOLATE COCONUT;1;2000;0;2000;1476;524;
2021-05-17 19:37:21;VTM;VITAMIN;5;500;0;2500;2125;375;
2021-05-17 19:37:21;bb;BENG-BENG;1;1500;0;1500;1450;50;
2021-05-17 19:37:21;HT;HOT-HOT;1;500;0;500;350;150;
2021-05-17 20:19:40;089686043617;INDOMIE MIEGHRTTI;3;2700;0;8100;7356;744;
2021-05-17 20:28:19;ARG;ARGUS 220ML;6;14500;0;87000;75000;12000;
2021-05-17 20:42:30;PUDING;VITA PUDDING;1;5000;0;5000;3750;1250;
2021-05-17 20:54:40;8991102303309;WFR TANGO SBJ 176G;1;10000;0;10000;8694;1306;
2021-05-17 21:10:40;089686611519;QTELA SINGKONG;1;5000;0;5000;4266;734;
2021-05-17 21:45:54;8999999502003;SARIMURNI RL RB 1,8G;1;1500;0;1500;1207;293;
2021-05-17 21:45:54;089686011494;INDOMIE SOTO PADANG;1;2600;0;2600;2317;283;
2021-05-17 21:45:54;BAYFLAST;BAYPLAST;2;500;0;1000;700;300;
2021-05-17 21:45:54;TL;TELUR;1;1500;0;1500;1300;200;
2021-05-17 21:52:22;089686011494;INDOMIE SOTO PADANG;1;2600;0;2600;2317;283;
2021-05-17 21:57:37;8998866202732;MILKU STROBERI 200ML;1;3000;0;3000;2375;625;
2021-05-17 21:57:37;8998866202725;MILKU COKLAT PREMIUM 200ML;1;3000;0;3000;2375;625;
2021-05-17 21:57:37;8998866201452;POTABEE REGULER BBQ BEEF 35GR;1;5000;0;5000;4150;850;
2021-05-17 21:57:37;PRG;PARAGO;11;500;0;5500;4400;1100;
2021-05-18 12:25:43;8998866608718;DAIA SOFTENER PINK;1;5000;0;5000;4450;550;
2021-05-18 12:25:43;MOLTO PINK;MOLTO ALL IN ONE 11 ML;2;500;0;1000;800;200;
2021-05-18 12:25:43;MOBIL;GULA GULA HP;1;2000;0;2000;1700;300;
2021-05-18 12:28:53;8991188943536;SASA SANTAN KELAPA 65ML;2;3000;0;6000;4874;1126;
2021-05-18 12:28:53;BTS;BIMURA TARO SEAWEED 250G;1;10000;0;10000;9300;700;
2021-05-18 12:28:53;8992775913000SCT;CHOCOLATOS CKLT DRINK SCT;2;2000;0;4000;3172;828;
2021-05-18 12:28:53;8994834005923;SPIX 1000;1;1000;0;1000;850;150;
2021-05-18 12:28:53;8992761139018;ADES 600ML;1;3500;0;3500;2292;1208;
2021-05-18 12:28:53;8997028590014;ARGUS 220ML;4;500;0;2000;1208;792;
2021-05-18 12:31:53;8998989300261;GUDANG GARAM SURYA 12 FILTER;1;18500;0;18500;17200;1300;
2021-05-18 12:36:40;8993989311699;CLAS MILD 16 FILTER;1;23000;0;23000;21700;1300;
2021-05-18 13:24:45;8999909010567;234 16 FILTER;1;22000;0;22000;21500;500;
2021-05-18 14:06:06;GL;GULA 1 LITER;3;11500;0;34500;31500;3000;
2021-05-18 14:06:06;8993058105013;EXTRA JOSS;1;12000;0;12000;9773;2227;
2021-05-18 14:40:39;089686010107;INDOMIE KALDU AYAM;1;2500;0;2500;2150;350;
2021-05-18 16:36:58;9556001025272;NESCAFE LATTE 240ML;1;8500;0;8500;7834;666;
2021-05-18 16:36:58;8992761166212;FRESTEA APPLE 350ML;1;4500;0;4500;3000;1500;
2021-05-18 16:36:58;VCL;VITAMIN C500 LEMON;1;1000;0;1000;575;425;
2021-05-18 16:36:58;8997009510055;YOU C1000;1;10000;0;10000;9166;834;
2021-05-18 16:36:58;8998898280401;TOLAK ANGIN FLU;3;3500;0;10500;8124;2376;
2021-05-18 16:51:38;8998866202732;MILKU STROBERI 200ML;1;3000;0;3000;2375;625;
2021-05-18 17:20:59;8994935000049;MINYAK GORENG DAMAI 5L;1;75000;0;75000;73780;1220;
2021-05-18 17:31:12;GL;GULA 1 LITER;1;11500;0;11500;10500;1000;
2021-05-18 17:49:17;8996001600375;LE MINERAL 330ML;1;2000;0;2000;1417;583;
2021-05-18 18:21:06;8999909003439;MARLBORO CRAFTED 12;1;8000;0;8000;7250;750;
2021-05-18 19:32:24;8998866501033;MINYAK GORENG SEDAAP POUCH 2L;1;28000;0;28000;27746;254;
2021-05-18 19:59:17;8997231980022;O'JELLY MINI STRAWBERRY;1;3000;0;3000;2250;750;
2021-05-18 19:59:17;8992696521797SCT;MILO UHT ACT GO 22G;2;2000;0;4000;2824;1176;
2021-05-18 19:59:17;8998866202923;FLORIDINA COCO;1;3000;0;3000;2500;500;
2021-05-18 19:59:17;8997231980015;O'JELLY MINI APPLE;1;3000;0;3000;2250;750;
2021-05-18 20:20:47;8999909096004;SAMPOERNA 16 FILTER;1;24000;0;24000;23000;1000;
2021-05-18 20:54:18;8992761139018;ADES 600ML;1;3500;0;3500;2292;1208;
2021-05-18 21:07:03;089686043617;INDOMIE MIEGHRTTI;1;2700;0;2700;2452;248;
2021-05-18 21:07:03;8998866200325;MIE SEDAAP SOTO;1;2500;0;2500;1952;548;
2021-05-18 21:07:03;COKLAT;COKLAT COIN;1;500;0;500;400;100;
2021-05-18 21:31:03;8998866202725;MILKU COKLAT PREMIUM 200ML;1;3000;0;3000;2375;625;
2021-05-18 21:31:03;8998898337440;TOLAK ANGIN CARE 10ML;1;10000;0;10000;7893;2107;
2021-05-18 21:31:03;089686611878;QTELA TEMPE;1;6000;0;6000;5370;630;
2021-05-18 21:31:03;089686611519;QTELA SINGKONG;1;5000;0;5000;4266;734;
2021-05-18 21:31:03;6907992823935;JD SWEETCORN;1;3500;0;3500;3000;500;
2021-05-18 21:31:03;8996001600146;TEH PUCUK HARUM 350ML;1;3000;0;3000;2314;686;
2021-05-18 21:31:03;089686021219;INTER MIE GORENG;3;1000;0;3000;2655;345;
2021-05-18 21:32:33;8992959953044;SWEETY BRONZE XL1;2;2500;0;5000;4500;500;
2021-05-18 21:48:19;089686010824;INDOMIE GORENG SPESIAL;4;2700;0;10800;9808;992;
2021-05-18 21:48:19;089686010343;INDOMIE SOTO MIE;4;2600;0;10400;9468;932;
2021-05-18 21:49:45;8998866202732;MILKU STROBERI 200ML;1;3000;0;3000;2375;625;
2021-05-18 22:29:00;9556001025272;NESCAFE LATTE 240ML;1;8500;0;8500;7834;666;
2021-05-18 22:29:00;8991102384841;WFR TANGO LONG CKLT 130G;1;5000;0;5000;4345;655;
2021-05-18 22:29:00;6907992823935;JD SWEETCORN;1;3500;0;3500;3000;500;
2021-05-19 11:04:24;123124;KOREK BIASA;1;2000;0;2000;1800;200;
2021-05-19 11:29:22;AMPLOP;AMPLOP;4;250;0;1000;560;440;
2021-05-19 11:43:18;8993989311699;CLAS MILD 16 FILTER;1;23000;0;23000;21700;1300;
2021-05-19 11:53:17;8993083929837;BISKITOP BLACK COOKIES;1;27000;0;27000;23700;3300;
2021-05-19 11:53:17;8991102989312;WFR TANGO SBJ 7G;1;8300;0;8300;7455;845;
2021-05-19 12:06:46;8998989300261;GUDANG GARAM SURYA 12 FILTER;1;18500;0;18500;17200;1300;
2021-05-19 12:06:46;8992959953082;SWEETY BRONZE L8;1;17000;0;17000;15380;1620;
2021-05-19 12:17:53;8998989300261;GUDANG GARAM SURYA 12 FILTER;2;18500;0;37000;34400;2600;
2021-05-19 12:36:28;TL;TELUR;3;1500;0;4500;3900;600;
2021-05-19 14:02:50;ff;FULLO BLASTO;1;1000;0;1000;995;5;
2021-05-19 14:02:50;ABC SPW;BATERAI ABC SPW;1;4500;0;4500;3893;607;
2021-05-19 14:02:50;8992775002735;CHOCOLATOS SUSU COKELAT;1;4000;0;4000;3520;480;
2021-05-19 14:02:50;8992946512223;SHINZUI;1;4000;0;4000;2500;1500;
2021-05-19 14:02:50;TUSTEL;TUSUK TELINGA;1;1000;0;1000;833;167;
2021-05-19 14:10:22;8992761166212;FRESTEA APPLE 350ML;1;4500;0;4500;3000;1500;
2021-05-19 14:10:22;8998009020186;BUAVITA GUAVA 250ML;1;7000;0;7000;6083;917;
2021-05-19 14:10:22;8998989500128;GUDANG GARAM MERAH KECIL 12KS;1;14000;0;14000;13000;1000;
2021-05-19 14:10:22;8999999390198;SUNLIGHT LIME NEW POUCH 755ML;1;17000;0;17000;15400;1600;
2021-05-19 14:10:22;001;PASEO SMART FACIAL SF 250S GT;1;10000;0;10000;9500;500;
2021-05-19 14:10:22;8998866609036;DAIA BUNGA GUSSET 565G;1;10000;0;10000;8700;1300;
2021-05-19 14:10:22;8999801700030;SUSU FOYU;1;11500;0;11500;10450;1050;
2021-05-19 14:10:22;9311931024036;COFFEEMIX SCT;1;1500;0;1500;1200;300;
2021-05-19 14:22:39;8992761136185;FANTA 1L;4;10000;0;40000;36000;4000;
2021-05-19 14:22:39;8992761136161;COCACOLA 1L;1;10000;0;10000;9000;1000;
2021-05-19 14:24:48;8999909010567;234 16 FILTER;2;22000;0;44000;43000;1000;
2021-05-19 14:44:17;8999999516208;ROYCO FDS CHICKEN NEW 230G;1;10000;0;10000;9000;1000;
2021-05-19 14:44:17;8997009510055;YOU C1000;1;10000;0;10000;9166;834;
2021-05-19 14:44:17;BK;BUMBU KACANG;1;5000;0;5000;5000;0;
2021-05-19 14:44:17;GL;GULA 1 LITER;1;11500;0;11500;10500;1000;
2021-05-19 14:44:17;8999999524722;SUNLIGHT LIME NEW PCH 435ML;1;10000;0;10000;9100;900;
2021-05-19 14:44:17;8998866803694;SOKLIN SOFTERGENT PURPLE BAG 770 & PIRING;1;18000;0;18000;16680;1320;
2021-05-19 14:44:17;001;PASEO SMART FACIAL SF 250S GT;1;10000;0;10000;9500;500;
2021-05-19 14:44:17;8993053641042;PASEO BABY WIPES GAZETTE 50S;1;17000;0;17000;15400;1600;
2021-05-19 14:44:17;8995333032113;TERIGU GATOT KACA 1 KG;1;8500;0;8500;8012;488;
2021-05-19 14:44:17;8998866200561;EKOMIE SUPER 600GR;1;10000;0;10000;8615;1385;
2021-05-19 14:44:17;8998866202664;POTABEE WAGYU BEEF STEAK 68 GR;1;8000;0;8000;7200;800;
2021-05-19 14:44:17;8998866201827;JAVANA GULA BATU 350ML;1;3000;0;3000;2150;850;
2021-05-19 17:00:22;6907992823591;JD STRAW MILKSHAKE;1;5000;0;5000;4300;700;
2021-05-19 17:00:22;6907992823652;JD CHOCOLATE MILKSHAKE;1;6000;0;6000;5200;800;
2021-05-19 18:05:56;8999909096004;SAMPOERNA 16 FILTER;1;24000;0;24000;23000;1000;
2021-05-19 18:08:32;8992696430860;KOKO KRUNCH 80G;1;9000;0;9000;8063;937;
2021-05-19 18:08:32;8992957220025;GOLDEN CITY MINI;1;3000;0;3000;2500;500;
2021-05-19 18:08:32;8991102281416;PERMEN MINTZ PPMINT;1;4500;0;4500;4000;500;
2021-05-19 18:08:32;8992761002039;FANTA STRAWBERRY PET 390 ML;1;5500;0;5500;4300;1200;
2021-05-19 19:31:10;8992725910400;LISTERINE COOLMINT 100ML;1;7500;0;7500;6800;700;
2021-05-19 19:31:10;8998866108119;POSH HIJAB PURPLE WISH 150ML;1;19500;0;19500;17500;2000;
2021-05-19 19:31:10;8992761166038;MMP ORANGE 300ML;1;5000;0;5000;3750;1250;
2021-05-19 19:31:10;8992761002022;SPRITE PET 390ML;1;5500;0;5500;4300;1200;
2021-05-19 19:32:05;8998866108119;POSH HIJAB PURPLE WISH 150ML;1;19500;0;19500;17500;2000;
2021-05-19 19:32:05;8992725910400;LISTERINE COOLMINT 100ML;1;7500;0;7500;6800;700;
2021-05-19 19:32:27;8998866202930;SEDAAP AYAM JERIT CUP;2;4500;0;9000;7476;1524;
2021-05-19 19:32:27;8992957220087;COKLAT SINGA;1;2000;0;2000;1700;300;
2021-05-19 19:40:58;8993989311699;CLAS MILD 16 FILTER;1;23000;0;23000;21700;1300;
2021-05-19 20:19:08;8997231980015;O'JELLY MINI APPLE;1;3000;0;3000;2250;750;
2021-05-19 20:19:08;TL;TELUR;3;1500;0;4500;3900;600;
2021-05-19 20:19:08;089686010107;INDOMIE KALDU AYAM;1;2500;0;2500;2150;350;
2021-05-19 20:24:53;8992959508312;SWEETY SILVER PANTS XL RTG;1;15500;0;15500;13944;1556;
2021-05-19 20:30:05;8997009510055;YOU C1000;1;10000;0;10000;9166;834;
2021-05-19 20:30:05;8992696404441;BEAR BRAND 189ML;1;9000;0;9000;7887;1113;
2021-05-19 20:34:28;8997231980022;O'JELLY MINI STRAWBERRY;1;3000;0;3000;2250;750;
2021-05-19 20:49:34;8992761002039;FANTA STRAWBERRY PET 390 ML;1;5500;0;5500;4300;1200;
2021-05-19 20:49:34;bb;BENG-BENG;3;1500;0;4500;4350;150;
2021-05-19 20:49:34;8996001318911;BETTER ISI 4;1;2000;0;2000;1700;300;
2021-05-19 21:36:11;8991102281416;PERMEN MINTZ PPMINT;1;4500;0;4500;4000;500;
2021-05-19 21:36:11;8996001600269;LE MINERAL 600ML;1;3000;0;3000;1688;1312;
2021-05-19 21:36:11;8992761166229;FRESTEA MARKISA 350ML;1;4500;0;4500;3000;1500;
2021-05-19 21:48:55;8998866200561;EKOMIE SUPER 600GR;1;10000;0;10000;8615;1385;
2021-05-19 22:02:22;6907992823669;JD MILKY STRAW;1;3000;0;3000;2600;400;
2021-05-19 22:27:56;8998866202664;POTABEE WAGYU BEEF STEAK 68 GR;1;8000;0;8000;7200;800;
2021-05-19 22:27:56;8886013257400;TWISTKO;2;1000;0;2000;1800;200;
2021-05-19 22:30:22;8998989300261;GUDANG GARAM SURYA 12 FILTER;1;18500;0;18500;17200;1300;
2021-05-19 22:30:22;8998866200882;SUKSESMIE GORENG AYAM KRMS 133GR;1;3500;0;3500;3047;453;
2021-05-20 12:52:34;9556001004673;MILO NESTLE MALAYSIA ACTIVE GO;1;85000;0;85000;80000;5000;
2021-05-20 12:53:02;8998898337440;TOLAK ANGIN CARE 10ML;2;10000;0;20000;15786;4214;
2021-05-20 13:51:25;8999999042646;RINSO MOLTO ROSE FRESH LIQ 40ML;1;6000;0;6000;4817;1183;
2021-05-20 13:51:25;8998866611718;EKONOMI PENCUCI PIRING  LIQ 780ML;1;12000;0;12000;10900;1100;
2021-05-20 13:51:25;8992388133017;NU MILK TEA ORI 330ML;1;6000;0;6000;5125;875;
2021-05-20 13:52:18;8991001502933;CHACHA TUBE;2;7500;0;15000;12800;2200;
2021-05-20 13:55:39;8991001005694;SELAMAT 20X15G;1;18000;0;18000;16000;2000;
2021-05-20 13:55:39;8992959953334;SWEETY BRONZE XL42;1;80000;0;80000;75455;4545;
2021-05-20 14:50:42;8998866202671;NOODLE SEDAAP MIE KOREAN SPICY SOUP CUP;2;5000;0;10000;8004;1996;
2021-05-20 14:50:42;8992761166212;FRESTEA APPLE 350ML;2;4500;0;9000;6000;3000;
2021-05-20 14:50:42;8991001502933;CHACHA TUBE;1;7500;0;7500;6400;1100;
2021-05-20 14:50:42;123124;KOREK BIASA;1;2000;0;2000;1800;200;
2021-05-20 16:16:11;8996001600269;LE MINERAL 600ML;1;3000;0;3000;1688;1312;
2021-05-20 16:18:46;GL;GULA 1 LITER;1;11500;0;11500;10500;1000;
2021-05-20 16:18:46;8991004011906;KOPI BORONG;1;10000;0;10000;8333;1667;
2021-05-20 16:18:46;8998989500128;GUDANG GARAM MERAH KECIL 12KS;2;14000;0;28000;26000;2000;
2021-05-20 17:07:18;8992959850046;CONFI PANTS M10;1;80000;0;80000;75120;4880;
2021-05-20 17:07:18;8993176110081;MINYAK KAYU PUTIH 30ML;1;12000;0;12000;9091;2909;
2021-05-20 17:07:18;001;PASEO SMART FACIAL SF 250S GT;1;10000;0;10000;9500;500;
2021-05-20 17:48:48;8992761122430;FRESTEA GREEN HONEY 500ML;1;6500;0;6500;4708;1792;
2021-05-20 17:48:48;8998866500135;HERSPROTEX SOFTCARE WINGS;1;5500;0;5500;4820;680;
2021-05-20 17:48:48;8991001780140;TWISTER CHOCO;1;5000;0;5000;4600;400;
2021-05-20 17:48:48;8991001503107;CHACHA PEANUT 35GR;1;5500;0;5500;4900;600;
2021-05-20 17:48:48;8991001780126;SELAMAT CKLAT 60G;1;5000;0;5000;4300;700;
2021-05-20 17:48:48;8992761111533;SPRITE SLIM CAM250ML;1;5000;0;5000;3750;1250;
2021-05-20 17:48:48;8992775001653;GERY SALUT CHOCOLATE COCONUT;2;2000;0;4000;2952;1048;
2021-05-20 17:52:20;8997009510055;YOU C1000;1;10000;0;10000;9166;834;
2021-05-20 18:17:47;8998009010590;ULTRA CHO 125;1;3000;0;3000;2428;572;
2021-05-20 18:17:47;8998009010569;ULTRA CHO 200;1;5000;0;5000;3830;1170;
2021-05-20 18:26:39;089686010107;INDOMIE KALDU AYAM;2;2500;0;5000;4300;700;
2021-05-20 18:39:46;TG APEL;TEH GELAS APEL;1;2000;0;2000;1178;822;
2021-05-20 18:39:46;8999999502003;SARIMURNI RL RB 1,8G;1;1500;0;1500;1207;293;
2021-05-20 18:39:46;6907992825069;JD FRUITY;1;5000;0;5000;4400;600;
2021-05-20 18:39:46;8991001503107;CHACHA PEANUT 35GR;1;5500;0;5500;4900;600;
2021-05-20 18:39:46;8992761002039;FANTA STRAWBERRY PET 390 ML;1;5500;0;5500;4300;1200;
2021-05-20 18:39:46;8991001502933;CHACHA TUBE;1;7500;0;7500;6400;1100;
2021-05-20 18:39:46;8996001600146;TEH PUCUK HARUM 350ML;1;3000;0;3000;2314;686;
2021-05-20 18:39:46;089686044249;SUPERMI NUTRIMI STEAK AYAM;1;3500;0;3500;2800;700;
2021-05-20 18:50:09;8998009010590;ULTRA CHO 125;1;3000;0;3000;2428;572;
2021-05-20 18:50:09;8998009010569;ULTRA CHO 200;1;5000;0;5000;3830;1170;
2021-05-20 18:50:09;8992761164539;NUTRIBOOST ORANGE 300ML;1;6500;0;6500;5300;1200;
2021-05-20 18:50:09;8991102387286SCT;TANGO LONG CKLT 47G;4;2000;0;8000;6204;1796;
2021-05-20 18:50:09;8991102714631;TANGO TETRA CKLT;1;5000;0;5000;4545;455;
2021-05-20 18:52:53;8998989300261;GUDANG GARAM SURYA 12 FILTER;1;18500;0;18500;17200;1300;
2021-05-20 20:26:31;8994935000285;MINYAK GORENG DUNIA 4500ML;1;70000;0;70000;66433;3567;
2021-05-20 20:26:31;711844610095;LARISSA UDANG 500 GR;2;11000;0;22000;19580;2420;
2021-05-20 20:39:42;8999999390198;SUNLIGHT LIME NEW POUCH 755ML;1;17000;0;17000;15400;1600;
2021-05-20 20:40:46;8994867007161;ROKOK PENA GOLD 20;1;17000;0;17000;15000;2000;
2021-05-20 20:40:46;HT;HOT-HOT;1;500;0;500;350;150;
2021-05-20 21:03:53;8992959850053;CONFIDENCE ADULT PANTS L10;1;100000;0;100000;92960;7040;
2021-05-20 21:03:53;KJ;KINDER JOY;1;2000;0;2000;1583;417;
2021-05-20 21:09:26;8992959953044;SWEETY BRONZE XL1;2;2500;0;5000;4500;500;
2021-05-20 21:14:28;bb;BENG-BENG;4;1500;0;6000;5800;200;
2021-05-20 22:10:25;8994834005923;SPIX 1000;1;1000;0;1000;850;150;
2021-05-20 22:10:25;8998866202923;FLORIDINA COCO;1;3000;0;3000;2500;500;
2021-05-20 22:12:13;8992775110157;GARUDA KACANG KULIT;1;5000;0;5000;3925;1075;
2021-05-20 22:12:13;8992761139018;ADES 600ML;1;3500;0;3500;2292;1208;
2021-05-20 22:12:13;TG APEL;TEH GELAS APEL;1;2000;0;2000;1178;822;
2021-05-20 22:12:13;8999908389008;HEMAVITON C1000;1;8000;0;8000;6000;2000;
2021-05-20 22:12:13;8992761164539;NUTRIBOOST ORANGE 300ML;1;6500;0;6500;5300;1200;
2021-05-20 22:12:13;8997025915124;HATARI PEANUT 125G;1;7000;0;7000;6037;963;
2021-05-20 22:12:13;6291100212866;KURMA KHALAS;1;85000;0;85000;80000;5000;
2021-05-20 22:12:13;8996001600375;LE MINERAL 330ML;1;2000;0;2000;1417;583;
2021-05-20 22:12:13;8996001600269;LE MINERAL 600ML;1;3000;0;3000;1688;1312;
2021-05-20 22:12:13;8996001600399;LE MINERAL 1500ML;1;5000;0;5000;4042;958;
2021-05-20 22:18:52;TL;TELUR;16;1500;0;24000;20800;3200;
2021-05-20 22:29:27;8997231980022;O'JELLY MINI STRAWBERRY;1;3000;0;3000;2250;750;
2021-05-21 11:53:16;8991102230308;BLASTER PINK;1;5000;0;5000;3106;1894;
2021-05-21 11:53:16;8991102213189;BLASTER UNGU;1;5000;0;5000;3106;1894;
2021-05-21 12:11:21;089686611519;QTELA SINGKONG;1;5000;0;5000;4266;734;
2021-05-21 12:11:21;8999999502409;ROYCO FDS BEEF 9G;2;500;0;1000;750;250;
2021-05-21 12:11:21;8991188943536;SASA SANTAN KELAPA 65ML;2;3000;0;6000;4874;1126;
2021-05-21 12:19:11;8992761111533;SPRITE SLIM CAM250ML;1;5000;0;5000;3750;1250;
2021-05-21 12:23:38;8998866202671;NOODLE SEDAAP MIE KOREAN SPICY SOUP CUP;1;5000;0;5000;4002;998;
2021-05-21 13:11:18;8998009010590;ULTRA CHO 125;1;3000;0;3000;2428;572;
2021-05-21 13:11:18;HT;HOT-HOT;2;500;0;1000;700;300;
2021-05-21 13:11:18;COKLAT;COKLAT COIN;2;500;0;1000;800;200;
2021-05-21 13:24:44;8999999526856;MOLTO ALL IN ONE BLUE 11ML;2;5500;0;11000;9600;1400;
2021-05-21 14:19:44;GL;GULA 1 LITER;1;11500;0;11500;10500;1000;
2021-05-21 14:43:56;8886057883665;KRATING DAENG;1;6000;0;6000;4286;1714;
2021-05-21 14:43:56;8992761164546;NUTRIBOOST STRAWBERRY 300ML;1;6500;0;6500;5300;1200;
2021-05-21 14:43:56;8992761002022;SPRITE PET 390ML;1;5500;0;5500;4300;1200;
2021-05-21 14:51:07;8994867000179;ROKOK PENA MILD 16;1;14500;0;14500;13000;1500;
2021-05-21 14:51:07;123124;KOREK BIASA;1;2000;0;2000;1800;200;
2021-05-21 14:51:07;8992775110157;GARUDA KACANG KULIT;1;5000;0;5000;3925;1075;
2021-05-21 14:57:04;8999999042646;RINSO MOLTO ROSE FRESH LIQ 40ML;1;6000;0;6000;4817;1183;
2021-05-21 15:30:51;8999999059781;SUNLIGHT LIME NEW POUCH 210ML;1;5000;0;5000;4300;700;
2021-05-21 16:04:13;8996001355985;BENG-BENG SHARE IT;1;27000;0;27000;25000;2000;
2021-05-21 16:34:13;8998989300261;GUDANG GARAM SURYA 12 FILTER;1;18500;0;18500;17200;1300;
2021-05-21 17:15:53;089686043051;INDOMIE COTO MAKASSAR;2;2800;0;5600;5050;550;
2021-05-21 17:15:53;8991004011906;KOPI BORONG;1;10000;0;10000;8333;1667;
2021-05-21 17:15:53;089686010107;INDOMIE KALDU AYAM;2;2500;0;5000;4300;700;
2021-05-21 17:15:53;8999999502393;ROYCO FDS CHICKEN 8G;1;5000;0;5000;4500;500;
2021-05-21 17:15:53;GL;GULA 1 LITER;2;11500;0;23000;21000;2000;
2021-05-21 17:15:53;8998866501033;MINYAK GORENG SEDAAP POUCH 2L;1;28000;0;28000;27746;254;
2021-05-21 17:16:49;TK;TEPUNG KETAN;1;13000;0;13000;13000;0;
2021-05-21 17:23:09;8998866605106;CLING BIRU BTL 440ML;1;8500;0;8500;7600;900;
2021-05-21 17:24:12;8992761122430;FRESTEA GREEN HONEY 500ML;1;6500;0;6500;4708;1792;
2021-05-21 17:24:12;8992761166052;FRESTEA MELATI 350ML;1;4500;0;4500;3000;1500;
2021-05-21 17:27:04;8992761145019;COCA COLA PET 250ML;1;3500;0;3500;2417;1083;
2021-05-21 17:28:30;8992933214116;NUTRIJELL MELON;2;6000;0;12000;10082;1918;
2021-05-21 17:28:30;8990800020013;MENTOS MINT HALAL IND;1;5700;0;5700;5150;550;
2021-05-21 17:28:30;8999801700030;SUSU FOYU;1;11500;0;11500;10450;1050;
2021-05-21 17:44:33;8992959954058;SWEETY BRONZE NB 44;1;48000;0;48000;45682;2318;
2021-05-21 17:55:52;8992761164539;NUTRIBOOST ORANGE 300ML;1;6500;0;6500;5300;1200;
2021-05-21 17:55:52;8998866200882;SUKSESMIE GORENG AYAM KRMS 133GR;1;3500;0;3500;3047;453;
2021-05-21 18:31:11;8993470411433;JOGER CLASSIC;1;1000;0;1000;850;150;
2021-05-21 18:31:11;089686043273;INDOMIE SAMBAL RICA;1;2700;0;2700;2452;248;
2021-05-21 18:35:39;COKLAT;COKLAT COIN;3;500;0;1500;1200;300;
2021-05-21 18:35:39;bb;BENG-BENG;1;1500;0;1500;1450;50;
2021-05-21 18:35:39;8994834003752;TICTIC;1;2000;0;2000;1700;300;
2021-05-21 18:36:01;COKLAT;COKLAT COIN;2;500;0;1000;800;200;
2021-05-21 18:36:01;8993470411433;JOGER CLASSIC;1;1000;0;1000;850;150;
2021-05-21 18:45:22;8999999537180;CLEAR SHP LEMON FRESH 9 ML;1;10500;0;10500;9300;1200;
2021-05-21 18:45:22;8999999571887;MOLTO EDP PURPLE 10ML;1;5000;0;5000;4800;200;
2021-05-21 18:45:22;8999999390198;SUNLIGHT LIME NEW POUCH 755ML;1;17000;0;17000;15400;1600;
2021-05-21 18:57:17;8994834003752;TICTIC;1;2000;0;2000;1700;300;
2021-05-21 18:57:17;8992957220087;COKLAT SINGA;1;2000;0;2000;1700;300;
2021-05-21 19:02:03;8886013257400;TWISTKO;2;1000;0;2000;1800;200;
2021-05-21 20:01:28;8997231980022;O'JELLY MINI STRAWBERRY;1;3000;0;3000;2250;750;
2021-05-21 20:01:28;COKLAT;COKLAT COIN;2;500;0;1000;800;200;
2021-05-21 20:01:28;6907992823829;JD MILKY MILK;1;3000;0;3000;2600;400;
2021-05-21 20:01:28;8993470671752;JOGER STICK DUO KACANG;1;1000;0;1000;850;150;
2021-05-21 20:40:13;8998866603683;FRES&NATURAL SOAP MERAH 65G;1;1800;0;1800;1425;375;
2021-05-21 20:42:53;8997231980022;O'JELLY MINI STRAWBERRY;1;3000;0;3000;2250;750;
2021-05-21 20:42:53;kp;KALPA;1;2000;0;2000;1666;334;
2021-05-21 20:42:53;bb;BENG-BENG;1;1500;0;1500;1450;50;
2021-05-21 20:42:53;JGR SHN;JOGER SHINY SACHET;1;500;0;500;437;63;
2021-05-21 21:14:09;8994867007161;ROKOK PENA GOLD 20;1;17000;0;17000;15000;2000;
2021-05-21 21:37:50;8992761002039;FANTA STRAWBERRY PET 390 ML;1;5500;0;5500;4300;1200;
2021-05-21 21:45:38;8992761136161;COCACOLA 1L;2;10000;0;20000;18000;2000;
2021-05-21 22:29:42;8996001600146;TEH PUCUK HARUM 350ML;1;3000;0;3000;2314;686;
2021-05-21 22:29:42;8997218380135;ICHITAN GREEN TEA;1;8000;0;8000;6583;1417;
2021-05-21 22:29:42;8999908204202;MY BABY MINYAK TELON 60ML;1;18000;0;18000;16900;1100;
2021-05-21 22:29:42;8998989300261;GUDANG GARAM SURYA 12 FILTER;1;18500;0;18500;17200;1300;
2021-05-22 12:14:39;8991001502933;CHACHA TUBE;3;7500;0;22500;19200;3300;
2021-05-22 13:06:18;8999999059316;LIFEBUOY TS MILDCARE 75G;2;3000;0;6000;5280;720;
2021-05-22 13:06:18;8993379210854;SABUN HARMONY APPLE 70G;1;2000;0;2000;1652;348;
2021-05-22 13:51:38;8999999027049;LIFEBUOY PRWTN RMBT RNTK 9ML;1;5000;0;5000;4500;500;
2021-05-22 16:22:43;8998866609487;SOKLIN SOFTERGEN 280G;1;5000;0;5000;4425;575;
2021-05-22 16:22:53;8992761166038;MMP ORANGE 300ML;1;5000;0;5000;3750;1250;
2021-05-22 16:28:49;8993083140058;BISKITOP COCONUT;1;27000;0;27000;25200;1800;
2021-05-22 18:03:28;8998866610377;ISOPLUS;1;3000;0;3000;2350;650;
2021-05-22 18:05:04;MOBIL;GULA GULA HP;1;2000;0;2000;1700;300;
2021-05-22 18:05:04;8991001502933;CHACHA TUBE;1;7500;0;7500;6400;1100;
2021-05-22 18:05:04;8991001111883;SILVERQUEEN CHUNKYBAR 33G;1;8000;0;8000;7150;850;
2021-05-22 18:44:57;8998989300261;GUDANG GARAM SURYA 12 FILTER;1;18500;0;18500;17200;1300;
2021-05-22 18:44:57;8999999195656;SARI WANGI 50X1.85;1;10000;0;10000;9500;500;
2021-05-22 18:59:43;8998989300261;GUDANG GARAM SURYA 12 FILTER;1;18500;0;18500;17200;1300;
2021-05-22 18:59:43;8998009010569;ULTRA CHO 200;1;5000;0;5000;3830;1170;
2021-05-22 18:59:43;8998009040023;TEH KOTAK;1;5000;0;5000;2827;2173;
2021-05-22 19:02:31;COKLAT;COKLAT COIN;6;500;0;3000;2400;600;
2021-05-22 19:12:08;11222;LEM KOREA;1;10000;0;10000;8000;2000;
2021-05-22 19:31:20;8992761002039;FANTA STRAWBERRY PET 390 ML;1;5500;0;5500;4300;1200;
2021-05-22 19:31:20;8992959953044;SWEETY BRONZE XL1;2;2500;0;5000;4500;500;
2021-05-22 19:57:59;6907992823652;JD CHOCOLATE MILKSHAKE;1;6000;0;6000;5200;800;
2021-05-22 19:57:59;8998866201483;POTABEE REGULER GRILLED SEAWEED 35GR;1;5000;0;5000;4150;850;
2021-05-22 19:57:59;8997231980022;O'JELLY MINI STRAWBERRY;1;3000;0;3000;2250;750;
2021-05-22 20:03:49;8997231980022;O'JELLY MINI STRAWBERRY;1;3000;0;3000;2250;750;
2021-05-22 20:03:49;8993470671752;JOGER STICK DUO KACANG;1;1000;0;1000;850;150;
2021-05-22 20:03:49;bb;BENG-BENG;1;1500;0;1500;1450;50;
2021-05-22 20:03:49;COKLAT;COKLAT COIN;6;500;0;3000;2400;600;
2021-05-22 20:03:49;6907992823829;JD MILKY MILK;1;3000;0;3000;2600;400;
2021-05-22 20:03:49;JGR SHN;JOGER SHINY SACHET;1;500;0;500;437;63;
2021-05-22 20:13:13;8992933215113;NUTRIJELL TANPA RASA;1;6000;0;6000;4950;1050;
2021-05-22 20:13:13;8992933213119;NUTRIJELL LECI;1;6000;0;6000;5041;959;
2021-05-22 20:13:13;GL;GULA 1 LITER;2;11500;0;23000;21000;2000;
2021-05-22 20:13:13;8999999059781;SUNLIGHT LIME NEW POUCH 210ML;1;5000;0;5000;4300;700;
2021-05-22 20:13:13;8991004011906;KOPI BORONG;1;10000;0;10000;8333;1667;
2021-05-22 20:13:13;8993470671752;JOGER STICK DUO KACANG;1;1000;0;1000;850;150;
2021-05-22 20:13:13;8998989500128;GUDANG GARAM MERAH KECIL 12KS;2;14000;0;28000;26000;2000;
2021-05-22 20:13:13;8998866610261;DAIA VIOLET GUSSET BAG 290 GR;1;5000;0;5000;4450;550;
2021-05-22 20:13:13;8991102281430;PERMEN MINTZ DUOMINT;1;4500;0;4500;4000;500;
2021-05-22 20:13:13;8990800020013;MENTOS MINT HALAL IND;1;5700;0;5700;5150;550;
2021-05-22 20:13:13;8998866610438;SOKLIN SOFTERGENT RED BAG 770G & PIRING;1;18000;0;18000;16680;1320;
2021-05-22 20:13:13;089686017748;SARIMIE GORENG ISI 2;2;3500;0;7000;6240;760;
2021-05-22 20:13:13;8997231980022;O'JELLY MINI STRAWBERRY;2;3000;0;6000;4500;1500;
2021-05-22 20:13:13;089686043051;INDOMIE COTO MAKASSAR;2;2800;0;5600;5050;550;
2021-05-22 20:13:13;089686044249;SUPERMI NUTRIMI STEAK AYAM;2;3500;0;7000;5600;1400;
2021-05-22 20:13:13;8999999502003;SARIMURNI RL RB 1,8G;1;1500;0;1500;1207;293;
2021-05-22 20:13:13;8992775002735;CHOCOLATOS SUSU COKELAT;1;4000;0;4000;3520;480;
2021-05-22 20:13:13;8998866202725;MILKU COKLAT PREMIUM 200ML;1;3000;0;3000;2375;625;
2021-05-22 20:13:13;8998866202732;MILKU STROBERI 200ML;1;3000;0;3000;2375;625;
2021-05-22 20:13:13;8992761166212;FRESTEA APPLE 350ML;1;4500;0;4500;3000;1500;
2021-05-22 20:13:13;8994834003752;TICTIC;1;2000;0;2000;1700;300;
2021-05-22 20:13:13;8993365121539;MADU TJ SUPER 150G;1;16800;0;16800;15220;1580;
2021-05-22 20:36:07;8992959508992;SWEETY SILVER PANTS L 28;1;56800;0;56800;51819;4981;
2021-05-22 20:36:07;8998866200646;KOPI TOP MURNI;1;11000;0;11000;9600;1400;
2021-05-22 21:02:01;8998866202732;MILKU STROBERI 200ML;1;3000;0;3000;2375;625;
2021-05-22 21:13:01;BB;PASEO SMARTY FACIAL TRAVEL PACK 50S GT;1;3000;0;3000;1980;1020;
2021-05-22 22:07:05;8998866202244;EKOMIE BUMBU KALDU AYAM;5;1000;0;5000;3990;1010;
2021-05-22 22:07:05;089686021219;INTER MIE GORENG;1;1000;0;1000;885;115;
2021-05-22 22:12:59;8999909096004;SAMPOERNA 16 FILTER;1;24000;0;24000;23000;1000;
2021-05-22 22:13:19;GL;GULA 1 LITER;1;11500;0;11500;10500;1000;
2021-05-22 22:21:10;COKLAT;COKLAT COIN;10;500;0;5000;4000;1000;
2021-05-22 22:23:40;6907992823867;JD CRUNCHY CHOCOLATE MALT;1;5500;0;5500;4700;800;
2021-05-22 22:29:09;8992761136161;COCACOLA 1L;1;10000;0;10000;9000;1000;
2021-05-22 22:29:09;8992761136178;SPRITE 1L;1;10000;0;10000;9000;1000;
2021-05-22 22:40:45;089686011036;INDOMIE GORENG PEDAS;1;2700;0;2700;2452;248;
2021-05-22 22:49:26;8993379200855;SABUN HARMONY STRAWBERRY 70G;2;2000;0;4000;3304;696;
2021-05-22 22:49:26;8993379152017;SABUN CUCI SURYA 200G;1;3000;0;3000;2281;719;
2021-05-22 22:49:26;8999999035532;VASELINE NIGHT REPAIR 200ML;1;33800;0;33800;30855;2945;
2021-05-22 22:49:26;8991001111883;SILVERQUEEN CHUNKYBAR 33G;1;8000;0;8000;7150;850;
2021-05-22 22:49:26;8996001600146;TEH PUCUK HARUM 350ML;1;3000;0;3000;2314;686;
2021-05-22 22:49:26;8992761139018;ADES 600ML;1;3500;0;3500;2292;1208;
2021-05-22 22:49:26;8998009020186;BUAVITA GUAVA 250ML;1;7000;0;7000;6083;917;
2021-05-22 22:49:26;8992775110157;GARUDA KACANG KULIT;1;5000;0;5000;3925;1075;
2021-05-23 11:54:40;8996001600269;LE MINERAL 600ML;1;3000;0;3000;1688;1312;
2021-05-23 14:09:29;6907992823843;JD MOCHA CRISPY;1;5000;0;5000;4400;600;
2021-05-23 14:09:29;6907992823867;JD CRUNCHY CHOCOLATE MALT;1;5500;0;5500;4700;800;
2021-05-23 14:10:49;8991111101316;JB OIL 50ML;1;9500;0;9500;8700;800;
2021-05-23 14:38:02;6907992823850;JD CHOCO CIRLE;1;5500;0;5500;4700;800;
2021-05-23 14:38:02;6907992823591;JD STRAW MILKSHAKE;1;5000;0;5000;4300;700;
2021-05-23 14:38:35;8992761145019;COCA COLA PET 250ML;1;3500;0;3500;2417;1083;
2021-05-23 14:38:35;8992761164546;NUTRIBOOST STRAWBERRY 300ML;1;6500;0;6500;5300;1200;
2021-05-23 14:40:38;8886020033431;KAPUR AJAIB ANTI KECOA DAN NYAMUK;1;3000;0;3000;2700;300;
2021-05-23 15:15:24;6907992823669;JD MILKY STRAW;1;3000;0;3000;2600;400;
2021-05-23 15:15:24;6907992824963;JD MILKY CHOCOLATE;1;3000;0;3000;2600;400;
2021-05-23 15:15:24;COKLAT;COKLAT COIN;2;500;0;1000;800;200;
2021-05-23 15:58:43;8992761164539;NUTRIBOOST ORANGE 300ML;1;6500;0;6500;5300;1200;
2021-05-23 15:58:43;8992761002022;SPRITE PET 390ML;1;5500;0;5500;4300;1200;
2021-05-23 15:58:43;8992761166205;FRESTEA GREEN HONEY 350ML;1;4500;0;4500;3000;1500;
2021-05-23 16:03:36;8992761139018;ADES 600ML;1;3500;0;3500;2292;1208;
2021-05-23 16:03:36;8886013257400;TWISTKO;1;1000;0;1000;900;100;
2021-05-23 16:03:36;YP;YUPI;2;250;0;500;416;84;
2021-05-23 18:39:25;089686044249;SUPERMI NUTRIMI STEAK AYAM;1;3500;0;3500;2800;700;
2021-05-23 18:41:57;8992696419742;NESCAFE COFFE CREAM;1;5000;0;5000;4099;901;
2021-05-23 19:22:09;8992959953044;SWEETY BRONZE XL1;2;2500;0;5000;4500;500;
2021-05-23 19:24:03;089686044249;SUPERMI NUTRIMI STEAK AYAM;1;3500;0;3500;2800;700;
2021-05-23 19:24:03;8999999016128;RINSO MOLTO ROSE FRESH 750ML;1;15000;0;15000;12507;2493;
2021-05-23 19:24:03;8993560026011;DETTOL FRESH;1;20000;0;20000;18524;1476;
2021-05-23 19:24:03;8999999059781;SUNLIGHT LIME NEW POUCH 210ML;1;5000;0;5000;4300;700;
2021-05-23 19:24:03;8999999557447;PEPSODENT ACTION123 SIWAK 110G;1;9000;0;9000;8000;1000;
2021-05-23 19:24:03;8998866106351;ZINC MEN ACTIVE COOL 70ML;1;8500;0;8500;7550;950;
2021-05-23 19:24:03;8999999519735;PEPSODENT TB BAMBOO SALT;1;13200;0;13200;11990;1210;
2021-05-23 19:24:03;8992946512223;SHINZUI;1;4000;0;4000;2500;1500;
2021-05-23 19:24:03;8992222054973;GATSBY STYLING POMADE 30GR;1;15000;0;15000;13000;2000;
2021-05-23 20:02:26;8994834006128;TICTIC PEDAS;1;2000;0;2000;1700;300;
2021-05-23 20:02:26;8997231980022;O'JELLY MINI STRAWBERRY;1;3000;0;3000;2250;750;
2021-05-23 20:02:26;PRG;PARAGO;2;500;0;1000;800;200;
2021-05-23 20:02:26;8993470411433;JOGER CLASSIC;1;1000;0;1000;850;150;
2021-05-23 20:02:26;YP;YUPI;2;250;0;500;416;84;
2021-05-23 20:02:26;JGR SHN;JOGER SHINY SACHET;1;500;0;500;437;63;
2021-05-23 20:02:26;HT;HOT-HOT;1;500;0;500;350;150;
2021-05-23 20:02:26;COKLAT;COKLAT COIN;1;500;0;500;400;100;
2021-05-23 21:05:18;8991102381024;FULLO VNL PCK;1;10000;0;10000;9000;1000;
2021-05-23 21:06:13;8992696404441;BEAR BRAND 189ML;2;9000;0;18000;15774;2226;
2021-05-23 21:12:51;089686043051;INDOMIE COTO MAKASSAR;1;2800;0;2800;2525;275;
2021-05-23 21:12:51;089686043273;INDOMIE SAMBAL RICA;1;2700;0;2700;2452;248;
2021-05-23 21:12:51;8998989300261;GUDANG GARAM SURYA 12 FILTER;1;18500;0;18500;17200;1300;
2021-05-23 21:12:51;8993176110081;MINYAK KAYU PUTIH 30ML;1;12000;0;12000;9091;2909;
2021-05-23 21:36:05;711844150027;ABC NANAS;1;13000;0;13000;12241;759;
2021-05-23 21:40:37;8996001600375;LE MINERAL 330ML;1;2000;0;2000;1417;583;
2021-05-23 22:30:16;8992761164546;NUTRIBOOST STRAWBERRY 300ML;2;6500;0;13000;10600;2400;
2021-05-23 22:30:16;8992761166205;FRESTEA GREEN HONEY 350ML;1;4500;0;4500;3000;1500;
2021-05-23 22:30:16;8991102300421;WFR TANGO COKLAT 176GR;1;10000;0;10000;8694;1306;
2021-05-23 22:30:16;8850507000094;POLICE BONCHA;2;2000;0;4000;1600;2400;
2021-05-24 13:18:22;8994867007161;ROKOK PENA GOLD 20;1;17000;0;17000;15000;2000;
2021-05-24 13:44:24;8998866501033;MINYAK GORENG SEDAAP POUCH 2L;6;28000;0;168000;166476;1524;
2021-05-24 14:54:28;089686010343;INDOMIE SOTO MIE;1;2600;0;2600;2367;233;
2021-05-24 14:54:28;089686010824;INDOMIE GORENG SPESIAL;2;2700;0;5400;4904;496;
2021-05-24 15:00:14;8998866201377;KRISBEE FRIES KENTANG GORENG 68 GR;1;5500;0;5500;4620;880;
2021-05-24 15:00:14;8998989500166;GUDANG GARAM MERAH BESAR 16KS;1;18000;0;18000;17000;1000;
2021-05-24 15:14:12;8998866200851;NOODLE SEDAAP MIE BAKSO SPESIAL CUP 77 GR;2;4500;0;9000;7300;1700;
2021-05-24 15:14:12;8998866202671;NOODLE SEDAAP MIE KOREAN SPICY SOUP CUP;1;5000;0;5000;4002;998;
2021-05-24 15:14:12;8998866202404;NOODLE SEDAAP MIE KOREAN SPICY CHICKEN CUP;1;5000;0;5000;4002;998;
2021-05-24 15:16:43;8999999528850;CITRA NAT GLOW WHITE 60ML;1;6200;0;6200;5625;575;
2021-05-24 15:16:43;8998866105484;EMERON LOVELY MOISTURE&BRIGHT;1;4300;0;4300;3800;500;
2021-05-24 15:16:43;VTM;VITAMIN;1;500;0;500;425;75;
2021-05-24 15:22:25;YP;YUPI;8;250;0;2000;1664;336;
2021-05-24 15:22:45;YP;YUPI;16;250;0;4000;3328;672;
2021-05-24 15:22:45;PRG;PARAGO;2;500;0;1000;800;200;
2021-05-24 15:47:00;VCL;VITAMIN C500 LEMON;1;1000;0;1000;575;425;
2021-05-24 15:47:00;VCO;VITAMIN C500 ORANGE;1;1000;0;1000;575;425;
2021-05-24 16:14:16;8999999534097;PEPSODENT PGB FCM 75G;1;5000;0;5000;3850;1150;
2021-05-24 16:44:47;089686010343;INDOMIE SOTO MIE;2;2600;0;5200;4734;466;
2021-05-24 16:44:47;8996001410042GT;TB TORA MOKA;1;13000;0;13000;8700;4300;
2021-05-24 16:46:49;8998866200561;EKOMIE SUPER 600GR;1;10000;0;10000;8615;1385;
2021-05-24 16:46:49;8997011700123;BIHUN JAGUNG 300GR;1;6000;0;6000;4979;1021;
2021-05-24 16:46:49;8999999533731;CITRA TS NATURE WHITE 70G;2;2200;0;4400;3800;600;
2021-05-24 16:46:49;8992979190986;TOTAL PUTIH SOFTENER;1;13000;0;13000;11532;1468;
2021-05-24 17:11:01;8994834006128;TICTIC PEDAS;1;2000;0;2000;1700;300;
2021-05-24 17:11:01;8998866202725;MILKU COKLAT PREMIUM 200ML;1;3000;0;3000;2375;625;
2021-05-24 17:32:39;8998989300261;GUDANG GARAM SURYA 12 FILTER;1;18500;0;18500;17200;1300;
2021-05-24 17:32:39;VTM;VITAMIN;1;500;0;500;425;75;
2021-05-24 17:48:02;8998866202732;MILKU STROBERI 200ML;1;3000;0;3000;2375;625;
2021-05-24 17:48:57;8992628020152;BIMOLI POUCH 2L;1;31000;0;31000;29800;1200;
2021-05-24 17:55:16;8996001600399;LE MINERAL 1500ML;1;5000;0;5000;4042;958;
2021-05-24 17:55:16;001;PASEO SMART FACIAL SF 250S GT;1;10000;0;10000;9500;500;
2021-05-24 17:55:16;8998009020186;BUAVITA GUAVA 250ML;2;7000;0;14000;12166;1834;
2021-05-24 17:55:16;8991102989428SCT;TANGO CKLT 24G SCT;1;1000;0;1000;609;391;
2021-05-24 18:23:56;8994834006128;TICTIC PEDAS;1;2000;0;2000;1700;300;
2021-05-24 18:23:56;8886013257400;TWISTKO;2;1000;0;2000;1800;200;
2021-05-24 18:23:56;8994834005923;SPIX 1000;1;1000;0;1000;850;150;
2021-05-24 18:38:23;TG;TEH GELAS;1;1000;0;1000;729;271;
2021-05-24 18:38:23;8992696404441;BEAR BRAND 189ML;1;9000;0;9000;7887;1113;
2021-05-24 18:50:45;8997231980022;O'JELLY MINI STRAWBERRY;1;3000;0;3000;2250;750;
2021-05-24 18:50:45;8997231980015;O'JELLY MINI APPLE;1;3000;0;3000;2250;750;
2021-05-24 18:59:59;GL;GULA 1 LITER;4;11500;0;46000;42000;4000;
2021-05-24 19:12:46;8886013213208;FRENCH FREIS 2000;3;5000;0;15000;11250;3750;
2021-05-24 19:18:33;8992725910417;LISTERINE FRESH BURST 100ML;1;7500;0;7500;6800;700;
2021-05-24 19:18:33;VCO;VITAMIN C500 ORANGE;1;1000;0;1000;575;425;
2021-05-24 19:34:48;711844610095;LARISSA UDANG 500 GR;3;11000;0;33000;29370;3630;
2021-05-24 19:52:47;8997231980022;O'JELLY MINI STRAWBERRY;1;3000;0;3000;2250;750;
2021-05-24 19:52:47;MOBIL;GULA GULA HP;1;2000;0;2000;1700;300;
2021-05-24 19:53:39;8993072153595;LARISST COTTON 35G;1;5000;0;5000;3300;1700;
2021-05-24 20:00:48;8995333060703;TERIGU KOMPAS 1KG;2;10500;0;21000;19632;1368;
2021-05-24 20:00:48;8998866201865;KRISBEE PILLOW CHOCOLAVA 120 GR;1;8000;0;8000;7250;750;
2021-05-24 20:00:48;8998866600521;SOKLIN FLOORCLENER KUNING 400ML;1;6000;0;6000;5025;975;
2021-05-24 20:00:48;8997226412019;EMINA CHEESE 165G;1;17000;0;17000;15000;2000;
2021-05-24 20:15:59;8998866202725;MILKU COKLAT PREMIUM 200ML;1;3000;0;3000;2375;625;
2021-05-24 20:15:59;8994834006128;TICTIC PEDAS;1;2000;0;2000;1700;300;
2021-05-24 21:05:18;ARG;ARGUS 220ML;2;14500;0;29000;25000;4000;
2021-05-24 21:06:03;VCO;VITAMIN C500 ORANGE;1;1000;0;1000;575;425;
2021-05-24 21:32:32;8992959072202;HN PANTS L 20;1;35000;0;35000;32576;2424;
2021-05-24 21:52:09;8998989300261;GUDANG GARAM SURYA 12 FILTER;1;18500;0;18500;17200;1300;
2021-05-24 21:52:42;PRG;PARAGO;2;500;0;1000;800;200;
2021-05-24 21:52:42;COKLAT;COKLAT COIN;1;500;0;500;400;100;
2021-05-24 21:52:42;YP;YUPI;2;250;0;500;416;84;
2021-05-24 22:06:33;ff;FULLO BLASTO;1;1000;0;1000;995;5;
2021-05-24 22:24:18;8992775110157;GARUDA KACANG KULIT;1;5000;0;5000;3925;1075;
2021-05-24 22:24:18;8992775211410;PILUS GARUDA PEDAS;1;5000;0;5000;4886;114;
2021-05-25 12:25:42;8997027490018;LADAMAS MERICA BUBUK;1;9500;0;9500;8898;602;
2021-05-25 12:25:42;8992753102204;BKM COKLAT 370G;1;11300;0;11300;9500;1800;
2021-05-25 12:25:42;BK;BUMBU KACANG;1;5000;0;5000;5000;0;
2021-05-25 12:25:42;8992959117569;SFX DS REG FLOW NW 8;1;4000;0;4000;3530;470;
2021-05-25 12:25:42;8992959117583;SFX DS REG FLOW WING 20;1;5000;0;5000;4288;712;
2021-05-25 12:25:42;8991102380805;FULLO  CKL PCK 8G;1;10000;0;10000;9000;1000;
2021-05-25 12:25:42;8999908204202;MY BABY MINYAK TELON 60ML;1;18000;0;18000;16900;1100;
2021-05-25 12:25:42;8997231980022;O'JELLY MINI STRAWBERRY;1;3000;0;3000;2250;750;
2021-05-25 12:25:42;8999999524722;SUNLIGHT LIME NEW PCH 435ML;1;10000;0;10000;9100;900;
2021-05-25 12:25:42;8998866202060;POTABEE AYAM BAKAR PEDAS 35 GR;2;5000;0;10000;8300;1700;
2021-05-25 12:25:42;8992959509005;SWEETY SILVER PANTS XL26;1;61500;0;61500;55910;5590;
2021-05-25 12:25:42;8992959953198;SWEETY BRONZE  XL2 6+2;1;60000;0;60000;54091;5909;
2021-05-25 12:52:40;8998989500166;GUDANG GARAM MERAH BESAR 16KS;1;18000;0;18000;17000;1000;
2021-05-25 12:52:40;bb;BENG-BENG;1;1500;0;1500;1450;50;
2021-05-25 12:52:40;BTS;BIMURA TARO SEAWEED 250G;1;10000;0;10000;9300;700;
2021-05-25 12:52:40;8992761002039;FANTA STRAWBERRY PET 390 ML;1;5500;0;5500;4300;1200;
2021-05-25 13:31:52;bb;BENG-BENG;2;1500;0;3000;2900;100;
2021-05-25 13:58:57;8992933241112;NUTRIJELL COKLAT;2;7000;0;14000;12832;1168;
2021-05-25 13:58:57;8999801700030;SUSU FOYU;1;11500;0;11500;10450;1050;
2021-05-25 13:58:57;8991188943536;SASA SANTAN KELAPA 65ML;2;3000;0;6000;4874;1126;
2021-05-25 13:58:57;8997018720018;SIRUP DHT;1;23000;0;23000;20958;2042;
2021-05-25 13:58:57;8997028900837;SABUN PAPAYA;1;10000;0;10000;9375;625;
2021-05-25 13:58:57;8993379200855;SABUN HARMONY STRAWBERRY 70G;1;2000;0;2000;1652;348;
2021-05-25 14:44:47;8998989300261;GUDANG GARAM SURYA 12 FILTER;1;18500;0;18500;17200;1300;
2021-05-25 14:56:43;GL;GULA 1 LITER;2;11500;0;23000;21000;2000;
2021-05-25 14:56:43;8998989300261;GUDANG GARAM SURYA 12 FILTER;3;18500;0;55500;51600;3900;
2021-05-25 14:56:43;8991102303309;WFR TANGO SBJ 176G;2;10000;0;20000;17388;2612;
2021-05-25 14:56:43;8993470279651;JOGER CHOCKY BAR;2;1000;0;2000;1734;266;
2021-05-25 14:56:43;8998009020186;BUAVITA GUAVA 250ML;1;7000;0;7000;6083;917;
2021-05-25 14:56:43;8993470671752;JOGER STICK DUO KACANG;1;1000;0;1000;850;150;
2021-05-25 14:56:43;8993571004732;SALAS SALEP CAP19 6G;1;7000;0;7000;6000;1000;
2021-05-25 14:56:43;8992761002022;SPRITE PET 390ML;1;5500;0;5500;4300;1200;
2021-05-25 14:56:43;8999909096004;SAMPOERNA 16 FILTER;1;24000;0;24000;23000;1000;
2021-05-25 14:56:43;8998898810721;KKB ENER-G C1000;1;8000;0;8000;6690;1310;
2021-05-25 14:56:43;JGR SHN;JOGER SHINY SACHET;4;500;0;2000;1748;252;
2021-05-25 14:56:43;8886013257400;TWISTKO;1;1000;0;1000;900;100;
2021-05-25 14:56:43;8999999195656;SARI WANGI 50X1.85;1;10000;0;10000;9500;500;
2021-05-25 14:56:43;8998989500128;GUDANG GARAM MERAH KECIL 12KS;1;14000;0;14000;13000;1000;
2021-05-25 14:56:43;8994935000285;MINYAK GORENG DUNIA 4500ML;2;70000;0;140000;132866;7134;
2021-05-25 14:56:43;8998866200646;KOPI TOP MURNI;1;11000;0;11000;9600;1400;
2021-05-25 14:56:43;8992222052979;GATSBY WATER GLOSS MERAH;1;5000;0;5000;3700;1300;
2021-05-25 14:56:43;8998866501033;MINYAK GORENG SEDAAP POUCH 2L;1;28000;0;28000;27746;254;
2021-05-25 14:56:43;8992959953181;SWEETY BRONZE L30+2;1;55000;0;55000;53410;1590;
2021-05-25 14:56:43;8992761164539;NUTRIBOOST ORANGE 300ML;1;6500;0;6500;5300;1200;
2021-05-25 14:56:43;6907992823843;JD MOCHA CRISPY;1;5000;0;5000;4400;600;
2021-05-25 14:58:38;8993989311699;CLAS MILD 16 FILTER;1;23000;0;23000;21700;1300;
2021-05-25 16:06:18;8992761166212;FRESTEA APPLE 350ML;1;4500;0;4500;3000;1500;
2021-05-25 16:06:18;089686611519;QTELA SINGKONG;1;5000;0;5000;4266;734;
2021-05-25 16:06:18;HT;HOT-HOT;1;500;0;500;350;150;
2021-05-25 16:32:48;8997231980015;O'JELLY MINI APPLE;1;3000;0;3000;2250;750;
2021-05-25 16:32:48;8886013257400;TWISTKO;1;1000;0;1000;900;100;
2021-05-25 16:32:48;8998866202732;MILKU STROBERI 200ML;1;3000;0;3000;2375;625;
2021-05-25 16:45:57;001;PASEO SMART FACIAL SF 250S GT;1;10000;0;10000;9500;500;
2021-05-25 16:47:11;089686611878;QTELA TEMPE;1;6000;0;6000;5370;630;
2021-05-25 16:47:11;8998866600521;SOKLIN FLOORCLENER KUNING 400ML;1;6000;0;6000;5025;975;
2021-05-25 16:47:25;TG;TEH GELAS;1;1000;0;1000;729;271;
2021-05-25 17:07:27;8991111109107;JB POWDER BEDTIME 75+25g;1;6000;0;6000;5440;560;
2021-05-25 17:07:27;BB;PASEO SMARTY FACIAL TRAVEL PACK 50S GT;1;3000;0;3000;1980;1020;
2021-05-25 17:35:30;089686611519;QTELA SINGKONG;1;5000;0;5000;4266;734;
2021-05-25 17:48:59;8993053641042;PASEO BABY WIPES GAZETTE 50S;1;17000;0;17000;15400;1600;
2021-05-25 17:48:59;001;PASEO SMART FACIAL SF 250S GT;1;10000;0;10000;9500;500;
2021-05-25 17:49:47;8993053641042;PASEO BABY WIPES GAZETTE 50S;1;17000;0;17000;15400;1600;
2021-05-25 18:35:17;8997231980022;O'JELLY MINI STRAWBERRY;1;3000;0;3000;2250;750;
2021-05-25 18:35:17;8997231980015;O'JELLY MINI APPLE;1;3000;0;3000;2250;750;
2021-05-25 18:35:17;8998866202770;MIE SEDAAP SALERO PADANG;1;2500;0;2500;2362;138;
2021-05-25 18:41:42;8998866201827;JAVANA GULA BATU 350ML;1;3000;0;3000;2150;850;
2021-05-25 18:51:42;8997231980015;O'JELLY MINI APPLE;1;3000;0;3000;2250;750;
2021-05-25 19:42:45;8999999534097;PEPSODENT PGB FCM 75G;1;5000;0;5000;3850;1150;
2021-05-25 19:42:45;8998866608305;GIV BENGKOANG KOTAK 76G;1;2000;0;2000;1820;180;
2021-05-25 19:42:45;8998866888615;GIV BIRU KOTAK 76G;1;2000;0;2000;1820;180;
2021-05-25 19:42:45;8998866602389;GIV UNGU KOTAK 76G;1;2000;0;2000;1820;180;
2021-05-25 19:42:45;8998866888639;GIV HIJAU KOTAK 76G;1;2000;0;2000;1820;180;
2021-05-25 19:42:45;8998866609142;GIV MULBERRY SILK KOTAK 76G;1;2000;0;2000;1820;180;
2021-05-25 19:42:45;8991111152073;LISTERINE GREEN TEA 100ML;1;8000;0;8000;7600;400;
2021-05-25 19:46:15;8997231980015;O'JELLY MINI APPLE;1;3000;0;3000;2250;750;
2021-05-25 19:46:15;PRG;PARAGO;4;500;0;2000;1600;400;
2021-05-25 19:56:43;6907992823843;JD MOCHA CRISPY;1;5000;0;5000;4400;600;
2021-05-25 19:56:43;8996001600146;TEH PUCUK HARUM 350ML;1;3000;0;3000;2314;686;
2021-05-25 20:31:23;8999909002821;MALBORO BLACK 16;1;22000;0;22000;20850;1150;
2021-05-25 20:45:19;8998866601429;POWDET DAIA BUNGA BAG 290GR;2;5000;0;10000;8900;1100;
2021-05-25 20:45:19;8997231980015;O'JELLY MINI APPLE;2;3000;0;6000;4500;1500;
2021-05-25 20:45:19;YP;YUPI;4;250;0;1000;832;168;
2021-05-25 20:53:54;8998989500166;GUDANG GARAM MERAH BESAR 16KS;2;18000;0;36000;34000;2000;
2021-05-25 20:55:08;COKLAT;COKLAT COIN;2;500;0;1000;800;200;
2021-05-25 20:55:08;PRG;PARAGO;2;500;0;1000;800;200;
2021-05-25 21:02:41;089686021219;INTER MIE GORENG;2;1000;0;2000;1770;230;
2021-05-25 21:02:41;8998866200301;MIE SEDAAP GORENG;1;2500;0;2500;2023;477;
2021-05-25 21:02:41;8996001301142;ROMA KELAPA;1;8000;0;8000;6628;1372;
2021-05-25 21:02:41;089686043204;INDOMIE MIE ACEH;2;2700;0;5400;4904;496;
2021-05-25 21:02:41;8996001318911;BETTER ISI 4;1;18000;0;18000;17000;1000;
2021-05-25 21:03:51;ARG;ARGUS 220ML;6;14500;0;87000;75000;12000;
2021-05-25 21:07:11;8998989300261;GUDANG GARAM SURYA 12 FILTER;1;18500;0;18500;17200;1300;
2021-05-25 21:07:11;VCO;VITAMIN C500 ORANGE;1;1000;0;1000;575;425;
2021-05-25 21:09:41;8993989311279;CLAS MILD 12;1;17000;0;17000;15700;1300;
2021-05-25 21:09:41;VCO;VITAMIN C500 ORANGE;1;1000;0;1000;575;425;
2021-05-25 21:50:44;089686010107;INDOMIE KALDU AYAM;4;2500;0;10000;8600;1400;
2021-05-25 22:06:52;8992870311091;SALONPAS;1;6000;0;6000;4806;1194;
2021-05-25 22:06:52;8997025914042;ATB MARIE SUSU 185G;1;7000;0;7000;4554;2446;
2021-05-25 22:06:52;6907992825076;JD WATERMELON APPLE;1;2000;0;2000;1700;300;
2021-05-25 22:06:52;8992696404441;BEAR BRAND 189ML;1;9000;0;9000;7887;1113;
2021-05-25 22:06:52;8997009510055;YOU C1000;1;10000;0;10000;9166;834;
2021-05-25 22:06:52;089686611878;QTELA TEMPE;1;6000;0;6000;5370;630;
2021-05-26 12:09:19;6907992823935;JD SWEETCORN;1;3500;0;3500;3000;500;
2021-05-26 12:09:19;8997231980015;O'JELLY MINI APPLE;1;3000;0;3000;2250;750;
2021-05-26 12:13:07;8998866608718;DAIA SOFTENER PINK;1;5000;0;5000;4450;550;
2021-05-26 12:13:07;MLTO PINK;MOLTO ALL IN ONE;1;1000;0;1000;800;200;
2021-05-26 12:13:07;8997231980022;O'JELLY MINI STRAWBERRY;2;3000;0;6000;4500;1500;
2021-05-26 12:13:07;8998989300261;GUDANG GARAM SURYA 12 FILTER;1;18500;0;18500;17200;1300;
2021-05-26 12:13:07;8993470671752;JOGER STICK DUO KACANG;1;1000;0;1000;850;150;
2021-05-26 12:13:07;8999999502003;SARIMURNI RL RB 1,8G;1;1500;0;1500;1207;293;
2021-05-26 12:13:07;8991102303309;WFR TANGO SBJ 176G;1;10000;0;10000;8694;1306;
2021-05-26 12:13:07;8996001305041;ROMA SANDWICH CKLT;1;7000;0;7000;5000;2000;
2021-05-26 12:13:07;8991004011906;KOPI BORONG;1;10000;0;10000;8333;1667;
2021-05-26 12:13:07;ARG;ARGUS 220ML;1;14500;0;14500;12500;2000;
2021-05-26 12:13:07;089686611519;QTELA SINGKONG;1;5000;0;5000;4266;734;
2021-05-26 12:14:53;8999999514518;RINSO MOLTO PERF ESSENCE 215ML;1;5000;0;5000;4250;750;
2021-05-26 12:40:20;8998866200301;MIE SEDAAP GORENG;1;2500;0;2500;2023;477;
2021-05-26 12:40:20;089686043204;INDOMIE MIE ACEH;1;2700;0;2700;2452;248;
2021-05-26 12:40:20;089686011036;INDOMIE GORENG PEDAS;1;2700;0;2700;2452;248;
2021-05-26 12:40:20;HT;HOT-HOT;4;500;0;2000;1400;600;
2021-05-26 12:53:10;KURMA;KURMA;1;60000;0;60000;55000;5000;
2021-05-26 12:53:10;8998989110167;SURYA GUDANG GARAM 16 FILTER;1;25000;0;25000;23200;1800;
2021-05-26 12:54:16;COKLAT;COKLAT COIN;8;500;0;4000;3200;800;
2021-05-26 12:54:16;8997231980022;O'JELLY MINI STRAWBERRY;1;3000;0;3000;2250;750;
2021-05-26 12:54:16;8997231980015;O'JELLY MINI APPLE;1;3000;0;3000;2250;750;
2021-05-26 13:00:47;8997231980022;O'JELLY MINI STRAWBERRY;1;3000;0;3000;2250;750;
2021-05-26 13:24:21;8991001111883;SILVERQUEEN CHUNKYBAR 33G;1;8000;0;8000;7150;850;
2021-05-26 13:24:21;HT;HOT-HOT;4;500;0;2000;1400;600;
2021-05-26 13:36:52;8994935000285;MINYAK GORENG DUNIA 4500ML;1;70000;0;70000;66433;3567;
2021-05-26 13:36:52;8992696404441;BEAR BRAND 189ML;1;9000;0;9000;7887;1113;
2021-05-26 14:36:14;8992959107515;SFX NON WING 23CM 8;1;4000;0;4000;3288;712;
2021-05-26 14:36:14;VCL;VITAMIN C500 LEMON;1;1000;0;1000;575;425;
2021-05-26 15:06:22;8992759120264;LARISST 220;1;10000;0;10000;9200;800;
2021-05-26 15:06:22;8996001600269;LE MINERAL 600ML;1;3000;0;3000;1688;1312;
2021-05-26 15:06:22;6907992823829;JD MILKY MILK;1;3000;0;3000;2600;400;
2021-05-26 15:06:22;COKLAT;COKLAT COIN;2;500;0;1000;800;200;
2021-05-26 17:18:16;8992761164546;NUTRIBOOST STRAWBERRY 300ML;1;6500;0;6500;5300;1200;
2021-05-26 17:18:16;089686611519;QTELA SINGKONG;1;5000;0;5000;4266;734;
2021-05-26 17:18:16;8998866201452;POTABEE REGULER BBQ BEEF 35GR;1;5000;0;5000;4150;850;
2021-05-26 17:18:16;HT;HOT-HOT;1;500;0;500;350;150;
2021-05-26 17:28:21;8992959974018;SFX SIRIH 36CM 12+1;1;17000;0;17000;15958;1042;
2021-05-26 17:28:21;8991102387286SCT;TANGO LONG CKLT 47G;1;2000;0;2000;1551;449;
2021-05-26 17:28:21;8991102989428SCT;TANGO CKLT 24G SCT;1;1000;0;1000;609;391;
2021-05-26 17:29:05;8999999037765;PEPSODENT WHITE 225G;1;12000;0;12000;10750;1250;
2021-05-26 17:31:04;8994834006128;TICTIC PEDAS;1;2000;0;2000;1700;300;
2021-05-26 17:31:04;ff;FULLO BLASTO;2;1000;0;2000;1990;10;
2021-05-26 17:31:04;8993470671752;JOGER STICK DUO KACANG;1;1000;0;1000;850;150;
2021-05-26 17:47:09;8999999195656;SARI WANGI 50X1.85;1;10000;0;10000;9500;500;
2021-05-26 18:24:30;089686611878;QTELA TEMPE;1;6000;0;6000;5370;630;
2021-05-26 18:24:30;8993470279651;JOGER CHOCKY BAR;1;1000;0;1000;867;133;
2021-05-26 18:24:30;001;PASEO SMART FACIAL SF 250S GT;1;10000;0;10000;9500;500;
2021-05-26 18:33:23;PTK;MINI NAIL CLIPPER BESAR THREE SEVEN;1;7000;0;7000;6000;1000;
2021-05-26 18:33:23;8997025911058;HATARI SHP KELAPA;1;6000;0;6000;4911;1089;
2021-05-26 18:53:27;COKLAT;COKLAT COIN;1;500;0;500;400;100;
2021-05-26 18:53:27;HT;HOT-HOT;1;500;0;500;350;150;
2021-05-26 18:53:27;PRG;PARAGO;2;500;0;1000;800;200;
2021-05-26 21:00:07;8998866202770;MIE SEDAAP SALERO PADANG;1;2500;0;2500;2362;138;
2021-05-26 21:00:07;8999999559540;LIFEBUOY BW LEMONFRESH 90ML;2;5000;0;10000;8000;2000;
2021-05-26 22:19:58;8998989110167;SURYA GUDANG GARAM 16 FILTER;1;25000;0;25000;23200;1800;
2021-05-26 22:19:58;6907992825076;JD WATERMELON APPLE;1;2000;0;2000;1700;300;
2021-05-26 22:19:58;8999908389008;HEMAVITON C1000;1;8000;0;8000;6000;2000;
2021-05-26 22:19:58;YP;YUPI;8;250;0;2000;1664;336;
2021-05-26 22:19:58;TL;TELUR;10;1500;0;15000;13000;2000;
2021-05-26 22:20:38;8997231980022;O'JELLY MINI STRAWBERRY;1;3000;0;3000;2250;750;
2021-05-26 22:20:38;8994834005923;SPIX 1000;1;1000;0;1000;850;150;
2021-05-27 13:41:09;8999909002821;MARLBORO BLACK 16;1;22000;0;22000;20850;1150;
2021-05-27 14:07:22;8999909096004;SAMPOERNA 16 FILTER;1;24000;0;24000;23000;1000;
2021-05-27 14:07:22;8998989110167;SURYA GUDANG GARAM 16 FILTER;1;25000;0;25000;23200;1800;
2021-05-27 14:38:48;8998866501033;MINYAK GORENG SEDAAP POUCH 2L;1;28000;0;28000;27746;254;
2021-05-27 15:00:23;8992959953129;SWEETY BRONZE M20;1;35000;0;35000;33020;1980;
2021-05-27 15:00:23;8993053641042;PASEO BABY WIPES GAZETTE 50S;1;17000;0;17000;15400;1600;
2021-05-27 15:00:23;BB;PASEO SMARTY FACIAL TRAVEL PACK 50S GT;1;3000;0;3000;1980;1020;
2021-05-27 15:00:23;001;PASEO SMART FACIAL SF 250S GT;1;10000;0;10000;9500;500;
2021-05-27 15:00:23;8999999706111;PEPSODENT WHITE 25G;1;2000;0;2000;1450;550;
2021-05-27 15:00:23;8999999031930;PEPSODENT TB TRIPLE CLEAN;1;3500;0;3500;2850;650;
2021-05-27 15:00:23;8999999036492;LUX BW PINK SOFT BTL 100ML;1;10000;0;10000;8690;1310;
2021-05-27 15:01:38;089686043051;INDOMIE COTO MAKASSAR;1;2800;0;2800;2525;275;
2021-05-27 15:01:38;089686043617;INDOMIE MIEGHRTTI;1;2700;0;2700;2452;248;
2021-05-27 15:46:20;8999999031930;PEPSODENT TB TRIPLE CLEAN;1;3500;0;3500;2850;650;
2021-05-27 15:46:20;76164217;MARLBORO MERAH;1;30000;0;30000;27700;2300;
2021-05-27 16:19:16;8992957220087;COKLAT SINGA;1;2000;0;2000;1700;300;
2021-05-27 16:24:22;8990800016757;BB TUTI FRUITTY COSMO;1;8500;0;8500;7600;900;
2021-05-27 16:24:22;8998009020186;BUAVITA GUAVA 250ML;1;7000;0;7000;6083;917;
2021-05-27 16:24:22;8992696523067;MILO ACTVGO UHT 180ML;2;4500;0;9000;7030;1970;
2021-05-27 16:24:22;8998009040023;TEH KOTAK;1;5000;0;5000;2827;2173;
2021-05-27 16:24:22;8992696523081;MILO UHT 110ML;1;2500;0;2500;1962;538;
2021-05-27 16:39:48;8991001111883;SILVERQUEEN CHUNKYBAR 33G;1;8000;0;8000;7150;850;
2021-05-27 16:39:48;8997231980022;O'JELLY MINI STRAWBERRY;2;3000;0;6000;4500;1500;
2021-05-27 16:39:48;8994834006128;TICTIC PEDAS;3;2000;0;6000;5100;900;
2021-05-27 16:39:48;8994834003752;TICTIC;1;2000;0;2000;1700;300;
2021-05-27 16:51:04;8998989500166;GUDANG GARAM MERAH BESAR 16KS;1;18000;0;18000;17000;1000;
2021-05-27 16:58:19;8999999059316;LIFEBUOY TS MILDCARE 75G;2;3000;0;6000;5280;720;
2021-05-27 16:58:19;8998989300261;GUDANG GARAM SURYA 12 FILTER;1;18500;0;18500;17200;1300;
2021-05-27 17:07:09;VCO;VITAMIN C500 ORANGE;1;1000;0;1000;575;425;
2021-05-27 17:27:27;8992775002155;CHOCOLATOS DRINK;1;4000;0;4000;3520;480;
2021-05-27 17:27:27;001;PASEO SMART FACIAL SF 250S GT;1;10000;0;10000;9500;500;
2021-05-27 17:27:27;8998866609487;SOKLIN SOFTERGEN 280G;1;5000;0;5000;4425;575;
2021-05-27 17:51:59;8998009020186;BUAVITA GUAVA 250ML;3;7000;0;21000;18249;2751;
2021-05-27 17:52:14;8991111102962;JB STARTERKIT BB GIFT SET;1;87000;0;87000;82880;4120;
2021-05-27 18:36:18;711844610095;LARISSA UDANG 500 GR;2;11000;0;22000;19580;2420;
2021-05-27 18:42:42;8997231980022;O'JELLY MINI STRAWBERRY;1;3000;0;3000;2250;750;
2021-05-27 18:42:42;COKLAT;COKLAT COIN;4;500;0;2000;1600;400;
2021-05-27 18:51:37;8993989311279;CLAS MILD 12;1;17000;0;17000;15700;1300;
2021-05-27 21:30:30;8997009510055;YOU C1000;1;10000;0;10000;9166;834;
2021-05-27 21:37:03;8992761002039;FANTA STRAWBERRY PET 390 ML;1;5500;0;5500;4300;1200;
2021-05-27 21:37:03;8992959953044;SWEETY BRONZE XL1;2;2500;0;5000;4500;500;
2021-05-27 21:37:03;bb;BENG-BENG;3;1500;0;4500;4350;150;
2021-05-27 22:23:57;ARG;ARGUS 220ML;6;14500;0;87000;75000;12000;
2021-05-27 22:23:57;8993058105013;EXTRA JOSS;1;12000;0;12000;9773;2227;
2021-05-28 09:14:02;RB;RED BOLD;1;19000;0;19000;17900;1100;
2021-05-28 09:14:02;8993989311699;CLAS MILD 16 FILTER;1;23000;0;23000;21700;1300;
2021-05-28 09:14:02;9556001025272;NESCAFE LATTE 240ML;1;8500;0;8500;7834;666;
2021-05-28 09:14:02;VCO;VITAMIN C500 ORANGE;2;1000;0;2000;1150;850;
2021-05-28 10:16:33;8992696407053;DNCO 3+ MADU 800G;1;84500;0;84500;82333;2167;
2021-05-28 11:10:55;8992761002022;SPRITE PET 390ML;1;5500;0;5500;4300;1200;
2021-05-28 11:11:53;8997231980022;O'JELLY MINI STRAWBERRY;1;3000;0;3000;2250;750;
2021-05-28 11:11:53;8997231980015;O'JELLY MINI APPLE;1;3000;0;3000;2250;750;
2021-05-28 11:11:53;PRG;PARAGO;2;500;0;1000;800;200;
2021-05-28 12:48:36;8992761166212;FRESTEA APPLE 350ML;2;4500;0;9000;6000;3000;
2021-05-28 12:48:36;8886013257400;TWISTKO;1;1000;0;1000;900;100;
2021-05-28 13:07:25;6907992823676;JD PEACH;2;2000;0;4000;3400;600;
2021-05-28 13:07:25;8997231980022;O'JELLY MINI STRAWBERRY;1;3000;0;3000;2250;750;
2021-05-28 13:09:42;8997231980022;O'JELLY MINI STRAWBERRY;1;3000;0;3000;2250;750;
2021-05-28 13:09:42;8997231980015;O'JELLY MINI APPLE;1;3000;0;3000;2250;750;
2021-05-28 13:09:42;PRG;PARAGO;2;500;0;1000;800;200;
2021-05-28 13:13:26;8997231980022;O'JELLY MINI STRAWBERRY;1;3000;0;3000;2250;750;
2021-05-28 13:13:26;ff;FULLO BLASTO;1;1000;0;1000;995;5;
2021-05-28 13:14:30;089686010107;INDOMIE KALDU AYAM;6;2500;0;15000;12900;2100;
2021-05-28 13:21:13;8998989500166;GUDANG GARAM MERAH BESAR 16KS;1;18000;0;18000;17000;1000;
2021-05-28 14:09:10;8993083929905;BISKITOP WAFER;1;30000;0;30000;27000;3000;
2021-05-28 14:09:10;8996001600641;TORA CAPPUCINO;1;3500;0;3500;2750;750;
2021-05-28 14:15:23;8992775110157;GARUDA KACANG KULIT;1;5000;0;5000;3925;1075;
2021-05-28 14:15:23;8994834003752;TICTIC;1;2000;0;2000;1700;300;
2021-05-28 14:15:23;8992761002022;SPRITE PET 390ML;1;5500;0;5500;4300;1200;
2021-05-28 14:15:23;6907992823676;JD PEACH;1;2000;0;2000;1700;300;
2021-05-28 14:15:23;8992761139018;ADES 600ML;1;3500;0;3500;2292;1208;
2021-05-28 14:58:41;8997231980022;O'JELLY MINI STRAWBERRY;1;3000;0;3000;2250;750;
2021-05-28 14:58:41;8997231980015;O'JELLY MINI APPLE;1;3000;0;3000;2250;750;
2021-05-28 15:38:02;8996001600399;LE MINERAL 1500ML;2;5000;0;10000;8084;1916;
2021-05-28 15:38:27;8997028590014;ARGUS 220ML;2;500;0;1000;604;396;
2021-05-28 16:39:47;VCL;VITAMIN C500 LEMON;1;1000;0;1000;575;425;
2021-05-28 16:39:47;089686043051;INDOMIE COTO MAKASSAR;1;2800;0;2800;2525;275;
2021-05-28 16:39:47;8991102989534;TANGO VANILA 24G;1;1000;0;1000;609;391;
2021-05-28 16:49:20;8999999195649;SARI WANGI 25X1.86G;1;6000;0;6000;5050;950;
2021-05-28 16:49:20;8999999059781;SUNLIGHT LIME NEW POUCH 210ML;1;5000;0;5000;4300;700;
2021-05-28 16:49:20;089686010107;INDOMIE KALDU AYAM;5;2500;0;12500;10750;1750;
2021-05-28 17:10:49;8998009020186;BUAVITA GUAVA 250ML;1;7000;0;7000;6083;917;
2021-05-28 17:18:46;8992775110157;GARUDA KACANG KULIT;1;5000;0;5000;3925;1075;
2021-05-28 17:18:46;8994834005923;SPIX 1000;1;1000;0;1000;850;150;
2021-05-28 18:36:52;8997028590014;ARGUS 220ML;4;500;0;2000;1208;792;
2021-05-28 18:36:52;VCO;VITAMIN C500 ORANGE;1;1000;0;1000;575;425;
2021-05-28 18:45:56;8998866200325;MIE SEDAAP SOTO;1;2500;0;2500;1952;548;
2021-05-28 18:45:56;8998866200578;MIE SEDAAP KARI KENTAL;1;2500;0;2500;2263;237;
2021-05-28 18:45:56;8998866202770;MIE SEDAAP SALERO PADANG;1;2500;0;2500;2362;138;
2021-05-28 18:45:56;001;PASEO SMART FACIAL SF 250S GT;1;10000;0;10000;9500;500;
2021-05-28 18:46:39;8998009010590;ULTRA CHO 125;3;3000;0;9000;7284;1716;
2021-05-28 18:46:39;8998009010569;ULTRA CHO 200;2;5000;0;10000;7660;2340;
2021-05-28 18:48:37;VTM;VITAMIN;1;500;0;500;425;75;
2021-05-28 19:07:23;8998009040023;TEH KOTAK;1;5000;0;5000;2827;2173;
2021-05-28 19:07:23;089686611519;QTELA SINGKONG;1;5000;0;5000;4266;734;
2021-05-28 19:07:23;8992775311325;GERY SNACK&SEREAL 100G;1;7000;0;7000;6012;988;
2021-05-28 19:08:18;VCO;VITAMIN C500 ORANGE;1;1000;0;1000;575;425;
2021-05-28 19:34:43;8999999031930;PEPSODENT TB TRIPLE CLEAN;1;3500;0;3500;2850;650;
2021-05-28 19:34:43;6901997923072;SILET SEAGULL;1;6000;0;6000;5500;500;
2021-05-28 19:34:43;8991111109114;JB BEDTIME 150+50G;1;10000;0;10000;9210;790;
2021-05-28 19:34:43;YP;YUPI;2;250;0;500;416;84;
2021-05-28 22:07:23;8997009510055;YOU C1000;1;10000;0;10000;9166;834;
2021-05-28 22:24:06;8994867007161;ROKOK PENA GOLD 20;1;17000;0;17000;15000;2000;
2021-05-29 11:42:37;8998989300261;GUDANG GARAM SURYA 12 FILTER;1;18500;0;18500;17200;1300;
2021-05-29 11:45:38;8991102989428SCT;TANGO CKLT 24G SCT;1;1000;0;1000;609;391;
2021-05-29 11:45:38;8993470671752;JOGER STICK DUO KACANG;1;1000;0;1000;850;150;
2021-05-29 11:45:38;kp;KALPA;1;2000;0;2000;1666;334;
2021-05-29 11:45:38;8998989500166;GUDANG GARAM MERAH BESAR 16KS;1;18000;0;18000;17000;1000;
2021-05-29 11:56:46;8999999706111;PEPSODENT WHITE 25G;1;2000;0;2000;1450;550;
2021-05-29 11:56:46;8999999059316;LIFEBUOY TS MILDCARE 75G;1;3000;0;3000;2640;360;
2021-05-29 11:56:59;8998009020186;BUAVITA GUAVA 250ML;1;7000;0;7000;6083;917;
2021-05-29 12:26:26;ARG;ARGUS 220ML;1;14500;0;14500;12500;2000;
2021-05-29 12:26:26;8994907000428;KECAP SACHET ABC;4;500;0;2000;1416;584;
2021-05-29 14:16:10;8998866200578;MIE SEDAAP KARI KENTAL;1;2500;0;2500;2263;237;
2021-05-29 14:17:39;8993989311279;CLAS MILD 12;1;17000;0;17000;15700;1300;
2021-05-29 14:40:12;8999999526863;MOLTO ALL IN ONE PINK 11ML;1;5500;0;5500;4800;700;
2021-05-29 14:40:12;8999999042639;RINSO ANTI NODA CLS LIQ 40ML;5;1000;0;5000;4025;975;
2021-05-29 14:42:53;8992761111533;SPRITE SLIM CAM250ML;2;5000;0;10000;7500;2500;
2021-05-29 14:42:53;8992775001042;PILUS GARUDA MI GORENG;1;5000;0;5000;4810;190;
2021-05-29 14:46:33;8991102987875;WFR TANGO POUCH CKL 115G;1;8000;0;8000;6786;1214;
2021-05-29 14:46:33;8992775211410;PILUS GARUDA PEDAS;1;5000;0;5000;4886;114;
2021-05-29 14:46:33;8998866613699;EMERON LOVELY COOLBRIGHT 100ML;1;4300;0;4300;3800;500;
2021-05-29 14:46:33;JGR SHN;JOGER SHINY SACHET;5;500;0;2500;2185;315;
2021-05-29 15:57:35;8999999037765;PEPSODENT WHITE 225G;2;12000;0;24000;21500;2500;
2021-05-29 15:57:35;8999999055769;FAIR&LOVELY MVIT FC FOAM 50 G;1;12500;0;12500;11180;1320;
2021-05-29 15:58:28;8998989110167;SURYA GUDANG GARAM 16 FILTER;1;25000;0;25000;23200;1800;
2021-05-29 15:58:28;BMO;BERAS MERAH ORGANIK;1;25000;0;25000;23500;1500;
2021-05-29 15:59:20;ABC;BATERAI ABC BIRU;1;8500;0;8500;7500;1000;
2021-05-29 15:59:31;8996001600146;TEH PUCUK HARUM 350ML;2;3000;0;6000;4628;1372;
2021-05-29 16:01:49;6907992823676;JD PEACH;1;2000;0;2000;1700;300;
2021-05-29 16:01:49;6907992823621;JD CREAMY YOGURT;1;3000;0;3000;2600;400;
2021-05-29 16:02:00;8999999007768;FAIR&LOVELY MULTIVITAMIN  CREAM 9 ML;2;4500;0;9000;6400;2600;
2021-05-29 16:47:01;8998989300261;GUDANG GARAM SURYA 12 FILTER;1;18500;0;18500;17200;1300;
2021-05-29 16:47:01;VCO;VITAMIN C500 ORANGE;2;1000;0;2000;1150;850;
2021-05-29 17:52:58;8991102380805;FULLO  CKL PCK 8G;1;10000;0;10000;9000;1000;
2021-05-29 17:52:58;8998866202725;MILKU COKLAT PREMIUM 200ML;1;3000;0;3000;2375;625;
2021-05-29 17:52:58;VCO;VITAMIN C500 ORANGE;1;1000;0;1000;575;425;
2021-05-29 17:52:58;6907992823843;JD MOCHA CRISPY;1;5000;0;5000;4400;600;
2021-05-29 17:55:09;8997218380074;ICHITAN MILK TEA;1;8000;0;8000;6583;1417;
2021-05-29 17:55:09;8998866201865;KRISBEE PILLOW CHOCOLAVA 120 GR;1;8000;0;8000;7250;750;
2021-05-29 17:56:01;8999999023997;CITRA BW FRESH WHITE 220ML;1;12000;0;12000;10700;1300;
2021-05-29 17:56:01;8998866610278;DAIA VIOLET GUSSET 565G;1;10000;0;10000;8700;1300;
2021-05-29 18:00:13;089686611878;QTELA TEMPE;1;6000;0;6000;5370;630;
2021-05-29 18:00:13;089686611519;QTELA SINGKONG;1;5000;0;5000;4266;734;
2021-05-29 18:00:13;8997210107877;VORTEX SMART 3;1;10000;0;10000;9500;500;
2021-05-29 18:00:13;8992761122331;FRESTEA APPEL 500ML;1;6500;0;6500;4708;1792;
2021-05-29 18:52:05;8998989500166;GUDANG GARAM MERAH BESAR 16KS;1;18000;0;18000;17000;1000;
2021-05-29 19:03:40;8994834003752;TICTIC;1;2000;0;2000;1700;300;
2021-05-29 19:03:40;VTM;VITAMIN;2;500;0;1000;850;150;
2021-05-29 19:03:40;YP;YUPI;4;250;0;1000;832;168;
2021-05-29 19:03:40;ff;FULLO BLASTO;2;1000;0;2000;1990;10;
2021-05-29 19:03:40;8992775002735;CHOCOLATOS SUSU COKELAT;1;4000;0;4000;3520;480;
2021-05-29 19:04:27;8992775002155;CHOCOLATOS DRINK;1;4000;0;4000;3520;480;
2021-05-29 19:04:27;ff;FULLO BLASTO;1;1000;0;1000;995;5;
2021-05-29 19:16:12;8998989500166;GUDANG GARAM MERAH BESAR 16KS;1;18000;0;18000;17000;1000;
2021-05-29 19:33:52;8991102303309;WFR TANGO SBJ 176G;1;10000;0;10000;8694;1306;
2021-05-29 19:54:56;8998666003089GT;TB GILUX MIX;1;9000;0;9000;8000;1000;
2021-05-29 20:05:09;8994834003752;TICTIC;1;2000;0;2000;1700;300;
2021-05-29 20:05:09;8998009010590;ULTRA CHO 125;1;3000;0;3000;2428;572;
2021-05-29 20:05:09;AMPLOP;AMPLOP;4;250;0;1000;560;440;
2021-05-29 20:05:09;8997009510055;YOU C1000;1;10000;0;10000;9166;834;
2021-05-29 20:05:09;8992696404441;BEAR BRAND 189ML;1;9000;0;9000;7887;1113;
2021-05-29 20:05:09;089686021127;INTER MIE KALDU;1;1000;0;1000;813;187;
2021-05-29 20:05:09;8991188943536;SASA SANTAN KELAPA 65ML;1;3000;0;3000;2437;563;
2021-05-29 20:05:09;8993274532105;BOLU;1;1000;0;1000;833;167;
2021-05-29 20:05:09;TUSTEL;TUSUK TELINGA;1;1000;0;1000;833;167;
2021-05-29 20:05:09;8998866200882;SUKSESMIE GORENG AYAM KRMS 133GR;1;3500;0;3500;3047;453;
2021-05-29 20:05:09;8998989300261;GUDANG GARAM SURYA 12 FILTER;1;18500;0;18500;17200;1300;
2021-05-29 20:05:09;089686010343;INDOMIE SOTO MIE;4;2600;0;10400;9468;932;
2021-05-29 20:05:09;8992761139018;ADES 600ML;3;3500;0;10500;6876;3624;
2021-05-29 20:05:09;JGR;JOGER CHOCKY PASTA;1;20000;0;20000;18190;1810;
2021-05-29 20:05:09;YP;YUPI;2;250;0;500;416;84;
2021-05-29 20:05:09;JGR SHN;JOGER SHINY SACHET;1;500;0;500;437;63;
2021-05-29 20:05:09;PRG;PARAGO;1;500;0;500;400;100;
2021-05-29 20:05:10;8992984920110;CUKA DAPUR DUA BELIBIS;1;4500;0;4500;3250;1250;
2021-05-29 20:07:32;8993989311699;CLAS MILD 16 FILTER;1;23000;0;23000;21700;1300;
2021-05-29 20:07:32;9556001025272;NESCAFE LATTE 240ML;1;8500;0;8500;7834;666;
2021-05-29 20:07:32;8992696404441;BEAR BRAND 189ML;1;9000;0;9000;7887;1113;
2021-05-29 20:07:32;HT;HOT-HOT;1;500;0;500;350;150;
2021-05-29 20:07:33;8998989300261;GUDANG GARAM SURYA 12 FILTER;1;18500;0;18500;17200;1300;
2021-05-29 20:07:33;8992761139018;ADES 600ML;1;3500;0;3500;2292;1208;
2021-05-29 20:07:33;8886013257400;TWISTKO;1;1000;0;1000;900;100;
2021-05-29 20:07:33;8992957220186;COKLAT RUSA;2;2000;0;4000;3400;600;
2021-05-29 20:07:33;VTM;VITAMIN;1;500;0;500;425;75;
2021-05-29 20:07:33;8993989311279;CLAS MILD 12;1;17000;0;17000;15700;1300;
2021-05-29 20:07:33;8994935000285;MINYAK GORENG DUNIA 4500ML;1;70000;0;70000;66433;3567;
2021-05-29 20:08:42;8886013257400;TWISTKO;5;1000;0;5000;4500;500;
2021-05-29 20:08:42;8992696422735;DNCO CKLT UHT 110ML;3;2500;0;7500;6123;1377;
2021-05-29 20:09:08;HT;HOT-HOT;1;500;0;500;350;150;
2021-05-29 20:11:48;BTS;BIMURA TARO SEAWEED 250G;1;10000;0;10000;9300;700;
2021-05-29 20:11:48;8997231980022;O'JELLY MINI STRAWBERRY;1;3000;0;3000;2250;750;
2021-05-29 20:11:48;8992696523081;MILO UHT 110ML;1;2500;0;2500;1962;538;
2021-05-29 20:11:48;8998898830125;KKB ENER-G ANGGUR;1;5500;0;5500;4824;676;
2021-05-29 20:34:12;8992696430860;KOKO KRUNCH 80G;1;9000;0;9000;8063;937;
2021-05-29 20:34:12;8992696523081;MILO UHT 110ML;1;2500;0;2500;1962;538;
2021-05-29 20:39:07;8999909010567;234 16 FILTER;1;22000;0;22000;21500;500;
2021-05-29 20:39:07;8998989121163;SURYA PRO MERAH;1;20000;0;20000;18600;1400;
2021-05-29 20:39:07;8998898101409;TOLAK ANGIN SIDOMUNCUL;5;3500;0;17500;13540;3960;
2021-05-29 21:20:54;8997211230147;KERUPUK BAWANG VITARASA;1;10000;0;10000;8580;1420;
2021-05-29 21:50:41;8997027300089;NOMOS;1;4000;0;4000;2963;1037;
2021-05-29 21:50:41;8996001600399;LE MINERAL 1500ML;1;5000;0;5000;4042;958;
2021-05-30 13:04:21;8996001600665;COOL TIME;1;3500;0;3500;2750;750;
2021-05-30 13:04:21;HT;HOT-HOT;1;500;0;500;350;150;
2021-05-30 13:15:28;8994907000428;KECAP SACHET ABC;2;500;0;1000;708;292;
2021-05-30 13:41:09;BTS;BIMURA TARO SEAWEED 250G;1;10000;0;10000;9300;700;
2021-05-30 14:47:41;BTS;BIMURA TARO SEAWEED 250G;1;10000;0;10000;9300;700;
2021-05-30 15:03:54;8992959304235;SFX COMFORT SLIM 29CM 8S;1;8000;0;8000;7387;613;
2021-05-30 15:03:54;8992696404441;BEAR BRAND 189ML;2;9000;0;18000;15774;2226;
2021-05-30 15:03:54;001;PASEO SMART FACIAL SF 250S GT;1;10000;0;10000;9500;500;
2021-05-30 15:57:19;GL;GULA 1 LITER;1;11500;0;11500;10500;1000;
2021-05-30 15:57:19;VTM;VITAMIN;1;500;0;500;425;75;
2021-05-30 16:24:35;089686010190;INDOMIE KARI AYAM;2;2800;0;5600;5044;556;
2021-05-30 17:04:25;8994867000179;ROKOK PENA MILD 16;2;14500;0;29000;26000;3000;
2021-05-30 17:19:56;8992696404441;BEAR BRAND 189ML;1;9000;0;9000;7887;1113;
2021-05-30 17:19:56;6907992823669;JD MILKY STRAW;3;3000;0;9000;7800;1200;
2021-05-30 17:19:56;6907992824963;JD MILKY CHOCOLATE;2;3000;0;6000;5200;800;
2021-05-30 17:19:56;8998866202695;KOPI MAYOR;1;6000;0;6000;4500;1500;
2021-05-30 17:19:56;8992222050418;GATSBY NORMAL 38GR;1;5000;0;5000;3850;1150;
2021-05-30 17:19:56;8998866106474;POSH BLAZE PINK 150ML;1;19500;0;19500;17500;2000;
2021-05-30 17:19:56;8991111101507;JB POWDER BLOSSOM 50G;1;3500;0;3500;3000;500;
2021-05-30 17:19:56;8996001302316;MALKIST ABON SCT;1;1000;0;1000;840;160;
2021-05-30 17:19:56;HT;HOT-HOT;2;500;0;1000;700;300;
2021-05-30 17:19:56;PRG;PARAGO;1;500;0;500;400;100;
2021-05-30 17:19:56;8999909982000;SAMPOERNA 12 FILTER;1;18000;0;18000;16000;2000;
2021-05-30 17:19:56;8999999008475;SUNLIGHT LIME NEW REF 1600ML;1;33000;0;33000;29800;3200;
2021-05-30 17:19:56;8992959953327;SWEETY BRONZE L52;1;85000;0;85000;80304;4696;
2021-05-30 17:19:56;8998866501033;MINYAK GORENG SEDAAP POUCH 2L;1;28000;0;28000;27746;254;
2021-05-30 17:19:56;8999999524722;SUNLIGHT LIME NEW PCH 435ML;1;10000;0;10000;9100;900;
2021-05-30 17:19:56;711844150027;ABC NANAS;1;13000;0;13000;12241;759;
2021-05-30 17:19:56;8993470671752;JOGER STICK DUO KACANG;1;1000;0;1000;850;150;
2021-05-30 17:19:56;8998866202732;MILKU STROBERI 200ML;2;3000;0;6000;4750;1250;
2021-05-30 17:19:56;GL;GULA 1 LITER;1;11500;0;11500;10500;1000;
2021-05-30 17:19:56;8998989500166;GUDANG GARAM MERAH BESAR 16KS;1;18000;0;18000;17000;1000;
2021-05-30 17:39:33;089686611519;QTELA SINGKONG;1;5000;0;5000;4266;734;
2021-05-30 17:47:35;8997028590014;ARGUS 220ML;2;500;0;1000;604;396;
2021-05-30 18:15:07;GL;GULA 1 LITER;10;11500;0;115000;105000;10000;
2021-05-30 18:15:07;8992959508855;SWEETY SILVER PANTS XL 18;1;47800;0;47800;43353;4447;
2021-05-30 18:15:07;8850507002968;A1 KING TRUCK;1;16500;0;16500;15500;1000;
2021-05-30 20:39:04;8999999195649;SARI WANGI 25X1.86G;1;6000;0;6000;5050;950;
2021-05-30 20:39:04;VCO;VITAMIN C500 ORANGE;1;1000;0;1000;575;425;
2021-05-30 21:38:20;8998866202770;MIE SEDAAP SALERO PADANG;1;2500;0;2500;2362;138;
2021-05-30 21:38:20;8998866200301;MIE SEDAAP GORENG;1;2500;0;2500;2023;477;
2021-05-30 21:38:20;8998866200325;MIE SEDAAP SOTO;2;2500;0;5000;3904;1096;
2021-05-30 21:39:33;8999999049423;REXONA MEN RO SPORT DEFENSE 45 ML;1;15000;0;15000;13550;1450;
2021-05-30 21:39:33;8999999706449;CLOSEUP ICY WHITE 65G;1;9000;0;9000;7865;1135;
2021-05-30 21:39:33;8999999048167;SUNSILK SHP BLACK SHINE 9ML;1;10500;0;10500;9300;1200;
2021-05-30 21:39:33;8996001600221;KOPIKO 78;1;5000;0;5000;4283;717;
2021-05-30 21:40:11;JGR SHN;JOGER SHINY SACHET;1;500;0;500;437;63;
2021-05-30 21:58:25;8992628022156;BIMOLI KLASIK TOUCH 1 LT;1;15500;0;15500;14350;1150;
2021-05-30 21:59:03;ARD;SENDAL ARDILES;1;15000;0;15000;13500;1500;
2021-05-31 12:29:07;ARG;ARGUS 220ML;3;14500;0;43500;37500;6000;
2021-05-31 12:30:14;ARG;ARGUS 220ML;1;14500;0;14500;12500;2000;
2021-05-31 12:38:55;8998989300261;GUDANG GARAM SURYA 12 FILTER;1;18500;0;18500;17200;1300;
2021-05-31 12:38:55;VCO;VITAMIN C500 ORANGE;2;1000;0;2000;1150;850;
2021-05-31 12:51:24;HT;HOT-HOT;2;500;0;1000;700;300;
2021-05-31 12:51:24;8999909002821;MARLBORO BLACK 16;1;22000;0;22000;20850;1150;
2021-05-31 13:05:03;8991002307209;COFFE CANDY;2;5000;0;10000;9000;1000;
2021-05-31 13:33:54;8992959508930;SWEETY SILVER PANTS L 54;1;108000;0;108000;99697;8303;
2021-05-31 15:13:50;8998866200325;MIE SEDAAP SOTO;5;2500;0;12500;9760;2740;
2021-05-31 15:13:50;8998866202619;MIE SEDAAP KOREAN SPICY SOUP;5;2500;0;12500;11365;1135;
2021-05-31 15:13:50;089686041705;INDOMIE GORENG JUMBO;4;3500;0;14000;12572;1428;
2021-05-31 15:13:50;8991102994422;TANGO WALUT CHOCOBNN 18G;1;9000;0;9000;8661;339;
2021-05-31 15:13:50;8996001355008;BENG-BENG SP20G;1;29000;0;29000;26500;2500;
2021-05-31 15:13:50;8991102387286GT;TANGO LONG CKLT 47G;1;17000;0;17000;15517;1483;
2021-05-31 15:13:50;8999999195649;SARI WANGI 25X1.86G;2;6000;0;12000;10100;1900;
2021-05-31 15:13:50;8995333060772;TERIGU GATOT KACA 500GR;2;4500;0;9000;8130;870;
2021-05-31 15:43:43;8998989300261;GUDANG GARAM SURYA 12 FILTER;1;18500;0;18500;17200;1300;
2021-05-31 16:11:44;8998866601535;BLEACHING SOKLIN PEMUTIH 500ML;1;7000;0;7000;4880;2120;
2021-05-31 16:38:16;GL;GULA 1 LITER;1;11500;0;11500;10500;1000;
2021-05-31 16:38:16;VCO;VITAMIN C500 ORANGE;2;1000;0;2000;1150;850;
2021-05-31 17:08:09;8992696521797SCT;MILO UHT ACT GO 22G;1;2000;0;2000;1412;588;
2021-05-31 17:09:15;8996001305041;ROMA SANDWICH CKLT;1;7000;0;7000;5000;2000;
2021-05-31 17:09:15;8992957220087;COKLAT SINGA;1;2000;0;2000;1700;300;
2021-05-31 17:09:15;JGR SHN;JOGER SHINY SACHET;1;500;0;500;437;63;
2021-05-31 17:09:15;YP;YUPI;1;250;0;250;208;42;
2021-05-31 17:09:22;YP;YUPI;1;250;0;250;208;42;
2021-05-31 17:18:25;8998866501033;MINYAK GORENG SEDAAP POUCH 2L;1;28000;0;28000;27746;254;
2021-05-31 17:45:28;8992770034151;MASAKO 250GR;1;10000;0;10000;8000;2000;
2021-05-31 17:49:50;9556001025272;NESCAFE LATTE 240ML;1;8500;0;8500;7834;666;
2021-05-31 17:49:50;8997231980022;O'JELLY MINI STRAWBERRY;1;3000;0;3000;2250;750;
2021-05-31 17:49:50;8991001503114;CHACHA MILK CHOCOLATE 35G;1;5500;0;5500;4900;600;
2021-05-31 17:49:50;ff;FULLO BLASTO;1;1000;0;1000;995;5;
2021-05-31 18:18:04;8998866202930;SEDAAP AYAM JERIT CUP;1;4500;0;4500;3738;762;
2021-05-31 18:18:04;HT;HOT-HOT;1;500;0;500;350;150;
2021-05-31 18:29:29;VTM;VITAMIN;2;500;0;1000;850;150;
2021-05-31 18:30:59;8999999195656;SARI WANGI 50X1.85;1;10000;0;10000;9500;500;
2021-05-31 18:38:33;8998866202930;SEDAAP AYAM JERIT CUP;1;4500;0;4500;3738;762;
2021-05-31 18:38:33;8998866202671;NOODLE SEDAAP MIE KOREAN SPICY SOUP CUP;1;5000;0;5000;4002;998;
2021-05-31 18:38:33;HT;HOT-HOT;1;500;0;500;350;150;
2021-05-31 18:51:10;6907992823669;JD MILKY STRAW;1;3000;0;3000;2600;400;
2021-05-31 18:51:10;6907992824963;JD MILKY CHOCOLATE;2;3000;0;6000;5200;800;
2021-05-31 19:00:53;6907992824963;JD MILKY CHOCOLATE;1;3000;0;3000;2600;400;
2021-05-31 19:00:53;VTM;VITAMIN;2;500;0;1000;850;150;
2021-05-31 19:13:36;089686049053;SARIMI PUAS;1;3000;0;3000;2400;600;
2021-05-31 19:25:51;8991102022347;SIKAT GIGI FORMULA RIPPLE;1;5000;0;5000;4583;417;
2021-05-31 19:25:51;8999999534097;PEPSODENT PGB FCM 75G;1;5000;0;5000;3850;1150;
2021-05-31 19:25:51;BB;PASEO SMARTY FACIAL TRAVEL PACK 50S GT;1;3000;0;3000;1980;1020;
2021-05-31 19:25:51;8999999558086;RINSO MOLTO FERFUME ESSENSE PWD 44G;5;1000;0;5000;4025;975;
2021-05-31 19:25:51;8993324850449;BABY LOVE COTTON BUDS;1;5000;0;5000;4500;500;
2021-05-31 19:25:51;8996001350423;ZUPER KEJU;1;9200;0;9200;8360;840;
2021-05-31 19:27:51;8997021870090;FRESH CARE LAVENDER 10ML;1;12000;0;12000;10000;2000;
2021-05-31 19:28:35;8996001600146;TEH PUCUK HARUM 350ML;1;3000;0;3000;2314;686;
2021-05-31 19:28:35;8992761145019;COCA COLA PET 250ML;1;3500;0;3500;2417;1083;
2021-05-31 19:30:43;8992761145019;COCA COLA PET 250ML;1;3500;0;3500;2417;1083;
2021-05-31 19:48:03;8998866610438;SOKLIN SOFTERGENT RED BAG 770G & PIRING;1;18000;0;18000;16680;1320;
2021-05-31 19:58:07;6291100212866;KURMA KHALAS;1;85000;0;85000;80000;5000;
2021-05-31 20:25:15;8992959509005;SWEETY SILVER PANTS XL26;1;61500;0;61500;55910;5590;
2021-05-31 20:25:48;HT;HOT-HOT;1;500;0;500;350;150;
2021-05-31 21:03:47;8992696422735;DNCO CKLT UHT 110ML;1;2500;0;2500;2041;459;
2021-05-31 21:03:47;089686010190;INDOMIE KARI AYAM;1;2800;0;2800;2522;278;
2021-05-31 21:03:47;8991102989428SCT;TANGO CKLT 24G SCT;1;1000;0;1000;609;391;
2021-05-31 21:03:47;8992957220087;COKLAT SINGA;1;2000;0;2000;1700;300;
2021-05-31 21:03:47;HT;HOT-HOT;2;500;0;1000;700;300;
2021-05-31 21:03:47;bb;BENG-BENG;1;1500;0;1500;1450;50;
2021-05-31 21:12:46;8997025914059;HATARI SEE HONG;1;6000;0;6000;4911;1089;
2021-05-31 21:13:23;089686611878;QTELA TEMPE;1;6000;0;6000;5370;630;
2021-05-31 21:13:23;8996001600221;KOPIKO 78;1;5000;0;5000;4283;717;
2021-05-31 21:13:23;PRG;PARAGO;2;500;0;1000;800;200;
2021-05-31 21:45:54;8998989300261;GUDANG GARAM SURYA 12 FILTER;1;18500;0;18500;17200;1300;
2021-05-31 22:10:08;8999909096004;SAMPOERNA 16 FILTER;1;24000;0;24000;23000;1000;
2021-05-31 22:10:08;8998989300261;GUDANG GARAM SURYA 12 FILTER;1;18500;0;18500;17200;1300;
2021-05-31 22:11:29;8999999552800;LUX YUZU BLOSSOM 75G;1;3500;0;3500;2800;700;
2021-05-31 22:11:29;8998866608718;DAIA SOFTENER PINK;1;5000;0;5000;4450;550;
2021-05-31 22:11:29;8998866202770;MIE SEDAAP SALERO PADANG;1;2500;0;2500;2362;138;
2021-05-31 22:12:44;8993072153595;LARISST COTTON 35G;1;5000;0;5000;3300;1700;
2021-05-31 22:22:59;8991111109107;JB POWDER BEDTIME 75+25g;1;6000;0;6000;5440;560;
2021-05-31 22:34:27;8998866201865;KRISBEE PILLOW CHOCOLAVA 120 GR;1;8000;0;8000;7250;750;
2021-05-31 22:34:27;8996001600146;TEH PUCUK HARUM 350ML;2;3000;0;6000;4628;1372;
2021-05-31 22:34:27;VCL;VITAMIN C500 LEMON;1;1000;0;1000;575;425;
