date,barcode,name,count,price,discount,total,buy_price,margin
1/11/2021 12:38,8999999034061,ZWITSAL BAT NAT HAIR&BODY  300ML,1,28700,0,28700,26125,2575
1/11/2021 12:38,8999999706661,PEPSODENT TB DBL CARE SENSITIVE,3,11500,0,34500,31200,3300
1/11/2021 12:38,8999999008475,SUNLIGHT LIME NEW REF 1600ML,1,33000,0,33000,29800,3200
1/11/2021 12:40,8992747180225,VIXAL PEMB PORS BIRU 720ML,1,18000,0,18000,16940,1060
1/11/2021 12:50,8998009020186,BBUAVITA GUAVA 250ML,9,6500,0,58500,53550,4950
1/11/2021 12:50,8998009020520,BUAVITA MINI GUAVA 125ML,8,5800,0,46400,42000,4400
1/11/2021 12:50,8999999042936,ZWITSAL BB SPA GIFT BOX,1,110000,0,110000,99715,10285
1/11/2021 16:54,8999999706111,PEPSODENT WHITE 25G,1,2000,0,2000,1450,550
1/11/2021 16:54,8999999049508,REXONA WMN RO SHOWER CLEAN 45 ML,1,15000,0,15000,13500,1500
1/11/2021 16:54,8999999036690,LUX TS MAGICAL ORCHID,1,3500,0,3500,2800,700
1/11/2021 19:12,8999999528935,CITRA HBL NATURAL GLOWING WHITE 120ML,1,12000,0,12000,10080,1920
1/11/2021 19:12,8999999048181,SUNSILK BLK SHINE 170ML,1,20000,0,20000,18150,1850
1/11/2021 19:12,8999999027261,LIFEBUOY BW LEMONFRESH LD REFF 450 ML,1,25000,0,25000,22110,2890
1/11/2021 19:14,8999999027261,LIFEBUOY BW LEMONFRESH LD REFF 450 ML,1,25000,0,25000,22110,2890
1/11/2021 19:14,8999999528935,CITRA HBL NATURAL GLOWING WHITE 120ML,1,12000,0,12000,10080,1920
1/11/2021 19:14,8999999048181,SUNSILK BLK SHINE 170ML,1,20000,0,20000,18150,1850
1/11/2021 19:17,8999999524722,SUNLIGHT LIME NEW PCH 435ML,1,10000,0,10000,9100,900
1/11/2021 19:17,8999999706173,PEPSODENT WHITE 120G,1,6700,0,6700,5940,760
1/11/2021 19:30,8999999552497,ZWITSAL KIDS SHP BLUE  CLN&FRSH 180 ML,1,15000,0,15000,13695,1305
1/11/2021 19:39,8999999552503,ZWITSAL KIDS SHP PINK SOFT&MSTR 180 ML,1,15000,0,15000,13695,1305
1/11/2021 19:39,8991102385091,WFR TANGO CKLT 7G,1,8300,0,8300,7455,845
1/12/2021 16:49,8999999042646,RINSO MOLTO PERFUME ESSENCE LIQ 40ML,1,11000,0,11000,9633,1367
1/12/2021 17:05,8999999042592,RINSO MOLTO PERFUME ESSENSE LIQ 4OML,1,5500,0,5500,4817,683
1/12/2021 17:36,8998009020520,BUAVITA MINI GUAVA 125ML,2,5800,0,11600,10500,1100
1/13/2021 20:09,8999999710880,PEPSODENT ACTION123 HERBAL 75G,1,7500,0,7500,6650,850
1/13/2021 20:09,8999999520151,PEPSODENT TB FAMILY SOFT,1,2100,0,2100,1900,200
1/15/2021 16:26,8999999544409,MOLTO DETERGEN CARE PURPLE PCH 700ML,1,20500,0,20500,18570,1930
1/15/2021 20:15,8999999514006,BANGO MANIS 60ML,2,3000,0,6000,4800,1200
1/17/2021 15:03,8998009020520,BUAVITA MINI GUAVA 125ML,2,5800,0,11600,10500,1100
1/17/2021 15:04,8999999035532,VASELINE NIGHT REPAIR 200ML,1,33800,0,33800,30855,2945
1/17/2021 15:09,8998866202619,SEDAAP MIE KOREAN SPICY SOUP BAG 77 GR,1,2300,0,2300,2027,273
1/17/2021 15:09,8998866202343,NOODLE SEDAAP MIE KOREAN SPICY 87 GR,1,2500,0,2500,2023,477
1/18/2021 12:59,8999999401238,RINSO ANTI NODA 770G,1,21200,0,21200,19338,1862
1/18/2021 21:20,8991102303309,WFR TANGO SBJ 176G,1,9200,0,9200,8336,864
1/19/2021 0:14,8999999706111,PEPSODENT WHITE 25G,1,2000,0,2000,1450,550
1/19/2021 0:14,8999999520151,PEPSODENT TB FAMILY SOFT,1,2100,0,2100,1900,200
1/19/2021 10:08,8996001600269,LE MINERAL 600ML,3,3000,0,9000,5064,3936
1/19/2021 17:45,8998866202770,SEDAAP MIE GORENG SALERO PADANG 86 GR,2,2300,0,4600,4046,554
1/19/2021 19:56,001,PASEO SMART FACIAL SF 250S GT,1,10000,0,10000,8700,1300
1/20/2021 9:09,8991102987875,WFR TANGO POUCH CKL 115G,1,7000,0,7000,6273,727
1/20/2021 9:09,8997025911706,HATARI SHP MARGARINE,1,5000,0,5000,4763,237
1/20/2021 15:50,8998866200646,KOPI TOP MURNI,1,11000,0,11000,9600,1400
1/20/2021 17:39,BMCC,BIMURA POTATO CINCIN 250G,1,10000,0,10000,9300,700
1/20/2021 17:39,8999999053048,PONDS FACIAL FOAM 100G,1,27000,0,27000,24900,2100
1/20/2021 19:03,8999999530266,LIFEBUOY MATCHA GREENTEA 100ML,1,10500,0,10500,9405,1095
1/20/2021 19:03,8998866201469,POTABEE REGULER BBQ BEEF 68 GR,1,8000,0,8000,7200,800
1/20/2021 22:13,8998866202435,JAPOTA UMAMI JAPANESE SEAWEED 35GR,1,5000,0,5000,4150,850
1/20/2021 23:31,8992753720606,OMELA 490G,1,12000,0,12000,10531,1469
1/20/2021 23:42,8999999552442,FAIR&LOVELY MV SRM SHEET MASK 20 MG,1,8500,0,8500,7500,1000
1/21/2021 9:34,8991102384841,WFR TANGO LONG CKLT 130G,1,4200,0,4200,3773,427
1/21/2021 10:16,8998866611220,FRES&NATURAL PUTIH 100ML,1,11500,0,11500,10310,1190
1/21/2021 12:06,8993365125032,MADU TJ SUPER 500G,2,43000,0,86000,81260,4740
1/21/2021 12:06,8991102303309,WFR TANGO SBJ 176G,2,9200,0,18400,16672,1728
1/21/2021 12:06,8991102300544,WFR TANGO VNL 176G,2,9200,0,18400,16672,1728
1/21/2021 12:06,8991004011906,KOPI BORONG,3,10000,0,30000,24999,5001
1/21/2021 12:09,089686010824,INDOMIE GORENG SPESIAL,1,2700,0,2700,2452,248
1/21/2021 12:20,089686060027,POP MIE AYAM JUMBO,2,4200,0,8400,7666,734
1/21/2021 12:23,8996001355008,BENG-BENG SP20G,1,29200,0,29200,26500,2700
1/21/2021 12:23,8998866106979,SIKAT GIGI,1,6000,0,6000,5000,1000
1/21/2021 12:49,8999999554286,SAHAJA PMBRSH LANTAI KNTM BUNGA JERUK 350ML,1,5000,0,5000,4450,550
1/21/2021 12:50,8999999554286,SAHAJA PMBRSH LANTAI KNTM BUNGA JERUK 350ML,1,5000,0,5000,4450,550
1/21/2021 12:58,8992753100101,BKM FULL CREAM GOLD 370,4,15000,0,60000,56000,4000
1/21/2021 13:29,BR,BERAS 10L,1,86500,0,86500,85000,1500
1/21/2021 13:32,001,PASEO SMART FACIAL SF 250S GT,2,10000,0,20000,17400,2600
1/21/2021 13:52,GL,GULA 1 LITER,5,10500,0,52500,50000,2500
1/21/2021 14:05,GL,GULA 1 LITER,60,10500,0,630000,600000,30000
1/21/2021 14:05,8998866501026,MINYAK GORENG SEDAAP POUCH 1 L,60,14500,0,870000,846600,23400
1/21/2021 14:09,GL,GULA 1 LITER,1,10500,0,10500,10000,500
1/21/2021 14:20,8998866108126,POSH HIJAB WINTER MAGIC 150ML,1,19500,0,19500,17500,2000
1/21/2021 14:20,8999999059903,PONDS AGE MIRACLE DAY CREAM 10G,1,28500,0,28500,25850,2650
1/21/2021 14:20,8999999706081,PEPSODENT WHITE 75G,1,4300,0,4300,3850,450
1/21/2021 14:20,8999999525088,MOLTO AIO BLUE SPK 250ML,1,9800,0,9800,8910,890
1/21/2021 14:20,8999999052959,PONDS WHITE BEAUTY FACIAL FOAM 50G,1,17000,0,17000,15600,1400
1/21/2021 14:24,8992775311615,CHOCOLATOS,1,12000,0,12000,9983,2017
1/21/2021 14:24,8996001355008,BENG-BENG SP20G,1,29200,0,29200,26500,2700
1/21/2021 14:24,8997231980039,O`JELLY KONYAKU (MAXI APPLE STRAWBERRY),1,5000,0,5000,4620,380
1/21/2021 14:24,8998866200301,NOODLE SEDAAP GORENG  90 GR,2,2500,0,5000,4046,954
1/21/2021 14:24,089686043204,INDOMIE MIE ACEH,1,2700,0,2700,2452,248
1/21/2021 14:24,8851019230573,POCKY STRAWBERRY 21G,1,5000,0,5000,3001,1999
1/21/2021 14:24,8991111109121,JB POWDER BLOSSOM 75+25G,1,6000,0,6000,5430,570
1/21/2021 14:24,8991001503114,CHACHA MILK CHOCOLATE 35G,1,5500,0,5500,4900,600
1/21/2021 14:24,8992775001042,PILUS GARUDA MI GORENG,1,5500,0,5500,4713,787
1/21/2021 14:24,8991001111883,SILVERQQUEEN CHUNKYBAR 33G,1,8000,0,8000,7150,850
1/21/2021 14:24,8991111101316,JB OIL 50ML,1,9500,0,9500,8700,800
1/21/2021 14:35,GL,GULA 1 LITER,1,10500,0,10500,10000,500
1/21/2021 14:43,8991102303309,WFR TANGO SBJ 176G,2,9200,0,18400,16672,1728
1/21/2021 14:43,BMCC,BIMURA POTATO CINCIN 250G,1,10000,0,10000,9300,700
1/21/2021 14:43,8991102281416,PERMEN MINTZ PPMINT,1,4500,0,4500,4000,500
1/21/2021 14:43,8998866108119,PO0SH HIJAB PURPLE WISH 150ML,1,19500,0,19500,17500,2000
1/21/2021 14:43,8991111101422,JB POWDER 200G,1,11700,0,11700,10660,1040
1/21/2021 14:43,8999999520175,REXONA WMN RO INVISIBLE ANTIBACT 45 ML,1,16500,0,16500,14900,1600
1/21/2021 14:45,8991102385091,WFR TANGO CKLT 7G,1,8300,0,8300,7455,845
1/21/2021 14:45,8996001370063,CHOKI-CHOKI,1,18200,0,18200,16500,1700
1/21/2021 14:45,8992775311325,GERY SNACK&SEREAL 100G,2,7000,0,14000,11784,2216
1/21/2021 14:46,8992775001691,GARUDA ROSTA WAGYU BEEF,1,8000,0,8000,7176,824
1/21/2021 14:47,SMC,BIMURA MAKARONI CINCIN 250G,2,10000,0,20000,18600,1400
1/21/2021 14:49,8998866202466,JAPOTA HAPPY HONEY BUTTER,1,5000,0,5000,4150,850
1/21/2021 14:49,BTS,BIMURA TARO SEAWEED 250G,1,10000,0,10000,9300,700
1/21/2021 14:49,8999999049423,REXONA MEN RO SPORT DEFENSE 45 ML,1,15000,0,15000,13550,1450
1/21/2021 15:00,8851019510132,POCKY,1,7300,0,7300,7000,300
1/21/2021 15:00,8996001320136,KOPIKO CAPP CANDY,1,6200,0,6200,5600,600
1/21/2021 15:11,8999999719401,VASELINE HW UV LIGHTENING PJ 400ML,1,43800,0,43800,39734,4066
1/21/2021 15:11,8999999049447,REXONA WMN RO ADVANCED WHITE 45 ML,1,16500,0,16500,14900,1600
1/21/2021 15:11,8999999048501,SUNSILK RFR ANTI DDRF 170ML,1,22200,0,22200,20020,2180
1/21/2021 15:13,8991001111883,SILVERQQUEEN CHUNKYBAR 33G,1,8000,0,8000,7150,850
1/21/2021 15:20,8996001320136,KOPIKO CAPP CANDY,1,6200,0,6200,5600,600
1/21/2021 15:20,BPO,BIMURA POTATO ORIGINAL 250G,1,10000,0,10000,9300,700
1/21/2021 15:20,8998866103985,CIPT SIKP,1,3000,0,3000,2552,448
1/21/2021 15:20,8999999706081,PEPSODENT WHITE 75G,1,4300,0,4300,3850,450
1/21/2021 15:20,8999999719401,VASELINE HW UV LIGHTENING PJ 400ML,1,43800,0,43800,39734,4066
1/21/2021 15:20,8999999037765,PEPSODENT WHITE 225G,1,11800,0,11800,10750,1050
1/21/2021 15:20,8999999524722,SUNLIGHT LIME NEW PCH 435ML,1,10000,0,10000,9100,900
1/21/2021 15:20,8999999048167,SUNSILK SHP BLACK SHINE 9ML,1,10500,0,10500,9300,1200
1/21/2021 15:22,BTS,BIMURA TARO SEAWEED 250G,1,10000,0,10000,9300,700
1/21/2021 15:22,SMC,BIMURA MAKARONI CINCIN 250G,1,10000,0,10000,9300,700
1/21/2021 15:23,8999999031602,SARI MURNI 20X1.6G,1,6000,0,6000,5400,600
1/21/2021 15:23,8998866610070,SOKLIN SOFTERGEN 280G PURPLE,1,5000,0,5000,4425,575
1/21/2021 15:23,BPO,BIMURA POTATO ORIGINAL 250G,1,10000,0,10000,9300,700
1/21/2021 15:41,8993470411433,JOGER CLASSIC,1,1000,0,1000,850,150
1/21/2021 16:08,8999999528829,CITRA SAKURA FAIR UV 120ML,1,11200,0,11200,10082,1118
1/21/2021 16:15,SMC,BIMURA MAKARONI CINCIN 250G,2,10000,0,20000,18600,1400
1/21/2021 16:16,8997025911058,HATARI SHP KELAPA,5,5000,0,25000,23815,1185
1/21/2021 16:22,8991001005007,TOP BLACK WHITE,4,22000,0,88000,78720,9280
1/21/2021 16:22,8991001903570,TOP CHOCOLATE,2,22000,0,44000,39360,4640
1/21/2021 16:22,8991001121400,SILVERQUEEN ALMOND 65G,4,15000,0,60000,52800,7200
1/21/2021 16:22,8992775312469,GERY SALUT COKELAT,1,11000,0,11000,9983,1017
1/21/2021 17:04,8851019230573,POCKY STRAWBERRY 21G,1,5000,0,5000,3001,1999
1/21/2021 18:08,089686010107,INDOMIE KALDU AYAM,2,2500,0,5000,4310,690
1/21/2021 18:08,8998866602389,GIV UNGU KOTAK 76G,1,2000,0,2000,1820,180
1/21/2021 18:08,GL,GULA 1 LITER,2,10500,0,21000,20000,1000
1/21/2021 18:11,8998866501033,MINYAK GORENG SEDAAP POUCH 2L,2,28500,0,57000,55492,1508
1/21/2021 18:15,8851019230573,POCKY STRAWBERRY 21G,2,5000,0,10000,6002,3998
1/21/2021 19:09,8998866202060,PTABEE AYAM BAKAR PEDAS 35 GREXT15,1,4800,0,4800,4150,650
1/21/2021 19:23,001,PASEO SMART FACIAL SF 250S GT,1,10000,0,10000,8700,1300
1/21/2021 19:23,8999999540159,VASELINE REPAIRING JELLY ALOE 50ML,1,23000,0,23000,21333,1667
1/21/2021 19:23,8992959974018,SFX SIRIH 36CM 12+1,1,12000,0,12000,10686,1314
1/21/2021 19:23,8992959117590,SFX DS REG FLOW WING 20,1,12000,0,12000,11250,750
1/21/2021 20:18,8998866202244,EKOMIE BUMBU KALDU AYAM,2,1000,0,2000,1720,280
1/21/2021 20:28,8991001502933,CHACHA TUBE,1,7500,0,7500,6400,1100
1/21/2021 20:28,8851019230566,POCKY CHOCO 22G,1,5000,0,5000,3001,1999
1/21/2021 20:28,8851019510132,POCKY,1,7300,0,7300,7000,300
1/21/2021 20:59,8992775311615,CHOCOLATOS,1,12000,0,12000,9983,2017
1/21/2021 20:59,8996001350850,SUPER STAR SNAPS,1,16300,0,16300,14800,1500
1/21/2021 20:59,8998866201483,POTABEE REGULER GRILLED SEAWEED 35GR,1,4800,0,4800,4150,650
1/21/2021 20:59,8991001780133,TWISTER BLACK,1,5000,0,5000,4600,400
1/21/2021 20:59,8992753182206,FF MILKY CKLT 180ML,1,4500,0,4500,3250,1250
1/21/2021 20:59,8851019230566,POCKY CHOCO 22G,1,5000,0,5000,3001,1999
1/21/2021 20:59,8851019210117,POCKY CHOCOLATE 47G,1,7300,0,7300,5671,1629
1/21/2021 20:59,8991102987875,WFR TANGO POUCH CKL 115G,2,7000,0,14000,12546,1454
1/21/2021 20:59,8992775311325,GERY SNACK&SEREAL 100G,1,7000,0,7000,5892,1108
1/21/2021 20:59,8991001503114,CHACHA MILK CHOCOLATE 35G,2,5500,0,11000,9800,1200
1/21/2021 21:01,8992388111145,MIE ABC SELERA PEDAS- SUP TOMAT PEDAS,2,2500,0,5000,4046,954
1/21/2021 21:01,8998866202312,NOODLE SEDAAP TASTY BAKMI AYAM 129 GR,1,5000,0,5000,4167,833
1/21/2021 21:01,8996001600146,TEH PUCUK HARUM 350ML,1,3000,0,3000,2314,686
1/21/2021 21:14,8997213204900,INLITE 30W,1,110000,0,110000,105000,5000
1/21/2021 23:57,8992753100101,BKM FULL CREAM GOLD 370,2,15000,0,30000,28000,2000
1/22/2021 7:50,8993470411433,JOGER CLASSIC,1,1000,0,1000,850,150
1/22/2021 7:56,8996001355237,SUPER STAR,1,11000,0,11000,9900,1100
1/22/2021 7:56,8995333060703,TERIGU KOMPAS,2,10500,0,21000,19632,1368
1/22/2021 7:56,8998866608008,KECAP MANIS SEDAAP BOTOL 135 ML,1,6300,0,6300,5615,685
1/22/2021 7:56,11,PASEO SMART FHSTD PERF 6P 12S,1,5000,0,5000,4264,736
1/22/2021 7:56,8997002060168,KRP SINGKOG PDS PANDA DUO,1,8000,0,8000,7300,700
1/22/2021 8:00,8997013790108,BIMURA KACANG TELUR 25G,1,1000,0,1000,875,125
1/22/2021 8:58,001,PASEO SMART FACIAL SF 250S GT,3,10000,0,30000,26100,3900
1/22/2021 8:58,8992753100101,BKM FULL CREAM GOLD 370,1,15000,0,15000,14000,1000
1/22/2021 8:58,089686061024,POP MIE MINI SOTO RL,4,3000,0,12000,10808,1192
1/22/2021 8:59,8999999031602,SARI MURNI 20X1.6G,1,6000,0,6000,5400,600
1/22/2021 12:02,8998866202244,EKOMIE BUMBU KALDU AYAM,1,1000,0,1000,860,140
1/22/2021 13:13,8996001600146,TEH PUCUK HARUM 350ML,1,3000,0,3000,2314,686
1/22/2021 13:14,8998866202770,SEDAAP MIE GORENG SALERO PADANG 86 GR,1,2300,0,2300,2023,277
1/22/2021 16:11,8998866201377,KRISBEE FRIES KENTANG GORENG 68 GR,2,5500,0,11000,9240,1760
1/22/2021 16:11,8991001502933,CHACHA TUBE,1,7500,0,7500,6400,1100
1/22/2021 17:26,8999999707835,CLOSEUP GREEN 65G,1,7000,0,7000,6000,1000
1/22/2021 17:26,8999999034023,VASELINE MEN ANTI ACNE 50G,1,17000,0,17000,15400,1600
1/22/2021 17:44,8998866202060,PTABEE AYAM BAKAR PEDAS 35 GREXT15,1,4800,0,4800,4150,650
1/22/2021 17:46,8998866202770,SEDAAP MIE GORENG SALERO PADANG 86 GR,1,2300,0,2300,2023,277
1/22/2021 19:41,8998866201889,KRISBEE PILLOW STRAWBERRY ICE CREAM 120GR,1,8200,0,8200,7250,950
1/22/2021 19:41,8999999001124,LIFEBUOY MILD CARE REF 250ML,1,15000,0,15000,13550,1450
1/22/2021 19:41,8998009010569,ULTRA CHO 200,1,4700,0,4700,3830,870
1/22/2021 19:41,8996001351918,ZUPER KEJU CHOCO,1,17000,0,17000,15500,1500
1/22/2021 19:42,8991001780133,TWISTER BLACK,1,5000,0,5000,4600,400
1/22/2021 20:56,8999999033132,LIFEBUOY PERAWATAN RMBT RNTK 170ML,1,16500,0,16500,14950,1550
1/22/2021 20:56,8991102989428,WFR TANGO LONG CKLT 24G GTG,1,7500,0,7500,6714,786
1/22/2021 20:56,8999999055752,FAIR&LOVELY MVIT FC FOAM 9 G,2,3500,0,7000,4900,2100
1/22/2021 20:59,SBR,MINYAK GORENG SABRINA POUCH 2L,24,26753,0,642072,642072,0
1/22/2021 21:04,MNY,MINYAK GORENG SEDAAP POUCH 2L,45,33297,0,1498365,1498365,0
1/22/2021 22:17,8998866501026,MINYAK GORENG SEDAAP POUCH 1 L,12,14500,0,174000,169320,4680
1/22/2021 22:20,8998866200301,NOODLE SEDAAP GORENG  90 GR,1,2500,0,2500,2023,477
1/22/2021 22:20,8998866200325,NOODLE SEDAAP MIE SOTO,1,2200,0,2200,1952,248
1/22/2021 22:20,8996001305041,ROMA SANDWICH CKLT,1,7000,0,7000,5000,2000
1/22/2021 22:30,8998898853100,SUSU JAHE,1,13000,0,13000,11800,1200
1/23/2021 8:39,8997025914059,HATARI SEE HONG,1,5000,0,5000,4763,237
1/23/2021 8:39,8999999556341,MOLTO EDP PINK ROSE 20ML,1,1000,0,1000,800,200
1/23/2021 8:39,001,PASEO SMART FACIAL SF 250S GT,1,10000,0,10000,8700,1300
1/23/2021 10:48,8998866611725,EKONOMI PENCUCI PIRING  LIQ 290ML,1,5000,0,5000,4200,800
1/23/2021 11:03,8998866202305,KECAP MANIS SEDAAP SPC BOTOL 135ML,1,6800,0,6800,6150,650
1/23/2021 11:28,8992761111533,SPRITE SLIM CAM250ML,1,4800,0,4800,3750,1050
1/23/2021 14:58,8992753101207,BENDERA KENTAL MANIS 370G,1,11500,0,11500,9700,1800
1/23/2021 16:31,8992957220186,COKLAT RUSA,1,2000,0,2000,1700,300
1/23/2021 16:49,8995150101696,M+SUSU ORIGINAL,1,5000,0,5000,4000,1000
1/23/2021 16:54,8991001780133,TWISTER BLACK,2,5000,0,10000,9200,800
1/23/2021 16:54,8991111101408,JB POWSER 50G,1,3500,0,3500,3000,500
1/23/2021 17:02,8999999045913,LIFEBUOY MILDCARE 110GR,1,4000,0,4000,3500,500
1/23/2021 17:09,8999999045913,LIFEBUOY MILDCARE 110GR,3,4000,0,12000,10500,1500
1/23/2021 17:56,8997231980039,O`JELLY KONYAKU (MAXI APPLE STRAWBERRY),1,5000,0,5000,4620,380
1/23/2021 17:57,8998866202237,NOODLE SEDAAP TASTY AYAM GEPREK 124 GR,1,5000,0,5000,4167,833
1/23/2021 18:09,8998866501033,MINYAK GORENG SEDAAP POUCH 2L,1,28500,0,28500,27746,754
1/23/2021 18:09,8992753720606,OMELA 490G,1,12000,0,12000,10531,1469
1/23/2021 18:13,8991102384841,WFR TANGO LONG CKLT 130G,1,4200,0,4200,3773,427
1/24/2021 8:50,8991102380805,FULLO  CKL PCK 8G,1,10000,0,10000,9000,1000
1/24/2021 8:50,8996001304143,SLAI OLAI NANAS,1,12000,0,12000,9900,2100
1/24/2021 8:50,8850507002968,A1 KING TRUCK,1,16500,0,16500,15500,1000
1/24/2021 9:51,8993365122536,MADU TJ SUPER 250G,2,25000,0,50000,45560,4440
1/24/2021 9:52,8997021870328,HOT IN CREAM 120ML,1,18500,0,18500,17000,1500
1/24/2021 9:54,8998866610070,SOKLIN SOFTERGEN 280G PURPLE,1,5000,0,5000,4425,575
1/24/2021 9:56,34678,SENDAL JEPIT,1,14000,0,14000,13500,500
1/24/2021 10:00,ARD,SENDAL ARDILES,1,15000,0,15000,13500,1500
1/24/2021 10:00,8999999502393,ROYCO FDS CHICKEN 8G,1,5000,0,5000,4500,500
1/24/2021 15:18,GL,GULA 1 LITER,3,10500,0,31500,34500,-3000
1/24/2021 16:29,8886020033431,KAPUR AJAIB BAGUS,2,3000,0,6000,5400,600
1/24/2021 16:29,8998866201711,KRISBEE KRUNCHY JAGUNG BAKAR MENTEGA 75 GR,2,5000,0,10000,8800,1200
1/24/2021 16:29,8998866201483,POTABEE REGULER GRILLED SEAWEED 35GR,2,4800,0,9600,8300,1300
1/24/2021 16:29,8996001338056,TAMARIN,2,5600,0,11200,10200,1000
1/24/2021 16:31,GL,GULA 1 LITER,2,11500,0,23000,21000,2000
1/24/2021 17:36,8998866202770,SEDAAP MIE GORENG SALERO PADANG 86 GR,2,2300,0,4600,4046,554
1/24/2021 17:52,GL,GULA 1 LITER,2,11500,0,23000,21000,2000
1/24/2021 17:52,001,PASEO SMART FACIAL SF 250S GT,1,10000,0,10000,8700,1300
1/24/2021 17:52,8991001502933,CHACHA TUBE,1,7500,0,7500,6400,1100
1/24/2021 17:52,8992959117583,SFX DS REG FLOW WING 20,1,5000,0,5000,4288,712
1/24/2021 19:38,KR,KRESEK,1,100,0,100,99,1
1/24/2021 19:38,8998866608312,GIV PAPAYA KOTAK 76GR,1,2000,0,2000,1820,180
1/24/2021 19:38,8998866803694,SOKLIN SOFTERGENT PURPLE BAG 770 & PIRING,1,18000,0,18000,16055,1945
1/24/2021 19:44,ARG,ARGUS 220ML,1,14500,0,14500,12500,2000
1/24/2021 20:57,123,BETREI JAM,1,5500,0,5500,5000,500
1/24/2021 20:59,001,PASEO SMART FACIAL SF 250S GT,1,10000,0,10000,8700,1300
1/24/2021 21:18,8998866202244,EKOMIE BUMBU KALDU AYAM,5,1000,0,5000,4300,700
1/24/2021 21:18,GL,GULA 1 LITER,1,11500,0,11500,10500,1000
1/24/2021 21:18,8997025911058,HATARI SHP KELAPA,1,5000,0,5000,4763,237
1/24/2021 22:10,8999999030179,PEPSODENT ACTION 123 COMPLETE 75G,1,6700,0,6700,5170,1530
1/24/2021 22:10,8999999024772,VASELINE HW PERFECT 10 100 ML,1,19000,0,19000,17600,1400
1/24/2021 22:36,089686010343,INDOME SOTO MIE,2,2600,0,5200,4734,466
1/24/2021 22:36,8998866200882,NOODLE SUKSESMIE GORENG AYAM KRMS 133GR,2,3500,0,7000,6000,1000
1/25/2021 9:53,8991102384841,WFR TANGO LONG CKLT 130G,1,4200,0,4200,3773,427
1/25/2021 9:56,8996001600375,LE MINERAL 330ML,1,2000,0,2000,1417,583
1/25/2021 10:13,8998898847109,KOPI JAHE,2,1500,0,3000,2360,640
1/25/2021 11:22,8998866202770,SEDAAP MIE GORENG SALERO PADANG 86 GR,1,2300,0,2300,2023,277
1/25/2021 11:25,8998866200325,NOODLE SEDAAP MIE SOTO,1,2200,0,2200,1952,248
1/25/2021 11:37,8992957220087,COKLAT SINGA,1,2000,0,2000,1700,300
1/25/2021 11:37,8991001111883,SILVERQQUEEN CHUNKYBAR 33G,1,8000,0,8000,7150,850
1/25/2021 11:39,8996001600269,LE MINERAL 600ML,2,3000,0,6000,3376,2624
1/25/2021 11:40,8991102384841,WFR TANGO LONG CKLT 130G,1,4200,0,4200,3773,427
1/25/2021 11:40,8996001600269,LE MINERAL 600ML,1,3000,0,3000,1688,1312
1/25/2021 12:27,089686010107,INDOMIE KALDU AYAM,2,2500,0,5000,4310,690
1/25/2021 12:56,8851019230573,POCKY STRAWBERRY 21G,1,5000,0,5000,3001,1999
1/25/2021 12:56,8851019230566,POCKY CHOCO 22G,1,5000,0,5000,3001,1999
1/25/2021 14:54,089686010107,INDOMIE KALDU AYAM,6,2500,0,15000,12930,2070
1/25/2021 17:22,8992959117514,SFX NON WING 20,1,10000,0,10000,9091,909
1/25/2021 18:18,8851019230566,POCKY CHOCO 22G,2,5000,0,10000,6002,3998
1/25/2021 18:18,8991001121400,SILVERQUEEN ALMOND 65G,1,15000,0,15000,13200,1800
1/25/2021 19:09,8998866200325,NOODLE SEDAAP MIE SOTO,1,2200,0,2200,1952,248
1/25/2021 20:25,8999999524722,SUNLIGHT LIME NEW PCH 435ML,1,10000,0,10000,9100,900
1/25/2021 21:24,8999999555122,MOLTO K-ROMANCE 20ML,6,1000,0,6000,4800,1200
1/25/2021 21:24,8999999502393,ROYCO FDS CHICKEN 8G,1,5000,0,5000,4500,500
1/25/2021 21:24,8995333060703,TERIGU KOMPAS,1,10500,0,10500,9816,684
1/25/2021 21:44,8996001600146,TEH PUCUK HARUM 350ML,1,3000,0,3000,2314,686
1/25/2021 21:44,8992696523081,MILO UHT 110ML,1,2500,0,2500,1962,538
1/25/2021 21:52,GL,GULA 1 LITER,4,11500,0,46000,42000,4000
1/25/2021 21:52,8991004011906,KOPI BORONG,2,10000,0,20000,16666,3334
1/25/2021 21:52,8995333032113,TERIGU GATOT KACA 1 KG,1,8500,0,8500,8012,488
1/25/2021 21:52,8996001355237,SUPER STAR,1,11000,0,11000,9900,1100
1/26/2021 12:14,8998866202435,JAPOTA UMAMI JAPANESE SEAWEED 35GR,1,5000,0,5000,4150,850
1/26/2021 13:09,8993470411433,JOGER CLASSIC,1,1000,0,1000,850,150
1/26/2021 16:10,8993470411433,JOGER CLASSIC,1,1000,0,1000,850,150
1/26/2021 16:10,8998866202732,MILKU STROBERI 200ML,1,3000,0,3000,2375,625
1/26/2021 16:13,8998866202732,MILKU STROBERI 200ML,1,3000,0,3000,2375,625
1/26/2021 16:37,8992957220087,COKLAT SINGA,1,2000,0,2000,1700,300
1/26/2021 16:46,8851019230573,POCKY STRAWBERRY 21G,1,5000,0,5000,3001,1999
1/26/2021 16:47,8997231980039,O`JELLY KONYAKU (MAXI APPLE STRAWBERRY),1,5000,0,5000,4620,380
1/26/2021 16:47,8851019210193,POCKY CHOCO BANANA 47G,1,7300,0,7300,5671,1629
1/26/2021 16:47,8998866201483,POTABEE REGULER GRILLED SEAWEED 35GR,1,4800,0,4800,4150,650
1/26/2021 16:47,8998866202435,JAPOTA UMAMI JAPANESE SEAWEED 35GR,1,5000,0,5000,4150,850
1/26/2021 17:23,8996001305041,ROMA SANDWICH CKLT,1,7000,0,7000,5000,2000
1/26/2021 17:24,8999999514006,BANGO MANIS 60ML,1,3000,0,3000,2400,600
1/26/2021 17:29,8998866200325,NOODLE SEDAAP MIE SOTO,1,2200,0,2200,1952,248
1/26/2021 19:24,8998866103985,CIPT SIKP,1,3000,0,3000,2552,448
1/26/2021 19:35,8998866103985,CIPT SIKP,1,3000,0,3000,2552,448
1/26/2021 19:35,8999999534097,PEPSODENT PGB FCM 75G,1,4300,0,4300,3850,450
1/26/2021 19:35,8999999533717,CITRA TS FRESH WHITE 70G,1,2200,0,2200,1900,300
1/26/2021 19:35,GL,GULA 1 LITER,1,11500,0,11500,10500,1000
1/26/2021 19:35,8999999502003,"SARIMURNI RL RB 1,8G",2,1500,0,3000,57960,-54960
1/26/2021 19:35,8992388111206,MIE ABC SELERA PEDAS-GULAI AYAM PEDAS,1,2500,0,2500,2022,478
1/26/2021 19:35,8998866200578,NOODLE SEDAAP KARI KENTAL SPC 75 GR,1,2300,0,2300,1952,348
1/26/2021 20:54,8993470411433,JOGER CLASSIC,2,1000,0,2000,1700,300
1/27/2021 10:20,8996001600665,COOL TIME,1,3200,0,3200,2750,450
1/27/2021 11:05,8991001121400,SILVERQUEEN ALMOND 65G,1,15000,0,15000,13200,1800
1/27/2021 11:23,GL,GULA 1 LITER,1,11500,0,11500,10500,1000
1/27/2021 12:14,GL,GULA 1 LITER,3,11500,0,34500,31500,3000
1/27/2021 12:14,8998866600538,SOKLIN FLOORCLENER PINK 400ML,1,6000,0,6000,5025,975
1/27/2021 12:14,8999999042646,RINSO MOLTO ROSE FRESH LIQ 40ML,2,5500,0,11000,9634,1366
1/27/2021 12:14,8934868015031,REXONA DEO LOTION ICE COOL,12,4600,0,55200,46800,8400
1/27/2021 12:22,8997025914059,HATARI SEE HONG,2,5000,0,10000,9526,474
1/27/2021 12:22,8992628022156,BIMOLI KLASIK TOUCH 1 LT,2,15500,0,31000,28282,2718
1/27/2021 12:22,089686010107,INDOMIE KALDU AYAM,5,2500,0,12500,10775,1725
1/27/2021 12:22,GL,GULA 1 LITER,3,11500,0,34500,31500,3000
1/27/2021 12:22,8999999045265,RINSO MOLTO ROSE FRESH PWD 770GR,1,21600,0,21600,19338,2262
1/27/2021 12:22,8998898101447,TOLAK ANGIN 12,1,35000,0,35000,32496,2504
1/27/2021 12:22,8999999504656,SARI MURNI 20X1.8G,1,5000,0,5000,4200,800
1/27/2021 12:22,8992753101207,BENDERA KENTAL MANIS 370G,2,11500,0,23000,19400,3600
1/27/2021 12:22,8999999710873,PEPSODENT ACTION123 HERBAL 120G,2,11400,0,22800,20800,2000
1/27/2021 12:22,8996001600269,LE MINERAL 600ML,1,3000,0,3000,1688,1312
1/27/2021 13:37,8992628022156,BIMOLI KLASIK TOUCH 1 LT,1,15500,0,15500,14141,1359
1/27/2021 13:37,8998008151065,MIWON 100 GR,1,3300,0,3300,2996,304
1/27/2021 14:22,8997231980039,O`JELLY KONYAKU (MAXI APPLE STRAWBERRY),1,5000,0,5000,4620,380
1/27/2021 14:46,8999999710880,PEPSODENT ACTION123 HERBAL 75G,1,7500,0,7500,6650,850
1/27/2021 14:54,8851019230573,POCKY STRAWBERRY 21G,1,5000,0,5000,3001,1999
1/27/2021 14:54,8991001503114,CHACHA MILK CHOCOLATE 35G,1,5500,0,5500,4900,600
1/27/2021 16:10,8992775001691,GARUDA ROSTA WAGYU BEEF,1,8000,0,8000,7176,824
1/27/2021 19:29,8999999502003,"SARIMURNI RL RB 1,8G",1,5000,0,5000,1207,3793
1/27/2021 19:29,8999999504656,SARI MURNI 20X1.8G,1,5000,0,5000,4200,800
1/27/2021 19:29,8992696521797,MILO ACTVGO SCT 22G,10,1500,0,15000,19440,-4440
1/27/2021 19:29,8996001600269,LE MINERAL 600ML,1,3000,0,3000,1688,1312
1/27/2021 19:29,8999999560584,LUX TS VELVET JASMINE 110G,1,4000,0,4000,3100,900
1/27/2021 19:29,8991102384841,WFR TANGO LONG CKLT 130G,1,4200,0,4200,3773,427
1/27/2021 19:29,8992775310212,GERY PASTA COKELAT,1,18000,0,18000,16029,1971
1/27/2021 19:45,8992388112401,MIE ABC SELERA PEDAS- GORENG AYAM PEDAS LIMAU,1,2600,0,2600,2368,232
1/27/2021 19:45,8992388111206,MIE ABC SELERA PEDAS-GULAI AYAM PEDAS,1,2500,0,2500,2022,478
1/27/2021 19:45,8998866200301,NOODLE SEDAAP GORENG  90 GR,1,2500,0,2500,2023,477
1/27/2021 19:45,8996001600399,LE MINERAL 1500ML,1,5000,0,5000,4042,958
1/27/2021 19:56,8999999059323,LIFEBOUY LEMONFRESH DG 75G,3,3000,0,9000,7500,1500
1/27/2021 20:41,8998866202725,MILKU COKLAT PREMIUM 200ML,1,3000,0,3000,2375,625
1/27/2021 20:55,8998866501033,MINYAK GORENG SEDAAP POUCH 2L,2,28500,0,57000,55492,1508
1/27/2021 21:06,8992696404441,BEAR BRAND 189ML,3,8500,0,25500,23661,1839
1/27/2021 21:06,8996001304143,SLAI OLAI NANAS,1,12000,0,12000,9900,2100
1/27/2021 21:06,8999999059323,LIFEBOUY LEMONFRESH DG 75G,2,3000,0,6000,5000,1000
1/27/2021 21:16,8998898819106,KOPI KKB GINGSENG,1,12500,0,12500,11050,1450
1/27/2021 21:18,8994867007161,ROKOK PENA GOLD 20,1,17000,0,17000,15000,2000
1/27/2021 22:16,8998866202732,MILKU STROBERI 200ML,1,3000,0,3000,2375,625
1/28/2021 7:41,8997025914059,HATARI SEE HONG,1,5000,0,5000,4763,237
1/28/2021 9:16,SKT,SIKAT CUCI,1,6000,0,6000,5000,1000
1/28/2021 9:16,8997025911706,HATARI SHP MARGARINE,1,5000,0,5000,4763,237
1/28/2021 10:05,8998866201483,POTABEE REGULER GRILLED SEAWEED 35GR,1,4800,0,4800,4150,650
1/28/2021 10:05,8996001600375,LE MINERAL 330ML,1,2000,0,2000,1417,583
1/28/2021 12:43,8993470411433,JOGER CLASSIC,1,1000,0,1000,850,150
1/28/2021 14:08,089686010824,INDOMIE GORENG SPESIAL,1,2700,0,2700,2452,248
1/28/2021 14:08,8998866202343,NOODLE SEDAAP MIE KOREAN SPICY 87 GR,1,2500,0,2500,2023,477
1/28/2021 14:08,8991102989428,WFR TANGO LONG CKLT 24G GTG,1,7500,0,7500,6714,786
1/28/2021 14:46,8998866202725,MILKU COKLAT PREMIUM 200ML,1,3000,0,3000,2375,625
1/28/2021 14:47,089686010107,INDOMIE KALDU AYAM,2,2500,0,5000,4310,690
1/28/2021 16:26,8998866202404,NOODLE SEDAAP MIE KOREAN SPICY CHICKEN CUP,1,4500,0,4500,3917,583
1/28/2021 16:26,8998866202312,NOODLE SEDAAP TASTY BAKMI AYAM 129 GR,1,5000,0,5000,4167,833
1/28/2021 16:47,8999999031602,SARI MURNI 20X1.6G,1,6000,0,6000,5400,600
1/28/2021 17:08,8996001355237,SUPER STAR,1,11000,0,11000,9900,1100
1/28/2021 17:08,8850507002968,A1 KING TRUCK,2,16500,0,33000,31000,2000
1/28/2021 18:16,8992761002039,FANTA STRAWBERRY PET 390 ML,1,5500,0,5500,4300,1200
1/28/2021 18:19,8991001111883,SILVERQUEEN CHUNKYBAR 33G,1,8000,0,8000,7150,850
1/28/2021 18:29,6949586607033,SILET ALSHABAB,1,8500,0,8500,7500,1000
1/28/2021 18:32,8999999034702,PONDS MEN ACNE SOLUTION 50G,1,18500,0,18500,17160,1340
1/28/2021 18:33,8999999030186,PEPSODENT ACTION 123 COMPLETE 190G,1,14000,0,14000,13200,800
1/28/2021 18:33,8999999520151,PEPSODENT TB FAMILY SOFT,1,2100,0,2100,1900,200
1/28/2021 18:57,8996001302323,MALKIST ABON,1,6500,0,6500,4800,1700
1/28/2021 18:57,8992957220117,COKLAT BERUANG,1,2000,0,2000,1700,300
1/28/2021 18:57,GL,GULA 1 LITER,2,11500,0,23000,21000,2000
1/28/2021 18:59,8998866603409,RAPIKA UNGU POUCH 400ML,1,5000,0,5000,4500,500
1/28/2021 18:59,8998866603522,SOKLIN FLOORCLENER UNGU 400ML,1,6000,0,6000,5025,975
1/28/2021 18:59,8999999524838,SUNLIGHT MINT POUCH 755ML,1,17000,0,17000,15400,1600
1/28/2021 18:59,8999999555450,VIXAL PEMB PORS BIRU 190ML,1,5000,0,5000,4200,800
1/28/2021 18:59,8999999710880,PEPSODENT ACTION123 HERBAL 75G,2,7500,0,15000,13300,1700
1/28/2021 18:59,8999999525590,PEPSODENT TB KIDS,2,12900,0,25800,23400,2400
1/28/2021 19:08,8999999401221,RINSO ANTI NODA CLASSIC 430G,1,10800,0,10800,9806,994
1/28/2021 19:08,GL,GULA 1 LITER,2,11500,0,23000,21000,2000
1/28/2021 19:17,8851019510132,POCKY,1,7300,0,7300,7000,300
1/28/2021 20:15,8998866607315,SOKLIN SOFTERGENT SAKURA 770G & PIRING,1,18000,0,18000,16055,1945
1/28/2021 20:15,8998866202060,PTABEE AYAM BAKAR PEDAS 35 GREXT15,1,4800,0,4800,4150,650
1/28/2021 20:15,8998866201483,POTABEE REGULER GRILLED SEAWEED 35GR,2,4800,0,9600,8300,1300
1/28/2021 20:15,8999999706173,PEPSODENT WHITE 120G,1,6700,0,6700,5940,760
1/28/2021 20:15,8999999059323,LIFEBOUY LEMONFRESH DG 75G,2,3000,0,6000,5000,1000
1/28/2021 20:15,8998009020186,BUAVITA GUAVA 250ML,1,6600,0,6600,5950,650
1/28/2021 20:15,8996001302347,SARI GANDUM FAM,1,8200,0,8200,7100,1100
1/28/2021 20:15,8991102987639,WFR TANGO LONG VNL 130G,1,4200,0,4200,3773,427
1/28/2021 20:15,8999999529291,MOLTO PURE SACHET 10ML,1,6000,0,6000,4800,1200
1/28/2021 20:15,8999999555122,MOLTO K-ROMANCE 20ML,6,1000,0,6000,4800,1200
1/28/2021 20:15,8850507002968,A1 KING TRUCK,1,16500,0,16500,15500,1000
1/28/2021 20:15,ARD,SENDAL ARDILES,1,15000,0,15000,13500,1500
1/28/2021 20:15,8999999559861,AXE DARK POCKET FRAG 17ML,1,10000,0,10000,8000,2000
1/28/2021 20:17,8886020033431,KAPUR AJAIB ANTI KECOA DAN NYAMUK,2,3000,0,6000,5400,600
1/28/2021 21:10,8998866610438,SOKLIN SOFTERGENT RED BAG 770G & PIRING,1,18000,0,18000,16055,1945
1/28/2021 21:26,GL,GULA 1 LITER,3,11500,0,34500,31500,3000
1/29/2021 9:02,8996001318430,BETTER 1000,1,1000,0,1000,820,180
1/29/2021 9:02,8998866202244,EKOMIE BUMBU KALDU AYAM,1,1000,0,1000,860,140
1/29/2021 9:55,8996001600375,LE MINERAL 330ML,1,2000,0,2000,1417,583
1/29/2021 10:21,8998866201490,POTABEE REGULER GRILLED SEAWED 68 GR,1,8000,0,8000,7200,800
1/29/2021 11:03,9556001004673,MILO NESTLE MALAYSIA ACTIVE GO,1,85000,0,85000,80000,5000
1/29/2021 11:03,8992761122331,FRESTEA APPEL 500ML,1,6500,0,6500,4708,1792
1/29/2021 12:04,8992628022156,BIMOLI KLASIK TOUCH 1 LT,1,15500,0,15500,14141,1359
1/29/2021 12:06,8998009020186,BUAVITA GUAVA 250ML,1,6600,0,6600,5950,650
1/29/2021 12:14,8996001302347,SARI GANDUM FAM,1,8200,0,8200,7100,1100
1/29/2021 12:17,8992761166038,MMP ORANGE 300ML,1,5000,0,5000,3750,1250
1/29/2021 12:40,34678,SENDAL JEPIT,1,14000,0,14000,13500,500
1/29/2021 12:40,GL,GULA 1 LITER,1,11500,0,11500,10500,1000
1/29/2021 12:40,8995333032113,TERIGU GATOT KACA 1 KG,1,8500,0,8500,8012,488
1/29/2021 12:40,9556040040038,SUSU F&N,1,33000,0,33000,33000,0
1/29/2021 12:40,8991001111883,SILVERQUEEN CHUNKYBAR 33G,1,8000,0,8000,7150,850
1/29/2021 13:15,8998866202770,SEDAAP MIE GORENG SALERO PADANG 86 GR,2,2300,0,4600,4046,554
1/29/2021 13:15,8993470411433,JOGER CLASSIC,1,1000,0,1000,850,150
1/29/2021 13:17,8998866200882,SUKSESMIE GORENG AYAM KRMS 133GR,1,3500,0,3500,3000,500
1/29/2021 13:19,8992957220087,COKLAT SINGA,1,2000,0,2000,1700,300
1/29/2021 13:23,8992388111145,MIE ABC SELERA PEDAS- SUP TOMAT PEDAS,1,2500,0,2500,2023,477
1/29/2021 13:23,8992388111206,MIE ABC SELERA PEDAS-GULAI AYAM PEDAS,1,2500,0,2500,2022,478
1/29/2021 13:23,8998866202244,EKOMIE BUMBU KALDU AYAM,1,1000,0,1000,860,140
1/29/2021 13:31,089686061079,POP MIE MINI AY BAWANG RL,1,3000,0,3000,2702,298
1/29/2021 13:31,8993470411433,JOGER CLASSIC,1,1000,0,1000,850,150
1/29/2021 13:33,8999999559540,LIFEBUOY BW LEMONFRESH 90ML,1,5000,0,5000,4000,1000
1/29/2021 16:52,8997231980039,O`JELLY KONYAKU (MAXI APPLE STRAWBERRY),1,5000,0,5000,4620,380
1/29/2021 16:57,GL,GULA 1 LITER,2,11500,0,23000,21000,2000
1/29/2021 16:57,8992753102204,BKM COKLAT 370G,1,11300,0,11300,9500,1800
1/29/2021 16:57,8991102987639,WFR TANGO LONG VNL 130G,1,4200,0,4200,3773,427
1/29/2021 16:57,8991102384841,WFR TANGO LONG CKLT 130G,1,4200,0,4200,3773,427
1/29/2021 18:12,BB,PASEO SMARTY FACIAL TRAVEL PACK 50S GT,1,2000,0,2000,1800,200
1/29/2021 18:12,089686043273,INDOMIE SAMBAL RICA,1,2700,0,2700,2452,248
1/29/2021 18:12,8992388112401,MIE ABC SELERA PEDAS- GORENG AYAM PEDAS LIMAU,1,2600,0,2600,2368,232
1/29/2021 19:56,8992761166038,MMP ORANGE 300ML,1,5000,0,5000,3750,1250
1/29/2021 20:07,8992959117583,SFX DS REG FLOW WING 20,1,5000,0,5000,4288,712
1/29/2021 20:09,8996001301142,ROMA KELAPA,2,8000,0,16000,13256,2744
1/29/2021 20:09,8998866200325,NOODLE SEDAAP MIE SOTO,3,2200,0,6600,5856,744
1/29/2021 20:09,8992753100101,BKM FULL CREAM GOLD 370,1,15000,0,15000,14000,1000
1/29/2021 20:09,8998866200301,NOODLE SEDAAP GORENG  90 GR,1,2500,0,2500,2023,477
1/29/2021 20:09,8998866200578,NOODLE SEDAAP KARI KENTAL SPC 75 GR,1,2300,0,2300,1952,348
1/29/2021 21:12,9556001004673,MILO NESTLE MALAYSIA ACTIVE GO,1,85000,0,85000,80000,5000
1/29/2021 22:42,ARG,ARGUS 220ML,1,14500,0,14500,12500,2000
1/29/2021 23:05,8998989110167,SURYA GUDANG GARAM 16 FILTER,1,24000,0,24000,22100,1900
1/29/2021 23:21,8992761002022,SPRITE PET 390ML,1,5500,0,5500,4300,1200
1/29/2021 23:22,8996001355817,BENG-BENG MAXX,1,27000,0,27000,24500,2500
1/29/2021 23:22,8992761166038,MMP ORANGE 300ML,1,5000,0,5000,3750,1250
1/29/2021 23:22,8992761111533,SPRITE SLIM CAM250ML,1,4800,0,4800,3750,1050
1/29/2021 23:30,8998866200820,NOODLE SEDAAP MIE AYAM BAWANG TLR CUP 77 GR,1,4300,0,4300,3650,650
1/30/2021 7:21,11222,LEM KOREA,1,9000,0,9000,8000,1000
1/30/2021 8:49,8998866803694,SOKLIN SOFTERGENT PURPLE BAG 770 & PIRING,1,18000,0,18000,16055,1945
1/30/2021 10:05,GL,GULA 1 LITER,3,11500,0,34500,31500,3000
1/30/2021 10:05,8999999720940,CLEAR STYLING CREAM 100G,1,12000,0,12000,10615,1385
1/30/2021 10:05,8996001350850,SUPER STAR SNAPS,1,16300,0,16300,14800,1500
1/30/2021 11:38,8992761147143,SPRITE WATERLYMO 425ML,1,5500,0,5500,4300,1200
1/30/2021 11:40,089686010107,INDOMIE KALDU AYAM,2,2500,0,5000,4310,690
1/30/2021 11:40,8998866201377,KRISBEE FRIES KENTANG GORENG 68 GR,1,5500,0,5500,4620,880
1/30/2021 11:40,089686043204,INDOMIE MIE ACEH,1,2700,0,2700,2452,248
1/30/2021 11:40,8997231980039,O`JELLY KONYAKU (MAXI APPLE STRAWBERRY),1,5000,0,5000,4620,380
1/30/2021 12:53,8992761002039,FANTA STRAWBERRY PET 390 ML,1,5500,0,5500,4300,1200
1/30/2021 12:56,8999999048181,SUNSILK BLK SHINE 170ML,1,20000,0,20000,18150,1850
1/30/2021 12:56,8998866610438,SOKLIN SOFTERGENT RED BAG 770G & PIRING,1,18000,0,18000,16055,1945
1/30/2021 13:00,8996001302347,SARI GANDUM FAM,1,8200,0,8200,7100,1100
1/30/2021 13:00,089686060102,POP MIE PEDE GLEDEEK,2,5000,0,10000,8900,1100
1/30/2021 13:00,089686060027,POP MIE AYAM JUMBO,2,4200,0,8400,7666,734
1/30/2021 13:00,089686060126,POP MIE BASO JUMBO,2,4200,0,8400,7666,734
1/30/2021 13:01,8996001355008,BENG-BENG SP20G,1,29200,0,29200,26500,2700
1/30/2021 13:01,8992761111540,FANTA STRAWBERY SLIM CAM 250ML,1,5000,0,5000,3750,1250
1/30/2021 13:02,8997025914332,HATARI CREAM CRECKERS,4,5000,0,20000,19052,948
1/30/2021 15:45,8992959077207,HN PANTS L 30,1,50000,0,50000,45455,4545
1/30/2021 15:45,8997002060168,KRP SINGKOG PDS PANDA DUO,1,8000,0,8000,7300,700
1/30/2021 15:45,8997011700123,BIHUN JAGUNG 300GR,1,5200,0,5200,4738,462
1/30/2021 15:45,8992775001820,CHOCOLATOS WAFER CREAM,1,17500,0,17500,15761,1739
1/30/2021 16:32,8992957220063,COKLAT BANGO,1,2000,0,2000,1700,300
1/30/2021 16:32,8992957220186,COKLAT RUSA,1,2000,0,2000,1700,300
1/30/2021 16:58,GL,GULA 1 LITER,1,11500,0,11500,10500,1000
1/30/2021 16:58,8992628022156,BIMOLI KLASIK TOUCH 1 LT,1,15500,0,15500,14141,1359
1/30/2021 16:58,8992761145033,FANTA STRAW PET 250ML,1,3500,0,3500,2417,1083
1/30/2021 17:09,GL,GULA 1 LITER,2,11500,0,23000,21000,2000
1/30/2021 17:09,8998866501026,MINYAK GORENG SEDAAP POUCH 1 L,1,14500,0,14500,14110,390
1/30/2021 17:09,8999999195656,SARI WANGI 50X1.85,1,10000,0,10000,8700,1300
1/30/2021 17:16,8992761002039,FANTA STRAWBERRY PET 390 ML,1,5500,0,5500,4300,1200
1/30/2021 17:21,8992761166038,MMP ORANGE 300ML,3,5000,0,15000,11250,3750
1/30/2021 17:21,8992761002022,SPRITE PET 390ML,1,5500,0,5500,4300,1200
1/30/2021 17:34,8991102380805,FULLO  CKL PCK 8G,1,10000,0,10000,9000,1000
1/30/2021 17:34,8998866202725,MILKU COKLAT PREMIUM 200ML,1,3000,0,3000,2375,625
1/30/2021 17:34,8992388111145,MIE ABC SELERA PEDAS- SUP TOMAT PEDAS,1,2500,0,2500,2023,477
1/30/2021 17:34,8992388111206,MIE ABC SELERA PEDAS-GULAI AYAM PEDAS,1,2500,0,2500,2022,478
1/30/2021 17:34,8851019230573,POCKY STRAWBERRY 21G,1,5000,0,5000,3001,1999
1/30/2021 17:34,8998866803694,SOKLIN SOFTERGENT PURPLE BAG 770 & PIRING,1,18000,0,18000,16055,1945
1/30/2021 17:34,8999999516208,ROYCO FDS CHICKEN NEW 230G,1,9000,0,9000,8200,800
1/30/2021 17:34,8992694247255,ZWITSAL BATH NAT HAIR&BODY 200ML,1,20500,0,20500,18810,1690
1/30/2021 17:34,8999999529291,MOLTO PURE SACHET 10ML,2,6000,0,12000,9600,2400
1/30/2021 17:34,8999999524722,SUNLIGHT LIME NEW PCH 435ML,1,10000,0,10000,9100,900
1/30/2021 17:35,8992959953075,SWEETY BRONZE M9,1,17000,0,17000,15190,1810
1/30/2021 18:01,8998866500708,FLORIDINA ORANGE,1,3000,0,3000,2500,500
1/30/2021 18:01,8998866202060,PTABEE AYAM BAKAR PEDAS 35 GREXT15,1,4800,0,4800,4150,650
1/30/2021 18:09,8993470411433,JOGER CLASSIC,2,1000,0,2000,1700,300
1/30/2021 19:05,8851019230573,POCKY STRAWBERRY 21G,1,5000,0,5000,3001,1999
1/30/2021 19:20,8992761164539,NUTRIBOOST ORANGE 300ML,1,6500,0,6500,5300,1200
1/30/2021 19:23,8991004011906,KOPI BORONG,1,10000,0,10000,8333,1667
1/30/2021 19:57,8997021870892,HOT IN CREAM STRONG 120G,1,18500,0,18500,17000,1500
1/30/2021 20:49,8991001780133,TWISTER BLACK,1,5000,0,5000,4600,400
1/30/2021 21:17,8998866200882,SUKSESMIE GORENG AYAM KRMS 133GR,1,3500,0,3500,3000,500
1/30/2021 21:17,8998866613262,SUKSESMIE SOTO 111 GR,1,3500,0,3500,2770,730
1/30/2021 21:17,8998866202619,SEDAAP MIE KOREAN SPICY SOUP BAG 77 GR,1,2300,0,2300,2027,273
1/30/2021 21:17,8998866202343,NOODLE SEDAAP MIE KOREAN SPICY 87 GR,1,2500,0,2500,2023,477
1/30/2021 21:17,8992388111206,MIE ABC SELERA PEDAS-GULAI AYAM PEDAS,1,2500,0,2500,2022,478
1/30/2021 21:17,GL,GULA 1 LITER,1,11500,0,11500,10500,1000
1/30/2021 21:17,8995333060772,TERIGU GATOT KACA 500GR,1,4500,0,4500,4065,435
1/30/2021 21:17,8998866501033,MINYAK GORENG SEDAAP POUCH 2L,1,28500,0,28500,27746,754
1/30/2021 21:17,8999999504656,SARI MURNI 20X1.8G,1,5000,0,5000,4200,800
1/30/2021 21:17,8998866602273,HERSPROTEX SOFTCARE MAX,1,3500,0,3500,2950,550
1/30/2021 21:17,8998866671736,CREAM EKONOMI 455G,2,5500,0,11000,9500,1500
1/30/2021 21:17,8998866609043,DAIA SOFTENER GUSSET 565G,1,10000,0,10000,8700,1300
1/30/2021 21:17,8998866611701,EKONOMI PENCUCI PIRING  LIQ 132ML,1,2000,0,2000,1337,663
1/30/2021 21:17,8991111109121,JB POWDER BLOSSOM 75+25G,1,6000,0,6000,5430,570
1/30/2021 21:17,8998866611206,FRES&NATURAL BLACK 100ML,1,11500,0,11500,10310,1190
1/30/2021 21:17,8999999520151,PEPSODENT TB FAMILY SOFT,4,2100,0,8400,7600,800
1/30/2021 21:17,8998866103985,CIPT SIKP,1,3000,0,3000,2552,448
1/30/2021 21:17,8934868015031,REXONA DEO LOTION ICE COOL,2,4600,0,9200,7800,1400
1/30/2021 21:17,8999999529833,CLEAR SHP ICM UNISEX 9 ML,1,10500,0,10500,9300,1200
1/30/2021 21:17,8998866108003,EMERON HJB CLEANFRESH 10ML,1,5000,0,5000,4185,815
1/30/2021 21:17,8999999554286,SAHAJA PMBRSH LANTAI KNTM BUNGA JERUK 350ML,1,5000,0,5000,4450,550
1/30/2021 21:17,8999999706180,PEPSODENT WHITE 190GR,1,10000,0,10000,9350,650
1/30/2021 21:17,8999999001124,LIFEBUOY MILD CARE REF 250ML,1,15000,0,15000,13550,1450
1/30/2021 21:17,8999999030179,PEPSODENT ACTION 123 COMPLETE 75G,1,6700,0,6700,5170,1530
1/30/2021 21:17,8999999719395,VASELINE HW UV LIGHTENING 100ML,1,12900,0,12900,11805,1095
1/30/2021 21:17,8998866602556,NUVO FAMILY MERAH 76G,2,2000,0,4000,3640,360
1/30/2021 21:17,8999999533724,CITRA TS PEARLY WHITE CNT 70G,2,2300,0,4600,3800,800
1/30/2021 21:17,8999999533717,CITRA TS FRESH WHITE 70G,2,2200,0,4400,3800,600
1/30/2021 21:17,8996001302347,SARI GANDUM FAM,1,8200,0,8200,7100,1100
1/30/2021 21:17,8996001301142,ROMA KELAPA,1,8000,0,8000,6628,1372
1/30/2021 21:17,8991102987639,WFR TANGO LONG VNL 130G,1,4200,0,4200,3773,427
1/30/2021 21:17,8992753101207,BENDERA KENTAL MANIS 370G,1,11500,0,11500,9700,1800
1/30/2021 21:17,8991102380805,FULLO  CKL PCK 8G,1,10000,0,10000,9000,1000
1/30/2021 21:17,8992775001820,CHOCOLATOS WAFER CREAM,1,17500,0,17500,15761,1739
1/30/2021 21:21,089686010107,INDOMIE KALDU AYAM,4,2500,0,10000,8620,1380
1/30/2021 21:34,8992761145026,SPRITE PET 250ML,1,3500,0,3500,2417,1083
1/30/2021 21:59,8998866202619,SEDAAP MIE KOREAN SPICY SOUP BAG 77 GR,2,2300,0,4600,4054,546
1/30/2021 21:59,8998866200301,NOODLE SEDAAP GORENG  90 GR,1,2500,0,2500,2023,477
1/30/2021 21:59,8998866200882,SUKSESMIE GORENG AYAM KRMS 133GR,1,3500,0,3500,3000,500
1/30/2021 22:18,089686010343,INDOME SOTO MIE,2,2600,0,5200,4734,466
1/30/2021 22:46,ARG,ARGUS 220ML,1,14500,0,14500,12500,2000
1/30/2021 22:50,8998989300261,GUDANG GARAM SURYA 12 FILTER,1,18000,0,18000,16450,1550
1/30/2021 22:50,123124,KOREK BIASA,1,2000,0,2000,1800,200
1/30/2021 23:24,8994867000179,ROKOK PENA MILD 16,1,14500,0,14500,13000,1500
1/30/2021 23:47,8992761166205,FRESTEA GREEN HONEY 350ML,1,4500,0,4500,3000,1500
1/30/2021 23:47,8992761164539,NUTRIBOOST ORANGE 300ML,1,6500,0,6500,5300,1200
1/31/2021 7:57,8997013790092,BIMURA KERUPUK BAWANG 25G,1,1000,0,1000,874,126
1/31/2021 7:57,8996001318911,BETTER ISI 4,1,2000,0,2000,1700,300
1/31/2021 8:25,8993470411433,JOGER CLASSIC,4,1000,0,4000,3400,600
1/31/2021 8:25,8997013790092,BIMURA KERUPUK BAWANG 25G,1,1000,0,1000,874,126
1/31/2021 8:31,8996001318911,BETTER ISI 4,1,2000,0,2000,1700,300
1/31/2021 8:43,8990800004563,MENTOS 40X50 BUAH IND,1,5700,0,5700,5150,550
1/31/2021 8:50,8991102987875,WFR TANGO POUCH CKL 115G,1,7000,0,7000,6273,727
1/31/2021 8:50,GL,GULA 1 LITER,2,11500,0,23000,21000,2000
1/31/2021 8:57,BR,BERAS 10L,1,86500,0,86500,85000,1500
1/31/2021 8:57,8999999524722,SUNLIGHT LIME NEW PCH 435ML,1,10000,0,10000,9100,900
1/31/2021 8:57,8998866610223,DAIA VIOLET BAG 850G & PIRING,1,18000,0,18000,15627,2373
1/31/2021 8:57,8992753101207,BENDERA KENTAL MANIS 370G,1,11500,0,11500,9700,1800
1/31/2021 8:57,8992628022156,BIMOLI KLASIK TOUCH 1 LT,1,15500,0,15500,14141,1359
1/31/2021 8:57,8991102987875,WFR TANGO POUCH CKL 115G,1,7000,0,7000,6273,727
1/31/2021 8:57,8993470411433,JOGER CLASSIC,1,1000,0,1000,850,150
1/31/2021 9:47,8992761166205,FRESTEA GREEN HONEY 350ML,1,4500,0,4500,3000,1500
1/31/2021 10:18,8998989300261,GUDANG GARAM SURYA 12 FILTER,1,18000,0,18000,16450,1550
1/31/2021 10:22,8995333060703,TERIGU KOMPAS 1KG,1,10500,0,10500,9816,684
1/31/2021 11:06,GL,GULA 1 LITER,5,11500,0,57500,52500,5000
1/31/2021 11:06,8998989110167,SURYA GUDANG GARAM 16 FILTER,1,24000,0,24000,22100,1900
1/31/2021 11:18,8998866200561,EKOMIE SUPER 600GR,2,10000,0,20000,17230,2770
1/31/2021 12:10,8998989300261,GUDANG GARAM SURYA 12 FILTER,1,18000,0,18000,16450,1550
1/31/2021 12:12,GL,GULA 1 LITER,2,11500,0,23000,21000,2000
1/31/2021 12:54,8992761164539,NUTRIBOOST ORANGE 300ML,1,6500,0,6500,5300,1200
1/31/2021 12:54,8996001304129,SLAI OLAI STROBERI,1,12000,0,12000,9900,2100
1/31/2021 12:54,8992957220186,COKLAT RUSA,1,2000,0,2000,1700,300
1/31/2021 12:54,8992957220063,COKLAT BANGO,1,2000,0,2000,1700,300
1/31/2021 13:48,8992959117590,SFX DS REG FLOW WING 20,1,12000,0,12000,11250,750
1/31/2021 13:48,8991102994422,TANGO WALUT CHOCOBNN 18G,1,8200,0,8200,7272,928
1/31/2021 13:48,8999999538453,SUNSILK SHP SOFT AND  SMOOTH 55 ML,1,4500,0,4500,3750,750
1/31/2021 13:49,8996001600399,LE MINERAL 1500ML,1,5000,0,5000,4042,958
1/31/2021 13:49,BB,PASEO SMARTY FACIAL TRAVEL PACK 50S GT,1,2000,0,2000,1800,200
1/31/2021 13:53,8998866202664,POTABEE WAGYU BEEF STEAK 68 GR,2,8000,0,16000,14400,1600
1/31/2021 13:53,8998866202053,POTABEE AYAM BAKAR PEDAS 68GR,1,8000,0,8000,7200,800
1/31/2021 13:53,8998866201377,KRISBEE FRIES KENTANG GORENG 68 GR,1,5500,0,5500,4620,880
1/31/2021 13:53,8996001302323,MALKIST ABON,1,6500,0,6500,4800,1700
1/31/2021 13:53,8992761139018,ADES 600ML,1,3500,0,3500,2292,1208
1/31/2021 13:53,8992761002022,SPRITE PET 390ML,1,5500,0,5500,4300,1200
1/31/2021 13:53,8992761166205,FRESTEA GREEN HONEY 350ML,1,4500,0,4500,3000,1500
1/31/2021 16:09,8998866201865,KRISBEE PILLOW CHOCOLAVA 120 GR,1,8200,0,8200,7250,950
1/31/2021 16:52,8999999549305,VASELINE SUPERFOOD CRANBERRY 200ML,1,26000,0,26000,23940,2060
1/31/2021 16:52,8992696523081,MILO UHT 110ML,2,2500,0,5000,3924,1076
1/31/2021 16:52,8992761122331,FRESTEA APPEL 500ML,1,6500,0,6500,4708,1792
1/31/2021 16:52,8992388133017,NU MILK TEA ORI 330ML,1,5000,0,5000,4604,396
1/31/2021 16:52,8999999549138,CLEAR HIJAB AD SHP HF TMT 160ML,1,25000,0,25000,23870,1130
1/31/2021 16:56,8998989110167,SURYA GUDANG GARAM 16 FILTER,1,24000,0,24000,22100,1900
1/31/2021 17:36,8995333060703,TERIGU KOMPAS 1KG,1,10500,0,10500,9816,684
1/31/2021 17:40,8992775311325,GERY SNACK&SEREAL 100G,1,7000,0,7000,5892,1108
1/31/2021 17:40,8851019230573,POCKY STRAWBERRY 21G,1,5000,0,5000,3001,1999
1/31/2021 17:42,8991102385091,WFR TANGO CKLT 7G,1,8300,0,8300,7455,845
1/31/2021 17:46,8992959002032,SWEETY SILVER PANTS L 36,1,72000,0,72000,68182,3818
1/31/2021 18:04,8994867000179,ROKOK PENA MILD 16,1,14500,0,14500,13000,1500
1/31/2021 18:25,8992761166052,FRESTEA MELATI 350ML,1,4500,0,4500,3000,1500
1/31/2021 18:53,8992761139018,ADES 600ML,1,3500,0,3500,2292,1208
1/31/2021 18:54,8991001502933,CHACHA TUBE,1,7500,0,7500,6400,1100
1/31/2021 19:13,8998866201469,POTABEE REGULER BBQ BEEF 68 GR,1,8000,0,8000,7200,800
1/31/2021 19:33,8992959953327,SWEETY BRONZE L52,1,85000,0,85000,80304,4696
1/31/2021 19:49,8991001502933,CHACHA TUBE,1,7500,0,7500,6400,1100
1/31/2021 20:33,8992696404441,BEAR BRAND 189ML,1,8500,0,8500,7887,613
1/31/2021 20:35,8996001600399,LE MINERAL 1500ML,2,5000,0,10000,8084,1916
1/31/2021 20:41,8992761139018,ADES 600ML,1,3500,0,3500,2292,1208
1/31/2021 20:41,8999999554903,DOVE SHP TOTAL HAIRFALL TRMT 11ML,1,10500,0,10500,9300,1200
1/31/2021 20:41,8998866201490,POTABEE REGULER GRILLED SEAWED 68 GR,1,8000,0,8000,7200,800
1/31/2021 20:41,8992388133017,NU MILK TEA ORI 330ML,1,5000,0,5000,4604,396
1/31/2021 20:41,8992761145026,SPRITE PET 250ML,1,3500,0,3500,2417,1083
1/31/2021 21:05,8996001357088,ASTOR SINGLE 18GR,1,10800,0,10800,9800,1000
1/31/2021 21:06,8998989300261,GUDANG GARAM SURYA 12 FILTER,1,18000,0,18000,16450,1550
1/31/2021 21:07,8992761111533,SPRITE SLIM CAM250ML,1,5000,0,5000,3750,1250
1/31/2021 21:35,8992761145026,SPRITE PET 250ML,1,3500,0,3500,2417,1083
1/31/2021 21:38,8851019230566,POCKY CHOCO 22G,1,5000,0,5000,3001,1999
1/31/2021 21:38,8996001350850,SUPER STAR SNAPS,1,16300,0,16300,14800,1500
1/31/2021 21:38,8992761166038,MMP ORANGE 300ML,1,5000,0,5000,3750,1250
1/31/2021 21:39,8992761111533,SPRITE SLIM CAM250ML,1,5000,0,5000,3750,1250
1/31/2021 21:39,8992957220087,COKLAT SINGA,1,2000,0,2000,1700,300
1/31/2021 21:41,8992761111533,SPRITE SLIM CAM250ML,1,5000,0,5000,3750,1250
1/31/2021 22:06,8992761145033,FANTA STRAW PET 250ML,1,3500,0,3500,2417,1083
1/31/2021 22:06,8992775211410,PILUS GARUDA PEDAS,1,5500,0,5500,4713,787
1/31/2021 22:44,8993470411433,JOGER CLASSIC,1,1000,0,1000,850,150
1/31/2021 22:44,8992775001691,GARUDA ROSTA WAGYU BEEF,3,8000,0,24000,21528,2472
1/31/2021 22:52,8998989110167,SURYA GUDANG GARAM 16 FILTER,1,24000,0,24000,22100,1900
2/1/2021 0:11,8992761139018,ADES 600ML,3,3500,0,10500,6876,3624
2/1/2021 0:11,8992388133017,NU MILK TEA ORI 330ML,1,5000,0,5000,4604,396
2/1/2021 7:24,GL,GULA 1 LITER,2,11500,0,23000,21000,2000
2/1/2021 7:24,8998866501033,MINYAK GORENG SEDAAP POUCH 2L,1,28500,0,28500,27746,754
2/1/2021 8:43,8998989121163,SURYA PRO MERAH,1,20000,0,20000,18600,1400
2/1/2021 8:43,089686010824,INDOMIE GORENG SPESIAL,2,2700,0,5400,4904,496
2/1/2021 10:14,089686011494,INDOMIE SOTO PADANG,1,2600,0,2600,2317,283
2/1/2021 10:14,8998866200325,NOODLE SEDAAP MIE SOTO,1,2200,0,2200,1952,248
2/1/2021 10:14,8998866202770,SEDAAP MIE GORENG SALERO PADANG 86 GR,1,2300,0,2300,2023,277
2/1/2021 10:14,8998866200578,NOODLE SEDAAP KARI KENTAL SPC 75 GR,1,2300,0,2300,1952,348
2/1/2021 11:37,8998989110167,SURYA GUDANG GARAM 16 FILTER,1,24000,0,24000,22100,1900
2/1/2021 12:52,8992388133017,NU MILK TEA ORI 330ML,1,5000,0,5000,4604,396
2/1/2021 14:07,8996001318911,BETTER ISI 4,1,2000,0,2000,1700,300
2/1/2021 14:07,8996001301579,MALKIST CKLT KELAPA PACK,1,11000,0,11000,9900,1100
2/1/2021 14:38,8998989300261,GUDANG GARAM SURYA 12 FILTER,1,18000,0,18000,16450,1550
2/1/2021 14:52,8998866201889,KRISBEE PILLOW STRAWBERRY ICE CREAM 120GR,1,8200,0,8200,7250,950
2/1/2021 14:52,8851019210117,POCKY CHOCOLATE 47G,1,7300,0,7300,5671,1629
2/1/2021 17:06,9556040040038,SUSU F&N,1,33000,0,33000,30000,3000
2/1/2021 17:06,8934868015031,REXONA DEO LOTION ICE COOL,1,4600,0,4600,3900,700
2/1/2021 17:06,8999999042387,rexona,1,4600,0,4600,2500,2100
2/1/2021 17:06,8999999059323,LIFEBOUY LEMONFRESH DG 75G,2,3000,0,6000,5000,1000
2/1/2021 17:06,8998866610278,DAIA VIOLET GUSSET 565G,1,10000,0,10000,8700,1300
2/1/2021 17:09,8998866610223,DAIA VIOLET BAG 850G & PIRING,1,18000,0,18000,15627,2373
2/1/2021 17:14,8992753100101,BKM FULL CREAM GOLD 370,2,15000,0,30000,28000,2000
2/1/2021 17:58,8998866202237,NOODLE SEDAAP TASTY AYAM GEPREK 124 GR,1,5000,0,5000,4167,833
2/1/2021 17:58,8993470411433,JOGER CLASSIC,2,1000,0,2000,1700,300
2/1/2021 17:58,8998866202732,MILKU STROBERI 200ML,1,3000,0,3000,2375,625
2/1/2021 18:21,8992696404441,BEAR BRAND 189ML,5,8500,0,42500,39435,3065
2/1/2021 18:21,8997013790092,BIMURA KERUPUK BAWANG 25G,2,1000,0,2000,1748,252
2/1/2021 18:22,8998866201490,POTABEE REGULER GRILLED SEAWED 68 GR,1,8000,0,8000,7200,800
2/1/2021 18:22,8992761122331,FRESTEA APPEL 500ML,2,6500,0,13000,9416,3584
2/1/2021 18:32,8998866202725,MILKU COKLAT PREMIUM 200ML,3,3000,0,9000,7125,1875
2/1/2021 18:32,8998866202732,MILKU STROBERI 200ML,3,3000,0,9000,7125,1875
2/1/2021 18:32,8998866202053,POTABEE AYAM BAKAR PEDAS 68GR,1,8000,0,8000,7200,800
2/1/2021 18:32,8991001121400,SILVERQUEEN ALMOND 65G,1,15000,0,15000,13200,1800
2/1/2021 18:32,8998866106979,CIPTADENT TB CHARCOAL PROTEC,1,6000,0,6000,5250,750
2/1/2021 18:32,8999999710866,soklin,1,18000,0,18000,17500,500
2/1/2021 18:32,8999999529604,CLEAR SHP COMPLETE CARE MEN 160ML,1,24800,0,24800,22700,2100
2/1/2021 18:32,GL,GULA 1 LITER,1,11500,0,11500,10500,1000
2/1/2021 18:39,8998866202732,MILKU STROBERI 200ML,1,3000,0,3000,2375,625
2/1/2021 18:59,8851019230566,POCKY CHOCO 22G,1,5000,0,5000,3001,1999
2/1/2021 19:00,8998866201865,KRISBEE PILLOW CHOCOLAVA 120 GR,1,8200,0,8200,7250,950
2/1/2021 19:00,8992761111533,SPRITE SLIM CAM250ML,2,5000,0,10000,7500,2500
2/1/2021 19:04,8999999045920,LIFEBUOY TS TOTAL 10 110GR,4,3500,0,14000,14000,0
2/1/2021 19:04,8999999534769,PEPSODENT ACTION123 CHARCOAL 160G,1,16800,0,16800,15345,1455
2/1/2021 19:04,8998866501026,MINYAK GORENG SEDAAP POUCH 1 L,1,14500,0,14500,14110,390
2/1/2021 19:04,GL,GULA 1 LITER,2,11500,0,23000,21000,2000
2/1/2021 19:04,8999999059781,SUNLIGHT LIME NEW POUCH 210ML,1,5000,0,5000,4300,700
2/1/2021 19:04,8999999031602,SARI MURNI 20X1.6G,1,6000,0,6000,5400,600
2/1/2021 19:04,8999999007768,FAIR&LOVELY MULTIVITAMIN  CREAM 9 ML,1,4500,0,4500,38400,-33900
2/1/2021 19:04,8998866107495,ZINC HAIRFALL TREATH SHT 10ML,1,5000,0,5000,4500,500
2/1/2021 19:04,8998866106535,EMERON LOVELY NAT GREEN 200ML,1,6000,0,6000,5075,925
2/1/2021 19:04,8998866106467,POSH LOVE SONG 150ML,1,19500,0,19500,17500,2000
2/1/2021 19:24,8992761122331,FRESTEA APPEL 500ML,1,6500,0,6500,4708,1792
2/1/2021 19:24,8998866201865,KRISBEE PILLOW CHOCOLAVA 120 GR,1,8200,0,8200,7250,950
2/1/2021 19:25,8991001780133,TWISTER BLACK,1,5000,0,5000,4600,400
2/1/2021 19:34,089686061024,POP MIE MINI SOTO RL,1,3000,0,3000,2702,298
2/1/2021 19:34,089686061079,POP MIE MINI AY BAWANG RL,2,3000,0,6000,5404,596
2/1/2021 19:35,8992761145026,SPRITE PET 250ML,1,3500,0,3500,2417,1083
2/1/2021 20:23,8992388133345,NU MILK TEA TEH TARIK 330ML,1,5000,0,5000,4604,396
2/1/2021 20:28,BB,PASEO SMARTY FACIAL TRAVEL PACK 50S GT,1,2000,0,2000,1800,200
2/1/2021 20:32,8998009010569,ULTRA CHO 200,1,4700,0,4700,3830,870
2/1/2021 21:18,8998866608824,KECAP MANIS SEDAAP BTL PLTSK 620ML,1,26000,0,26000,23460,2540
2/1/2021 21:18,8999999706661,PEPSODENT TB DBL CARE SENSITIVE,1,11500,0,11500,10400,1100
2/1/2021 21:18,8999999706180,PEPSODENT WHITE 190GR,1,10000,0,10000,9350,650
2/1/2021 21:25,8992761139018,ADES 600ML,1,3500,0,3500,2292,1208
2/1/2021 21:53,8992761166038,MMP ORANGE 300ML,1,5000,0,5000,3750,1250
2/1/2021 21:56,8994867006997,ROKOK PENA BOLD 20BTG,1,17000,0,17000,15000,2000
2/1/2021 21:56,8992761145019,COCA COLA PET 250ML,1,3500,0,3500,2417,1083
2/1/2021 21:56,8992761145033,FANTA STRAW PET 250ML,1,3500,0,3500,2417,1083
2/1/2021 22:04,8992775001042,PILUS GARUDA MI GORENG,1,5500,0,5500,4713,787
2/1/2021 23:20,089686010343,INDOME SOTO MIE,1,2600,0,2600,2367,233
2/2/2021 9:05,8998866201490,POTABEE REGULER GRILLED SEAWED 68 GR,1,8000,0,8000,7200,800
2/2/2021 9:05,8851019230566,POCKY CHOCO 22G,1,5000,0,5000,3001,1999
2/2/2021 9:05,8996001600375,LE MINERAL 330ML,2,2000,0,4000,2834,1166
2/2/2021 9:05,8996001318911,BETTER ISI 4,1,2000,0,2000,1700,300
2/2/2021 10:21,8998989500166,GUDANG GARAM MERAH BESAR 16KS,2,17000,0,34000,30600,3400
2/2/2021 10:21,8998989500128,GUDANG GARAM MERAH KECIL 12KS,1,13000,0,13000,11900,1100
2/2/2021 10:22,ARG,ARGUS 220ML,1,14500,0,14500,12500,2000
2/2/2021 10:27,8998898847109,KOPI JAHE,1,1500,0,1500,11800,-10300
2/2/2021 10:27,8998866200837,NOODLE SEDAAPMIE SOTO CUP 81 GR,1,4500,0,4500,3650,850
2/2/2021 10:54,089686061079,POP MIE MINI AY BAWANG RL,2,3000,0,6000,5404,596
2/2/2021 11:15,8998866202725,MILKU COKLAT PREMIUM 200ML,1,3000,0,3000,2375,625
2/2/2021 11:26,8997025911706,HATARI SHP MARGARINE,2,5000,0,10000,9526,474
2/2/2021 11:27,GL,GULA 1 LITER,1,11500,0,11500,10500,1000
2/2/2021 11:33,8991111101422,JB POWDER 200G,1,11700,0,11700,10660,1040
2/2/2021 11:33,8999999529628,CLEAR COMP SOFT CARE 160ML,1,23400,0,23400,21400,2000
2/2/2021 12:06,8992761139018,ADES 600ML,2,3500,0,7000,4584,2416
2/2/2021 12:11,8992761166038,MMP ORANGE 300ML,1,5000,0,5000,3750,1250
2/2/2021 12:12,8992761145033,FANTA STRAW PET 250ML,3,3500,0,10500,7251,3249
2/2/2021 12:12,8992761145026,SPRITE PET 250ML,1,3500,0,3500,2417,1083
2/2/2021 12:12,8992761166052,FRESTEA MELATI 350ML,1,4500,0,4500,3000,1500
2/2/2021 14:34,8995333060703,TERIGU KOMPAS 1KG,1,10500,0,10500,9816,684
2/2/2021 14:44,8992761002039,FANTA STRAWBERRY PET 390 ML,1,5500,0,5500,4300,1200
2/2/2021 16:21,8992761139018,ADES 600ML,1,3500,0,3500,2292,1208
2/2/2021 16:27,8997013790108,BIMURA KACANG TELUR 25G,1,1000,0,1000,875,125
2/2/2021 16:45,8997013790108,BIMURA KACANG TELUR 25G,1,1000,0,1000,875,125
2/2/2021 16:56,8993470279651,JOGER CHOCKY BAR,1,1000,0,1000,867,133
2/2/2021 17:01,8998866202725,MILKU COKLAT PREMIUM 200ML,1,3000,0,3000,2375,625
2/2/2021 17:03,8998866202732,MILKU STROBERI 200ML,1,3000,0,3000,2375,625
2/2/2021 17:34,8993470279651,JOGER CHOCKY BAR,2,1000,0,2000,1734,266
2/2/2021 17:46,8993470279651,JOGER CHOCKY BAR,1,1000,0,1000,867,133
2/2/2021 18:33,089686061024,POP MIE MINI SOTO RL,2,3000,0,6000,5404,596
2/2/2021 18:33,089686061079,POP MIE MINI AY BAWANG RL,2,3000,0,6000,5404,596
2/2/2021 18:34,8998989300261,GUDANG GARAM SURYA 12 FILTER,1,18000,0,18000,16450,1550
2/2/2021 19:00,8997025911706,HATARI SHP MARGARINE,1,5000,0,5000,4763,237
2/2/2021 19:15,089686060027,POP MIE AYAM JUMBO,1,4500,0,4500,3833,667
2/2/2021 19:44,GL,GULA 1 LITER,3,11500,0,34500,31500,3000
2/2/2021 20:16,GL,GULA 1 LITER,1,11500,0,11500,10500,1000
2/2/2021 20:20,8993470279651,JOGER CHOCKY BAR,2,1000,0,2000,1734,266
2/2/2021 20:26,8998866202244,EKOMIE BUMBU KALDU AYAM,5,1000,0,5000,4300,700
2/2/2021 20:46,8999999033217,LIFEBUOY SHP ANTI KETEMBE 170ML,1,16500,0,16500,14950,1550
2/2/2021 20:58,8999999504656,SARI MURNI 20X1.8G,1,5000,0,5000,4200,800
2/2/2021 20:58,8991663000723,KOREK,1,2000,0,2000,1500,500
2/2/2021 21:00,123124,KOREK BIASA,1,2000,0,2000,1800,200
2/2/2021 21:53,8998989110167,SURYA GUDANG GARAM 16 FILTER,2,24000,0,48000,44200,3800
2/2/2021 22:07,8998866202732,MILKU STROBERI 200ML,1,3000,0,3000,2375,625
2/2/2021 22:17,8998866201490,POTABEE REGULER GRILLED SEAWED 68 GR,1,8000,0,8000,7200,800
2/2/2021 22:23,8993470279651,JOGER CHOCKY BAR,5,1000,0,5000,4335,665
2/2/2021 22:23,8993470411433,JOGER CLASSIC,7,1000,0,7000,5950,1050
2/2/2021 22:23,8991001503114,CHACHA MILK CHOCOLATE 35G,1,5500,0,5500,4900,600
2/2/2021 22:29,8998866202770,SEDAAP MIE GORENG SALERO PADANG 86 GR,1,2500,0,2500,2023,477
2/2/2021 22:29,8998866200325,NOODLE SEDAAP MIE SOTO,1,2200,0,2200,1952,248
2/2/2021 22:29,089686010107,INDOMIE KALDU AYAM,1,2500,0,2500,2155,345
2/2/2021 22:29,089686011494,INDOMIE SOTO PADANG,1,2600,0,2600,2317,283
2/2/2021 23:19,8851019230566,POCKY CHOCO 22G,1,5000,0,5000,3001,1999
2/2/2021 23:47,089686043204,INDOMIE MIE ACEH,2,2700,0,5400,4904,496
2/2/2021 23:47,8998866202770,SEDAAP MIE GORENG SALERO PADANG 86 GR,1,2500,0,2500,2023,477
2/2/2021 23:47,8998866202732,MILKU STROBERI 200ML,2,3000,0,6000,4750,1250
2/2/2021 23:50,8998866202725,MILKU COKLAT PREMIUM 200ML,2,3000,0,6000,4750,1250
2/3/2021 0:08,8992761145026,SPRITE PET 250ML,3,3500,0,10500,7251,3249
2/3/2021 0:08,8998866201711,KRISBEE KRUNCHY JAGUNG BAKAR MENTEGA 75 GR,1,5000,0,5000,4400,600
2/3/2021 0:09,8998866201711,KRISBEE KRUNCHY JAGUNG BAKAR MENTEGA 75 GR,3,5000,0,15000,13200,1800
2/3/2021 0:09,8998866201452,POTABEE REGULER BBQ BEEF 35GR,1,4800,0,4800,4150,650
2/3/2021 0:10,8997013790108,BIMURA KACANG TELUR 25G,3,1000,0,3000,2625,375
2/3/2021 9:01,ARG,ARGUS 220ML,1,14500,0,14500,12500,2000
2/3/2021 9:08,8998866202664,POTABEE WAGYU BEEF STEAK 68 GR,1,8000,0,8000,7200,800
2/3/2021 9:21,8992761166205,FRESTEA GREEN HONEY 350ML,4,4500,0,18000,12000,6000
2/3/2021 9:21,8992761139018,ADES 600ML,4,3500,0,14000,9168,4832
2/3/2021 9:21,8991001121400,SILVERQUEEN ALMOND 65G,1,15000,0,15000,13200,1800
2/3/2021 9:23,8998866501033,MINYAK GORENG SEDAAP POUCH 2L,1,28500,0,28500,27746,754
2/3/2021 10:49,9556001025272,NESCAFE LATTE 240ML,1,8000,0,8000,7437,563
2/3/2021 10:49,8992696523081,MILO UHT 110ML,2,2500,0,5000,3924,1076
2/3/2021 11:09,089686061024,POP MIE MINI SOTO RL,1,3000,0,3000,2702,298
2/3/2021 11:09,089686061079,POP MIE MINI AY BAWANG RL,1,3000,0,3000,2702,298
2/3/2021 11:55,8992957220063,COKLAT BANGO,1,2000,0,2000,1700,300
2/3/2021 11:55,8991001780133,TWISTER BLACK,1,5000,0,5000,4600,400
2/3/2021 11:55,8996001600146,TEH PUCUK HARUM 350ML,3,3000,0,9000,6942,2058
2/3/2021 11:55,8998866200851,NOODLE SEDAAP MIE BAKSO SPESIAL CUP 77 GR,1,4500,0,4500,3650,850
2/3/2021 11:55,8998866200837,NOODLE SEDAAPMIE SOTO CUP 81 GR,1,4500,0,4500,3650,850
2/3/2021 13:05,8997013790108,BIMURA KACANG TELUR 25G,5,1000,0,5000,4375,625
2/3/2021 13:05,8996001318430,BETTER 1000,2,1000,0,2000,1640,360
2/3/2021 13:05,8998898810721,KKB ENER-G C1000,1,8000,0,8000,6690,1310
2/3/2021 13:05,8992753031900,BKM SCT PUTIH 40G,1,7500,0,7500,6900,600
2/3/2021 14:00,8997025914059,HATARI SEE HONG,2,5000,0,10000,9526,474
2/3/2021 14:00,8998866202725,MILKU COKLAT PREMIUM 200ML,1,3000,0,3000,2375,625
2/3/2021 14:00,8998009020186,BUAVITA GUAVA 250ML,1,6600,0,6600,5950,650
2/3/2021 14:06,8998866202664,POTABEE WAGYU BEEF STEAK 68 GR,1,8000,0,8000,7200,800
2/3/2021 14:06,8998866202435,JAPOTA UMAMI JAPANESE SEAWEED 35GR,1,5000,0,5000,4150,850
2/3/2021 14:49,8993470279651,JOGER CHOCKY BAR,2,1000,0,2000,1734,266
2/3/2021 14:49,8991001111883,SILVERQUEEN CHUNKYBAR 33G,1,8000,0,8000,7150,850
2/3/2021 14:56,8992761166038,MMP ORANGE 300ML,2,5000,0,10000,7500,2500
2/3/2021 15:01,8998989110167,SURYA GUDANG GARAM 16 FILTER,1,24000,0,24000,22100,1900
2/3/2021 16:55,GL,GULA 1 LITER,1,11500,0,11500,10500,1000
2/3/2021 17:06,089686041705,INDOMIE GORENG JUMBO,1,3500,0,3500,3143,357
2/3/2021 17:24,8999999516208,ROYCO FDS CHICKEN NEW 230G,1,9000,0,9000,8200,800
2/3/2021 17:24,8999999537180,CLEAR SHP LEMON FRESH 9 ML,1,10500,0,10500,9300,1200
2/3/2021 17:27,8998866201452,POTABEE REGULER BBQ BEEF 35GR,2,4800,0,9600,8300,1300
2/3/2021 19:32,8998866202725,MILKU COKLAT PREMIUM 200ML,1,3000,0,3000,2375,625
2/3/2021 19:32,8993470279651,JOGER CHOCKY BAR,1,1000,0,1000,867,133
2/3/2021 21:05,8998866200301,NOODLE SEDAAP GORENG  90 GR,1,2500,0,2500,2023,477
2/3/2021 22:02,8992761122331,FRESTEA APPEL 500ML,1,6500,0,6500,4708,1792
2/3/2021 22:02,8996001600146,TEH PUCUK HARUM 350ML,1,3000,0,3000,2314,686
2/3/2021 22:02,8992761145026,SPRITE PET 250ML,1,3500,0,3500,2417,1083
2/3/2021 22:51,8998866105507,EMERON LOVELY NOURIST&BRIGHT 100ML,2,4300,0,8600,7600,1000
2/3/2021 22:51,8999999007768,FAIR&LOVELY MULTIVITAMIN  CREAM 9 ML,1,4500,0,4500,3200,1300
2/3/2021 22:51,8993470279651,JOGER CHOCKY BAR,4,1000,0,4000,3468,532
2/3/2021 22:51,8998866608718,DAIA SOFTENER PINK,1,5000,0,5000,4450,550
2/3/2021 22:51,8999999195656,SARI WANGI 50X1.85,1,10000,0,10000,8700,1300
2/3/2021 22:51,8996001301142,ROMA KELAPA,1,8000,0,8000,6628,1372
2/3/2021 22:51,8993470671752,JOGER STICK DUO KACANG,1,1000,0,1000,850,150
2/3/2021 22:54,8991102987899,WFR TANGO POUCH VNL 115G,1,7000,0,7000,6273,727
2/3/2021 22:54,089686011036,INDOMIE GORENG PEDAS,1,2700,0,2700,2452,248
2/3/2021 22:54,089686010824,INDOMIE GORENG SPESIAL,1,2700,0,2700,2452,248
2/3/2021 22:54,089686010107,INDOMIE KALDU AYAM,1,2500,0,2500,2155,345
2/3/2021 22:54,8997013790108,BIMURA KACANG TELUR 25G,2,1000,0,2000,1750,250
2/4/2021 8:58,8997025911706,HATARI SHP MARGARINE,1,5000,0,5000,4763,237
2/4/2021 9:31,GL,GULA 1 LITER,1,11500,0,11500,10500,1000
2/4/2021 9:33,8992761147143,SPRITE WATERLYMON 425ML,1,5500,0,5500,4300,1200
2/4/2021 9:58,8998989300261,GUDANG GARAM SURYA 12 FILTER,1,18000,0,18000,16450,1550
2/4/2021 11:04,8996001600375,LE MINERAL 330ML,5,2000,0,10000,7085,2915
2/4/2021 11:04,8992957220087,COKLAT SINGA,5,2000,0,10000,8500,1500
2/4/2021 11:09,8992775001042,PILUS GARUDA MI GORENG,1,5500,0,5500,4713,787
2/4/2021 11:19,8992761002039,FANTA STRAWBERRY PET 390 ML,1,5500,0,5500,4300,1200
2/4/2021 11:19,8992761002022,SPRITE PET 390ML,1,5500,0,5500,4300,1200
2/4/2021 13:23,8998866202244,EKOMIE BUMBU KALDU AYAM,2,1000,0,2000,1720,280
2/4/2021 13:23,8997013790108,BIMURA KACANG TELUR 25G,1,1000,0,1000,875,125
2/4/2021 13:39,8992696523081,MILO UHT 110ML,1,2500,0,2500,1962,538
2/4/2021 13:43,8993470279651,JOGER CHOCKY BAR,1,1000,0,1000,867,133
2/4/2021 14:11,8996001600146,TEH PUCUK HARUM 350ML,1,3000,0,3000,2314,686
2/4/2021 14:11,8992775311325,GERY SNACK&SEREAL 100G,1,7000,0,7000,5892,1108
2/4/2021 14:11,8991102987899,WFR TANGO POUCH VNL 115G,1,7000,0,7000,6273,727
2/4/2021 14:11,8997013790108,BIMURA KACANG TELUR 25G,1,1000,0,1000,875,125
2/4/2021 14:11,8997013790092,BIMURA KERUPUK BAWANG 25G,2,1000,0,2000,1748,252
2/4/2021 14:24,8992761139018,ADES 600ML,1,3500,0,3500,2292,1208
2/4/2021 14:24,8997013790108,BIMURA KACANG TELUR 25G,1,1000,0,1000,875,125
2/4/2021 14:44,089686041705,INDOMIE GORENG JUMBO,2,3500,0,7000,6286,714
2/4/2021 14:45,8998866201841,GOLDA DOLCE LATTE 200ML,1,3000,0,3000,2500,500
2/4/2021 15:35,8991102987875,WFR TANGO POUCH CKL 115G,1,7000,0,7000,6273,727
2/4/2021 15:35,8997021870137,FRESH CARE SPLASH FRUITY 10ML,1,12000,0,12000,10000,2000
2/4/2021 16:13,8997210107877,VORTEX SMART 3,1,10000,0,10000,9500,500
2/4/2021 16:41,8998866500708,FLORIDINA ORANGE,1,3000,0,3000,2500,500
2/4/2021 16:41,8998866202237,NOODLE SEDAAP TASTY AYAM GEPREK 124 GR,1,5000,0,5000,4167,833
2/4/2021 16:41,8998866202312,NOODLE SEDAAP TASTY BAKMI AYAM 129 GR,1,5000,0,5000,4167,833
2/4/2021 16:41,8993470279651,JOGER CHOCKY BAR,1,1000,0,1000,867,133
2/4/2021 16:44,8998989110167,SURYA GUDANG GARAM 16 FILTER,1,24000,0,24000,22100,1900
2/4/2021 16:47,8992761122331,FRESTEA APPEL 500ML,1,6500,0,6500,4708,1792
2/4/2021 16:53,8999999401252,RINSO ANTI NODA CLASSIC 1.8KG,1,44800,0,44800,40726,4074
2/4/2021 16:53,8934868015024,REXONA DEO LOTION FREE SPIRIT 9G,12,4600,0,55200,46800,8400
2/4/2021 16:53,8999999537180,CLEAR SHP LEMON FRESH 9 ML,1,10500,0,10500,9300,1200
2/4/2021 16:53,8998866608329,CREAM EKONOMI PUTIH 455G,1,5500,0,5500,4750,750
2/4/2021 18:09,8992753102204,BKM COKLAT 370G,1,11300,0,11300,9500,1800
2/4/2021 19:41,8999999390198,SUNLIGHT LIME NEW POUCH 755ML,1,17000,0,17000,15400,1600
2/4/2021 20:43,8997013790092,BIMURA KERUPUK BAWANG 25G,1,1000,0,1000,874,126
2/4/2021 20:43,8991001503114,CHACHA MILK CHOCOLATE 35G,1,5500,0,5500,4900,600
2/4/2021 21:50,8999999008475,SUNLIGHT LIME NEW REF 1600ML,1,33000,0,33000,29800,3200
2/4/2021 21:59,8998989300261,GUDANG GARAM SURYA 12 FILTER,1,18000,0,18000,16450,1550
2/4/2021 22:27,ARG,ARGUS 220ML,1,14500,0,14500,12500,2000
2/4/2021 22:31,8998866610261,POWDET DAIA SOFTENER BAG 290 GR,1,5000,0,5000,4450,550
2/4/2021 22:31,8998866808729,ROYALE SOFT WHITE,1,5000,0,5000,4500,500
2/4/2021 22:52,ARG,ARGUS 220ML,1,14500,0,14500,12500,2000
2/4/2021 23:10,8996001301142,ROMA KELAPA,1,8000,0,8000,6628,1372
2/4/2021 23:10,8997013790108,BIMURA KACANG TELUR 25G,2,1000,0,2000,1750,250
2/5/2021 8:54,ARG,ARGUS 220ML,1,14500,0,14500,12500,2000
2/5/2021 9:46,BB,PASEO SMARTY FACIAL TRAVEL PACK 50S GT,1,2000,0,2000,1800,200
2/5/2021 10:39,GL,GULA 1 LITER,1,11500,0,11500,10500,1000
2/5/2021 10:55,8998866200844,NOODLE SEDAAP MIE KARI SPESIAL CUP 81 GR,1,4500,0,4500,3650,850
2/5/2021 10:55,8997013790108,BIMURA KACANG TELUR 25G,2,1000,0,2000,1750,250
2/5/2021 10:55,8997013790092,BIMURA KERUPUK BAWANG 25G,2,1000,0,2000,1748,252
2/5/2021 10:55,8991001111883,SILVERQUEEN CHUNKYBAR 33G,2,8000,0,16000,14300,1700
2/5/2021 10:55,8992775001042,PILUS GARUDA MI GORENG,1,5500,0,5500,4713,787
2/5/2021 12:09,8997013790108,BIMURA KACANG TELUR 25G,6,1000,0,6000,5250,750
2/5/2021 14:20,8998866202770,SEDAAP MIE GORENG SALERO PADANG 86 GR,2,2500,0,5000,4046,954
2/5/2021 14:28,8999999549305,VASELINE SUPERFOOD CRANBERRY 200ML,1,26000,0,26000,23940,2060
2/5/2021 16:10,089686010107,INDOMIE KALDU AYAM,1,2500,0,2500,2155,345
2/5/2021 16:10,8996001304990,SARI GANDUM 115G,1,6000,0,6000,5100,900
2/5/2021 16:10,8998866202770,SEDAAP MIE GORENG SALERO PADANG 86 GR,2,2500,0,5000,4046,954
2/5/2021 16:10,089686043204,INDOMIE MIE ACEH,1,2700,0,2700,2452,248
2/5/2021 16:53,8992761166205,FRESTEA GREEN HONEY 350ML,1,4500,0,4500,3000,1500
2/5/2021 18:51,8992761002039,FANTA STRAWBERRY PET 390 ML,1,5500,0,5500,4300,1200
2/5/2021 18:55,8991111101507,JB POWDER BLOSSOM 50G,1,3500,0,3500,3000,500
2/5/2021 18:55,8999999059323,LIFEBOUY LEMONFRESH DG 75G,1,3000,0,3000,2500,500
2/5/2021 18:56,8997013790092,BIMURA KERUPUK BAWANG 25G,3,1000,0,3000,2622,378
2/5/2021 19:43,8992775002087,GARUDA TING-TING 84G,1,6000,0,6000,4924,1076
2/5/2021 19:43,8992761002039,FANTA STRAWBERRY PET 390 ML,1,5500,0,5500,4300,1200
2/5/2021 19:43,8998866201889,KRISBEE PILLOW STRAWBERRY ICE CREAM 120GR,1,8200,0,8200,7250,950
2/5/2021 19:43,8998866202404,NOODLE SEDAAP MIE KOREAN SPICY CHICKEN CUP,1,5000,0,5000,3917,1083
2/5/2021 19:43,8992761145033,FANTA STRAW PET 250ML,3,3500,0,10500,7251,3249
2/5/2021 19:43,8992761145026,SPRITE PET 250ML,1,3500,0,3500,2417,1083
2/5/2021 19:43,8992761145019,COCA COLA PET 250ML,1,3500,0,3500,2417,1083
2/5/2021 19:43,8992957220186,COKLAT RUSA,2,2000,0,4000,3400,600
2/5/2021 19:48,8992761145026,SPRITE PET 250ML,1,3500,0,3500,2417,1083
2/5/2021 20:16,8998989100120,GUDANG GARAM MINI,1,18000,0,18000,16600,1400
2/5/2021 20:16,8998989300261,GUDANG GARAM SURYA 12 FILTER,1,18000,0,18000,16450,1550
2/5/2021 20:33,8851019510132,POCKY,1,7300,0,7300,7000,300
2/5/2021 20:33,8991001111883,SILVERQUEEN CHUNKYBAR 33G,1,8000,0,8000,7150,850
2/5/2021 20:47,089686067002,POP MIE PDS DOWER RS AYAM,1,5000,0,5000,4450,550
2/5/2021 20:47,089686010343,INDOMIE SOTO MIE,2,2600,0,5200,4734,466
2/5/2021 20:47,8999999195656,SARI WANGI 50X1.85,1,10000,0,10000,8700,1300
2/5/2021 20:47,8997013790108,BIMURA KACANG TELUR 25G,1,1000,0,1000,875,125
2/5/2021 21:30,8992761166205,FRESTEA GREEN HONEY 350ML,2,4500,0,9000,6000,3000
2/5/2021 22:43,8992761002022,SPRITE PET 390ML,1,5500,0,5500,4300,1200
2/5/2021 23:00,089686010343,INDOMIE SOTO MIE,1,2600,0,2600,2367,233
2/5/2021 23:00,089686010107,INDOMIE KALDU AYAM,1,2500,0,2500,2155,345
2/5/2021 23:34,8992696404441,BEAR BRAND 189ML,6,8500,0,51000,47322,3678
2/5/2021 23:34,8996001600375,LE MINERAL 330ML,6,2000,0,12000,8502,3498
2/5/2021 23:34,8991102300544,WFR TANGO VNL 176G,2,9200,0,18400,16672,1728
2/6/2021 8:30,8998866608725,DAIA SOFTENER BAG 850G,1,18000,0,18000,15627,2373
2/6/2021 8:30,8998866601436,PODET DAIA BUNGA BAG 850GR & PIRING,1,17300,0,17300,15627,1673
2/6/2021 8:30,8998866501033,MINYAK GORENG SEDAAP POUCH 2L,1,28500,0,28500,27746,754
2/6/2021 8:37,8992753631209,OMELA 370,2,9500,0,19000,16800,2200
2/6/2021 8:58,8999999516208,ROYCO FDS CHICKEN NEW 230G,1,9000,0,9000,8200,800
2/6/2021 8:58,8991102385091,WFR TANGO CKLT 7G,1,8300,0,8300,7455,845
2/6/2021 8:58,8998866692601,SOKLIN FLOORCLENER HIJAU 450ML,1,7000,0,7000,6385,615
2/6/2021 8:58,8998866107457,POSH SUMMER LOVE 150ML,1,19500,0,19500,17500,2000
2/6/2021 8:58,8992959117590,SFX DS REG FLOW WING 20,1,12000,0,12000,11250,750
2/6/2021 8:58,8998866103985,CIPT SIKP,2,3000,0,6000,5104,896
2/6/2021 8:58,8998866202343,NOODLE SEDAAP MIE KOREAN SPICY 87 GR,4,2500,0,10000,8092,1908
2/6/2021 8:58,8998866200301,NOODLE SEDAAP GORENG  90 GR,2,2500,0,5000,4046,954
2/6/2021 8:58,8999999057640,MOLTO EDP BLK PURPLE 20ML,5,1000,0,5000,4000,1000
2/6/2021 8:58,BB,PASEO SMARTY FACIAL TRAVEL PACK 50S GT,1,2000,0,2000,1800,200
2/6/2021 8:58,8998009010569,ULTRA CHO 200,4,4700,0,18800,15320,3480
2/6/2021 10:33,8998989300261,GUDANG GARAM SURYA 12 FILTER,1,18000,0,18000,16450,1550
2/6/2021 13:14,8998866201452,POTABEE REGULER BBQ BEEF 35GR,1,4800,0,4800,4150,650
2/6/2021 13:14,8998866201841,GOLDA DOLCE LATTE 200ML,1,3000,0,3000,2500,500
2/6/2021 13:18,8998989300261,GUDANG GARAM SURYA 12 FILTER,1,18000,0,18000,16450,1550
2/6/2021 13:18,8999999034696,PONDS MEN ENERGY CHARGE 100G,1,29500,0,29500,26620,2880
2/6/2021 13:53,8998866608008,KECAP MANIS SEDAAP BOTOL 135 ML,1,6300,0,6300,5615,685
2/6/2021 14:05,8992761139018,ADES 600ML,2,3500,0,7000,4584,2416
2/6/2021 14:33,GL,GULA 1 LITER,1,11500,0,11500,10500,1000
2/6/2021 14:52,8998898830125,KKB ENER-G ANGGUR,1,5500,0,5500,4824,676
2/6/2021 14:55,8992761166052,FRESTEA MELATI 350ML,1,4500,0,4500,3000,1500
2/6/2021 15:06,8992761147143,SPRITE WATERLYMON 425ML,1,5500,0,5500,4300,1200
2/6/2021 15:20,8996001600146,TEH PUCUK HARUM 350ML,1,3000,0,3000,2314,686
2/6/2021 15:20,8996001304990,SARI GANDUM 115G,1,6000,0,6000,5100,900
2/6/2021 15:28,11222,LEM KOREA,1,9000,0,9000,8000,1000
2/6/2021 15:30,8998866600538,SOKLIN FLOORCLENER PINK 400ML,1,6000,0,6000,5025,975
2/6/2021 15:30,8991102987899,WFR TANGO POUCH VNL 115G,1,7000,0,7000,6273,727
2/6/2021 15:39,8992761164539,NUTRIBOOST ORANGE 300ML,1,6500,0,6500,5300,1200
2/6/2021 16:38,8992696404441,BEAR BRAND 189ML,3,8500,0,25500,23661,1839
2/6/2021 16:38,8991001121400,SILVERQUEEN ALMOND 65G,1,15000,0,15000,13200,1800
2/6/2021 16:38,8997013790108,BIMURA KACANG TELUR 25G,1,1000,0,1000,875,125
2/6/2021 16:42,8992761164539,NUTRIBOOST ORANGE 300ML,1,6500,0,6500,5300,1200
2/6/2021 16:53,8992761122331,FRESTEA APPEL 500ML,1,6500,0,6500,4708,1792
2/6/2021 17:06,GL,GULA 1 LITER,3,11500,0,34500,31500,3000
2/6/2021 17:44,8992959002032,SWEETY SILVER PANTS L 36,1,72000,0,72000,68182,3818
2/6/2021 17:55,8991111101965,JB POWDER 300G,1,12500,0,12500,11250,1250
2/6/2021 18:13,8998866201469,POTABEE REGULER BBQ BEEF 68 GR,1,8000,0,8000,7200,800
2/6/2021 18:15,8992753720804,BKM 490,3,14000,0,42000,37950,4050
2/6/2021 18:15,8998866501033,MINYAK GORENG SEDAAP POUCH 2L,1,28500,0,28500,27746,754
2/6/2021 18:15,8992959508848,SWEETY SILVER PANTS L 18,1,41500,0,41500,37728,3772
2/6/2021 18:51,ARG,ARGUS 220ML,1,14500,0,14500,12500,2000
2/6/2021 19:15,8992696404441,BEAR BRAND 189ML,1,8500,0,8500,7887,613
2/6/2021 19:58,8996001305058,ROMA SANDWICH KACANG,1,7000,0,7000,5000,2000
2/6/2021 19:58,8992959953037,SWEETY BRONZE L1,1,3000,0,3000,2671,329
2/6/2021 20:13,8998989110129,SURYA KECIL MERAH 12KS,1,18000,0,18000,16450,1550
2/6/2021 20:21,8993470671752,JOGER STICK DUO KACANG,1,1000,0,1000,850,150
2/6/2021 20:24,8996001305041,ROMA SANDWICH CKLT,2,7000,0,14000,10000,4000
2/6/2021 20:24,8992753102204,BKM COKLAT 370G,1,11300,0,11300,9500,1800
2/6/2021 20:24,8934868015031,REXONA DEO LOTION ICE COOL,3,4600,0,13800,11700,2100
2/6/2021 20:24,8999999003074,VASELINE ALOE SOOTHE,1,13200,0,13200,11805,1395
2/6/2021 20:56,8998989110167,SURYA GUDANG GARAM 16 FILTER,2,24000,0,48000,44200,3800
2/6/2021 20:58,8998866202053,POTABEE AYAM BAKAR PEDAS 68GR,1,8000,0,8000,7200,800
2/6/2021 21:03,8998989110167,SURYA GUDANG GARAM 16 FILTER,1,24000,0,24000,22100,1900
2/6/2021 21:05,8999999049508,REXONA WMN RO SHOWER CLEAN 45 ML,1,15000,0,15000,13500,1500
2/6/2021 21:23,8999999401221,RINSO ANTI NODA CLASSIC 430G,1,10800,0,10800,9806,994
2/6/2021 23:02,8992761166038,MMP ORANGE 300ML,1,5000,0,5000,3750,1250
2/6/2021 23:02,8992957220186,COKLAT RUSA,2,2000,0,4000,3400,600
2/6/2021 23:02,8992761145033,FANTA STRAW PET 250ML,1,3500,0,3500,2417,1083
2/6/2021 23:02,8997013790108,BIMURA KACANG TELUR 25G,5,1000,0,5000,4375,625
2/6/2021 23:40,8998898819106,KOPI KKB GINGSENG,1,12500,0,12500,11050,1450
2/7/2021 8:41,8992761145019,COCA COLA PET 250ML,6,3500,0,21000,14502,6498
2/7/2021 10:24,8998866202343,NOODLE SEDAAP MIE KOREAN SPICY 87 GR,2,2500,0,5000,4046,954
2/7/2021 10:28,8991001780492,SELAMAT COKLAT,1,13000,0,13000,11800,1200
2/7/2021 10:28,8998009010231,ULTRA CHO 250,1,6000,0,6000,4784,1216
2/7/2021 10:28,8991001111883,SILVERQUEEN CHUNKYBAR 33G,1,8000,0,8000,7150,850
2/7/2021 10:28,8992696523067,MILO ACTVGO UHT 180ML,1,4500,0,4500,3515,985
2/7/2021 10:28,8992775311325,GERY SNACK&SEREAL 100G,2,7000,0,14000,11784,2216
2/7/2021 10:28,8850507002968,A1 KING TRUCK,1,16500,0,16500,15500,1000
2/7/2021 10:36,8998989110167,SURYA GUDANG GARAM 16 FILTER,1,24000,0,24000,22100,1900
2/7/2021 10:36,123124,KOREK BIASA,1,2000,0,2000,1800,200
2/7/2021 10:48,8998866202053,POTABEE AYAM BAKAR PEDAS 68GR,1,8000,0,8000,7200,800
2/7/2021 10:48,8851019210193,POCKY CHOCO BANANA 47G,1,7300,0,7300,5671,1629
2/7/2021 10:50,GL,GULA 1 LITER,2,11500,0,23000,21000,2000
2/7/2021 10:56,8998866888622,GIV MERAH KOTAK 76G,2,2000,0,4000,3640,360
2/7/2021 10:59,8999999707859,CLOSEUP GREEN 160G,1,15000,0,15000,13600,1400
2/7/2021 10:59,JGR,JOGER CHOCKY PASTA,1,20000,0,20000,18190,1810
2/7/2021 11:01,8999999024482,CITRA BW PEARLY WHITE REFF 220ML,1,12000,0,12000,10700,1300
2/7/2021 11:01,8999999710880,PEPSODENT ACTION123 HERBAL 75G,1,7500,0,7500,6650,850
2/7/2021 11:01,8991102385091,WFR TANGO CKLT 7G,1,8300,0,8300,7455,845
2/7/2021 11:02,11,PASEO SMART FHSTD PERF 6P 12S,1,5000,0,5000,4264,736
2/7/2021 11:19,8997013790108,BIMURA KACANG TELUR 25G,1,1000,0,1000,875,125
2/7/2021 11:33,CC,NICE FACIAL KILOAN 900 GR DUO,1,34500,0,34500,31325,3175
2/7/2021 11:48,8992761164539,NUTRIBOOST ORANGE 300ML,1,6500,0,6500,5300,1200
2/7/2021 12:00,8992761122331,FRESTEA APPEL 500ML,1,6500,0,6500,4708,1792
2/7/2021 13:12,8997013790108,BIMURA KACANG TELUR 25G,1,1000,0,1000,875,125
2/7/2021 13:12,8992775110157,GARUDA KACANG KULIT,1,5000,0,5000,3925,1075
2/7/2021 13:13,8998898830125,KKB ENER-G ANGGUR,1,5500,0,5500,4824,676
2/7/2021 13:56,8992761145033,FANTA STRAW PET 250ML,2,3500,0,7000,4834,2166
2/7/2021 14:22,8992761139018,ADES 600ML,1,3500,0,3500,2292,1208
2/7/2021 14:27,8992957220117,COKLAT BERUANG,1,2000,0,2000,1700,300
2/7/2021 14:27,8992957220087,COKLAT SINGA,1,2000,0,2000,1700,300
2/7/2021 14:27,8993470411433,JOGER CLASSIC,1,1000,0,1000,850,150
2/7/2021 14:27,8993470671752,JOGER STICK DUO KACANG,1,1000,0,1000,850,150
2/7/2021 14:48,8998989300391,SURYA PRO PUTIH,1,20000,0,20000,18600,1400
2/7/2021 14:48,123124,KOREK BIASA,1,2000,0,2000,1800,200
2/7/2021 15:15,8992761139018,ADES 600ML,1,3500,0,3500,2292,1208
2/7/2021 15:42,8992761002039,FANTA STRAWBERRY PET 390 ML,1,5500,0,5500,4300,1200
2/7/2021 16:05,8998866202770,SEDAAP MIE GORENG SALERO PADANG 86 GR,1,2500,0,2500,2023,477
2/7/2021 16:05,089686043204,INDOMIE MIE ACEH,1,2700,0,2700,2452,248
2/7/2021 16:05,089686010107,INDOMIE KALDU AYAM,1,2500,0,2500,2155,345
2/7/2021 16:08,123,BETREI JAM,1,5500,0,5500,5000,500
2/7/2021 16:31,8850507002968,A1 KING TRUCK,1,16500,0,16500,15500,1000
2/7/2021 16:38,GL,GULA 1 LITER,10,11500,0,115000,105000,10000
2/7/2021 16:38,8992753101207,BENDERA KENTAL MANIS 370G,2,11500,0,23000,19400,3600
2/7/2021 16:38,8991001780133,TWISTER BLACK,2,5000,0,10000,9200,800
2/7/2021 16:38,9556001004673,MILO NESTLE MALAYSIA ACTIVE GO,1,85000,0,85000,80000,5000
2/7/2021 16:38,8999999195649,SARI WANGI 25X1.86G,1,6000,0,6000,5050,950
2/7/2021 16:38,8992628022156,BIMOLI KLASIK TOUCH 1 LT,2,15500,0,31000,28282,2718
2/7/2021 17:17,ARG,ARGUS 220ML,3,14500,0,43500,37500,6000
2/7/2021 17:36,8999999529550,CLEAR COMPLETE SOFT CARE 80ML,1,11200,0,11200,10120,1080
2/7/2021 17:36,8998866602570,NUVO FAMILY KUNING 76G,2,2000,0,4000,3640,360
2/7/2021 19:49,8992761139018,ADES 600ML,1,3500,0,3500,2292,1208
2/7/2021 20:15,GL,GULA 1 LITER,2,11500,0,23000,21000,2000
2/7/2021 20:15,8999999706661,PEPSODENT TB DBL CARE SENSITIVE,1,11500,0,11500,10400,1100
2/7/2021 20:15,8997210107877,VORTEX SMART 3,1,10000,0,10000,9500,500
2/7/2021 20:15,8991004011906,KOPI BORONG,1,10000,0,10000,8333,1667
2/7/2021 20:15,8991102987899,WFR TANGO POUCH VNL 115G,1,7000,0,7000,6273,727
2/7/2021 20:23,8992761166052,FRESTEA MELATI 350ML,1,4500,0,4500,3000,1500
2/7/2021 20:31,8992761002022,SPRITE PET 390ML,1,5500,0,5500,4300,1200
2/7/2021 20:31,8998989300261,GUDANG GARAM SURYA 12 FILTER,1,18000,0,18000,16450,1550
2/7/2021 21:05,8992761002022,SPRITE PET 390ML,1,5500,0,5500,4300,1200
2/7/2021 22:01,8998866200578,NOODLE SEDAAP KARI KENTAL SPC 75 GR,2,2300,0,4600,3904,696
2/7/2021 22:01,8992761139018,ADES 600ML,1,3500,0,3500,2292,1208
2/7/2021 22:18,8992761139018,ADES 600ML,1,3500,0,3500,2292,1208
2/7/2021 22:19,8996001370063,CHOKI-CHOKI,1,18200,0,18200,16500,1700
2/7/2021 22:20,8992761139018,ADES 600ML,1,3500,0,3500,2292,1208
2/7/2021 22:22,8991001502933,CHACHA TUBE,1,7500,0,7500,6400,1100
2/7/2021 22:22,8993470411433,JOGER CLASSIC,1,1000,0,1000,850,150
2/7/2021 22:49,8998009020186,BUAVITA GUAVA 250ML,2,6600,0,13200,11900,1300
2/7/2021 22:49,8992696404441,BEAR BRAND 189ML,2,8500,0,17000,15774,1226
2/7/2021 22:49,8992761166038,MMP ORANGE 300ML,1,5000,0,5000,3750,1250
2/7/2021 22:49,089686060102,POP MIE PEDE GLEDEEK,2,5000,0,10000,8900,1100
2/7/2021 22:49,089686067002,POP MIE PDS DOWER RS AYAM,1,5000,0,5000,4450,550
2/7/2021 22:54,089686060362,POP MIE SOTO AYAM JUMBO,1,4500,0,4500,3833,667
2/7/2021 23:05,8991102987639,WFR TANGO LONG VNL 130G,2,4500,0,9000,7546,1454
2/7/2021 23:05,8996001304990,SARI GANDUM 115G,1,6000,0,6000,5100,900
2/7/2021 23:05,8992761166038,MMP ORANGE 300ML,1,5000,0,5000,3750,1250
2/7/2021 23:05,8992761145026,SPRITE PET 250ML,1,3500,0,3500,2417,1083
2/7/2021 23:06,8999999052997,PONDS CLEAR SOLUTION FACIAL SCRUB 50G,1,18200,0,18200,16300,1900
2/7/2021 23:06,8999999527372,PONDS MEN LIGHT OIL 50G,1,19000,0,19000,17160,1840
2/7/2021 23:08,8999999538422,CLEAR SHP ICM UNISEX 55 ML,1,4200,0,4200,3750,450
2/7/2021 23:11,089686060461,POP MIE RASA KARI AYAM,1,4500,0,4500,3833,667
2/7/2021 23:17,089686067002,POP MIE PDS DOWER RS AYAM,1,5000,0,5000,4450,550
2/8/2021 9:22,8993470279651,JOGER CHOCKY BAR,1,1000,0,1000,867,133
2/8/2021 9:22,8998866500708,FLORIDINA ORANGE,1,3000,0,3000,2500,500
2/8/2021 9:23,8998866202060,POTABEE AYAM BAKAR PEDAS 35 GR,1,4800,0,4800,4150,650
2/8/2021 9:25,8993470671752,JOGER STICK DUO KACANG,1,1000,0,1000,850,150
2/8/2021 9:28,8999999195649,SARI WANGI 25X1.86G,1,6000,0,6000,5050,950
2/8/2021 9:35,8998866501033,MINYAK GORENG SEDAAP POUCH 2L,1,28500,0,28500,27746,754
2/8/2021 10:59,8992696404441,BEAR BRAND 189ML,4,8500,0,34000,31548,2452
2/8/2021 10:59,8998009020186,BUAVITA GUAVA 250ML,1,6600,0,6600,5950,650
2/8/2021 10:59,8991001502933,CHACHA TUBE,2,7500,0,15000,12800,2200
2/8/2021 10:59,8992957220063,COKLAT BANGO,1,2000,0,2000,1700,300
2/8/2021 10:59,8992761122331,FRESTEA APPEL 500ML,1,6500,0,6500,4708,1792
2/8/2021 11:57,8992761139018,ADES 600ML,1,3500,0,3500,2292,1208
2/8/2021 11:57,8996001600375,LE MINERAL 330ML,1,2000,0,2000,1417,583
2/8/2021 11:57,8996001600269,LE MINERAL 600ML,1,3000,0,3000,1688,1312
2/8/2021 11:57,8998866201469,POTABEE REGULER BBQ BEEF 68 GR,1,8000,0,8000,7200,800
2/8/2021 13:03,8992761122430,FRESTEA GREEN HONEY 500ML,4,6500,0,26000,18832,7168
2/8/2021 13:03,8998989300230,SIGNATURE BESAR,1,20000,0,20000,18600,1400
2/8/2021 13:28,8992761166205,FRESTEA GREEN HONEY 350ML,1,4500,0,4500,3000,1500
2/8/2021 13:28,8992761164539,NUTRIBOOST ORANGE 300ML,1,6500,0,6500,5300,1200
2/8/2021 13:35,8997013790108,BIMURA KACANG TELUR 25G,1,1000,0,1000,875,125
2/8/2021 14:03,8992761002022,SPRITE PET 390ML,1,5500,0,5500,4300,1200
2/8/2021 14:05,8998866201841,GOLDA DOLCE LATTE 200ML,1,3000,0,3000,2500,500
2/8/2021 14:13,8998866200882,SUKSESMIE GORENG AYAM KRMS 133GR,1,3500,0,3500,3000,500
2/8/2021 18:00,8996001600146,TEH PUCUK HARUM 350ML,1,3000,0,3000,2314,686
2/8/2021 18:47,8992761145033,FANTA STRAW PET 250ML,2,3500,0,7000,4834,2166
2/8/2021 18:47,8998866202619,SEDAAP MIE KOREAN SPICY SOUP BAG 77 GR,1,2300,0,2300,2027,273
2/8/2021 18:55,8998866200325,NOODLE SEDAAP MIE SOTO,2,2200,0,4400,3904,496
2/8/2021 19:13,GL,GULA 1 LITER,1,11500,0,11500,10500,1000
2/8/2021 19:13,8993470279651,JOGER CHOCKY BAR,1,1000,0,1000,867,133
2/8/2021 20:23,8999999524722,SUNLIGHT LIME NEW PCH 435ML,1,10000,0,10000,9100,900
2/8/2021 20:34,BR,BERAS 10L,1,86500,0,86500,85000,1500
2/8/2021 20:50,8998989110167,SURYA GUDANG GARAM 16 FILTER,2,24000,0,48000,44200,3800
2/8/2021 21:10,11,PASEO SMART FHSTD PERF 6P 12S,1,5000,0,5000,4264,736
2/8/2021 21:10,089686010107,INDOMIE KALDU AYAM,1,2500,0,2500,2155,345
2/8/2021 21:10,089686010343,INDOMIE SOTO MIE,2,2600,0,5200,4734,466
2/8/2021 21:10,8999908204202,MY BABY MINYAK TELON 60ML,1,15000,0,15000,13545,1455
2/8/2021 22:32,8994867000179,ROKOK PENA MILD 16,1,14500,0,14500,13000,1500
2/9/2021 11:26,8998989500128,GUDANG GARAM MERAH KECIL 12KS,1,13000,0,13000,11900,1100
2/9/2021 11:27,8998866610278,DAIA VIOLET GUSSET 565G,1,10000,0,10000,8700,1300
2/9/2021 11:33,8850507001152,MOTU ATV,1,10000,0,10000,8000,2000
2/9/2021 11:34,8992761002039,FANTA STRAWBERRY PET 390 ML,1,5500,0,5500,4300,1200
2/9/2021 12:21,8850507001152,MOTU ATV,1,10000,0,10000,8000,2000
2/9/2021 12:21,8850507002951,BONCHA EGG SQUISHY,1,12000,0,12000,10841,1159
2/9/2021 12:31,8992761122331,FRESTEA APPEL 500ML,1,6500,0,6500,4708,1792
2/9/2021 12:58,089686011036,INDOMIE GORENG PEDAS,1,2700,0,2700,2452,248
2/9/2021 13:17,8992959117569,SFX DS REG FLOW NW 8,1,4000,0,4000,3530,470
2/9/2021 13:52,8992957220087,COKLAT SINGA,3,2000,0,6000,5100,900
2/9/2021 13:52,8992694242502,ZWITZAL SOAP CALSSIC 70G,1,3800,0,3800,3410,390
2/9/2021 13:52,8992761166038,MMP ORANGE 300ML,1,5000,0,5000,3750,1250
2/9/2021 14:03,8998866202244,EKOMIE BUMBU KALDU AYAM,1,1000,0,1000,860,140
2/9/2021 16:25,8999999195656,SARI WANGI 50X1.85,1,10000,0,10000,8700,1300
2/9/2021 16:41,8998866200882,SUKSESMIE GORENG AYAM KRMS 133GR,1,3500,0,3500,3000,500
2/9/2021 16:41,8998866613262,SUKSESMIE SOTO 111 GR,1,3500,0,3500,2770,730
2/9/2021 16:41,8993470279651,JOGER CHOCKY BAR,3,1000,0,3000,2601,399
2/9/2021 17:21,8991001780492,SELAMAT COKLAT,1,13000,0,13000,11800,1200
2/9/2021 17:21,8991102381024,FULLO VNL PCK,1,10000,0,10000,9000,1000
2/9/2021 17:21,8998866200561,EKOMIE SUPER 600GR,1,10000,0,10000,8615,1385
2/9/2021 17:21,8992696521797,MILO ACTVGO SCT 22G,11,2200,0,24200,21384,2816
2/9/2021 19:23,8996001600375,LE MINERAL 330ML,1,2000,0,2000,1417,583
2/9/2021 19:38,8996001600146,TEH PUCUK HARUM 350ML,1,3000,0,3000,2314,686
2/9/2021 20:01,8992761145019,COCA COLA PET 250ML,1,3500,0,3500,2417,1083
2/9/2021 20:16,8992753102204,BKM COKLAT 370G,1,11300,0,11300,9500,1800
2/9/2021 20:23,8991004011906,KOPI BORONG,1,10000,0,10000,8333,1667
2/9/2021 20:53,8992761145026,SPRITE PET 250ML,1,3500,0,3500,2417,1083
2/9/2021 21:39,8992957220087,COKLAT SINGA,3,2000,0,6000,5100,900
2/9/2021 21:50,8992761139018,ADES 600ML,1,3500,0,3500,2292,1208
2/9/2021 22:29,8992761111533,SPRITE SLIM CAM250ML,1,5000,0,5000,3750,1250
2/9/2021 22:43,8998989121163,SURYA PRO MERAH,1,20000,0,20000,18600,1400
2/9/2021 22:43,8992761145033,FANTA STRAW PET 250ML,4,3500,0,14000,9668,4332
2/9/2021 23:18,ARG,ARGUS 220ML,1,14500,0,14500,12500,2000
2/9/2021 23:22,8996001600269,LE MINERAL 600ML,24,1854,0,44496,40512,3984
2/9/2021 23:24,9999,ISOLASI LAKBAN,1,8000,0,8000,6500,1500
2/10/2021 9:22,8998866501033,MINYAK GORENG SEDAAP POUCH 2L,1,28500,0,28500,27746,754
2/10/2021 13:04,8992761111533,SPRITE SLIM CAM250ML,1,5000,0,5000,3750,1250
2/10/2021 13:42,8992761122331,FRESTEA APPEL 500ML,1,6500,0,6500,4708,1792
2/10/2021 14:20,8991001121615,SILVERQUEEN NUT,1,15000,0,15000,13200,1800
2/10/2021 14:20,8992959974018,SFX SIRIH 36CM 12+1,1,12000,0,12000,10686,1314
2/10/2021 15:44,8850507002951,BONCHA EGG SQUISHY,1,12000,0,12000,10841,1159
2/10/2021 16:07,8992761166038,MMP ORANGE 300ML,1,5000,0,5000,3750,1250
2/10/2021 16:14,8850507002951,BONCHA EGG SQUISHY,1,12000,0,12000,10841,1159
2/10/2021 17:14,8998009020186,BUAVITA GUAVA 250ML,2,6600,0,13200,11900,1300
2/10/2021 17:20,8992959953075,SWEETY BRONZE M9,1,17000,0,17000,15190,1810
2/10/2021 17:20,8998866200301,NOODLE SEDAAP GORENG  90 GR,2,2500,0,5000,4046,954
2/10/2021 17:20,089686010107,INDOMIE KALDU AYAM,2,2500,0,5000,4310,690
2/10/2021 17:20,8997013790092,BIMURA KERUPUK BAWANG 25G,2,1000,0,2000,1748,252
2/10/2021 17:32,8991102281430,PERMEN MINTZ DUOMINT,1,4500,0,4500,4000,500
2/10/2021 17:32,8998898847109,KOPI JAHE,1,13000,0,13000,11800,1200
2/10/2021 17:32,089686067002,POP MIE PDS DOWER RS AYAM,1,5000,0,5000,4450,550
2/10/2021 17:32,8993379152017,SABUN CUCI SURYA 200G,1,3000,0,3000,2281,719
2/10/2021 17:43,8992761145033,FANTA STRAW PET 250ML,1,3500,0,3500,2417,1083
2/10/2021 17:43,8992761166205,FRESTEA GREEN HONEY 350ML,1,4500,0,4500,3000,1500
2/10/2021 17:43,089686061079,POP MIE MINI AY BAWANG RL,2,3000,0,6000,5404,596
2/10/2021 18:09,089686010107,INDOMIE KALDU AYAM,2,2500,0,5000,4310,690
2/10/2021 18:19,8992761166038,MMP ORANGE 300ML,1,5000,0,5000,3750,1250
2/10/2021 19:03,8998866202244,EKOMIE BUMBU KALDU AYAM,5,1000,0,5000,4300,700
2/10/2021 19:12,8992775310212,GERY PASTA COKELAT,1,18000,0,18000,16029,1971
2/10/2021 19:12,8999999552503,ZWITSAL KIDS SHP PINK SOFT&MSTR 180 ML,1,15000,0,15000,13695,1305
2/10/2021 19:12,8991001503114,CHACHA MILK CHOCOLATE 35G,1,5500,0,5500,4900,600
2/10/2021 19:12,8991001503107,CHACHA PEANUT 35GR,1,5500,0,5500,4900,600
2/10/2021 19:12,8993470411433,JOGER CLASSIC,1,1000,0,1000,850,150
2/10/2021 19:26,089686060126,POP MIE BASO JUMBO,3,4500,0,13500,11499,2001
2/10/2021 19:26,8998866200813,NOODLE SEDAAP MIE GORENG CUP 85 GR,2,4500,0,9000,7834,1166
2/10/2021 19:26,8998866200820,NOODLE SEDAAP MIE AYAM BAWANG TLR CUP 77 GR,1,4500,0,4500,3650,850
2/10/2021 19:26,089686060027,POP MIE AYAM JUMBO,1,4500,0,4500,3833,667
2/10/2021 19:26,089686060362,POP MIE SOTO AYAM JUMBO,3,4500,0,13500,11499,2001
2/10/2021 19:26,8991102989428,WFR TANGO LONG CKLT 24G GTG,1,7500,0,7500,6714,786
2/10/2021 19:26,8991001121615,SILVERQUEEN NUT,1,15000,0,15000,13200,1800
2/10/2021 19:26,8996001304990,SARI GANDUM 115G,1,6000,0,6000,5100,900
2/10/2021 19:27,8998898830125,KKB ENER-G ANGGUR,1,5500,0,5500,4824,676
2/10/2021 19:58,MG,MINYAK GOSOK SAFERTABAT,1,28000,0,28000,25000,3000
2/10/2021 21:43,8998866608718,DAIA SOFTENER PINK,2,5000,0,10000,8900,1100
2/10/2021 21:43,8992753100101,BKM FULL CREAM GOLD 370,1,15000,0,15000,14000,1000
2/10/2021 21:43,8991001111883,SILVERQUEEN CHUNKYBAR 33G,1,8000,0,8000,7150,850
2/10/2021 21:51,8998989110167,SURYA GUDANG GARAM 16 FILTER,1,24000,0,24000,22100,1900
2/11/2021 7:19,9556001004673,MILO NESTLE MALAYSIA ACTIVE GO,1,85000,0,85000,80000,5000
2/11/2021 8:54,8996001600375,LE MINERAL 330ML,2,2000,0,4000,2834,1166
2/11/2021 9:04,8998866501033,MINYAK GORENG SEDAAP POUCH 2L,1,28500,0,28500,27746,754
2/11/2021 9:04,JGR,JOGER CHOCKY PASTA,1,20000,0,20000,18190,1810
2/11/2021 9:58,GL,GULA 1 LITER,8,11500,0,92000,84000,8000
2/11/2021 10:09,8998009020186,BUAVITA GUAVA 250ML,1,6600,0,6600,5950,650
2/11/2021 13:28,8991111109107,JB POWDER BEDTIME 75+25g,1,6000,0,6000,5440,560
2/11/2021 13:28,8998866602563,NUVO FAMILY HIJAU 76G,1,2000,0,2000,1820,180
2/11/2021 13:28,8998866610742,NOVO FAMILY PINK 76G,1,2000,0,2000,1820,180
2/11/2021 13:28,8997021300092,LARISSA BAWANG 250GR,1,5500,0,5500,5125,375
2/11/2021 13:28,8993379152017,SABUN CUCI SURYA 200G,2,3000,0,6000,4562,1438
2/11/2021 13:36,GL,GULA 1 LITER,3,11500,0,34500,31500,3000
2/11/2021 13:36,8996001350423,ZUPER KEJU,1,9200,0,9200,8360,840
2/11/2021 13:36,8991102989428,WFR TANGO LONG CKLT 24G GTG,1,7500,0,7500,6714,786
2/11/2021 13:36,8999999195656,SARI WANGI 50X1.85,1,10000,0,10000,8700,1300
2/11/2021 13:36,8992775311615,CHOCOLATOS,1,12000,0,12000,9983,2017
2/11/2021 13:36,8992388133017,NU MILK TEA ORI 330ML,1,5000,0,5000,4604,396
2/11/2021 13:38,8991001780133,TWISTER BLACK,1,5000,0,5000,4600,400
2/11/2021 14:49,8998866610223,DAIA VIOLET BAG 850G & PIRING,1,18000,0,18000,15627,2373
2/11/2021 14:49,8992775311325,GERY SNACK&SEREAL 100G,1,7000,0,7000,5892,1108
2/11/2021 14:49,8851019230566,POCKY CHOCO 22G,1,5000,0,5000,3001,1999
2/11/2021 14:49,8992696523081,MILO UHT 110ML,2,2500,0,5000,3924,1076
2/11/2021 14:49,8992696521629,DNCO COKLT UHT 180ML,1,5000,0,5000,3533,1467
2/11/2021 14:51,8998866602273,HERSPROTEX SOFTCARE MAX,1,3500,0,3500,2950,550
2/11/2021 14:51,8997001245887,TERIGU KITA 1KG,1,9500,0,9500,8500,1000
2/11/2021 14:51,8997025914332,HATARI CREAM CRECKERS,2,5000,0,10000,9526,474
2/11/2021 14:51,8998866604703,RAPIKA BIANG PINK 250MLBTL,1,8500,0,8500,7650,850
2/11/2021 14:53,8997210107877,VORTEX SMART 3,1,10000,0,10000,9500,500
2/11/2021 14:53,8991111152073,LISTERINE GREEN TEA 100ML,1,8000,0,8000,7600,400
2/11/2021 14:53,8992775001660,WAFER CREAM COKLAT TABUR KEJU,1,19000,0,19000,17721,1279
2/11/2021 14:53,8999999034733,PONDS MEN WHITE BOOST 100G,1,29500,0,29500,26620,2880
2/11/2021 14:53,8999999525811,MOLTO AIO BLUE PCH 720,1,26800,0,26800,23900,2900
2/11/2021 14:53,8992747180225,VIXAL PEMB PORS BIRU 720ML,1,18000,0,18000,16940,1060
2/11/2021 14:57,089686011494,INDOMIE SOTO PADANG,4,2600,0,10400,9268,1132
2/11/2021 14:57,8999999710880,PEPSODENT ACTION123 HERBAL 75G,1,7500,0,7500,6650,850
2/11/2021 14:57,8999999559557,LUX BW MAGICAL ORCHID 85ML,1,5000,0,5000,4000,1000
2/11/2021 14:57,8999999502393,ROYCO FDS CHICKEN 8G,2,5000,0,10000,9000,1000
2/11/2021 14:57,GL,GULA 1 LITER,3,11500,0,34500,31500,3000
2/11/2021 14:59,8996001304020,SLAI OLAI NANAS,1,8500,0,8500,7700,800
2/11/2021 14:59,8995333060703,TERIGU KOMPAS 1KG,2,10500,0,21000,19632,1368
2/11/2021 14:59,8999999045265,RINSO MOLTO ROSE FRESH PWD 770GR,1,21600,0,21600,19338,2262
2/11/2021 14:59,8999999525675,MOLTO HYGIENE 720ML,1,28000,0,28000,25150,2850
2/11/2021 14:59,8999999524838,SUNLIGHT MINT POUCH 755ML,1,17000,0,17000,15400,1600
2/11/2021 14:59,8999999049478,REXONA WMN RO NATURALS BIO 45 ML,1,16500,0,16500,14900,1600
2/11/2021 14:59,8998009010590,ULTRA CHO 125,2,3000,0,6000,4856,1144
2/11/2021 15:03,8992696523081,MILO UHT 110ML,1,2500,0,2500,1962,538
2/11/2021 15:36,8994867000179,ROKOK PENA MILD 16,1,14500,0,14500,13000,1500
2/11/2021 15:36,8992761002015,COCA COLA PET 390ML,1,5500,0,5500,4333,1167
2/11/2021 16:05,8993470279651,JOGER CHOCKY BAR,2,1000,0,2000,1734,266
2/11/2021 16:55,8996001320051,KOPIKO COFFE CANDY,1,6200,0,6200,5600,600
2/11/2021 16:57,8993470279651,JOGER CHOCKY BAR,1,1000,0,1000,867,133
2/11/2021 17:11,8996001304020,SLAI OLAI NANAS,1,8500,0,8500,7700,800
2/11/2021 17:11,8998866613262,SUKSESMIE SOTO 111 GR,2,3500,0,7000,5540,1460
2/11/2021 17:11,8999999524722,SUNLIGHT LIME NEW PCH 435ML,1,10000,0,10000,9100,900
2/11/2021 17:11,8995333060703,TERIGU KOMPAS 1KG,1,10500,0,10500,9816,684
2/11/2021 17:11,8996001320051,KOPIKO COFFE CANDY,1,6200,0,6200,5600,600
2/11/2021 17:11,8992628022156,BIMOLI KLASIK TOUCH 1 LT,1,15500,0,15500,14141,1359
2/11/2021 17:21,8992628022156,BIMOLI KLASIK TOUCH 1 LT,1,15500,0,15500,14141,1359
2/11/2021 17:21,8992753631209,OMELA 370,2,9500,0,19000,16800,2200
2/11/2021 17:22,GL,GULA 1 LITER,1,11500,0,11500,10500,1000
2/11/2021 17:25,8992696523067,MILO ACTVGO UHT 180ML,1,4500,0,4500,3515,985
2/11/2021 19:17,8998866501033,MINYAK GORENG SEDAAP POUCH 2L,1,28500,0,28500,27746,754
2/11/2021 19:17,JGR,JOGER CHOCKY PASTA,1,20000,0,20000,18190,1810
2/11/2021 20:43,8992761145033,FANTA STRAW PET 250ML,1,3500,0,3500,2417,1083
2/11/2021 21:35,8998866603522,SOKLIN FLOORCLENER UNGU 400ML,1,6000,0,6000,5025,975
2/11/2021 21:35,8999999551223,RINSO ACTIVE FRESH LIQ 700ML,1,19500,0,19500,17900,1600
2/11/2021 22:54,8992761166052,FRESTEA MELATI 350ML,1,4500,0,4500,3000,1500
2/12/2021 0:17,8993470279651,JOGER CHOCKY BAR,3,1000,0,3000,2601,399
2/12/2021 9:01,8998866200325,NOODLE SEDAAP MIE SOTO,2,2200,0,4400,3904,496
2/12/2021 9:49,8992957220087,COKLAT SINGA,1,2000,0,2000,1700,300
2/12/2021 9:49,8993470279651,JOGER CHOCKY BAR,1,1000,0,1000,867,133
2/12/2021 9:49,8998898830125,KKB ENER-G ANGGUR,1,5500,0,5500,4824,676
2/12/2021 10:01,8996001600269,LE MINERAL 600ML,24,1875,0,45000,40512,4488
2/12/2021 10:12,8996001318980,BETTER 120G,2,6000,0,12000,10200,1800
2/12/2021 10:12,8996001304990,SARI GANDUM 115G,1,6000,0,6000,5100,900
2/12/2021 10:20,8997013790092,BIMURA KERUPUK BAWANG 25G,2,1000,0,2000,1748,252
2/12/2021 10:20,8998866102605,KODOMO TB REG 2IN1,1,7500,0,7500,6600,900
2/12/2021 10:20,8992696521629,DNCO COKLT UHT 180ML,1,5000,0,5000,3533,1467
2/12/2021 10:20,8998009020186,BUAVITA GUAVA 250ML,1,6600,0,6600,5950,650
2/12/2021 10:20,8998866201711,KRISBEE KRUNCHY JAGUNG BAKAR MENTEGA 75 GR,1,5500,0,5500,4400,1100
2/12/2021 10:20,8998866202732,MILKU STROBERI 200ML,1,3000,0,3000,2375,625
2/12/2021 10:20,8993379200886,SABUN HARMONY ORANGE 70G,1,2000,0,2000,1652,348
2/12/2021 10:20,8998866608718,DAIA SOFTENER PINK,1,5000,0,5000,4450,550
2/12/2021 10:20,8999999401023,MOLTO PEWANGI PINK 820ML,1,12500,0,12500,11275,1225
2/12/2021 10:20,8999999052959,PONDS WHITE BEAUTY FACIAL FOAM 50G,1,17000,0,17000,15600,1400
2/12/2021 10:20,8999999004248,CITRA NATURAL WHITE SCRUB 200ML,1,16200,0,16200,14550,1650
2/12/2021 10:48,8992761145026,SPRITE PET 250ML,1,3500,0,3500,2417,1083
2/12/2021 11:45,8992761139018,ADES 600ML,1,3500,0,3500,2292,1208
2/12/2021 12:03,8996001600375,LE MINERAL 330ML,1,2000,0,2000,1417,583
2/12/2021 12:27,8992761166038,MMP ORANGE 300ML,1,5000,0,5000,3750,1250
2/12/2021 12:39,8998866200813,NOODLE SEDAAP MIE GORENG CUP 85 GR,1,4500,0,4500,3917,583
2/12/2021 13:32,8998866202770,SEDAAP MIE GORENG SALERO PADANG 86 GR,2,2500,0,5000,4046,954
2/12/2021 13:32,8998866201841,GOLDA DOLCE LATTE 200ML,1,3000,0,3000,2500,500
2/12/2021 13:32,8998866202732,MILKU STROBERI 200ML,1,3000,0,3000,2375,625
2/12/2021 14:23,089686043204,INDOMIE MIE ACEH,1,2700,0,2700,2452,248
2/12/2021 14:59,8998898830125,KKB ENER-G ANGGUR,1,5500,0,5500,4824,676
2/12/2021 15:01,8992761145033,FANTA STRAW PET 250ML,1,3500,0,3500,2417,1083
2/12/2021 15:24,GL,GULA 1 LITER,3,11500,0,34500,31500,3000
2/12/2021 15:24,8996001338056,TAMARIN,1,5600,0,5600,5100,500
2/12/2021 17:29,089686067002,POP MIE PDS DOWER RS AYAM,1,5000,0,5000,4450,550
2/12/2021 17:29,089686060461,POP MIE RASA KARI AYAM,2,4500,0,9000,7666,1334
2/12/2021 17:29,8996001305058,ROMA SANDWICH KACANG,1,7000,0,7000,5000,2000
2/12/2021 17:29,8996001370063,CHOKI-CHOKI,1,18200,0,18200,16500,1700
2/12/2021 17:30,8998866201933,MINYAK GORENG SEDAAP 5 L,1,71500,0,71500,70230,1270
2/12/2021 17:32,8990800020013,MENTOS MINT HALAL IND,1,5700,0,5700,5150,550
2/12/2021 17:32,8991102281416,PERMEN MINTZ PPMINT,1,4500,0,4500,4000,500
2/12/2021 17:37,8996001318980,BETTER 120G,1,6000,0,6000,5100,900
2/12/2021 18:12,8992761139018,ADES 600ML,1,3500,0,3500,2292,1208
2/12/2021 18:40,8996001304990,SARI GANDUM 115G,1,6000,0,6000,5100,900
2/12/2021 19:39,8998866501033,MINYAK GORENG SEDAAP POUCH 2L,1,28500,0,28500,27746,754
2/12/2021 21:40,8998866501033,MINYAK GORENG SEDAAP POUCH 2L,1,28500,0,28500,27746,754
2/12/2021 21:43,8996001600269,LE MINERAL 600ML,4,3000,0,12000,6752,5248
2/12/2021 21:44,8998989110167,SURYA GUDANG GARAM 16 FILTER,2,24000,0,48000,44200,3800
2/12/2021 21:48,8998866202343,NOODLE SEDAAP MIE KOREAN SPICY 87 GR,1,2500,0,2500,2023,477
2/12/2021 22:31,8992761145026,SPRITE PET 250ML,1,3500,0,3500,2417,1083
2/13/2021 10:49,8996001318911,BETTER ISI 4,2,2000,0,4000,3400,600
2/13/2021 10:49,GL,GULA 1 LITER,5,11500,0,57500,52500,5000
2/13/2021 10:49,8998866202671,NOODLE SEDAAP MIE KOREAN SPICY SOUP CUP,2,5000,0,10000,7834,2166
2/13/2021 10:49,8996001301142,ROMA KELAPA,3,8000,0,24000,19884,4116
2/13/2021 10:49,8996001302323,MALKIST ABON,4,6500,0,26000,19200,6800
2/13/2021 10:49,8998989110167,SURYA GUDANG GARAM 16 FILTER,1,24000,0,24000,22100,1900
2/13/2021 11:56,8998866202725,MILKU COKLAT PREMIUM 200ML,1,3000,0,3000,2375,625
2/13/2021 11:56,8998866202732,MILKU STROBERI 200ML,1,3000,0,3000,2375,625
2/13/2021 12:24,8996001320136,KOPIKO CAPP CANDY,1,6200,0,6200,5600,600
2/13/2021 12:24,8996001355237,SUPER STAR,1,11000,0,11000,9900,1100
2/13/2021 12:43,8998989100120,GUDANG GARAM MINI,1,18000,0,18000,16600,1400
2/13/2021 13:22,711844610095,LARISSA UDANG 500 GR,1,11000,0,11000,9790,1210
2/13/2021 14:37,8992761166052,FRESTEA MELATI 350ML,1,4500,0,4500,3000,1500
2/13/2021 14:37,8997013790108,BIMURA KACANG TELUR 25G,1,1000,0,1000,875,125
2/13/2021 16:43,8998866200301,NOODLE SEDAAP GORENG  90 GR,1,2500,0,2500,2023,477
2/13/2021 16:43,8992388111145,MIE ABC SELERA PEDAS- SUP TOMAT PEDAS,1,2500,0,2500,2023,477
2/13/2021 16:50,089686041705,INDOMIE GORENG JUMBO,1,3500,0,3500,3143,357
2/13/2021 16:50,8992775610008,TING-TING GARUDA 2.5G,1,7500,0,7500,6296,1204
2/13/2021 17:33,8999999045920,LIFEBUOY TS TOTAL 10 110GR,1,4000,0,4000,3500,500
2/13/2021 17:33,8996001305249,ROMA KELAPA CREAM,1,6800,0,6800,5514,1286
2/13/2021 17:33,8996001302347,SARI GANDUM FAM,1,8200,0,8200,7100,1100
2/13/2021 17:33,8996001304013,SLAI OLAI PACK,2,8500,0,17000,15400,1600
2/13/2021 17:33,8999999529710,CLEAR COOL SPORT MNTL 160ML,1,24800,0,24800,22700,2100
2/13/2021 17:33,6907992823904,JD CRU,1,8000,0,8000,6800,1200
2/13/2021 17:33,8999999030186,PEPSODENT ACTION 123 COMPLETE 190G,1,14000,0,14000,13200,800
2/13/2021 17:33,6907992823652,JDDD,1,6000,0,6000,5000,1000
2/13/2021 17:57,6907992823645,JD COCONUT BLISS,1,4000,0,4000,3500,500
2/13/2021 17:57,6907992823942,JD JUJUBE,2,4500,0,9000,7600,1400
2/13/2021 18:12,089686010190,INDOMIE KARI AYAM,2,2800,0,5600,5044,556
2/13/2021 18:12,8998899001920,BAYGON MAX,1,4000,0,4000,3500,500
2/13/2021 18:15,8997013790108,BIMURA KACANG TELUR 25G,3,1000,0,3000,2625,375
2/13/2021 18:20,8991001121615,SILVERQUEEN NUT,6,15000,0,90000,79200,10800
2/13/2021 18:30,8992761145026,SPRITE PET 250ML,2,3500,0,7000,4834,2166
2/13/2021 19:18,8998898830125,KKB ENER-G ANGGUR,1,5500,0,5500,4824,676
2/13/2021 19:27,GL,GULA 1 LITER,1,11500,0,11500,10500,1000
2/13/2021 19:27,8991102303309,WFR TANGO SBJ 176G,1,9200,0,9200,8336,864
2/13/2021 19:27,089686011036,INDOMIE GORENG PEDAS,2,2700,0,5400,4904,496
2/13/2021 19:27,8995333060703,TERIGU KOMPAS 1KG,1,10500,0,10500,9816,684
2/13/2021 19:27,8992628022156,BIMOLI KLASIK TOUCH 1 LT,1,15500,0,15500,14141,1359
2/13/2021 19:34,8996001600375,LE MINERAL 330ML,1,2000,0,2000,1417,583
2/13/2021 20:08,8996001318980,BETTER 120G,1,6000,0,6000,5100,900
2/13/2021 22:20,8992761145026,SPRITE PET 250ML,1,3500,0,3500,2417,1083
2/13/2021 22:52,8999999500665,"RINSO MOLTO ROSE FRESH PWD 1,8KG",1,44700,0,44700,40726,3974
2/13/2021 23:50,8992761145019,COCA COLA PET 250ML,1,3500,0,3500,2417,1083
2/13/2021 23:50,8992761145026,SPRITE PET 250ML,1,3500,0,3500,2417,1083
2/14/2021 8:33,8998866202053,POTABEE AYAM BAKAR PEDAS 68GR,2,8000,0,16000,14400,1600
2/14/2021 10:24,8998989110167,SURYA GUDANG GARAM 16 FILTER,1,24000,0,24000,22100,1900
2/14/2021 10:59,GL,GULA 1 LITER,40,11500,0,460000,420000,40000
2/14/2021 10:59,8994867000179,ROKOK PENA MILD 16,2,14500,0,29000,26000,3000
2/14/2021 11:05,8992761139018,ADES 600ML,1,3500,0,3500,2292,1208
2/14/2021 11:13,6907992825076,JD WATERMELON APPLE,1,2000,0,2000,1700,300
2/14/2021 11:35,GL,GULA 1 LITER,2,11500,0,23000,21000,2000
2/14/2021 11:35,8991004011906,KOPI BORONG,1,10000,0,10000,8333,1667
2/14/2021 11:35,8995333000822,TERIGU KOMPAS SOFT 500GR,1,5500,0,5500,4967,533
2/14/2021 11:35,8992770061034,SAJIKU,1,2000,0,2000,1500,500
2/14/2021 12:35,8993470671752,JOGER STICK DUO KACANG,1,1000,0,1000,850,150
2/14/2021 13:06,6907992823966,JD BLUEBERRY,1,3500,0,3500,3000,500
2/14/2021 13:31,6907992823966,JD BLUEBERRY,3,3500,0,10500,9000,1500
2/14/2021 13:31,8993470671752,JOGER STICK DUO KACANG,1,1000,0,1000,850,150
2/14/2021 13:31,8993470411433,JOGER CLASSIC,2,1000,0,2000,1700,300
2/14/2021 13:33,8992761002015,COCA COLA PET 390ML,1,5500,0,5500,4333,1167
2/14/2021 13:58,089686010107,INDOMIE KALDU AYAM,3,2500,0,7500,6465,1035
2/14/2021 13:58,089686010824,INDOMIE GORENG SPESIAL,2,2700,0,5400,4904,496
2/14/2021 13:58,089686010343,INDOMIE SOTO MIE,1,2600,0,2600,2367,233
2/14/2021 15:05,8999999031930,PEPSODENT TB TRIPLE CLEAN,1,3500,0,3500,2850,650
2/14/2021 15:05,6907992824963,JD CHOCO BLAST,1,3000,0,3000,2600,400
2/14/2021 15:05,8992775311325,GERY SNACK&SEREAL 100G,1,7000,0,7000,5892,1108
2/14/2021 15:05,8999999055769,FAIR&LOVELY MVIT FC FOAM 50 G,1,12500,0,12500,11180,1320
2/14/2021 15:05,8999999544126,FAIR&LOVELY BB CREAM 15 MG,1,20000,0,20000,17625,2375
2/14/2021 15:05,6907992823621,JD CREAMY YOGURT,1,4000,0,4000,2600,1400
2/14/2021 15:42,6907992823867,JD CRUNCHY CHOCOLATE MALT,1,5500,0,5500,4700,800
2/14/2021 15:42,6907992823874,JD CRUNCHY CHOCO BLUEBERRY,1,5500,0,5500,4700,800
2/14/2021 16:02,089686010107,INDOMIE KALDU AYAM,1,2500,0,2500,2155,345
2/14/2021 17:30,8998866200882,SUKSESMIE GORENG AYAM KRMS 133GR,1,3500,0,3500,3000,500
2/14/2021 17:59,8998009020186,BUAVITA GUAVA 250ML,1,6600,0,6600,5950,650
2/14/2021 17:59,8997013790108,BIMURA KACANG TELUR 25G,2,1000,0,2000,1750,250
2/14/2021 18:25,8992761139018,ADES 600ML,1,3500,0,3500,2292,1208
2/14/2021 18:25,8992761166052,FRESTEA MELATI 350ML,1,4500,0,4500,3000,1500
2/14/2021 18:25,8992957220087,COKLAT SINGA,1,2000,0,2000,1700,300
2/14/2021 18:50,8998009020186,BUAVITA GUAVA 250ML,1,6600,0,6600,5950,650
2/14/2021 19:01,8998989500166,GUDANG GARAM MERAH BESAR 16KS,2,17000,0,34000,30600,3400
2/14/2021 19:01,8998866200301,NOODLE SEDAAP GORENG  90 GR,2,2500,0,5000,4046,954
2/14/2021 19:01,089686010107,INDOMIE KALDU AYAM,3,2500,0,7500,6465,1035
2/14/2021 19:01,GL,GULA 1 LITER,1,11500,0,11500,10500,1000
2/14/2021 19:01,8998866608459,POWDET DAIA PUTIH BAG 290GR,2,5000,0,10000,8900,1100
2/14/2021 19:01,8991004011906,KOPI BORONG,1,10000,0,10000,8333,1667
2/14/2021 19:06,8999999195656,SARI WANGI 50X1.85,1,10000,0,10000,8700,1300
2/14/2021 19:29,GL,GULA 1 LITER,3,11500,0,34500,31500,3000
2/14/2021 19:58,8992753102204,BKM COKLAT 370G,1,11300,0,11300,9500,1800
2/14/2021 19:58,8996001301142,ROMA KELAPA,1,8000,0,8000,6628,1372
2/14/2021 19:58,8998866202732,MILKU STROBERI 200ML,1,3000,0,3000,2375,625
2/14/2021 21:40,8992761145019,COCA COLA PET 250ML,1,3500,0,3500,2417,1083
2/14/2021 21:40,8992761145033,FANTA STRAW PET 250ML,2,3500,0,7000,4834,2166
2/14/2021 21:40,8998989121163,SURYA PRO MERAH,1,20000,0,20000,18600,1400
2/14/2021 21:40,8992957220186,COKLAT RUSA,2,2000,0,4000,3400,600
2/14/2021 21:40,8992957220117,COKLAT BERUANG,2,2000,0,4000,3400,600
2/14/2021 21:49,6907992823942,JD JUJUBE,1,4500,0,4500,3800,700
2/14/2021 21:53,8994867007161,ROKOK PENA GOLD 20,1,17000,0,17000,15000,2000
2/14/2021 21:53,8992775311325,GERY SNACK&SEREAL 100G,1,7000,0,7000,5892,1108
2/14/2021 22:05,8998866500135,HERSPROTEX SOFTCARE WINGS,1,5500,0,5500,4820,680
2/14/2021 23:46,8998989300261,GUDANG GARAM SURYA 12 FILTER,1,18000,0,18000,16450,1550
2/14/2021 23:46,089686010824,INDOMIE GORENG SPESIAL,1,2700,0,2700,2452,248
2/14/2021 23:47,GL,GULA 1 LITER,1,11500,0,11500,10500,1000
2/15/2021 0:19,76164217,MARLBORO MERAH,1,30000,0,30000,27700,2300
2/15/2021 8:57,8998866501033,MINYAK GORENG SEDAAP POUCH 2L,2,28500,0,57000,55492,1508
2/15/2021 8:57,8998866610070,SOKLIN SOFTERGEN 280G PURPLE,1,5000,0,5000,4425,575
2/15/2021 8:57,089686010824,INDOMIE GORENG SPESIAL,1,2700,0,2700,2452,248
2/15/2021 10:10,8997213203095,INLITE 7W,1,34000,0,34000,31000,3000
2/15/2021 10:18,089686060362,POP MIE SOTO AYAM JUMBO,1,4500,0,4500,3833,667
2/15/2021 10:34,8993470671752,JOGER STICK DUO KACANG,1,1000,0,1000,850,150
2/15/2021 11:31,8998866202732,MILKU STROBERI 200ML,2,3000,0,6000,4750,1250
2/15/2021 11:54,6907992823645,JD COCONUT BLISS,1,4000,0,4000,3500,500
2/15/2021 11:54,6907992823850,CHOCO CIRLE,1,5000,0,5000,4700,300
2/15/2021 11:57,6907992823676,JD PEACH,1,2000,0,2000,1700,300
2/15/2021 11:57,6907992823843,JD MOCHA CRISPY,2,5000,0,10000,8800,1200
2/15/2021 12:01,GL,GULA 1 LITER,1,11500,0,11500,10500,1000
2/15/2021 12:01,8998866201933,MINYAK GORENG SEDAAP 5 L,1,71500,0,71500,70230,1270
2/15/2021 12:09,089686060126,POP MIE BASO JUMBO,1,4500,0,4500,3833,667
2/15/2021 14:01,8998898829129,KKB ENER-G JERUK,1,5500,0,5500,4824,676
2/15/2021 14:01,8998898830125,KKB ENER-G ANGGUR,1,5500,0,5500,4824,676
2/15/2021 14:01,8997013790108,BIMURA KACANG TELUR 25G,2,1000,0,2000,1750,250
2/15/2021 16:31,SWAL,SENDAL SWALLOW,1,18000,0,18000,16500,1500
2/15/2021 16:48,8998866201377,KRISBEE FRIES KENTANG GORENG 68 GR,1,5500,0,5500,4620,880
2/15/2021 16:48,8998989300261,GUDANG GARAM SURYA 12 FILTER,1,18000,0,18000,16450,1550
2/15/2021 16:58,8996001301142,ROMA KELAPA,1,8000,0,8000,6628,1372
2/15/2021 17:35,8992761002022,SPRITE PET 390ML,1,5500,0,5500,4300,1200
2/15/2021 17:47,8993470279651,JOGER CHOCKY BAR,2,1000,0,2000,1734,266
2/15/2021 17:47,8992761145019,COCA COLA PET 250ML,1,3500,0,3500,2417,1083
2/15/2021 18:10,8999999035495,VASELINE INSTA FAIR 190ML,1,33100,0,33100,30855,2245
2/15/2021 18:10,8999999035532,VASELINE NIGHT REPAIR 200ML,1,33800,0,33800,30855,2945
2/15/2021 18:17,8991111152080,LISTERINE NATURAL GREEN TEA 250ML,1,21500,0,21500,19550,1950
2/15/2021 18:20,8992959117590,SFX DS REG FLOW WING 20,1,12000,0,12000,11250,750
2/15/2021 18:20,TUSTEL,TUSUK TELINGA,1,1000,0,1000,833,167
2/15/2021 18:26,8992761139018,ADES 600ML,1,3500,0,3500,2292,1208
2/15/2021 18:26,8998866200844,NOODLE SEDAAP MIE KARI SPESIAL CUP 81 GR,1,4500,0,4500,3650,850
2/15/2021 19:08,8998866200882,SUKSESMIE GORENG AYAM KRMS 133GR,1,3500,0,3500,3000,500
2/15/2021 19:08,8992957220087,COKLAT SINGA,1,2000,0,2000,1700,300
2/15/2021 19:11,8999999007782,FAIR&LOVELY MULTIVITAMIN CREAM 25 MG,1,16500,0,16500,14905,1595
2/15/2021 19:11,8999999544126,FAIR&LOVELY BB CREAM 15 MG,1,20000,0,20000,17625,2375
2/15/2021 19:23,GL,GULA 1 LITER,1,11500,0,11500,10500,1000
2/15/2021 19:23,8998866501026,MINYAK GORENG SEDAAP POUCH 1 L,1,14500,0,14500,14110,390
2/15/2021 19:23,SNTN,SANTAN,1,2000,0,2000,1500,500
2/15/2021 19:23,8999999552503,ZWITSAL KIDS SHP PINK SOFT&MSTR 180 ML,1,15000,0,15000,13695,1305
2/15/2021 19:26,8992761139018,ADES 600ML,1,3500,0,3500,2292,1208
2/15/2021 19:26,8997013790108,BIMURA KACANG TELUR 25G,1,1000,0,1000,875,125
2/15/2021 19:29,8998989100120,GUDANG GARAM MINI,1,18000,0,18000,16600,1400
2/15/2021 20:21,8992775311325,GERY SNACK&SEREAL 100G,1,7000,0,7000,5892,1108
2/15/2021 21:09,8992696404441,BEAR BRAND 189ML,1,8500,0,8500,7887,613
2/15/2021 21:25,6907992823621,JD CREAMY YOGURT,1,3000,0,3000,2600,400
2/15/2021 22:00,8998989300261,GUDANG GARAM SURYA 12 FILTER,1,18000,0,18000,16450,1550
2/15/2021 23:03,8992761139018,ADES 600ML,2,3500,0,7000,4584,2416
2/15/2021 23:54,8992222010221,TANCHO TREATMENT,1,15000,0,15000,13000,2000
2/16/2021 7:48,8996001357088,ASTOR SINGLE 18GR,1,10800,0,10800,9800,1000
2/16/2021 7:48,8998866200578,NOODLE SEDAAP KARI KENTAL SPC 75 GR,1,2300,0,2300,1952,348
2/16/2021 7:48,8998866202053,POTABEE AYAM BAKAR PEDAS 68GR,1,8000,0,8000,7200,800
2/16/2021 9:57,8995333000822,TERIGU KOMPAS SOFT 500GR,1,5500,0,5500,4967,533
2/16/2021 9:58,8993470279651,JOGER CHOCKY BAR,1,1000,0,1000,867,133
2/16/2021 10:16,8998989500166,GUDANG GARAM MERAH BESAR 16KS,1,17000,0,17000,15300,1700
2/16/2021 10:51,089686010107,INDOMIE KALDU AYAM,2,2500,0,5000,4310,690
2/16/2021 11:05,8996001370063,CHOKI-CHOKI,1,18200,0,18200,16500,1700
2/16/2021 12:04,8992759120264,LARISST 220,2,12000,0,24000,18400,5600
2/16/2021 12:06,8999909096004,SAMPOERNA 16 FILTER,1,24000,0,24000,23000,1000
2/16/2021 12:09,76164217,MARLBORO MERAH,1,30000,0,30000,27700,2300
2/16/2021 12:21,8992753631209,OMELA 370,3,9500,0,28500,25200,3300
2/16/2021 12:21,6907992823867,JD CRUNCHY CHOCOLATE MALT,1,5500,0,5500,4700,800
2/16/2021 12:21,6907992823843,JD MOCHA CRISPY,2,5000,0,10000,8800,1200
2/16/2021 12:26,6907992823843,JD MOCHA CRISPY,1,5000,0,5000,4400,600
2/16/2021 12:26,8992753184002,FF MILKY STRW 115G,2,3000,0,6000,4356,1644
2/16/2021 12:26,6907992823829,JD MILKY MILK,2,3000,0,6000,5200,800
2/16/2021 12:26,6907992823874,JD CRUNCHY CHOCO BLUEBERRY,2,5500,0,11000,9400,1600
2/16/2021 12:26,6907992823966,JD BLUEBERRY,1,3500,0,3500,3000,500
2/16/2021 13:21,8996001600375,LE MINERAL 330ML,10,2000,0,20000,14170,5830
2/16/2021 13:21,GL,GULA 1 LITER,1,11500,0,11500,10500,1000
2/16/2021 14:18,8992759120264,LARISST 220,1,12000,0,12000,9200,2800
2/16/2021 15:03,8992761145026,SPRITE PET 250ML,1,3500,0,3500,2417,1083
2/16/2021 15:03,8992957220087,COKLAT SINGA,2,2000,0,4000,3400,600
2/16/2021 15:44,8998989300261,GUDANG GARAM SURYA 12 FILTER,1,18000,0,18000,16450,1550
2/16/2021 15:52,8992761139018,ADES 600ML,1,3500,0,3500,2292,1208
2/16/2021 17:35,8998866202244,EKOMIE BUMBU KALDU AYAM,4,1000,0,4000,3440,560
2/16/2021 17:35,8999999524722,SUNLIGHT LIME NEW PCH 435ML,1,10000,0,10000,9100,900
2/16/2021 17:35,8992628022156,BIMOLI KLASIK TOUCH 1 LT,1,16000,0,16000,14350,1650
2/16/2021 17:39,GL,GULA 1 LITER,1,11500,0,11500,10500,1000
2/16/2021 17:39,8993470671752,JOGER STICK DUO KACANG,3,1000,0,3000,2550,450
2/16/2021 17:54,8998866201452,POTABEE REGULER BBQ BEEF 35GR,1,4800,0,4800,4150,650
2/16/2021 18:05,8996001600375,LE MINERAL 330ML,2,2000,0,4000,2834,1166
2/16/2021 18:09,8992745120469,HIT SPRAY ORRG 415+35ML,1,27500,0,27500,25500,2000
2/16/2021 18:09,8992775001820,CHOCOLATOS WAFER CREAM,1,17500,0,17500,15761,1739
2/16/2021 18:13,8998866202732,MILKU STROBERI 200ML,1,3000,0,3000,2375,625
2/16/2021 18:19,8998866200882,SUKSESMIE GORENG AYAM KRMS 133GR,1,3500,0,3500,3000,500
2/16/2021 18:42,8998866200578,NOODLE SEDAAP KARI KENTAL SPC 75 GR,2,2300,0,4600,3904,696
2/16/2021 19:24,089686060102,POP MIE PEDE GLEDEEK,1,5000,0,5000,4450,550
2/16/2021 19:50,8992696422735,DNCO CKLT UHT 110ML,1,2500,0,2500,2041,459
2/16/2021 19:50,8992696523081,MILO UHT 110ML,1,2500,0,2500,1962,538
2/16/2021 19:59,8997018250218,JAHE MERAH,2,1000,0,2000,1666,334
2/16/2021 20:19,8998866202435,JAPOTA UMAMI JAPANESE SEAWEED 35GR,1,5000,0,5000,4150,850
2/16/2021 20:19,8998866201483,POTABEE REGULER GRILLED SEAWEED 35GR,1,5000,0,5000,4150,850
2/16/2021 20:27,8992761166038,MMP ORANGE 300ML,2,5000,0,10000,7500,2500
2/16/2021 20:32,8998866202435,JAPOTA UMAMI JAPANESE SEAWEED 35GR,1,5000,0,5000,4150,850
2/16/2021 20:39,8998989110167,SURYA GUDANG GARAM 16 FILTER,1,24000,0,24000,22100,1900
2/16/2021 21:46,9556040040038,SUSU F&N,1,33000,0,33000,30000,3000
2/16/2021 21:46,8992388133345,NU MILK TEA TEH TARIK 330ML,1,5000,0,5000,4604,396
2/16/2021 21:46,8992759120264,LARISST 220,1,12000,0,12000,9200,2800
2/16/2021 21:46,8993324850449,BABY LOVE COTTON BUDS,1,5000,0,5000,4500,500
2/16/2021 21:52,8998866202732,MILKU STROBERI 200ML,1,3000,0,3000,2375,625
2/16/2021 22:08,8998989110167,SURYA GUDANG GARAM 16 FILTER,1,24000,0,24000,22100,1900
2/16/2021 22:18,8998866202244,EKOMIE BUMBU KALDU AYAM,1,1000,0,1000,860,140
2/16/2021 22:18,8998866202343,NOODLE SEDAAP MIE KOREAN SPICY 87 GR,1,2500,0,2500,2023,477
2/16/2021 22:18,8998866202619,SEDAAP MIE KOREAN SPICY SOUP BAG 77 GR,1,2300,0,2300,2027,273
2/16/2021 22:18,8992388112401,MIE ABC SELERA PEDAS- GORENG AYAM PEDAS LIMAU,1,2600,0,2600,2368,232
2/16/2021 22:18,8992388111206,MIE ABC SELERA PEDAS-GULAI AYAM PEDAS,1,2500,0,2500,2022,478
2/16/2021 22:24,8998989500166,GUDANG GARAM MERAH BESAR 16KS,2,17000,0,34000,30600,3400
2/16/2021 22:25,GL,GULA 1 LITER,1,11500,0,11500,10500,1000
2/16/2021 22:26,8998866613262,SUKSESMIE SOTO 111 GR,1,3500,0,3500,2770,730
2/16/2021 22:33,8997013790108,BIMURA KACANG TELUR 25G,2,1000,0,2000,1750,250
2/16/2021 22:35,8999908284907,MY BABY MINYAK TELON 90ML,1,25000,0,25000,22700,2300
2/16/2021 22:44,8998899001920,BAYGON MAX,1,4000,0,4000,3500,500
2/17/2021 9:14,8995333060703,TERIGU KOMPAS 1KG,1,10500,0,10500,9816,684
2/17/2021 9:34,ARG,ARGUS 220ML,1,14500,0,14500,12500,2000
2/17/2021 9:34,8992759120264,LARISST 220,1,12000,0,12000,9200,2800
2/17/2021 9:34,TUSTEL,TUSUK TELINGA,1,1000,0,1000,833,167
2/17/2021 9:42,76164217,MARLBORO MERAH,1,30000,0,30000,27700,2300
2/17/2021 9:50,8992753631209,OMELA 370,1,9500,0,9500,8400,1100
2/17/2021 10:48,PT,POTO-POTO SINJAI,1,6000,0,6000,5000,1000
2/17/2021 10:48,KRP,KERUPUK BAWANG SINJAI,1,6000,0,6000,5000,1000
2/17/2021 10:48,8999999538446,SUNSILK SHP BLKSHINE 55 ML3750,1,4500,0,4500,3750,750
2/17/2021 11:10,JGR SHN,JOGER SHINY SACHET,1,500,0,500,405,95
2/17/2021 11:22,8998989300261,GUDANG GARAM SURYA 12 FILTER,1,18000,0,18000,16450,1550
2/17/2021 11:25,8998989121163,SURYA PRO MERAH,1,20000,0,20000,18600,1400
2/17/2021 11:25,8994867007161,ROKOK PENA GOLD 20,1,17000,0,17000,15000,2000
2/17/2021 14:03,GL,GULA 1 LITER,2,11500,0,23000,21000,2000
2/17/2021 14:03,8998866200301,NOODLE SEDAAP GORENG  90 GR,4,2500,0,10000,8092,1908
2/17/2021 14:03,8999801700030,SUSU FOYU,1,11500,0,11500,10450,1050
2/17/2021 14:03,8998866602570,NUVO FAMILY KUNING 76G,1,2000,0,2000,1820,180
2/17/2021 14:03,8998866606158,NUVO ACTIVE COOL 110G,1,3000,0,3000,2600,400
2/17/2021 14:03,BTS,BIMURA TARO SEAWEED 250G,1,10000,0,10000,9300,700
2/17/2021 14:03,8850507001152,MOTU ATV,1,10000,0,10000,8000,2000
2/17/2021 14:03,8995333060703,TERIGU KOMPAS 1KG,1,10500,0,10500,9816,684
2/17/2021 14:03,8998866104043,ZINC HAIRFALL TRETH BTL 70ML,1,8500,0,8500,7550,950
2/17/2021 14:41,8998009010231,ULTRA CHO 250,1,6000,0,6000,4784,1216
2/17/2021 14:41,8997013790108,BIMURA KACANG TELUR 25G,4,1000,0,4000,3500,500
2/17/2021 14:52,8998866202312,NOODLE SEDAAP TASTY BAKMI AYAM 129 GR,1,5000,0,5000,4167,833
2/17/2021 15:05,8992957220087,COKLAT SINGA,3,2000,0,6000,5100,900
2/17/2021 15:13,8992761166038,MMP ORANGE 300ML,2,5000,0,10000,7500,2500
2/17/2021 16:05,8998989100120,GUDANG GARAM MINI,1,18000,0,18000,16600,1400
2/17/2021 16:07,8998898830125,KKB ENER-G ANGGUR,1,5500,0,5500,4824,676
2/17/2021 16:26,GL,GULA 1 LITER,1,11500,0,11500,10500,1000
2/17/2021 16:26,8993365140363,MASU KURMA TJ 250G,1,22500,0,22500,20570,1930
2/17/2021 16:26,8993365122536,MADU TJ SUPER 250G,1,25000,0,25000,22780,2220
2/17/2021 16:26,8996001355008,BENG-BENG SP20G,1,29000,0,29000,26500,2500
2/17/2021 16:26,089686010190,INDOMIE KARI AYAM,5,2800,0,14000,12610,1390
2/17/2021 16:26,8999999059781,SUNLIGHT LIME NEW POUCH 210ML,1,5000,0,5000,4300,700
2/17/2021 16:26,8996001301579,MALKIST CKLT KELAPA PACK,1,11000,0,11000,9900,1100
2/17/2021 16:26,8999999195649,SARI WANGI 25X1.86G,1,6000,0,6000,5050,950
2/17/2021 16:26,8998866608718,DAIA SOFTENER PINK,1,5000,0,5000,4450,550
2/17/2021 16:26,8992628022156,BIMOLI KLASIK TOUCH 1 LT,1,16000,0,16000,14350,1650
2/17/2021 16:29,8998866202312,NOODLE SEDAAP TASTY BAKMI AYAM 129 GR,1,5000,0,5000,4167,833
2/17/2021 16:35,6907992823959,JD HAWTHORN BERRY,1,2000,0,2000,1700,300
2/17/2021 16:36,6907992823935,JD SWEETCORN,1,3500,0,3500,3000,500
2/17/2021 16:36,6907992823911,JD CRUNCHY HONEYDEW MELON,1,8000,0,8000,6800,1200
2/17/2021 16:36,6907992823904,JD CRUNCHY CHOCOLATE VAN,2,8000,0,16000,13600,2400
2/17/2021 17:34,089686060461,POP MIE RASA KARI AYAM,2,4500,0,9000,7666,1334
2/17/2021 17:34,8998866608084,KECAP MANIS SEDAAP POUCH 550ML,1,19000,0,19000,17000,2000
2/17/2021 17:34,8992628022156,BIMOLI KLASIK TOUCH 1 LT,1,16000,0,16000,14350,1650
2/17/2021 17:34,8998866200844,NOODLE SEDAAP MIE KARI SPESIAL CUP 81 GR,1,4500,0,4500,3650,850
2/17/2021 17:34,8998866200837,NOODLE SEDAAPMIE SOTO CUP 81 GR,1,4500,0,4500,3650,850
2/17/2021 17:34,089686060362,POP MIE SOTO AYAM JUMBO,2,4500,0,9000,7666,1334
2/17/2021 17:34,8998866200851,NOODLE SEDAAP MIE BAKSO SPESIAL CUP 77 GR,1,4500,0,4500,3650,850
2/17/2021 17:34,8998866200301,NOODLE SEDAAP GORENG  90 GR,2,2500,0,5000,4046,954
2/17/2021 17:34,8992761145026,SPRITE PET 250ML,1,3500,0,3500,2417,1083
2/17/2021 17:34,8999999528218,CITRA NATURAL WHITE BTL 220ML,1,17000,0,17000,15450,1550
2/17/2021 17:34,8994037703749,WENIS JERUK,1,8000,0,8000,6500,1500
2/17/2021 17:35,JGR SHN,JOGER SHINY SACHET,2,500,0,1000,874,126
2/17/2021 18:30,6907992823843,JD MOCHA CRISPY,1,5000,0,5000,4400,600
2/17/2021 18:38,8998866200325,NOODLE SEDAAP MIE SOTO,2,2200,0,4400,3904,496
2/17/2021 19:15,8991102989428,WFR TANGO LONG CKLT 24G GTG,1,1000,0,1000,672,328
2/17/2021 19:37,8998866200882,SUKSESMIE GORENG AYAM KRMS 133GR,1,3500,0,3500,3000,500
2/17/2021 19:37,6907992823669,JD MILKY STRAW,1,3000,0,3000,2600,400
2/17/2021 19:39,8998989110167,SURYA GUDANG GARAM 16 FILTER,1,24000,0,24000,22100,1900
2/17/2021 20:37,8998866202343,NOODLE SEDAAP MIE KOREAN SPICY 87 GR,1,2500,0,2500,2023,477
2/17/2021 20:51,8998989110167,SURYA GUDANG GARAM 16 FILTER,1,24000,0,24000,22100,1900
2/17/2021 21:29,8992761166038,MMP ORANGE 300ML,1,5000,0,5000,3750,1250
2/17/2021 21:29,8992957220025,GOLDEN CITY MINI,1,3000,0,3000,2500,500
2/17/2021 21:29,8992957220087,COKLAT SINGA,1,2000,0,2000,1700,300
2/17/2021 21:58,089686041705,INDOMIE GORENG JUMBO,1,3500,0,3500,3143,357
2/17/2021 21:58,8850507000094,POLICE BONCHA,1,2000,0,2000,800,1200
2/17/2021 22:16,8999909982000,SAMPOERNA 12 FILTER,1,18000,0,18000,16200,1800
2/17/2021 22:32,8992959953037,SWEETY BRONZE L1,2,3000,0,6000,5342,658
2/17/2021 22:36,8996001600665,COOL TIME,1,3200,0,3200,2750,450
2/17/2021 22:40,8992761145026,SPRITE PET 250ML,1,3500,0,3500,2417,1083
2/18/2021 9:48,8991001503107,CHACHA PEANUT 35GR,1,5500,0,5500,4900,600
2/18/2021 9:48,JGR SHN,JOGER SHINY SACHET,2,500,0,1000,874,126
2/18/2021 9:48,8991102989428,WFR TANGO LONG CKLT 24G GTG,1,1000,0,1000,672,328
2/18/2021 10:57,8992761166038,MMP ORANGE 300ML,1,5000,0,5000,3750,1250
2/18/2021 12:21,8998989500166,GUDANG GARAM MERAH BESAR 16KS,2,17000,0,34000,30600,3400
2/18/2021 12:21,8998866201841,GOLDA DOLCE LATTE 200ML,1,3000,0,3000,2500,500
2/18/2021 12:26,8999909010567,234 16 FILTER,1,23000,0,23000,21500,1500
2/18/2021 12:57,BTS,BIMURA TARO SEAWEED 250G,1,10000,0,10000,9300,700
2/18/2021 12:59,8992761002022,SPRITE PET 390ML,1,5500,0,5500,4300,1200
2/18/2021 13:30,8992745120469,HIT SPRAY ORRG 415+35ML,1,27500,0,27500,25500,2000
2/18/2021 13:59,123,BETREI JAM,1,5500,0,5500,5000,500
2/18/2021 14:24,6907992823591,JD STRAW MILKSHAKE,1,5000,0,5000,4300,700
2/18/2021 15:26,8992761164539,NUTRIBOOST ORANGE 300ML,1,8500,0,8500,5300,3200
2/18/2021 15:29,8998866200325,NOODLE SEDAAP MIE SOTO,2,2200,0,4400,3904,496
2/18/2021 18:15,8992628510158,SIMAS PALMIA,1,6500,0,6500,4832,1668
2/18/2021 18:22,6907992823935,JD SWEETCORN,1,3500,0,3500,3000,500
2/18/2021 19:10,8998866202732,MILKU STROBERI 200ML,1,3000,0,3000,2375,625
2/18/2021 19:32,8998989110167,SURYA GUDANG GARAM 16 FILTER,2,24000,0,48000,44200,3800
2/18/2021 19:32,123124,KOREK BIASA,1,2000,0,2000,1800,200
2/18/2021 19:58,8998866202244,EKOMIE BUMBU KALDU AYAM,5,1000,0,5000,4300,700
2/18/2021 20:15,8992696404441,BEAR BRAND 189ML,1,8500,0,8500,7887,613
2/18/2021 23:04,8992388133345,NU MILK TEA TEH TARIK 330ML,1,5000,0,5000,4604,396
2/18/2021 23:04,76239878,MARLBORO GOLD,1,30000,0,30000,27700,2300
2/18/2021 23:26,8998989300261,GUDANG GARAM SURYA 12 FILTER,1,18000,0,18000,16450,1550
2/18/2021 23:26,089686010343,INDOMIE SOTO MIE,2,2600,0,5200,4734,466
2/18/2021 23:56,089686021127,INTER MIE KALDU,2,1000,0,2000,1626,374
2/19/2021 10:35,8998866200646,KOPI TOP MURNI,1,11000,0,11000,9600,1400
2/19/2021 10:35,JGR SHN,JOGER SHINY SACHET,3,500,0,1500,1311,189
2/19/2021 10:35,8998009020520,BUAVITA MINI GUAVA 125ML,2,5800,0,11600,10500,1100
2/19/2021 10:35,8997013790092,BIMURA KERUPUK BAWANG 25G,1,1000,0,1000,874,126
2/19/2021 10:35,8996001305249,ROMA KELAPA CREAM,1,6800,0,6800,5514,1286
2/19/2021 10:35,8996001305041,ROMA SANDWICH CKLT,1,7000,0,7000,5000,2000
2/19/2021 10:35,8992761139018,ADES 600ML,1,3500,0,3500,2292,1208
2/19/2021 10:35,8999999037765,PEPSODENT WHITE 225G,1,12000,0,12000,10750,1250
2/19/2021 10:35,GL,GULA 1 LITER,1,11500,0,11500,10500,1000
2/19/2021 10:47,GL,GULA 1 LITER,4,11500,0,46000,42000,4000
2/19/2021 10:47,8995333032113,TERIGU GATOT KACA 1 KG,1,8500,0,8500,8012,488
2/19/2021 10:47,8999801700030,SUSU FOYU,1,11500,0,11500,10450,1050
2/19/2021 12:16,34678,SENDAL JEPIT,1,14000,0,14000,13500,500
2/19/2021 12:32,ARD,SENDAL ARDILES,1,15000,0,15000,13500,1500
2/19/2021 12:32,JGR SHN,JOGER SHINY SACHET,10,500,0,5000,4370,630
2/19/2021 12:33,8992761139018,ADES 600ML,2,3500,0,7000,4584,2416
2/19/2021 14:06,8996001304020,SLAI OLAI NANAS,1,8500,0,8500,7700,800
2/19/2021 14:16,8998866604963,POWDET DAIA LEMON 290GR,1,5000,0,5000,4450,550
2/19/2021 14:41,8992761139018,ADES 600ML,1,3500,0,3500,2292,1208
2/19/2021 14:48,8998898830125,KKB ENER-G ANGGUR,1,5500,0,5500,4824,676
2/19/2021 14:49,8992761139018,ADES 600ML,1,3500,0,3500,2292,1208
2/19/2021 14:53,8998866613262,SUKSESMIE SOTO 111 GR,1,3500,0,3500,2770,730
2/19/2021 14:53,089686048704,SARIMIE GORENG AYAM KCP ISI 2,1,3500,0,3500,3120,380
2/19/2021 14:53,089686041705,INDOMIE GORENG JUMBO,2,3500,0,7000,6286,714
2/19/2021 15:03,GL,GULA 1 LITER,1,11500,0,11500,10500,1000
2/19/2021 15:38,8992761002022,SPRITE PET 390ML,1,5500,0,5500,4300,1200
2/19/2021 15:38,JGR SHN,JOGER SHINY SACHET,2,500,0,1000,874,126
2/19/2021 16:07,8992761139018,ADES 600ML,1,3500,0,3500,2292,1208
2/19/2021 16:19,8998866200578,NOODLE SEDAAP KARI KENTAL SPC 75 GR,1,2300,0,2300,1952,348
2/19/2021 16:19,8992761139018,ADES 600ML,1,3500,0,3500,2292,1208
2/19/2021 16:21,GL,GULA 1 LITER,2,11500,0,23000,21000,2000
2/19/2021 16:21,8999999516208,ROYCO FDS CHICKEN NEW 230G,3,9000,0,27000,24600,2400
2/19/2021 16:21,8996001301579,MALKIST CKLT KELAPA PACK,1,11000,0,11000,9900,1100
2/19/2021 16:33,8992959930120,CONFIDENCE CLASSIC NIGHT XL6,1,42000,0,42000,38182,3818
2/19/2021 16:33,8999999003067,VASELINE SPF24 100ML,1,19500,0,19500,17600,1900
2/19/2021 16:38,089686021127,INTER MIE KALDU,1,1000,0,1000,813,187
2/19/2021 17:55,6907992824963,JD CHOCO BLAST,1,3000,0,3000,2600,400
2/19/2021 17:55,6907992823676,JD PEACH,1,2000,0,2000,1700,300
2/19/2021 17:55,6907992823942,JD JUJUBE,1,4500,0,4500,3800,700
2/19/2021 17:55,8992957220087,COKLAT SINGA,2,2000,0,4000,3400,600
2/19/2021 17:55,JGR SHN,JOGER SHINY SACHET,1,500,0,500,437,63
2/19/2021 18:18,6907992823959,JD HAWTHORN BERRY,1,2000,0,2000,1700,300
2/19/2021 18:18,6907992825076,JD WATERMELON APPLE,1,2000,0,2000,1700,300
2/19/2021 18:37,6907992823935,JD SWEETCORN,1,3500,0,3500,3000,500
2/19/2021 19:20,8992959077207,HN PANTS L 30,1,50000,0,50000,45455,4545
2/19/2021 19:20,8886020033431,KAPUR AJAIB ANTI KECOA DAN NYAMUK,1,3000,0,3000,2700,300
2/19/2021 19:20,ARD,SENDAL ARDILES,1,15000,0,15000,13500,1500
2/19/2021 19:54,8991002103764,GOOD DAY CPUCINO 10X25G,2,1500,0,3000,2790,210
2/19/2021 19:54,8996001600399,LE MINERAL 1500ML,1,5000,0,5000,4042,958
2/19/2021 20:05,8998866202244,EKOMIE BUMBU KALDU AYAM,5,1000,0,5000,4300,700
2/19/2021 20:05,8999999514006,BANGO MANIS 60ML,1,3000,0,3000,2400,600
2/19/2021 20:33,8996001318980,BETTER 120G,1,6000,0,6000,5100,900
2/19/2021 20:33,8993365131538,MADU TJ MURNI 150G,1,14800,0,14800,13430,1370
2/19/2021 20:33,8996001305041,ROMA SANDWICH CKLT,1,7000,0,7000,5000,2000
2/19/2021 20:33,8998866611220,FRES&NATURAL PUTIH 100ML,1,11500,0,11500,10310,1190
2/19/2021 20:33,8991102987899,WFR TANGO POUCH VNL 115G,1,7000,0,7000,6273,727
2/19/2021 20:33,8991102300544,WFR TANGO VNL 176G,1,9200,0,9200,8336,864
2/19/2021 21:14,9556001004673,MILO NESTLE MALAYSIA ACTIVE GO,1,85000,0,85000,80000,5000
2/19/2021 21:14,8996001600269,LE MINERAL 600ML,1,3000,0,3000,1688,1312
2/19/2021 21:19,8999909982000,SAMPOERNA 12 FILTER,1,18000,0,18000,16200,1800
2/19/2021 21:22,089686021127,INTER MIE KALDU,2,1000,0,2000,1626,374
2/19/2021 22:06,8999999560423,DOVE SUPER SHAMPOO 125ML,1,18500,0,18500,17000,1500
2/19/2021 22:10,8993072153595,LARISST COTTON 35G,1,5000,0,5000,3300,1700
2/19/2021 22:40,GL,GULA 1 LITER,3,11500,0,34500,31500,3000
2/19/2021 22:40,8996200900092,HEROCYN 85GR,1,13000,0,13000,11650,1350
2/19/2021 22:40,8993176110081,MINYAK KAYU PUTIH 30ML,1,12000,0,12000,9091,2909
2/19/2021 23:20,8998989300261,GUDANG GARAM SURYA 12 FILTER,1,18000,0,18000,16450,1550
2/20/2021 0:00,8998866200301,NOODLE SEDAAP GORENG  90 GR,1,2500,0,2500,2023,477
2/20/2021 0:00,8998866202619,SEDAAP MIE KOREAN SPICY SOUP BAG 77 GR,1,2300,0,2300,2027,273
2/20/2021 0:13,JGR SHN,JOGER SHINY SACHET,1,500,0,500,437,63
2/20/2021 10:37,8998989500166,GUDANG GARAM MERAH BESAR 16KS,2,17000,0,34000,30600,3400
2/20/2021 12:13,6907992823621,JD CREAMY YOGURT,1,3000,0,3000,2600,400
2/20/2021 12:13,8992761166052,FRESTEA MELATI 350ML,1,4500,0,4500,3000,1500
2/20/2021 12:58,8996001318911,BETTER ISI 4,2,2000,0,4000,3400,600
2/20/2021 12:58,8998866202312,NOODLE SEDAAP TASTY BAKMI AYAM 129 GR,1,5000,0,5000,4167,833
2/20/2021 13:30,8992761002015,COCA COLA PET 390ML,2,5500,0,11000,8666,2334
2/20/2021 13:58,089686067002,POP MIE PDS DOWER RS AYAM,1,5000,0,5000,4450,550
2/20/2021 13:58,8998866200301,NOODLE SEDAAP GORENG  90 GR,1,2500,0,2500,2023,477
2/20/2021 13:58,8999999059781,SUNLIGHT LIME NEW POUCH 210ML,1,5000,0,5000,4300,700
2/20/2021 15:50,6907992823942,JD JUJUBE,1,4500,0,4500,3800,700
2/20/2021 15:50,8997013790108,BIMURA KACANG TELUR 25G,1,1000,0,1000,875,125
2/20/2021 15:50,JGR SHN,JOGER SHINY SACHET,1,500,0,500,437,63
2/20/2021 16:00,8992959508879,SWEETY SILVER PANTS L 7,3,16800,0,50400,45684,4716
2/20/2021 16:00,8996001304020,SLAI OLAI NANAS,1,8500,0,8500,7700,800
2/20/2021 16:00,8992775002087,GARUDA TING-TING 84G,1,6000,0,6000,4924,1076
2/20/2021 16:00,8998866202053,POTABEE AYAM BAKAR PEDAS 68GR,1,8000,0,8000,7200,800
2/20/2021 16:20,8992696523081,MILO UHT 110ML,1,2500,0,2500,1962,538
2/20/2021 16:31,8996001600269,LE MINERAL 600ML,1,3000,0,3000,1688,1312
2/20/2021 16:31,8850507000094,POLICE BONCHA,1,2000,0,2000,800,1200
2/20/2021 16:49,8992761139018,ADES 600ML,1,3500,0,3500,2292,1208
2/20/2021 16:49,JGR SHN,JOGER SHINY SACHET,3,500,0,1500,1311,189
2/20/2021 18:02,GL,GULA 1 LITER,1,11500,0,11500,10500,1000
2/20/2021 18:09,8992959953327,SWEETY BRONZE L52,1,85000,0,85000,80304,4696
2/20/2021 18:09,8998866607315,SOKLIN SOFTERGENT SAKURA 770G & PIRING,1,18000,0,18000,16055,1945
2/20/2021 18:09,8999999037765,PEPSODENT WHITE 225G,1,12000,0,12000,10750,1250
2/20/2021 18:09,8999999049492,REXONA WMN RO POWDER DRY 45 ML,1,15000,0,15000,13500,1500
2/20/2021 18:09,8996001355237,SUPER STAR,1,11000,0,11000,9900,1100
2/20/2021 18:14,6907992823676,JD PEACH,1,2000,0,2000,1700,300
2/20/2021 18:18,8991102989428,WFR TANGO LONG CKLT 24G GTG,1,1000,0,1000,672,328
2/20/2021 19:04,8999999059781,SUNLIGHT LIME NEW POUCH 210ML,1,5000,0,5000,4300,700
2/20/2021 19:05,6907992825076,JD WATERMELON APPLE,4,2000,0,8000,6800,1200
2/20/2021 19:05,6907992823676,JD PEACH,1,2000,0,2000,1700,300
2/20/2021 19:25,8992761145033,FANTA STRAW PET 250ML,4,3500,0,14000,9668,4332
2/20/2021 19:25,8997013790108,BIMURA KACANG TELUR 25G,10,1000,0,10000,8750,1250
2/20/2021 19:25,8999909010567,234 16 FILTER,1,23000,0,23000,21500,1500
2/20/2021 19:38,8997021870328,HOT IN CREAM 120ML,1,18500,0,18500,17000,1500
2/20/2021 19:38,8993571003827,CAP 19 BEDAK SALICYL MENTHOL 100G,1,8000,0,8000,7000,1000
2/20/2021 20:24,8998866610261,POWDET DAIA SOFTENER BAG 290 GR,1,5000,0,5000,4450,550
2/20/2021 21:14,8998989300261,GUDANG GARAM SURYA 12 FILTER,1,18000,0,18000,16450,1550
2/20/2021 21:14,8996001355237,SUPER STAR,1,11000,0,11000,9900,1100
2/20/2021 21:17,8991102989428,WFR TANGO LONG CKLT 24G GTG,1,1000,0,1000,672,328
2/20/2021 21:17,GL,GULA 1 LITER,1,11500,0,11500,10500,1000
2/20/2021 21:28,GL,GULA 1 LITER,1,11500,0,11500,10500,1000
2/20/2021 21:34,8995333000822,TERIGU KOMPAS SOFT 500GR,1,5500,0,5500,4967,533
2/20/2021 21:34,GL,GULA 1 LITER,2,11500,0,23000,21000,2000
2/21/2021 11:11,8999999514006,BANGO MANIS 60ML,1,3000,0,3000,2400,600
2/21/2021 11:11,8995333060703,TERIGU KOMPAS 1KG,1,10500,0,10500,9816,684
2/21/2021 11:11,GL,GULA 1 LITER,1,11500,0,11500,10500,1000
2/21/2021 11:11,8996001600269,LE MINERAL 600ML,1,3000,0,3000,1688,1312
2/21/2021 11:11,8996001600399,LE MINERAL 1500ML,1,5000,0,5000,4042,958
2/21/2021 11:11,8998989300261,GUDANG GARAM SURYA 12 FILTER,1,18000,0,18000,16450,1550
2/21/2021 11:11,8998866201469,POTABEE REGULER BBQ BEEF 68 GR,1,8000,0,8000,7200,800
2/21/2021 11:29,6907992825076,JD WATERMELON APPLE,1,2000,0,2000,1700,300
2/21/2021 11:55,JGR SHN,JOGER SHINY SACHET,1,500,0,500,437,63
2/21/2021 13:50,8997011700123,BIHUN JAGUNG 300GR,1,5200,0,5200,4738,462
2/21/2021 14:07,8998898830125,KKB ENER-G ANGGUR,1,5500,0,5500,4824,676
2/21/2021 14:07,8997013790108,BIMURA KACANG TELUR 25G,3,1000,0,3000,2625,375
2/21/2021 16:31,8992753101207,BENDERA KENTAL MANIS 370G,2,11500,0,23000,19400,3600
2/21/2021 17:20,6907992823652,JD CHOCOLATE MILKSHAKE,1,6000,0,6000,5200,800
2/21/2021 17:20,6907992825076,JD WATERMELON APPLE,1,2000,0,2000,1700,300
2/21/2021 17:36,8992761139018,ADES 600ML,1,3500,0,3500,2292,1208
2/21/2021 17:36,8992761122331,FRESTEA APPEL 500ML,1,6500,0,6500,4708,1792
2/21/2021 18:40,6907992823935,JD SWEETCORN,2,3500,0,7000,6000,1000
2/21/2021 19:22,8999909010567,234 16 FILTER,1,23000,0,23000,21500,1500
2/21/2021 19:22,8997013790108,BIMURA KACANG TELUR 25G,1,1000,0,1000,875,125
2/21/2021 20:07,8998989110167,SURYA GUDANG GARAM 16 FILTER,1,24000,0,24000,22100,1900
2/21/2021 20:08,8992761166212,FRESTEA APPLE 350ML,1,4500,0,4500,3000,1500
2/21/2021 20:08,8992761166229,FRESTEA MARKISA 350ML,1,4500,0,4500,3000,1500
2/21/2021 20:09,8993470671752,JOGER STICK DUO KACANG,1,1000,0,1000,850,150
2/21/2021 20:37,8992761139018,ADES 600ML,1,3500,0,3500,2292,1208
2/21/2021 21:17,GL,GULA 1 LITER,1,11500,0,11500,10500,1000
2/21/2021 21:17,8999999706173,PEPSODENT WHITE 120G,1,6700,0,6700,5940,760
2/21/2021 21:17,8992775002087,GARUDA TING-TING 84G,1,6000,0,6000,4924,1076
2/21/2021 21:17,8998866501026,MINYAK GORENG SEDAAP POUCH 1 L,1,15500,0,15500,14110,1390
2/21/2021 21:17,8996001304013,SLAI OLAI PACK,1,8500,0,8500,7700,800
2/21/2021 21:17,8998866103985,CIPT SIKP,1,3000,0,3000,2552,448
2/21/2021 21:17,8997021870151,FRESH CARE STRONG 110ML,1,12000,0,12000,10000,2000
2/21/2021 21:17,8996001312353,MALKIST KELAPA KOPYOR,1,6700,0,6700,5400,1300
2/21/2021 21:17,8998866200882,SUKSESMIE GORENG AYAM KRMS 133GR,1,3500,0,3500,3000,500
2/21/2021 21:17,089686021141,INTER MIE SOTO,2,1000,0,2000,1708,292
2/21/2021 21:17,8998866200578,NOODLE SEDAAP KARI KENTAL SPC 75 GR,1,2300,0,2300,1952,348
2/21/2021 21:17,8998866613262,SUKSESMIE SOTO 111 GR,1,3500,0,3500,2770,730
2/21/2021 21:17,089686021127,INTER MIE KALDU,2,1000,0,2000,1626,374
2/21/2021 21:17,8998866202343,NOODLE SEDAAP MIE KOREAN SPICY 87 GR,2,2500,0,5000,4046,954
2/21/2021 21:17,8997021300092,LARISSA BAWANG 250GR,1,5500,0,5500,5125,375
2/21/2021 21:17,8998898853100,SUSU JAHE,1,13000,0,13000,11800,1200
2/21/2021 21:17,8999999529840,CLEAR SHP SPR FRSH APPLE 9 AML,1,10500,0,10500,9300,1200
2/21/2021 21:17,8998866610261,POWDET DAIA SOFTENER BAG 290 GR,1,5000,0,5000,4450,550
2/21/2021 21:17,8998866600101,CREAM EKONOMI LEMON 455G,1,5500,0,5500,4750,750
2/21/2021 21:17,8998866613002,CREAM EKONOMI PINK 455G,1,5500,0,5500,4750,750
2/21/2021 21:25,8991002103764,GOOD DAY CPUCINO 10X25G,10,1500,0,15000,13950,1050
2/21/2021 22:01,8998866202404,NOODLE SEDAAP MIE KOREAN SPICY CHICKEN CUP,1,5000,0,5000,3917,1083
2/21/2021 23:02,8998989300261,GUDANG GARAM SURYA 12 FILTER,1,18000,0,18000,16450,1550
2/21/2021 23:20,089686017748,SARIMIE GORENG ISI 2,1,3500,0,3500,3120,380
2/21/2021 23:24,8996200900023,HEROCYN 150GR,1,18000,0,18000,16400,1600
2/21/2021 23:24,8998989300261,GUDANG GARAM SURYA 12 FILTER,1,18000,0,18000,16450,1550
2/22/2021 10:52,8998866693578,SOKLIN FLOORCLENER PINK 900ML,1,14000,0,14000,12436,1564
2/22/2021 10:52,8998899400334,BAYGON ORANGE BLOSSOM,1,38000,0,38000,35000,3000
2/22/2021 10:52,8998899002132,BAY FRESH LEMON 320ML,1,18500,0,18500,16700,1800
2/22/2021 10:52,8999999001155,LIFEBUOY BW TOTAL10 300ML,1,24000,0,24000,21550,2450
2/22/2021 10:52,8996200900023,HEROCYN 150GR,1,18000,0,18000,16400,1600
2/22/2021 10:52,8998898101447,TOLAK ANGIN 12,1,35000,0,35000,32496,2504
2/22/2021 10:52,ARD,SENDAL ARDILES,1,15000,0,15000,13500,1500
2/22/2021 10:52,8992761166038,MMP ORANGE 300ML,1,5000,0,5000,3750,1250
2/22/2021 10:52,8999999037765,PEPSODENT WHITE 225G,1,12000,0,12000,10750,1250
2/22/2021 11:25,8992775311325,GERY SNACK&SEREAL 100G,1,7000,0,7000,5892,1108
2/22/2021 11:25,8998866202664,POTABEE WAGYU BEEF STEAK 68 GR,1,8000,0,8000,7200,800
2/22/2021 11:25,8998866202732,MILKU STROBERI 200ML,2,3000,0,6000,4750,1250
2/22/2021 11:46,8998866202732,MILKU STROBERI 200ML,1,3000,0,3000,2375,625
2/22/2021 11:46,8996001304990,SARI GANDUM 115G,1,6000,0,6000,5100,900
2/22/2021 13:03,8998989500166,GUDANG GARAM MERAH BESAR 16KS,2,17000,0,34000,30600,3400
2/22/2021 13:03,8992946511790,SHINZUI 85G,1,5000,0,5000,3475,1525
2/22/2021 14:16,8999908284907,MY BABY MINYAK TELON 90ML,1,25000,0,25000,22700,2300
2/22/2021 16:30,8999999030179,PEPSODENT ACTION 123 COMPLETE 75G,1,6700,0,6700,5170,1530
2/22/2021 16:30,8996001304990,SARI GANDUM 115G,1,6000,0,6000,5100,900
2/22/2021 16:43,8992761145026,SPRITE PET 250ML,1,3500,0,3500,2417,1083
2/22/2021 16:43,JGR SHN,JOGER SHINY SACHET,3,500,0,1500,1311,189
2/22/2021 17:22,8850507000094,POLICE BONCHA,1,2000,0,2000,800,1200
2/22/2021 17:22,8998009010590,ULTRA CHO 125,1,3000,0,3000,2428,572
2/22/2021 17:22,8996001305041,ROMA SANDWICH CKLT,1,7000,0,7000,5000,2000
2/22/2021 17:59,8995333060703,TERIGU KOMPAS 1KG,1,10500,0,10500,9816,684
2/22/2021 19:07,ARG,ARGUS 220ML,1,14500,0,14500,12500,2000
2/22/2021 19:07,8998989110167,SURYA GUDANG GARAM 16 FILTER,1,24000,0,24000,22100,1900
2/22/2021 19:10,JGR SHN,JOGER SHINY SACHET,1,500,0,500,437,63
2/22/2021 19:20,8992761145033,FANTA STRAW PET 250ML,1,3500,0,3500,2417,1083
2/22/2021 19:23,8998866201377,KRISBEE FRIES KENTANG GORENG 68 GR,1,5500,0,5500,4620,880
2/22/2021 19:23,JGR SHN,JOGER SHINY SACHET,2,500,0,1000,874,126
2/22/2021 19:28,8998866201964,MINYAK GORENG SABRINA 2L POUCH,1,28000,0,28000,26753,1247
2/22/2021 19:28,8991102989428,WFR TANGO LONG CKLT 24G GTG,2,1000,0,2000,1344,656
2/22/2021 19:40,8992761122331,FRESTEA APPEL 500ML,1,6500,0,6500,4708,1792
2/22/2021 19:40,8992761145026,SPRITE PET 250ML,1,3500,0,3500,2417,1083
2/22/2021 19:44,8998866200578,NOODLE SEDAAP KARI KENTAL SPC 75 GR,1,2300,0,2300,1952,348
2/22/2021 19:45,JGR SHN,JOGER SHINY SACHET,1,500,0,500,437,63
2/22/2021 19:50,8994037703749,WENIS JERUK,1,8000,0,8000,6500,1500
2/22/2021 19:59,8998989300261,GUDANG GARAM SURYA 12 FILTER,1,18000,0,18000,16450,1550
2/22/2021 20:14,8995333032113,TERIGU GATOT KACA 1 KG,3,8500,0,25500,24036,1464
2/22/2021 20:14,8993379210854,SABUN HARMONY 70G,2,2000,0,4000,3304,696
2/22/2021 20:14,8998866601429,POWDET DAIA BUNGA BAG 290GR,1,5000,0,5000,4450,550
2/22/2021 21:15,8998899001920,BAYGON MAX,1,4000,0,4000,3500,500
2/22/2021 21:15,8718291206453,PHILIPS 15 W,1,48000,0,48000,45000,3000
2/22/2021 21:44,089686010190,INDOMIE KARI AYAM,1,2800,0,2800,2522,278
2/22/2021 21:44,089686011494,INDOMIE SOTO PADANG,1,2600,0,2600,2317,283
2/22/2021 21:49,8999909096004,SAMPOERNA 16 FILTER,1,24000,0,24000,23000,1000
2/22/2021 21:49,8999909982000,SAMPOERNA 12 FILTER,1,18000,0,18000,16200,1800
2/22/2021 22:20,8992761002039,FANTA STRAWBERRY PET 390 ML,4,5500,0,22000,17200,4800
2/22/2021 22:25,8999999502003,"SARIMURNI RL RB 1,8G",1,1500,0,1500,1207,293
2/22/2021 23:04,8998989110167,SURYA GUDANG GARAM 16 FILTER,1,24000,0,24000,22100,1900
2/23/2021 11:30,8992628022156,BIMOLI KLASIK TOUCH 1 LT,1,16000,0,16000,14350,1650
2/23/2021 11:32,RAINBOW,MINICOCO RAINBOW,2,500,0,1000,900,100
2/23/2021 11:44,8992753631209,OMELA 370,1,9500,0,9500,8400,1100
2/23/2021 11:51,ATIRA,MIE KREMES ATIRA,1,500,0,500,425,75
2/23/2021 11:52,8992753720606,OMELA 490G,1,12000,0,12000,10531,1469
2/23/2021 12:41,8992761166212,FRESTEA APPLE 350ML,1,4500,0,4500,3000,1500
2/23/2021 12:48,8998866202770,SEDAAP MIE GORENG SALERO PADANG 86 GR,1,2500,0,2500,2023,477
2/23/2021 13:33,GL,GULA 1 LITER,3,11500,0,34500,31500,3000
2/23/2021 13:33,8996001351895,ZUPERRR KEJU SUSU,1,10000,0,10000,8000,2000
2/23/2021 13:36,8992761166205,FRESTEA GREEN HONEY 350ML,2,4500,0,9000,6000,3000
2/23/2021 13:44,GL,GULA 1 LITER,1,11500,0,11500,10500,1000
2/23/2021 13:50,8995333060772,TERIGU GATOT KACA 500GR,1,4500,0,4500,4065,435
2/23/2021 15:36,8992761166212,FRESTEA APPLE 350ML,2,4500,0,9000,6000,3000
2/23/2021 15:46,8998866501026,MINYAK GORENG SEDAAP POUCH 1 L,1,15500,0,15500,14110,1390
2/23/2021 15:48,089686011494,INDOMIE SOTO PADANG,1,2600,0,2600,2317,283
2/23/2021 15:58,8998989300261,GUDANG GARAM SURYA 12 FILTER,1,18000,0,18000,16450,1550
2/23/2021 15:58,8991102989428,WFR TANGO LONG CKLT 24G GTG,1,1000,0,1000,672,328
2/23/2021 15:58,8991102989534,WFR TANGO LONG VNL 24G GTG,1,1000,0,1000,672,328
2/23/2021 16:53,8992957214307,SAFARI MECES,1,5500,0,5500,4500,1000
2/23/2021 16:56,8998989300261,GUDANG GARAM SURYA 12 FILTER,1,18000,0,18000,16450,1550
2/23/2021 16:56,8992957220025,GOLDEN CITY MINI,1,3000,0,3000,2500,500
2/23/2021 16:56,8934868015031,REXONA DEO LOTION ICE COOL,1,4600,0,4600,3900,700
2/23/2021 16:56,COKLAT,COKLAT COIN,4,500,0,2000,1600,400
2/23/2021 17:02,8991111109138,JB POWDER BLOSSOM 150+50G,1,10000,0,10000,9210,790
2/23/2021 17:02,8991111101507,JB POWDER BLOSSOM 50G,1,3500,0,3500,3000,500
2/23/2021 17:33,8998866107457,POSH SUMMER LOVE 150ML,1,19500,0,19500,17500,2000
2/23/2021 17:33,COKLAT,COKLAT COIN,1,500,0,500,400,100
2/23/2021 19:25,8992775110157,GARUDA KACANG KULIT,1,5000,0,5000,3925,1075
2/23/2021 19:25,8992761139018,ADES 600ML,1,3500,0,3500,2292,1208
2/23/2021 19:34,8992761122331,FRESTEA APPEL 500ML,1,6500,0,6500,4708,1792
2/23/2021 19:34,089686021219,INTER MIE GORENG,1,1000,0,1000,885,115
2/23/2021 19:34,8997013790108,BIMURA KACANG TELUR 25G,1,1000,0,1000,875,125
2/23/2021 19:34,6907992823966,JD BLUEBERRY,1,3500,0,3500,3000,500
2/23/2021 19:34,8992775110157,GARUDA KACANG KULIT,1,5000,0,5000,3925,1075
2/23/2021 21:33,COKLAT,COKLAT COIN,1,500,0,500,400,100
2/23/2021 22:19,8998989300261,GUDANG GARAM SURYA 12 FILTER,1,18000,0,18000,16450,1550
2/23/2021 22:46,8992761145033,FANTA STRAW PET 250ML,3,3500,0,10500,7251,3249
2/23/2021 22:46,8998989300261,GUDANG GARAM SURYA 12 FILTER,1,18000,0,18000,16450,1550
2/23/2021 22:48,8999909010567,234 16 FILTER,1,23000,0,23000,21500,1500
2/23/2021 22:50,8999801700030,SUSU FOYU,1,11500,0,11500,10450,1050
2/23/2021 23:53,8998866600101,CREAM EKONOMI LEMON 455G,1,5500,0,5500,4750,750
2/23/2021 23:53,8934868015024,REXONA DEO LOTION FREE SPIRIT 9G,1,4600,0,4600,3900,700
2/24/2021 0:06,089686011036,INDOMIE GORENG PEDAS,1,2700,0,2700,2452,248
2/24/2021 0:30,8992761166205,FRESTEA GREEN HONEY 350ML,1,4500,0,4500,3000,1500
2/24/2021 9:08,8992761139018,ADES 600ML,1,3500,0,3500,2292,1208
2/24/2021 10:59,8997002060168,KRP SINGKOG PDS PANDA DUO,5,8000,0,40000,36500,3500
2/24/2021 10:59,8991111102832,JB POWDER BEDTIME 300G,1,14500,0,14500,13120,1380
2/24/2021 10:59,CC,NICE FACIAL KILOAN 900 GR DUO,1,34500,0,34500,31325,3175
2/24/2021 10:59,8997011700123,BIHUN JAGUNG 300GR,5,5200,0,26000,23690,2310
2/24/2021 11:05,8998989300261,GUDANG GARAM SURYA 12 FILTER,1,18000,0,18000,16450,1550
2/24/2021 11:05,8991102989428,WFR TANGO LONG CKLT 24G GTG,1,1000,0,1000,672,328
2/24/2021 11:05,8991102989534,WFR TANGO LONG VNL 24G GTG,1,1000,0,1000,672,328
2/24/2021 11:39,6907992823621,JD CREAMY YOGURT,1,3000,0,3000,2600,400
2/24/2021 11:39,8996001318911,BETTER ISI 4,2,2000,0,4000,3400,600
2/24/2021 12:46,8998898829129,KKB ENER-G JERUK,1,5500,0,5500,4824,676
2/24/2021 12:56,8992761139018,ADES 600ML,1,3500,0,3500,2292,1208
2/24/2021 12:56,8996001338056,TAMARIN,1,5600,0,5600,5100,500
2/24/2021 14:50,8993324850449,BABY LOVE COTTON BUDS,1,5000,0,5000,4500,500
2/24/2021 15:09,8998866201377,KRISBEE FRIES KENTANG GORENG 68 GR,1,5500,0,5500,4620,880
2/24/2021 15:09,8992761139018,ADES 600ML,1,3500,0,3500,2292,1208
2/24/2021 15:13,8996001600146,TEH PUCUK HARUM 350ML,1,3000,0,3000,2314,686
2/24/2021 15:13,8999999195656,SARI WANGI 50X1.85,1,10000,0,10000,8700,1300
2/24/2021 16:33,8996001318980,BETTER 120G,2,6000,0,12000,10200,1800
2/24/2021 16:33,8992775110157,GARUDA KACANG KULIT,4,5000,0,20000,15700,4300
2/24/2021 16:33,8992775211434,PILUS GARUDA SAPI PANGGANG,2,5500,0,11000,9426,1574
2/24/2021 16:33,8991102300544,WFR TANGO VNL 176G,1,9200,0,9200,8336,864
2/24/2021 16:33,8992775001691,GARUDA ROSTA WAGYU BEEF,1,8000,0,8000,7176,824
2/24/2021 16:33,8996001308042,SARI GANDUM BOX,1,22000,0,22000,20500,1500
2/24/2021 16:35,8999999034023,VASELINE MEN ANTI ACNE 50G,1,17000,0,17000,15400,1600
2/24/2021 17:07,8996001318911,BETTER ISI 4,1,2000,0,2000,1700,300
2/24/2021 17:07,8996001318430,BETTER 1000,1,1000,0,1000,820,180
2/24/2021 17:07,8997021870052,FRESH CARE GREEN TEA 10ML,1,12000,0,12000,10000,2000
2/24/2021 17:26,8998866201377,KRISBEE FRIES KENTANG GORENG 68 GR,2,5500,0,11000,9240,1760
2/24/2021 17:26,6907992823973,JD PINEAPPLE,1,5000,0,5000,4300,700
2/24/2021 17:26,6907992823966,JD BLUEBERRY,1,3500,0,3500,3000,500
2/24/2021 17:26,8991001502933,CHACHA TUBE,1,7500,0,7500,6400,1100
2/24/2021 17:47,COKLAT,COKLAT COIN,1,500,0,500,400,100
2/24/2021 17:52,8992761145019,COCA COLA PET 250ML,1,3500,0,3500,2417,1083
2/24/2021 18:09,8998866202343,NOODLE SEDAAP MIE KOREAN SPICY 87 GR,1,2500,0,2500,2023,477
2/24/2021 18:09,COKLAT,COKLAT COIN,2,500,0,1000,800,200
2/24/2021 18:09,JGR SHN,JOGER SHINY SACHET,1,500,0,500,437,63
2/24/2021 19:02,089686010824,INDOMIE GORENG SPESIAL,2,2700,0,5400,4904,496
2/24/2021 19:11,8999908204202,MY BABY MINYAK TELON 60ML,1,15000,0,15000,13545,1455
2/24/2021 19:11,8992775110157,GARUDA KACANG KULIT,1,5000,0,5000,3925,1075
2/24/2021 19:18,8998866200301,NOODLE SEDAAP GORENG  90 GR,4,2500,0,10000,8092,1908
2/24/2021 19:18,8998866202619,SEDAAP MIE KOREAN SPICY SOUP BAG 77 GR,1,2300,0,2300,2027,273
2/24/2021 19:18,089686048704,SARIMIE GORENG AYAM KCP ISI 2,1,3500,0,3500,3120,380
2/24/2021 19:23,8996001318911,BETTER ISI 4,1,2000,0,2000,1700,300
2/24/2021 19:23,BTS,BIMURA TARO SEAWEED 250G,1,10000,0,10000,9300,700
2/24/2021 19:23,8998009010569,ULTRA CHO 200,1,5000,0,5000,3830,1170
2/24/2021 19:23,8996001600146,TEH PUCUK HARUM 350ML,1,3000,0,3000,2314,686
2/24/2021 19:37,8996001355817,BENG-BENG MAXX,1,27000,0,27000,24500,2500
2/24/2021 19:37,8996001355008,BENG-BENG SP20G,1,29000,0,29000,26500,2500
2/24/2021 19:37,8992775610008,TING-TING GARUDA 2.5G,1,7500,0,7500,6296,1204
2/24/2021 19:40,8996001350423,ZUPER KEJU,2,9200,0,18400,16720,1680
2/24/2021 19:55,8991001502933,CHACHA TUBE,1,7500,0,7500,6400,1100
2/24/2021 19:56,GL,GULA 1 LITER,3,11500,0,34500,31500,3000
2/24/2021 20:58,8998866201964,MINYAK GORENG SABRINA 2L POUCH,1,28000,0,28000,26753,1247
2/24/2021 21:31,8992761002039,FANTA STRAWBERRY PET 390 ML,1,5500,0,5500,4300,1200
2/24/2021 21:31,8996001305249,ROMA KELAPA CREAM,1,6800,0,6800,5514,1286
2/24/2021 21:31,8991102385091,WFR TANGO CKLT 7G,1,8300,0,8300,7455,845
2/24/2021 22:20,ARD,SENDAL ARDILES,1,15000,0,15000,13500,1500
2/24/2021 22:20,8996001600665,COOL TIME,1,3500,0,3500,2750,750
2/24/2021 22:53,8996001301142,ROMA KELAPA,1,8000,0,8000,6628,1372
2/24/2021 22:53,PT,POTO-POTO SINJAI,2,6000,0,12000,10000,2000
2/24/2021 23:00,8998989300261,GUDANG GARAM SURYA 12 FILTER,1,18000,0,18000,16450,1550
2/25/2021 0:50,8998989300261,GUDANG GARAM SURYA 12 FILTER,1,18000,0,18000,16450,1550
2/25/2021 0:53,8997028590014,ARGUS 220ML,1,500,0,500,302,198
2/25/2021 10:35,8998866610261,POWDET DAIA SOFTENER BAG 290 GR,1,5000,0,5000,4450,550
2/25/2021 10:35,8998866108317,EMERON HJB ANTDNDF 10ML,1,1000,0,1000,4185,-3185
2/25/2021 10:35,8999999045616,MOLTO AIO PINK SCH,3,1000,0,3000,2400,600
2/25/2021 10:35,8998989500166,GUDANG GARAM MERAH BESAR 16KS,2,17000,0,34000,30600,3400
2/25/2021 10:35,RAINBOW,MINICOCO RAINBOW,2,500,0,1000,900,100
2/25/2021 10:53,8998866202619,SEDAAP MIE KOREAN SPICY SOUP BAG 77 GR,1,2300,0,2300,2027,273
2/25/2021 10:53,8998866202770,SEDAAP MIE GORENG SALERO PADANG 86 GR,1,2500,0,2500,2023,477
2/25/2021 11:20,18997210107584,GUNTING MONTANA,1,20000,0,20000,15000,5000
2/25/2021 11:25,GL,GULA 1 LITER,1,11500,0,11500,10500,1000
2/25/2021 11:28,8999999544416,MOLTO CARE,1,20000,0,20000,18570,1430
2/25/2021 12:41,8997011700123,BIHUN JAGUNG 300GR,1,5200,0,5200,4738,462
2/25/2021 14:33,8999999559854,AXE BLACK POCKET FRAG 17ML,1,10000,0,10000,8000,2000
2/25/2021 14:33,JGR SHN,JOGER SHINY SACHET,10,500,0,5000,4370,630
2/25/2021 14:56,8996001600146,TEH PUCUK HARUM 350ML,1,3000,0,3000,2314,686
2/25/2021 14:56,PUDING,VITA PUDDING,1,5000,0,5000,3750,1250
2/25/2021 14:56,ARD,SENDAL ARDILES,1,15000,0,15000,13500,1500
2/25/2021 17:02,8992761139018,ADES 600ML,1,3500,0,3500,2292,1208
2/25/2021 17:02,JGR SHN,JOGER SHINY SACHET,3,500,0,1500,1311,189
2/25/2021 17:17,8992761139018,ADES 600ML,1,3500,0,3500,2292,1208
2/25/2021 17:17,8992775311325,GERY SNACK&SEREAL 100G,2,7000,0,14000,11784,2216
2/25/2021 17:26,8992761166212,FRESTEA APPLE 350ML,1,4500,0,4500,3000,1500
2/25/2021 18:31,SNTN,SANTAN BUBUK,2,2000,0,4000,3000,1000
2/25/2021 18:38,8999999059316,LIFEBOUY TS MILDCARE 75G,1,3000,0,3000,2500,500
2/25/2021 20:14,8998866202244,EKOMIE BUMBU KALDU AYAM,1,1000,0,1000,860,140
2/25/2021 20:14,COKLAT,COKLAT COIN,2,500,0,1000,800,200
2/25/2021 20:22,GL,GULA 1 LITER,1,11500,0,11500,10500,1000
2/25/2021 20:41,GL,GULA 1 LITER,3,11500,0,34500,31500,3000
2/25/2021 20:46,8992957214307,SAFARI MECES,1,5500,0,5500,4500,1000
2/25/2021 20:47,COKLAT,COKLAT COIN,1,500,0,500,400,100
2/25/2021 20:50,GL,GULA 1 LITER,1,11500,0,11500,10500,1000
2/25/2021 21:24,8998866202343,NOODLE SEDAAP MIE KOREAN SPICY 87 GR,1,2500,0,2500,2023,477
2/25/2021 21:24,8998866200578,NOODLE SEDAAP KARI KENTAL SPC 75 GR,1,2300,0,2300,1952,348
2/25/2021 21:24,8998866200325,NOODLE SEDAAP MIE SOTO,1,2200,0,2200,1952,248
2/25/2021 21:24,8998866202619,SEDAAP MIE KOREAN SPICY SOUP BAG 77 GR,2,2300,0,4600,4054,546
2/26/2021 12:19,8995333032113,TERIGU GATOT KACA 1 KG,1,8500,0,8500,8012,488
2/26/2021 12:19,8992628510158,SIMAS PALMIA,1,6000,0,6000,4832,1168
2/26/2021 12:19,RAINBOW,MINICOCO RAINBOW,2,500,0,1000,900,100
2/26/2021 12:19,COKLAT,COKLAT COIN,2,500,0,1000,800,200
2/26/2021 12:19,8993379255152,PIZZI DISHWASHING 800ML LIME,1,13000,0,13000,12312,688
2/26/2021 12:46,8999999502003,"SARIMURNI RL RB 1,8G",2,1500,0,3000,2414,586
2/26/2021 12:50,RAINBOW,MINICOCO RAINBOW,3,500,0,1500,1350,150
2/26/2021 13:07,8992388133345,NU MILK TEA TEH TARIK 330ML,1,5000,0,5000,4604,396
2/26/2021 13:07,8995333032113,TERIGU GATOT KACA 1 KG,1,8500,0,8500,8012,488
2/26/2021 13:08,8998989300308,SIGNATURE KECIL,1,15000,0,15000,13700,1300
2/26/2021 14:41,8998898810721,KKB ENER-G C1000,1,8000,0,8000,6690,1310
2/26/2021 14:59,8992761145026,SPRITE PET 250ML,4,3500,0,14000,9668,4332
2/26/2021 14:59,8996001304136,SLAI OLAI BLUEBERRY,1,12000,0,12000,9900,2100
2/26/2021 14:59,8999909096004,SAMPOERNA 16 FILTER,1,24000,0,24000,23000,1000
2/26/2021 14:59,6907992823843,JD MOCHA CRISPY,1,5000,0,5000,4400,600
2/26/2021 14:59,6907992823829,JD MILKY MILK,1,3000,0,3000,2600,400
2/26/2021 14:59,8996001308042,SARI GANDUM BOX,1,22000,0,22000,20500,1500
2/26/2021 15:12,8992761166038,MMP ORANGE 300ML,1,5000,0,5000,3750,1250
2/26/2021 16:05,8999999030186,PEPSODENT ACTION 123 COMPLETE 190G,1,14000,0,14000,13200,800
2/26/2021 16:05,8996001600146,TEH PUCUK HARUM 350ML,1,3000,0,3000,2314,686
2/26/2021 16:05,8998009020520,BUAVITA MINI GUAVA 125ML,1,5800,0,5800,5250,550
2/26/2021 16:18,8999999710873,PEPSODENT ACTION123 HERBAL 120G,1,11400,0,11400,10400,1000
2/26/2021 16:18,8992628020152,BIMOLI POUCH 2L,1,30000,0,30000,28983,1017
2/26/2021 16:18,8999999524722,SUNLIGHT LIME NEW PCH 435ML,1,10000,0,10000,9100,900
2/26/2021 16:18,8992775211410,PILUS GARUDA PEDAS,1,5500,0,5500,4713,787
2/26/2021 16:18,8992775002087,GARUDA TING-TING 84G,1,6000,0,6000,4924,1076
2/26/2021 16:21,8999999045265,RINSO MOLTO ROSE FRESH PWD 770GR,1,21600,0,21600,19338,2262
2/26/2021 16:21,8999999524807,SUNLIGHT HABBATUSSAUDA POUCH 755ML,1,17000,0,17000,15400,1600
2/26/2021 16:21,8992761111540,FANTA STRAWBERY SLIM CAM 250ML,2,5000,0,10000,7500,2500
2/26/2021 16:21,8999999528850,CITRA NAT GLOW WHITE 60ML,1,6200,0,6200,5625,575
2/26/2021 16:21,8992761166038,MMP ORANGE 300ML,2,5000,0,10000,7500,2500
2/26/2021 16:21,089686010824,INDOMIE GORENG SPESIAL,5,2700,0,13500,12260,1240
2/26/2021 17:10,GL,GULA 1 LITER,3,11500,0,34500,31500,3000
2/26/2021 17:10,8999999195649,SARI WANGI 25X1.86G,1,6000,0,6000,5050,950
2/26/2021 17:10,8996001304013,SLAI OLAI PACK,1,8500,0,8500,7700,800
2/26/2021 17:10,8991001780126,SELAMAT CKLAT 60G,2,5000,0,10000,8600,1400
2/26/2021 17:11,8996001318911,BETTER ISI 4,1,2000,0,2000,1700,300
2/26/2021 17:14,BTS,BIMURA TARO SEAWEED 250G,1,10000,0,10000,9300,700
2/26/2021 17:14,SNTN,SANTAN BUBUK,1,2500,0,2500,1500,1000
2/26/2021 17:14,8992957214307,SAFARI MECES,1,5500,0,5500,4500,1000
2/26/2021 17:14,8998866202619,SEDAAP MIE KOREAN SPICY SOUP BAG 77 GR,1,2300,0,2300,2027,273
2/26/2021 17:14,8998866202343,NOODLE SEDAAP MIE KOREAN SPICY 87 GR,1,2500,0,2500,2023,477
2/26/2021 17:14,8991102989534,WFR TANGO LONG VNL 24G GTG,3,1000,0,3000,2016,984
2/26/2021 17:17,BTS,BIMURA TARO SEAWEED 250G,1,10000,0,10000,9300,700
2/26/2021 17:35,8992957220063,COKLAT BANGO,1,2000,0,2000,1700,300
2/26/2021 17:40,8995150101696,M+SUSU ORIGINAL,1,5000,0,5000,4000,1000
2/26/2021 17:40,8992388133345,NU MILK TEA TEH TARIK 330ML,1,5000,0,5000,4604,396
2/26/2021 17:58,8999909010567,234 16 FILTER,1,23000,0,23000,21500,1500
2/26/2021 18:27,8992388133345,NU MILK TEA TEH TARIK 330ML,1,5000,0,5000,4604,396
2/26/2021 18:30,8992388133345,NU MILK TEA TEH TARIK 330ML,1,5000,0,5000,4604,396
2/26/2021 19:05,8997011700123,BIHUN JAGUNG 300GR,1,5200,0,5200,4738,462
2/26/2021 19:08,8999909096004,SAMPOERNA 16 FILTER,1,24000,0,24000,23000,1000
2/26/2021 19:20,8996001600146,TEH PUCUK HARUM 350ML,2,3000,0,6000,4628,1372
2/26/2021 20:04,8999999557355,ZWITSAL BABY BOTTLE CLEANER 135 ML,1,5000,0,5000,4000,1000
2/26/2021 20:18,8999999195649,SARI WANGI 25X1.86G,1,6000,0,6000,5050,950
2/26/2021 20:18,8998866201452,POTABEE REGULER BBQ BEEF 35GR,1,4800,0,4800,4150,650
2/26/2021 20:18,8998866201483,POTABEE REGULER GRILLED SEAWEED 35GR,1,5000,0,5000,4150,850
2/26/2021 20:18,8998866202435,JAPOTA UMAMI JAPANESE SEAWEED 35GR,1,5000,0,5000,4150,850
2/26/2021 20:18,ARD,SENDAL ARDILES,1,15000,0,15000,13500,1500
2/26/2021 20:18,8999801700030,SUSU FOYU,2,11500,0,23000,20900,2100
2/26/2021 20:18,BTS,BIMURA TARO SEAWEED 250G,1,10000,0,10000,9300,700
2/26/2021 20:18,8995333000822,TERIGU KOMPAS SOFT 500GR,1,5500,0,5500,4967,533
2/26/2021 20:18,8998866200837,NOODLE SEDAAPMIE SOTO CUP 81 GR,1,4500,0,4500,3650,850
2/26/2021 20:18,8998866200851,NOODLE SEDAAP MIE BAKSO SPESIAL CUP 77 GR,1,4500,0,4500,3650,850
2/26/2021 20:18,8992775001820,CHOCOLATOS WAFER CREAM,1,17500,0,17500,15761,1739
2/26/2021 20:18,8996001350515,ZUPERRR KEJU CHOCO,1,10000,0,10000,8000,2000
2/26/2021 20:18,8998866201377,KRISBEE FRIES KENTANG GORENG 68 GR,1,5500,0,5500,4620,880
2/26/2021 20:18,8999999059781,SUNLIGHT LIME NEW POUCH 210ML,1,5000,0,5000,4300,700
2/26/2021 20:18,8998866610711,NOVO ACTIVE CLEAN 110G,2,3000,0,6000,5200,800
2/26/2021 20:18,8998866612180,SOKLIN SOFTERGEN 280G SAKURA,3,5000,0,15000,13275,1725
2/26/2021 20:18,GL,GULA 1 LITER,1,11500,0,11500,10500,1000
2/26/2021 20:26,8998009020520,BUAVITA MINI GUAVA 125ML,2,5800,0,11600,10500,1100
2/26/2021 20:29,8998866202060,POTABEE AYAM BAKAR PEDAS 35 GR,1,5000,0,5000,4150,850
2/26/2021 20:29,8996001304990,SARI GANDUM 115G,2,6000,0,12000,10200,1800
2/26/2021 20:29,8996001305058,ROMA SANDWICH KACANG,1,7000,0,7000,5000,2000
2/26/2021 20:29,8998866202725,MILKU COKLAT PREMIUM 200ML,1,3000,0,3000,2375,625
2/26/2021 20:53,BTS,BIMURA TARO SEAWEED 250G,1,10000,0,10000,9300,700
2/26/2021 20:53,8998866608046,KECAP MANIS SEDAAP POUCH 225ML,1,8300,0,8300,7375,925
2/26/2021 21:32,8998866201841,GOLDA DOLCE LATTE 200ML,2,3000,0,6000,5000,1000
2/26/2021 22:11,8998866202619,SEDAAP MIE KOREAN SPICY SOUP BAG 77 GR,1,2300,0,2300,2027,273
2/27/2021 10:31,8998866608718,DAIA SOFTENER PINK,1,5000,0,5000,4450,550
2/27/2021 10:31,8996001338056,TAMARIN,1,5600,0,5600,5100,500
2/27/2021 10:31,8996001600375,LE MINERAL 330ML,1,2000,0,2000,1417,583
2/27/2021 10:31,8992957214307,SAFARI MECES,1,5500,0,5500,4500,1000
2/27/2021 10:31,SWAL,SENDAL SWALLOW,1,18000,0,18000,16500,1500
2/27/2021 10:42,8999999537180,CLEAR SHP LEMON FRESH 9 ML,1,10500,0,10500,9300,1200
2/27/2021 10:42,8999999531478,MOLTO BLACK,1,5500,0,5500,6,5494
2/27/2021 10:50,8997013790108,BIMURA KACANG TELUR 25G,3,1000,0,3000,2625,375
2/27/2021 10:50,8998866200578,NOODLE SEDAAP KARI KENTAL SPC 75 GR,1,2300,0,2300,1952,348
2/27/2021 11:45,8998866201483,POTABEE REGULER GRILLED SEAWEED 35GR,1,5000,0,5000,4150,850
2/27/2021 11:45,8998866202435,JAPOTA UMAMI JAPANESE SEAWEED 35GR,1,5000,0,5000,4150,850
2/27/2021 11:53,6907992825076,JD WATERMELON APPLE,1,2000,0,2000,1700,300
2/27/2021 11:53,6907992823959,JD HAWTHORN BERRY,1,2000,0,2000,1700,300
2/27/2021 11:53,6907992823966,JD BLUEBERRY,1,3500,0,3500,3000,500
2/27/2021 13:09,8998989110167,SURYA GUDANG GARAM 16 FILTER,1,24000,0,24000,22100,1900
2/27/2021 13:09,8998866692663,SOKLIN FLOORCLENER KUNING 450ML,1,7000,0,7000,6385,615
2/27/2021 13:40,8999909096004,SAMPOERNA 16 FILTER,1,24000,0,24000,23000,1000
2/27/2021 14:28,8992957220087,COKLAT SINGA,1,2000,0,2000,1700,300
2/27/2021 14:36,089686010190,INDOMIE KARI AYAM,2,2800,0,5600,5044,556
2/27/2021 14:56,9556001025272,NESCAFE LATTE 240ML,1,8500,0,8500,7437,1063
2/27/2021 14:58,GL,GULA 1 LITER,1,11500,0,11500,10500,1000
2/27/2021 16:23,8996001305249,ROMA KELAPA CREAM,1,6800,0,6800,5514,1286
2/27/2021 16:51,8992775311615,CHOCOLATOS,1,12000,0,12000,9983,2017
2/27/2021 16:51,8998866202053,POTABEE AYAM BAKAR PEDAS 68GR,1,8000,0,8000,7200,800
2/27/2021 16:51,6907992823966,JD BLUEBERRY,1,3500,0,3500,3000,500
2/27/2021 16:51,6907992823607,JD CHOCO CAPTAIN,1,5500,0,5500,4700,800
2/27/2021 16:51,8999999544409,MOLTO DETERGEN CARE PURPLE PCH 700ML,1,20500,0,20500,18570,1930
2/27/2021 16:51,8992388112401,MIE ABC SELERA PEDAS- GORENG AYAM PEDAS LIMAU,1,2600,0,2600,2368,232
2/27/2021 16:51,8998866200844,NOODLE SEDAAP MIE KARI SPESIAL CUP 81 GR,1,4500,0,4500,3650,850
2/27/2021 17:03,8998866500708,FLORIDINA ORANGE,1,3000,0,3000,2500,500
2/27/2021 17:05,8850507002968,A1 KING TRUCK,1,16500,0,16500,15500,1000
2/27/2021 17:47,8999908284907,MY BABY MINYAK TELON 90ML,1,25000,0,25000,22700,2300
2/27/2021 17:47,8992959508862,SWEETY SILVER PANTS M 8,1,16800,0,16800,15229,1571
2/27/2021 18:22,8996001304990,SARI GANDUM 115G,1,6000,0,6000,5100,900
2/27/2021 18:22,8996001301579,MALKIST CKLT KELAPA PACK,1,11000,0,11000,9900,1100
2/27/2021 18:22,8992761002022,SPRITE PET 390ML,1,5500,0,5500,4300,1200
2/27/2021 18:24,8992761166052,FRESTEA MELATI 350ML,1,4500,0,4500,3000,1500
2/27/2021 19:30,8998866200578,NOODLE SEDAAP KARI KENTAL SPC 75 GR,2,2300,0,4600,3904,696
2/27/2021 19:45,8997028590014,ARGUS 220ML,2,500,0,1000,604,396
2/27/2021 20:01,COKLAT,COKLAT COIN,4,500,0,2000,1600,400
2/27/2021 22:41,8992736980164,SASA TEPUNG KENTUCKY 80G,1,3000,0,3000,2181,819
2/27/2021 22:41,8999999192150,ROYCO FDS CHICKEN 100GR,1,5000,0,5000,4300,700
2/27/2021 22:41,8992736025162,SASA TEPUNG PISANG GORENG,1,5000,0,5000,4455,545
2/27/2021 22:41,089686821086,ICHI OCHA MELATI,1,3000,0,3000,2250,750
2/27/2021 22:41,FUZO,KUACI FUZO,2,1000,0,2000,1700,300
2/27/2021 22:41,8998866500708,FLORIDINA ORANGE,1,3000,0,3000,2500,500
2/27/2021 22:43,8996001600146,TEH PUCUK HARUM 350ML,1,3000,0,3000,2314,686
2/27/2021 22:43,8992775211434,PILUS GARUDA SAPI PANGGANG,1,5500,0,5500,4713,787
2/27/2021 22:43,JGR SHN,JOGER SHINY SACHET,3,500,0,1500,1311,189
2/27/2021 23:01,089686010343,INDOMIE SOTO MIE,1,2600,0,2600,2367,233
2/27/2021 23:01,089686011036,INDOMIE GORENG PEDAS,1,2700,0,2700,2452,248
2/28/2021 11:35,8998989110167,SURYA GUDANG GARAM 16 FILTER,1,24000,0,24000,22100,1900
2/28/2021 11:35,8996001338056,TAMARIN,1,5600,0,5600,5100,500
2/28/2021 11:35,8999999195649,SARI WANGI 25X1.86G,1,6000,0,6000,5050,950
2/28/2021 11:35,8999999401221,RINSO ANTI NODA CLASSIC 430G,1,10800,0,10800,9806,994
2/28/2021 11:35,8992957220025,GOLDEN CITY MINI,1,3000,0,3000,2500,500
2/28/2021 11:35,8998866611701,EKONOMI PENCUCI PIRING  LIQ 132ML,1,2000,0,2000,1337,663
2/28/2021 11:35,8998866202770,SEDAAP MIE GORENG SALERO PADANG 86 GR,1,2500,0,2500,2023,477
2/28/2021 11:35,8999999559533,LIFEBUOY BW TOTAL 10 90ML,1,5000,0,5000,4000,1000
2/28/2021 11:35,COKLAT,COKLAT COIN,4,500,0,2000,1600,400
2/28/2021 11:35,8999909010567,234 16 FILTER,1,23000,0,23000,21500,1500
2/28/2021 11:35,8992696520103,DNCO CKLT FORT SCH 39G,1,3000,0,3000,2647,353
2/28/2021 11:35,8991111111964,C&C FACIAL WASH 50ML,1,12000,0,12000,10870,1130
2/28/2021 11:52,8992736424293,SASA BUMBU NASI GORENG 20G,2,2000,0,4000,2272,1728
2/28/2021 11:52,8992696404441,BEAR BRAND 189ML,1,8500,0,8500,7887,613
2/28/2021 12:03,8998989500166,GUDANG GARAM MERAH BESAR 16KS,1,17000,0,17000,15300,1700
2/28/2021 12:03,123124,KOREK BIASA,1,2000,0,2000,1800,200
2/28/2021 12:25,089686011036,INDOMIE GORENG PEDAS,1,2700,0,2700,2452,248
2/28/2021 12:32,COKLAT,COKLAT COIN,6,500,0,3000,2400,600
2/28/2021 12:32,6907992823676,JD PEACH,1,2000,0,2000,1700,300
2/28/2021 12:52,8995333060703,TERIGU KOMPAS 1KG,2,10500,0,21000,19632,1368
2/28/2021 12:52,BTS,BIMURA TARO SEAWEED 250G,1,10000,0,10000,9300,700
2/28/2021 12:52,8992959953136,SWEETY BRONZE L20,1,40000,0,40000,36770,3230
2/28/2021 12:52,BR,BERAS 10L,2,86500,0,173000,170000,3000
2/28/2021 12:52,8999999555122,MOLTO K-ROMANCE 20ML,2,1000,0,2000,1600,400
2/28/2021 12:52,8991111153148,LISTERINE SIWAK 250ML,1,21500,0,21500,19550,1950
2/28/2021 12:52,8998866609487,SOKLIN SOFTERGEN 280G,2,5000,0,10000,8850,1150
2/28/2021 12:52,8992745120469,HIT SPRAY ORRG 415+35ML,1,27500,0,27500,25500,2000
2/28/2021 12:52,8999999519100,LUX VELVET JASMINE 3PC 110G,1,11200,0,11200,10160,1040
2/28/2021 12:52,8998866888622,GIV MERAH KOTAK 76G,2,2000,0,4000,3640,360
2/28/2021 12:52,8992946511790,SHINZUI 85G,3,5000,0,15000,10425,4575
2/28/2021 12:52,ARD,SENDAL ARDILES,1,15000,0,15000,13500,1500
2/28/2021 13:02,8992959508831,SWEETY SILVER PANTS 18,1,36800,0,36800,33466,3334
2/28/2021 13:02,8998866200578,NOODLE SEDAAP KARI KENTAL SPC 75 GR,3,2300,0,6900,5856,1044
2/28/2021 13:02,GL,GULA 1 LITER,2,11500,0,23000,21000,2000
2/28/2021 13:02,8992628020152,BIMOLI POUCH 2L,1,30000,0,30000,28983,1017
2/28/2021 13:02,8994867000162,ROKOK PUNDIMAS KRETEK16,5,10000,0,50000,43000,7000
2/28/2021 13:02,8991102989312,WFR TANGO SBJ 7G,2,8300,0,16600,14910,1690
2/28/2021 13:02,8992753101207,BENDERA KENTAL MANIS 370G,1,11500,0,11500,9700,1800
2/28/2021 13:02,8992959953174,SWEETY BRONZE M34+2,1,58000,0,58000,53182,4818
2/28/2021 13:02,8999908204202,MY BABY MINYAK TELON 60ML,1,15000,0,15000,13545,1455
2/28/2021 13:44,8997011700123,BIHUN JAGUNG 300GR,1,5200,0,5200,4738,462
2/28/2021 15:00,8994867000179,ROKOK PENA MILD 16,1,14500,0,14500,13000,1500
2/28/2021 15:00,6907992823874,JD CRUNCHY CHOCO BLUEBERRY,1,5500,0,5500,4700,800
2/28/2021 15:00,6907992823867,JD CRUNCHY CHOCOLATE MALT,1,5500,0,5500,4700,800
2/28/2021 15:00,8998866202244,EKOMIE BUMBU KALDU AYAM,1,1000,0,1000,860,140
2/28/2021 15:00,8999999502393,ROYCO FDS CHICKEN 8G,1,5000,0,5000,4500,500
2/28/2021 16:06,8996001600641,TORA CAPPUCINO,1,3500,0,3500,2750,750
2/28/2021 16:06,JGR SHN,JOGER SHINY SACHET,3,500,0,1500,1311,189
2/28/2021 16:14,8999999528218,CITRA NATURAL WHITE BTL 220ML,1,17000,0,17000,15450,1550
2/28/2021 16:14,8999999529550,CLEAR COMPLETE SOFT CARE 80ML,1,11200,0,11200,10120,1080
2/28/2021 16:24,GL,GULA 1 LITER,1,11500,0,11500,10500,1000
2/28/2021 16:38,8998866201889,KRISBEE PILLOW STRAWBERRY ICE CREAM 120GR,1,8000,0,8000,7250,750
2/28/2021 16:39,8992628020152,BIMOLI POUCH 2L,1,30000,0,30000,28983,1017
2/28/2021 16:41,8998989100120,GUDANG GARAM MINI,1,3500,0,3500,16600,-13100
2/28/2021 17:25,8999801700030,SUSU FOYU,1,11500,0,11500,10450,1050
2/28/2021 17:32,8992775211410,PILUS GARUDA PEDAS,1,5500,0,5500,4713,787
2/28/2021 17:32,8996001600641,TORA CAPPUCINO,1,3500,0,3500,2750,750
2/28/2021 17:32,8996001600610,TORA MILKY LATTE 180ML,1,3500,0,3500,2750,750
2/28/2021 17:32,COKLAT,COKLAT COIN,4,500,0,2000,1600,400
2/28/2021 17:34,8998866202244,EKOMIE BUMBU KALDU AYAM,2,1000,0,2000,1720,280
2/28/2021 19:49,8997013790108,BIMURA KACANG TELUR 25G,2,1000,0,2000,1750,250
2/28/2021 19:49,8991102989534,WFR TANGO LONG VNL 24G GTG,3,1000,0,3000,2016,984
2/28/2021 19:49,089686010190,INDOMIE KARI AYAM,1,2800,0,2800,2522,278
2/28/2021 19:49,089686010343,INDOMIE SOTO MIE,2,2600,0,5200,4734,466
2/28/2021 19:49,089686010824,INDOMIE GORENG SPESIAL,2,2700,0,5400,4904,496
2/28/2021 19:50,8992761139018,ADES 600ML,1,3500,0,3500,2292,1208
2/28/2021 19:50,8996001600269,LE MINERAL 600ML,1,3000,0,3000,1688,1312
2/28/2021 19:52,8998866500708,FLORIDINA ORANGE,1,3000,0,3000,2500,500
2/28/2021 19:52,COKLAT,COKLAT COIN,1,500,0,500,400,100
2/28/2021 19:52,FUZO,KUACI FUZO,1,1000,0,1000,850,150
2/28/2021 20:05,089686011494,INDOMIE SOTO PADANG,1,2600,0,2600,2317,283
2/28/2021 20:05,8998866202244,EKOMIE BUMBU KALDU AYAM,2,1000,0,2000,1720,280
2/28/2021 20:05,6907992824963,JD CHOCO BLAST,1,3000,0,3000,2600,400
2/28/2021 20:05,6907992823669,JD MILKY STRAW,1,3000,0,3000,2600,400
2/28/2021 20:05,ATIRA,MIE KREMES ATIRA,3,500,0,1500,1275,225
2/28/2021 20:36,8991002103764,GOOD DAY CPUCINO 10X25G,4,1500,0,6000,5580,420
2/28/2021 20:45,8992696405417,DNCO  SHC 27G,1,3000,0,3000,2647,353
2/28/2021 20:45,8996001305249,ROMA KELAPA CREAM,1,6800,0,6800,5514,1286
2/28/2021 20:45,8997028590014,ARGUS 220ML,1,500,0,500,302,198
2/28/2021 21:31,8991111109121,JB POWDER BLOSSOM 75+25G,1,6000,0,6000,5430,570
2/28/2021 22:33,ARG,ARGUS 220ML,1,14500,0,14500,12500,2000
2/28/2021 22:45,089686010343,INDOMIE SOTO MIE,2,2600,0,5200,4734,466
2/28/2021 23:00,8992761145026,SPRITE PET 250ML,3,3500,0,10500,7251,3249
2/28/2021 23:00,8992761145033,FANTA STRAW PET 250ML,4,3500,0,14000,9668,4332
2/28/2021 23:00,8992761145019,COCA COLA PET 250ML,3,3500,0,10500,7251,3249
2/28/2021 23:00,8992761139018,ADES 600ML,2,3500,0,7000,4584,2416
2/28/2021 23:23,8998866202770,SEDAAP MIE GORENG SALERO PADANG 86 GR,1,2500,0,2500,2023,477
2/28/2021 23:23,ATIRA,MIE KREMES ATIRA,3,500,0,1500,1275,225
2/28/2021 23:23,FUZO,KUACI FUZO,1,1000,0,1000,850,150
3/1/2021 10:42,GL,GULA 1 LITER,2,11500,0,23000,21000,2000
3/1/2021 10:42,8992984920110,CUKA DAPUR DUA BELIBIS,1,4500,0,4500,3250,1250
3/1/2021 10:42,8998866608008,KECAP MANIS SEDAAP BOTOL 135 ML,1,6300,0,6300,5615,685
3/1/2021 10:42,8995102703534,TERASI DUO 6 GR,1,4000,0,4000,3720,280
3/1/2021 10:42,8999999502393,ROYCO FDS CHICKEN 8G,1,5000,0,5000,4500,500
3/1/2021 10:42,8998866202060,POTABEE AYAM BAKAR PEDAS 35 GR,1,5000,0,5000,4150,850
3/1/2021 10:42,8991102989534,WFR TANGO LONG VNL 24G GTG,1,1000,0,1000,672,328
3/1/2021 10:43,8992761166212,FRESTEA APPLE 350ML,1,4500,0,4500,3000,1500
3/1/2021 11:05,089686821086,ICHI OCHA MELATI,1,3000,0,3000,2250,750
3/1/2021 11:46,8996001600146,TEH PUCUK HARUM 350ML,1,3000,0,3000,2314,686
3/1/2021 12:00,8996001600146,TEH PUCUK HARUM 350ML,1,3000,0,3000,2314,686
3/1/2021 12:11,8999999504656,SARI MURNI 20X1.8G,1,5000,0,5000,4200,800
3/1/2021 12:25,8992775312414,GERY CHOCO HEZELNUT,1,11000,0,11000,9983,1017
3/1/2021 12:25,8999999401221,RINSO ANTI NODA CLASSIC 430G,1,10800,0,10800,9806,994
3/1/2021 12:25,089686834055,FREISS JERUK,1,11000,0,11000,8750,2250
3/1/2021 12:52,8997011700123,BIHUN JAGUNG 300GR,1,5200,0,5200,4738,462
3/1/2021 12:53,8999999390198,SUNLIGHT LIME NEW POUCH 755ML,1,17000,0,17000,15400,1600
3/1/2021 12:53,8995333060703,TERIGU KOMPAS 1KG,1,10500,0,10500,9816,684
3/1/2021 13:02,8998866611152,CREAM EKONOMI VIOLET 455G,1,5500,0,5500,4750,750
3/1/2021 13:02,8998866609029,DAIA PUTIH GUSSWET 565G,1,10000,0,10000,8700,1300
3/1/2021 13:02,8999999710873,PEPSODENT ACTION123 HERBAL 120G,1,11400,0,11400,10400,1000
3/1/2021 13:02,8998866501033,MINYAK GORENG SEDAAP POUCH 2L,1,29000,0,29000,27746,1254
3/1/2021 13:02,8992959117583,SFX DS REG FLOW WING 20,1,5000,0,5000,4288,712
3/1/2021 13:02,GL,GULA 1 LITER,2,11500,0,23000,21000,2000
3/1/2021 13:02,8718291206491,PHILIPS 20 W,1,65000,0,65000,60000,5000
3/1/2021 14:08,GL,GULA 1 LITER,10,11500,0,115000,105000,10000
3/1/2021 14:08,8992628020152,BIMOLI POUCH 2L,3,30000,0,90000,86949,3051
3/1/2021 14:28,8992759120264,LARISST 220,1,12000,0,12000,9200,2800
3/1/2021 14:28,8998866201469,POTABEE REGULER BBQ BEEF 68 GR,1,8000,0,8000,7200,800
3/1/2021 14:53,8993176110074,MINYAK KAYU PUTIH 60ML,1,20000,0,20000,17333,2667
3/1/2021 14:53,8998866501026,MINYAK GORENG SEDAAP POUCH 1 L,1,15500,0,15500,14110,1390
3/1/2021 14:58,8991102281430,PERMEN MINTZ DUOMINT,1,4500,0,4500,4000,500
3/1/2021 14:58,8851019510132,POCKY,1,7300,0,7300,7000,300
3/1/2021 14:58,089686010343,INDOMIE SOTO MIE,2,2600,0,5200,4734,466
3/1/2021 15:23,8993176110074,MINYAK KAYU PUTIH 60ML,1,20000,0,20000,17333,2667
3/1/2021 15:23,POTO,KERUPUK PANJANG,1,5000,0,5000,4000,1000
3/1/2021 16:34,9556001174659,MILO ACT GO 240ML,1,8500,0,8500,7437,1063
3/1/2021 16:34,8991115012021,BB STRAWBERRY CREAM,1,8500,0,8500,7600,900
3/1/2021 17:01,8993365140363,MASU KURMA TJ 250G,1,22500,0,22500,20570,1930
3/1/2021 17:08,8992761166212,FRESTEA APPLE 350ML,1,4500,0,4500,3000,1500
3/1/2021 17:08,8992775712603,MYTEA POCI OOLONG,1,5000,0,5000,4410,590
3/1/2021 17:16,ARD,SENDAL ARDILES,1,15000,0,15000,13500,1500
3/1/2021 17:21,8999999024482,CITRA BW PEARLY WHITE REFF 220ML,1,12000,0,12000,10700,1300
3/1/2021 17:21,8999999538446,SUNSILK SHP BLKSHINE 55 ML3750,1,4500,0,4500,3750,750
3/1/2021 17:21,8999999034726,PONDS MEN WHITE BOOST 50G,1,18500,0,18500,17160,1340
3/1/2021 17:55,8992696404441,BEAR BRAND 189ML,1,8500,0,8500,7887,613
3/1/2021 17:56,8992761166229,FRESTEA MARKISA 350ML,1,4500,0,4500,3000,1500
3/1/2021 17:56,9556040040038,SUSU F&N,1,33000,0,33000,30000,3000
3/1/2021 17:56,8996001600146,TEH PUCUK HARUM 350ML,1,3000,0,3000,2314,686
3/1/2021 18:05,6907992823669,JD MILKY STRAW,1,3000,0,3000,2600,400
3/1/2021 18:05,COKLAT,COKLAT COIN,4,500,0,2000,1600,400
3/1/2021 18:34,8992761122430,FRESTEA GREEN HONEY 500ML,1,6500,0,6500,4708,1792
3/1/2021 18:34,8996001600146,TEH PUCUK HARUM 350ML,2,3000,0,6000,4628,1372
3/1/2021 19:15,9556001047175,NESCAFE ORI 240ML,1,8500,0,8500,7337,1163
3/1/2021 19:15,8992775110157,GARUDA KACANG KULIT,1,5000,0,5000,3925,1075
3/1/2021 19:15,8992761166212,FRESTEA APPLE 350ML,1,4500,0,4500,3000,1500
3/1/2021 19:27,GL,GULA 1 LITER,2,11500,0,23000,21000,2000
3/1/2021 19:27,8995333032113,TERIGU GATOT KACA 1 KG,1,8500,0,8500,8012,488
3/1/2021 19:52,8992761166212,FRESTEA APPLE 350ML,1,4500,0,4500,3000,1500
3/1/2021 19:52,8992761139018,ADES 600ML,1,3500,0,3500,2292,1208
3/1/2021 20:59,8992753102303,BKM SCT CKLT 40G,1,7500,0,7500,6900,600
3/1/2021 20:59,8991102384841,WFR TANGO LONG CKLT 130G,2,5000,0,10000,7546,2454
3/1/2021 21:00,8992761139018,ADES 600ML,1,3500,0,3500,2292,1208
3/1/2021 21:02,8992761139018,ADES 600ML,1,3500,0,3500,2292,1208
3/1/2021 21:40,8998899001920,BAYGON MAX,1,4000,0,4000,3500,500
3/1/2021 22:01,8998989300261,GUDANG GARAM SURYA 12 FILTER,1,18000,0,18000,16450,1550
3/1/2021 22:03,8998989110167,SURYA GUDANG GARAM 16 FILTER,1,24000,0,24000,22100,1900
3/1/2021 22:03,ARD,SENDAL ARDILES,1,15000,0,15000,13500,1500
3/1/2021 22:03,ATIRA,MIE KREMES ATIRA,2,500,0,1000,850,150
3/1/2021 22:33,6907992823829,JD MILKY MILK,1,3000,0,3000,2600,400
3/1/2021 22:33,ATIRA,MIE KREMES ATIRA,9,500,0,4500,3825,675
3/1/2021 22:36,8995333032113,TERIGU GATOT KACA 1 KG,2,8500,0,17000,16024,976
3/1/2021 22:36,GL,GULA 1 LITER,2,11500,0,23000,21000,2000
3/1/2021 22:36,8999999390198,SUNLIGHT LIME NEW POUCH 755ML,1,17000,0,17000,15400,1600
3/1/2021 23:04,BRS,BERAS BUMN 10KG,1,128000,0,128000,90000,38000
3/1/2021 23:28,8991102230308,BLASTER PINK,1,5000,0,5000,3106,1894
3/1/2021 23:28,8998899001920,BAYGON MAX,1,4000,0,4000,3500,500
3/1/2021 23:28,FUZO,KUACI FUZO,1,1000,0,1000,850,150
3/2/2021 0:00,8991001770301,SELAMAT CLACK VANILA,1,13000,0,13000,11800,1200
3/2/2021 0:03,76164217,MARLBORO MERAH,1,30000,0,30000,27700,2300
3/2/2021 0:03,8997028590014,ARGUS 220ML,3,500,0,1500,906,594
3/2/2021 0:03,6907992823935,JD SWEETCORN,1,3500,0,3500,3000,500
3/2/2021 10:20,GL,GULA 1 LITER,1,11500,0,11500,10500,1000
3/2/2021 10:20,8999999195649,SARI WANGI 25X1.86G,1,6000,0,6000,5050,950
3/2/2021 10:20,FUZO,KUACI FUZO,1,1000,0,1000,850,150
3/2/2021 10:20,6907992825076,JD WATERMELON APPLE,1,2000,0,2000,1700,300
3/2/2021 10:22,GL,GULA 1 LITER,2,11500,0,23000,21000,2000
3/2/2021 10:22,8997012321204,MAXX BUMBU BALADO,1,5000,0,5000,4100,900
3/2/2021 10:22,8998898847109,KOPI JAHE,2,1500,0,3000,23600,-20600
3/2/2021 10:22,6907992825076,JD WATERMELON APPLE,1,2000,0,2000,1700,300
3/2/2021 11:00,RT TWR,ROTI TAWAR JUMBO,1,7000,0,7000,6200,800
3/2/2021 11:14,8998989300261,GUDANG GARAM SURYA 12 FILTER,1,18000,0,18000,16450,1550
3/2/2021 11:14,8998866200301,NOODLE SEDAAP GORENG  90 GR,1,2500,0,2500,2023,477
3/2/2021 11:14,ATIRA,MIE KREMES ATIRA,1,500,0,500,425,75
3/2/2021 11:25,8996001318911,BETTER ISI 4,1,2000,0,2000,1700,300
3/2/2021 11:31,8996001600146,TEH PUCUK HARUM 350ML,1,3000,0,3000,2314,686
3/2/2021 11:31,RT BAKPIA,ROTI BAKPIA,2,1000,0,2000,1500,500
3/2/2021 12:00,8993989311279,CLAS MILD 12,1,16500,0,16500,15700,800
3/2/2021 12:00,RT ISI 6,ROTI ISI 6,1,5000,0,5000,4500,500
3/2/2021 12:03,089686010824,INDOMIE GORENG SPESIAL,1,2700,0,2700,2452,248
3/2/2021 12:03,8998866200301,NOODLE SEDAAP GORENG  90 GR,1,2500,0,2500,2023,477
3/2/2021 12:50,8998866202053,POTABEE AYAM BAKAR PEDAS 68GR,1,8000,0,8000,7200,800
3/2/2021 12:50,8998866500708,FLORIDINA ORANGE,1,3000,0,3000,2500,500
3/2/2021 12:50,8992761166052,FRESTEA MELATI 350ML,1,4500,0,4500,3000,1500
3/2/2021 12:54,8992957214307,SAFARI MECES,1,5500,0,5500,4500,1000
3/2/2021 13:32,8998866201520,KOPI TOP TORAJA MURNI,1,11000,0,11000,9600,1400
3/2/2021 14:28,8992761122430,FRESTEA GREEN HONEY 500ML,2,6500,0,13000,9416,3584
3/2/2021 15:42,8992761166212,FRESTEA APPLE 350ML,1,4500,0,4500,3000,1500
3/2/2021 15:42,8998898829129,KKB ENER-G JERUK,1,5500,0,5500,4824,676
3/2/2021 16:01,RT TWR,ROTI TAWAR JUMBO,3,7000,0,21000,18600,2400
3/2/2021 16:17,8992775712603,MYTEA POCI OOLONG,1,5000,0,5000,4410,590
3/2/2021 16:33,8990800016757,BB TUTI FRUITTY COSMO,1,8500,0,8500,7600,900
3/2/2021 16:33,8996001600146,TEH PUCUK HARUM 350ML,1,3000,0,3000,2314,686
3/2/2021 16:33,8991001111883,SILVERQUEEN CHUNKYBAR 33G,1,8000,0,8000,7150,850
3/2/2021 16:37,6907992824963,JD CHOCO BLAST,1,3000,0,3000,2600,400
3/2/2021 16:45,8999909010567,234 16 FILTER,1,22000,0,22000,21500,500
3/2/2021 17:23,8998866201377,KRISBEE FRIES KENTANG GORENG 68 GR,1,5500,0,5500,4620,880
3/2/2021 17:23,8992775110157,GARUDA KACANG KULIT,1,5000,0,5000,3925,1075
3/2/2021 17:23,8992761122331,FRESTEA APPEL 500ML,1,6500,0,6500,4708,1792
3/2/2021 17:35,8992959508992,SWEETY SILVER PANTS L 28,1,56800,0,56800,51819,4981
3/2/2021 17:44,8998866604932,DAIA LEMON BAG 850G & PIRING,1,18000,0,18000,15627,2373
3/2/2021 17:44,8998866201964,MINYAK GORENG SABRINA 2L POUCH,1,28000,0,28000,26753,1247
3/2/2021 17:47,8999999034061,ZWITSAL BAT NAT HAIR&BODY  300ML,1,28700,0,28700,26125,2575
3/2/2021 17:50,8996001600399,LE MINERAL 1500ML,1,5000,0,5000,4042,958
3/2/2021 18:02,8998866202671,NOODLE SEDAAP MIE KOREAN SPICY SOUP CUP,1,5000,0,5000,3917,1083
3/2/2021 18:23,8998866609043,DAIA SOFTENER GUSSET 565G,1,10000,0,10000,8700,1300
3/2/2021 18:23,8991002103764,GOOD DAY CPUCINO 10X25G,4,1500,0,6000,5580,420
3/2/2021 18:23,089686021127,INTER MIE KALDU,2,1000,0,2000,1626,374
3/2/2021 18:23,8993072254018,MELROSE COTTON BUDS BSR,1,5000,0,5000,4050,950
3/2/2021 18:23,001,PASEO SMART FACIAL SF 250S GT,1,10000,0,10000,9500,500
3/2/2021 18:23,RT ISI 6,ROTI ISI 6,1,5000,0,5000,4500,500
3/2/2021 18:23,8992222010221,TANCHO TREATMENT,2,15000,0,30000,26000,4000
3/2/2021 18:33,RT BAKPIA,ROTI BAKPIA,2,1000,0,2000,1500,500
3/2/2021 18:34,8996001600610,TORA MILKY LATTE 180ML,1,3500,0,3500,2750,750
3/2/2021 18:34,COKLAT,COKLAT COIN,2,500,0,1000,800,200
3/2/2021 18:34,JGR SHN,JOGER SHINY SACHET,1,500,0,500,437,63
3/2/2021 19:05,8998866201865,KRISBEE PILLOW CHOCOLAVA 120 GR,1,8000,0,8000,7250,750
3/2/2021 19:05,8998866202053,POTABEE AYAM BAKAR PEDAS 68GR,2,8000,0,16000,14400,1600
3/2/2021 19:11,GL,GULA 1 LITER,5,11500,0,57500,52500,5000
3/2/2021 19:30,8992761002022,SPRITE PET 390ML,1,5500,0,5500,4300,1200
3/2/2021 19:30,8998898101409,TOLAK ANGIN SIDOMUNCUL,1,3000,0,3000,2708,292
3/2/2021 20:34,GL,GULA 1 LITER,3,11500,0,34500,31500,3000
3/2/2021 20:34,8992628020152,BIMOLI POUCH 2L,1,30000,0,30000,28983,1017
3/2/2021 20:34,8991002105409,KOPI KAPAL API,1,20000,0,20000,18888,1112
3/2/2021 20:34,8999999195656,SARI WANGI 50X1.85,1,10000,0,10000,8700,1300
3/2/2021 21:48,8998866202725,MILKU COKLAT PREMIUM 200ML,1,3000,0,3000,2375,625
3/2/2021 21:48,8850507002968,A1 KING TRUCK,1,16500,0,16500,15500,1000
3/2/2021 21:48,JGR SHN,JOGER SHINY SACHET,5,500,0,2500,2185,315
3/2/2021 21:48,8998866202060,POTABEE AYAM BAKAR PEDAS 35 GR,1,5000,0,5000,4150,850
3/2/2021 21:48,8992696523067,MILO ACTVGO UHT 180ML,4,4500,0,18000,14060,3940
3/2/2021 22:13,RT KJ,ROTI KASUR JUMBO,1,7000,0,7000,6200,800
3/2/2021 22:13,8992761145033,FANTA STRAW PET 250ML,1,3500,0,3500,2417,1083
3/2/2021 22:13,8998866200325,NOODLE SEDAAP MIE SOTO,1,2200,0,2200,1952,248
3/3/2021 12:04,8993989311279,CLAS MILD 12,1,17000,0,17000,15700,1300
3/3/2021 12:04,8998989300261,GUDANG GARAM SURYA 12 FILTER,1,18000,0,18000,16450,1550
3/3/2021 13:37,6907992824963,JD MILKY CHOCOLATE,3,3000,0,9000,7800,1200
3/3/2021 13:37,6907992823843,JD MOCHA CRISPY,1,5000,0,5000,4400,600
3/3/2021 13:38,8998866608459,POWDET DAIA PUTIH BAG 290GR,1,5000,0,5000,4450,550
3/3/2021 13:46,8996001600146,TEH PUCUK HARUM 350ML,4,3000,0,12000,9256,2744
3/3/2021 13:46,089686821086,ICHI OCHA MELATI,1,3000,0,3000,2250,750
3/3/2021 13:46,8992388101085,NU GREEN TEA ORIGINAL 330ML,1,3500,0,3500,2854,646
3/3/2021 13:46,8992388101092,NU GREEN TE HONEY 330ML,1,3500,0,3500,2854,646
3/3/2021 13:46,8997013790108,BIMURA KACANG TELUR 25G,10,1000,0,10000,8750,1250
3/3/2021 15:01,8998866501026,MINYAK GORENG SEDAAP POUCH 1 L,3,15500,0,46500,42330,4170
3/3/2021 15:01,8992753101207,BENDERA KENTAL MANIS 370G,2,11500,0,23000,19400,3600
3/3/2021 15:01,GL,GULA 1 LITER,10,11500,0,115000,105000,10000
3/3/2021 15:01,8998866608084,KECAP MANIS SEDAAP POUCH 550ML,1,19000,0,19000,17000,2000
3/3/2021 15:01,RT TWR,ROTI TAWAR JUMBO,1,7000,0,7000,6200,800
3/3/2021 15:03,8996001600375,LE MINERAL 330ML,1,2000,0,2000,1417,583
3/3/2021 15:14,8992761139018,ADES 600ML,2,3500,0,7000,4584,2416
3/3/2021 15:26,8996001600146,TEH PUCUK HARUM 350ML,1,3000,0,3000,2314,686
3/3/2021 15:26,8998866202619,SEDAAP MIE KOREAN SPICY SOUP BAG 77 GR,2,2300,0,4600,4054,546
3/3/2021 15:26,8997018720018,SIRUP DHT,1,23000,0,23000,20958,2042
3/3/2021 15:26,8996001600641,TORA CAPPUCINO,1,3500,0,3500,2750,750
3/3/2021 15:26,COKLAT,COKLAT COIN,2,500,0,1000,800,200
3/3/2021 15:26,JGR SHN,JOGER SHINY SACHET,10,500,0,5000,4370,630
3/3/2021 15:32,8998866201841,GOLDA DOLCE LATTE 200ML,1,3000,0,3000,2500,500
3/3/2021 15:48,8996001600146,TEH PUCUK HARUM 350ML,1,3000,0,3000,2314,686
3/3/2021 16:43,8998866200325,NOODLE SEDAAP MIE SOTO,2,2200,0,4400,3904,496
3/3/2021 16:46,8996001301579,MALKIST CKLT KELAPA PACK,1,11000,0,11000,9900,1100
3/3/2021 16:56,GL,GULA 1 LITER,3,11500,0,34500,31500,3000
3/3/2021 17:02,FUZO,KUACI FUZO,1,1000,0,1000,850,150
3/3/2021 17:02,COKLAT,COKLAT COIN,10,500,0,5000,4000,1000
3/3/2021 17:13,6907992823935,JD SWEETCORN,2,3500,0,7000,6000,1000
3/3/2021 17:13,6907992823911,JD CRUNCHY HONEYDEW MELON,1,8000,0,8000,6800,1200
3/3/2021 17:13,6907992823904,JD CRUNCHY CHOCOLATE VAN,2,8000,0,16000,13600,2400
3/3/2021 17:39,8992959001875,SWEETY SILVER PANTS S RTG,1,10200,0,10200,9168,1032
3/3/2021 17:42,8992959953013,SWEETY BRONZE S1,1,2000,0,2000,1379,621
3/3/2021 17:45,8997013790108,BIMURA KACANG TELUR 25G,2,1000,0,2000,1750,250
3/3/2021 17:45,8997013790092,BIMURA KERUPUK BAWANG 25G,1,1000,0,1000,874,126
3/3/2021 17:45,ARD,SENDAL ARDILES,1,15000,0,15000,13500,1500
3/3/2021 17:51,8998866500708,FLORIDINA ORANGE,1,3000,0,3000,2500,500
3/3/2021 18:40,089686043273,INDOMIE SAMBAL RICA,1,2700,0,2700,2452,248
3/3/2021 19:33,8998866202725,MILKU COKLAT PREMIUM 200ML,3,3000,0,9000,7125,1875
3/3/2021 19:33,8998866610070,SOKLIN SOFTERGEN 280G PURPLE,1,5000,0,5000,4425,575
3/3/2021 19:33,8998866202770,SEDAAP MIE GORENG SALERO PADANG 86 GR,2,2500,0,5000,4046,954
3/3/2021 19:33,8999999529291,MOLTO PURE SACHET 10ML,1,6000,0,6000,4800,1200
3/3/2021 19:42,8993379200855,SABUN HARMONY STRAWBERRY 70G,2,2000,0,4000,3304,696
3/3/2021 20:12,RT KN,ROTI KASUR NANAS,1,7000,0,7000,6200,800
3/3/2021 20:12,089686011494,INDOMIE SOTO PADANG,1,2600,0,2600,2317,283
3/3/2021 20:12,8998866602273,HERSPROTEX SOFTCARE MAX,1,3500,0,3500,2950,550
3/3/2021 20:36,6907992823843,JD MOCHA CRISPY,1,5000,0,5000,4400,600
3/3/2021 20:36,RT 1000,ROTI 1000,1,1000,0,1000,750,250
3/3/2021 20:36,8992761166038,MMP ORANGE 300ML,1,5000,0,5000,3750,1250
3/3/2021 20:36,8997028590014,ARGUS 220ML,2,500,0,1000,604,396
3/3/2021 20:36,089686017748,SARIMIE GORENG ISI 2,1,3500,0,3500,3120,380
3/3/2021 20:36,8998866500708,FLORIDINA ORANGE,1,3000,0,3000,2500,500
3/3/2021 20:40,089686011494,INDOMIE SOTO PADANG,2,2600,0,5200,4634,566
3/3/2021 20:42,GL,GULA 1 LITER,1,11500,0,11500,10500,1000
3/3/2021 20:42,8995333032113,TERIGU GATOT KACA 1 KG,2,8500,0,17000,16024,976
3/3/2021 20:42,8998898830125,KKB ENER-G ANGGUR,2,5500,0,11000,9648,1352
3/3/2021 20:48,8992761139018,ADES 600ML,1,3500,0,3500,2292,1208
3/3/2021 21:31,8999801700030,SUSU FOYU,1,11000,0,11000,10000,1000
3/3/2021 22:00,8998866202619,SEDAAP MIE KOREAN SPICY SOUP BAG 77 GR,4,2300,0,9200,8108,1092
3/3/2021 22:27,8992959508855,SWEETY SILVER PANTS XL 18,1,47800,0,47800,43353,4447
3/3/2021 22:28,8998866200301,NOODLE SEDAAP GORENG  90 GR,1,2500,0,2500,2023,477
3/3/2021 22:28,089686043204,INDOMIE MIE ACEH,2,2700,0,5400,4904,496
3/4/2021 10:07,8998989500166,GUDANG GARAM MERAH BESAR 16KS,2,17000,0,34000,30600,3400
3/4/2021 10:07,8996001600399,LE MINERAL 1500ML,2,5000,0,10000,8084,1916
3/4/2021 10:07,8994867006997,ROKOK PENA BOLD 20BTG,1,17000,0,17000,15000,2000
3/4/2021 10:07,8998989300261,GUDANG GARAM SURYA 12 FILTER,1,18000,0,18000,16450,1550
3/4/2021 10:07,8998866201841,GOLDA DOLCE LATTE 200ML,1,3000,0,3000,2500,500
3/4/2021 10:07,8993989311279,CLAS MILD 12,1,17000,0,17000,15700,1300
3/4/2021 10:32,8991002105409,KOPI KAPAL API,1,20000,0,20000,18888,1112
3/4/2021 10:56,8999999192150,ROYCO FDS CHICKEN 100GR,4,5000,0,20000,17200,2800
3/4/2021 11:38,8996001318911,BETTER ISI 4,1,2000,0,2000,1700,300
3/4/2021 12:32,PUDING,VITA PUDDING,1,5000,0,5000,3750,1250
3/4/2021 12:32,8992761145033,FANTA STRAW PET 250ML,1,3500,0,3500,2417,1083
3/4/2021 12:42,8998866613262,SUKSESMIE SOTO 111 GR,1,3500,0,3500,2770,730
3/4/2021 12:42,8998866200578,NOODLE SEDAAP KARI KENTAL SPC 75 GR,1,2300,0,2300,1952,348
3/4/2021 12:42,8998866202619,SEDAAP MIE KOREAN SPICY SOUP BAG 77 GR,1,2300,0,2300,2027,273
3/4/2021 12:42,8998866202770,SEDAAP MIE GORENG SALERO PADANG 86 GR,1,2500,0,2500,2023,477
3/4/2021 12:42,8992388111145,MIE ABC SELERA PEDAS- SUP TOMAT PEDAS,1,2500,0,2500,2023,477
3/4/2021 12:42,8998866202343,NOODLE SEDAAP MIE KOREAN SPICY 87 GR,1,2500,0,2500,2023,477
3/4/2021 12:42,RT BAKPIA,ROTI BAKPIA,2,1000,0,2000,1500,500
3/4/2021 12:42,8996001410042,TORABIKA MOKA,1,1500,0,1500,809,691
3/4/2021 13:21,RT CD,ROTI COKLAT DURIAN,1,7000,0,7000,6200,800
3/4/2021 13:21,RT KJ,ROTI KASUR JUMBO,1,7000,0,7000,6200,800
3/4/2021 13:21,089686821086,ICHI OCHA MELATI,1,3000,0,3000,2250,750
3/4/2021 13:26,8998989110167,SURYA GUDANG GARAM 16 FILTER,1,24000,0,24000,22100,1900
3/4/2021 13:26,8993989311279,CLAS MILD 12,1,17000,0,17000,15700,1300
3/4/2021 13:26,8992761139018,ADES 600ML,2,3500,0,7000,4584,2416
3/4/2021 13:53,8998866501033,MINYAK GORENG SEDAAP POUCH 2L,1,29000,0,29000,27746,1254
3/4/2021 13:53,711844150027,ABC NANAS,1,15000,0,15000,12241,2759
3/4/2021 13:53,8998866201711,KRISBEE KRUNCHY JAGUNG BAKAR MENTEGA 75 GR,1,5500,0,5500,4400,1100
3/4/2021 13:53,8992959107515,SFX NON WING 23CM 8,1,4000,0,4000,3288,712
3/4/2021 13:53,8999999524524,MOLTO EDP PINK LUXURY ROSE 800ML,1,29200,0,29200,26600,2600
3/4/2021 13:53,8999999524722,SUNLIGHT LIME NEW PCH 435ML,1,10000,0,10000,9100,900
3/4/2021 13:53,6907992823652,JD CHOCOLATE MILKSHAKE,1,6000,0,6000,5200,800
3/4/2021 13:53,6907992823829,JD MILKY MILK,1,3000,0,3000,2600,400
3/4/2021 13:53,8997013790108,BIMURA KACANG TELUR 25G,1,1000,0,1000,875,125
3/4/2021 13:53,8997013790092,BIMURA KERUPUK BAWANG 25G,1,1000,0,1000,874,126
3/4/2021 13:53,RT 1000,ROTI 1000,2,1000,0,2000,1500,500
3/4/2021 13:53,8992736025162,SASA TEPUNG PISANG GORENG,1,5000,0,5000,4455,545
3/4/2021 13:53,8999999192150,ROYCO FDS CHICKEN 100GR,1,5000,0,5000,4300,700
3/4/2021 13:53,8850507002951,BONCHA EGG SQUISHY,1,12000,0,12000,10841,1159
3/4/2021 13:53,8998866202725,MILKU COKLAT PREMIUM 200ML,1,3000,0,3000,2375,625
3/4/2021 13:53,8992957220087,COKLAT SINGA,1,2000,0,2000,1700,300
3/4/2021 13:53,8992957220063,COKLAT BANGO,1,2000,0,2000,1700,300
3/4/2021 13:53,8999999036638,LUX VELVET JAMINE 75G,1,3500,0,3500,2800,700
3/4/2021 13:53,8850507000094,POLICE BONCHA,1,2000,0,2000,800,1200
3/4/2021 13:53,COKLAT,COKLAT COIN,4,500,0,2000,1600,400
3/4/2021 13:53,8850507001176,HERO RACING,1,12000,0,12000,10600,1400
3/4/2021 13:58,8993365122536,MADU TJ SUPER 250G,1,25000,0,25000,22780,2220
3/4/2021 13:59,8997021870328,HOT IN CREAM 120ML,1,18500,0,18500,17000,1500
3/4/2021 14:01,KRP,KERUPUK BAWANG SINJAI,1,6000,0,6000,5000,1000
3/4/2021 14:01,JGR SHN,JOGER SHINY SACHET,1,500,0,500,437,63
3/4/2021 14:07,RT 1000,ROTI 1000,3,1000,0,3000,2250,750
3/4/2021 14:54,8992761164539,NUTRIBOOST ORANGE 300ML,1,6500,0,6500,5300,1200
3/4/2021 14:54,8992957220087,COKLAT SINGA,2,2000,0,4000,3400,600
3/4/2021 15:41,8992761166038,MMP ORANGE 300ML,2,5000,0,10000,7500,2500
3/4/2021 15:41,8992775001691,GARUDA ROSTA WAGYU BEEF,1,8000,0,8000,7176,824
3/4/2021 15:58,8998866202770,SEDAAP MIE GORENG SALERO PADANG 86 GR,1,2500,0,2500,2023,477
3/4/2021 15:58,8998866202619,SEDAAP MIE KOREAN SPICY SOUP BAG 77 GR,1,2300,0,2300,2027,273
3/4/2021 15:58,089686041705,INDOMIE GORENG JUMBO,1,3500,0,3500,3143,357
3/4/2021 16:44,8992959117590,SFX DS REG FLOW WING 20,1,12000,0,12000,11250,750
3/4/2021 16:44,8997013790108,BIMURA KACANG TELUR 25G,1,1000,0,1000,875,125
3/4/2021 16:52,8997012321204,MAXX BUMBU BALADO,1,5000,0,5000,4100,900
3/4/2021 16:56,8996001600146,TEH PUCUK HARUM 350ML,1,3000,0,3000,2314,686
3/4/2021 16:56,8998989100120,GUDANG GARAM MINI,1,18000,0,18000,16600,1400
3/4/2021 17:25,8993989311279,CLAS MILD 12,1,17000,0,17000,15700,1300
3/4/2021 17:26,ROYCO,ROYCO RASA AYAM,2,500,0,1000,750,250
3/4/2021 17:46,8998009010590,ULTRA CHO 125,1,3000,0,3000,2428,572
3/4/2021 17:47,8998009010590,ULTRA CHO 125,1,3000,0,3000,2428,572
3/4/2021 17:49,8851019510132,POCKY,1,7300,0,7300,7000,300
3/4/2021 17:49,8992775311325,GERY SNACK&SEREAL 100G,1,7000,0,7000,5892,1108
3/4/2021 17:49,8999999048501,SUNSILK RFR ANTI DDRF 170ML,1,22200,0,22200,20020,2180
3/4/2021 17:53,8999909982000,SAMPOERNA 12 FILTER,1,18000,0,18000,16200,1800
3/4/2021 17:53,8992761145033,FANTA STRAW PET 250ML,1,3500,0,3500,2417,1083
3/4/2021 17:53,8998866501026,MINYAK GORENG SEDAAP POUCH 1 L,12,15500,0,186000,169320,16680
3/4/2021 17:58,8999909096004,SAMPOERNA 16 FILTER,1,6000,0,6000,23000,-17000
3/4/2021 17:58,123124,KOREK BIASA,1,2000,0,2000,1800,200
3/4/2021 18:16,8998866202404,NOODLE SEDAAP MIE KOREAN SPICY CHICKEN CUP,1,5000,0,5000,3917,1083
3/4/2021 18:26,8998989300261,GUDANG GARAM SURYA 12 FILTER,1,18000,0,18000,16450,1550
3/4/2021 18:50,089686060102,POP MIE PEDE GLEDEEK,1,5000,0,5000,4450,550
3/4/2021 18:50,8992761111533,SPRITE SLIM CAM250ML,1,5000,0,5000,3750,1250
3/4/2021 20:34,8997025911706,HATARI SHP MARGARINE,1,5000,0,5000,4800,200
3/4/2021 20:34,8992696404441,BEAR BRAND 189ML,1,8500,0,8500,7887,613
3/4/2021 20:35,8996001338056,TAMARIN,1,5600,0,5600,5100,500
3/4/2021 20:58,8997011700123,BIHUN JAGUNG 300GR,1,5200,0,5200,4738,462
3/4/2021 21:05,8992775712603,MYTEA POCI OOLONG,1,5000,0,5000,4410,590
3/4/2021 21:05,8992761164539,NUTRIBOOST ORANGE 300ML,1,6500,0,6500,5300,1200
3/4/2021 21:05,8997013790108,BIMURA KACANG TELUR 25G,1,1000,0,1000,875,125
3/4/2021 21:05,8997028590014,ARGUS 220ML,2,500,0,1000,604,396
3/4/2021 21:43,8999999549480,SUNLIGHT LIME CRM SCH 270G,1,5000,0,5000,4500,500
3/4/2021 21:57,SFX,SOFTEX DAUN SIRIH 1,2,500,0,1000,826,174
3/4/2021 22:31,76164217,MARLBORO MERAH,1,30000,0,30000,27700,2300
3/5/2021 10:01,8995333060703,TERIGU KOMPAS 1KG,1,10500,0,10500,9816,684
3/5/2021 10:01,GL,GULA 1 LITER,3,11500,0,34500,31500,3000
3/5/2021 10:01,8998989110167,SURYA GUDANG GARAM 16 FILTER,1,24000,0,24000,22100,1900
3/5/2021 10:01,123124,KOREK BIASA,1,2000,0,2000,1800,200
3/5/2021 10:01,8998866201841,GOLDA DOLCE LATTE 200ML,1,3000,0,3000,2500,500
3/5/2021 10:01,8992775311615,CHOCOLATOS,1,12000,0,12000,9983,2017
3/5/2021 10:06,8992959953167,SWEETY BRONZE S36,1,48000,0,48000,45682,2318
3/5/2021 10:06,8998989300261,GUDANG GARAM SURYA 12 FILTER,1,18000,0,18000,16450,1550
3/5/2021 10:06,8998898101409,TOLAK ANGIN SIDOMUNCUL,1,3500,0,3500,2708,792
3/5/2021 10:07,8994867000162,ROKOK PUNDIMAS KRETEK16,1,10000,0,10000,8600,1400
3/5/2021 10:17,8998989110167,SURYA GUDANG GARAM 16 FILTER,1,24000,0,24000,22100,1900
3/5/2021 11:15,8992775211434,PILUS GARUDA SAPI PANGGANG,2,5500,0,11000,9426,1574
3/5/2021 11:15,8992775211410,PILUS GARUDA PEDAS,1,5500,0,5500,4713,787
3/5/2021 11:15,8991111101316,JB OIL 50ML,1,9500,0,9500,8700,800
3/5/2021 11:15,8999908204202,MY BABY MINYAK TELON 60ML,1,15000,0,15000,13545,1455
3/5/2021 11:15,8992761002022,SPRITE PET 390ML,1,5500,0,5500,4300,1200
3/5/2021 11:19,8998989300261,GUDANG GARAM SURYA 12 FILTER,1,18000,0,18000,16450,1550
3/5/2021 11:47,ARG,ARGUS 220ML,1,14500,0,14500,12500,2000
3/5/2021 13:14,089686821086,ICHI OCHA MELATI,1,3000,0,3000,2250,750
3/5/2021 13:14,8991102989534,WFR TANGO LONG VNL 24G GTG,3,1000,0,3000,2016,984
3/5/2021 13:14,8997013790108,BIMURA KACANG TELUR 25G,2,1000,0,2000,1750,250
3/5/2021 13:14,RT 1000,ROTI 1000,1,1000,0,1000,750,250
3/5/2021 13:49,8998866202671,NOODLE SEDAAP MIE KOREAN SPICY SOUP CUP,1,5000,0,5000,3917,1083
3/5/2021 13:50,8992761166212,FRESTEA APPLE 350ML,2,4500,0,9000,6000,3000
3/5/2021 14:26,8993072153595,LARISST COTTON 35G,1,5000,0,5000,3300,1700
3/5/2021 14:26,8999999528836,CITRA NOURISH WHT 120ML,1,11800,0,11800,10082,1718
3/5/2021 14:49,089686017748,SARIMIE GORENG ISI 2,1,3500,0,3500,3120,380
3/5/2021 14:49,8992761145033,FANTA STRAW PET 250ML,1,3500,0,3500,2417,1083
3/5/2021 15:16,8996001600146,TEH PUCUK HARUM 350ML,1,3000,0,3000,2314,686
3/5/2021 15:26,RT TWR,ROTI TAWAR JUMBO,1,7000,0,7000,6200,800
3/5/2021 16:05,8992761139018,ADES 600ML,1,3500,0,3500,2292,1208
3/5/2021 16:05,8992761166212,FRESTEA APPLE 350ML,1,4500,0,4500,3000,1500
3/5/2021 16:05,8992957220087,COKLAT SINGA,2,2000,0,4000,3400,600
3/5/2021 17:26,8991004011906,KOPI BORONG,1,10000,0,10000,8333,1667
3/5/2021 17:26,8997025914059,HATARI SEE HONG,1,5000,0,5000,4800,200
3/5/2021 17:26,8991102989534,WFR TANGO LONG VNL 24G GTG,2,1000,0,2000,1344,656
3/5/2021 17:39,8995333032113,TERIGU GATOT KACA 1 KG,1,8500,0,8500,8012,488
3/5/2021 17:42,8998866610261,POWDET DAIA SOFTENER BAG 290 GR,2,5000,0,10000,8900,1100
3/5/2021 17:42,8998866608312,GIV PAPAYA KOTAK 76GR,2,2000,0,4000,3640,360
3/5/2021 17:42,8998866200561,EKOMIE SUPER 600GR,1,10000,0,10000,8615,1385
3/5/2021 17:42,8991004011906,KOPI BORONG,2,10000,0,20000,16666,3334
3/5/2021 17:42,8998866603393,RAPIKA HIJAU POUCH 400ML,1,5000,0,5000,4500,500
3/5/2021 17:42,8999999524722,SUNLIGHT LIME NEW PCH 435ML,1,10000,0,10000,9100,900
3/5/2021 20:46,11222,LEM KOREA,1,9000,0,9000,8000,1000
3/5/2021 21:09,8997028590014,ARGUS 220ML,5,500,0,2500,1510,990
3/5/2021 21:09,6907992823966,JD BLUEBERRY,1,3500,0,3500,3000,500
3/5/2021 21:09,8991102714495,TANGO DRINK COKLAT,1,5000,0,5000,3818,1182
3/5/2021 21:09,RT BAKPIA,ROTI BAKPIA,1,1000,0,1000,750,250
3/5/2021 21:09,8998866200844,NOODLE SEDAAP MIE KARI SPESIAL CUP 81 GR,1,4500,0,4500,3650,850
3/5/2021 21:16,8992870311091,SALONPAS,1,6000,0,6000,4806,1194
3/5/2021 21:16,8997025911706,HATARI SHP MARGARINE,2,5000,0,10000,9600,400
3/5/2021 21:16,GL,GULA 1 LITER,1,11500,0,11500,10500,1000
3/5/2021 22:22,8998866200851,NOODLE SEDAAP MIE BAKSO SPESIAL CUP 77 GR,1,4500,0,4500,3650,850
3/5/2021 23:26,8992753100101,BKM FULL CREAM GOLD 370,1,15500,0,15500,14800,700
3/5/2021 23:26,8992761164546,NUTRIBOOST STRAWBERRY 300ML,1,7000,0,7000,5300,1700
3/6/2021 10:49,089686010343,INDOMIE SOTO MIE,1,2600,0,2600,2367,233
3/6/2021 10:49,8992696405240,DNCO FORT CKLT 400G,1,37000,0,37000,35077,1923
3/6/2021 10:49,8999999710880,PEPSODENT ACTION123 HERBAL 75G,1,7500,0,7500,6650,850
3/6/2021 10:49,8998866612180,SOKLIN SOFTERGEN 280G SAKURA,1,5000,0,5000,4425,575
3/6/2021 10:49,8999999059781,SUNLIGHT LIME NEW POUCH 210ML,1,5000,0,5000,4300,700
3/6/2021 10:49,8999999401023,MOLTO PEWANGI PINK 820ML,1,12500,0,12500,11275,1225
3/6/2021 10:49,8997025911706,HATARI SHP MARGARINE,1,5000,0,5000,4800,200
3/6/2021 10:49,8992628022156,BIMOLI KLASIK TOUCH 1 LT,1,16000,0,16000,14350,1650
3/6/2021 10:49,8999999538422,CLEAR SHP ICM UNISEX 55 ML,1,4200,0,4200,3750,450
3/6/2021 11:45,8998866501026,MINYAK GORENG SEDAAP POUCH 1 L,1,15500,0,15500,14110,1390
3/6/2021 11:45,001,PASEO SMART FACIAL SF 250S GT,1,10000,0,10000,9500,500
3/6/2021 11:45,8993379254469,SABUN LERVIA 90G,1,3500,0,3500,2966,534
3/6/2021 11:45,8998866607315,SOKLIN SOFTERGENT SAKURA 770G & PIRING,1,18000,0,18000,16055,1945
3/6/2021 11:45,8992696404441,BEAR BRAND 189ML,3,8500,0,25500,23661,1839
3/6/2021 11:45,8993176110135,MINYAK TELON LANG 30ML,1,10000,0,10000,8167,1833
3/6/2021 11:45,8998866202312,NOODLE SEDAAP TASTY BAKMI AYAM 129 GR,1,5000,0,5000,4167,833
3/6/2021 12:11,8996001600146,TEH PUCUK HARUM 350ML,1,3000,0,3000,2314,686
3/6/2021 12:11,8996001318911,BETTER ISI 4,1,2000,0,2000,1700,300
3/6/2021 13:35,8992761166229,FRESTEA MARKISA 350ML,1,4500,0,4500,3000,1500
3/6/2021 13:38,8991002103764,GOOD DAY CPUCINO 10X25G,4,1500,0,6000,5580,420
3/6/2021 13:38,8992761139018,ADES 600ML,1,3500,0,3500,2292,1208
3/6/2021 13:38,8991102381024,FULLO VNL PCK,1,10000,0,10000,9000,1000
3/6/2021 13:38,8992775001691,GARUDA ROSTA WAGYU BEEF,1,8000,0,8000,7176,824
3/6/2021 13:38,8994834003752,TOCTIC,1,2000,0,2000,1700,300
3/6/2021 13:38,RAINBOW,MINICOCO RAINBOW,2,500,0,1000,900,100
3/6/2021 13:46,8992761002015,COCA COLA PET 390ML,1,5500,0,5500,4333,1167
3/6/2021 13:46,8996001301579,MALKIST CKLT KELAPA PACK,1,11000,0,11000,9900,1100
3/6/2021 13:54,8998989110167,SURYA GUDANG GARAM 16 FILTER,1,24000,0,24000,22100,1900
3/6/2021 13:54,8990800004563,MENTOS 40X50 BUAH IND,1,5500,0,5500,5150,350
3/6/2021 14:28,8994834003752,TOCTIC,2,2000,0,4000,3400,600
3/6/2021 14:28,COKLAT,COKLAT COIN,2,500,0,1000,800,200
3/6/2021 14:45,8992761139018,ADES 600ML,1,3500,0,3500,2292,1208
3/6/2021 15:04,8992957220087,COKLAT SINGA,1,2000,0,2000,1700,300
3/6/2021 15:08,8999909096004,SAMPOERNA 16 FILTER,1,24000,0,24000,23000,1000
3/6/2021 15:36,089686011036,INDOMIE GORENG PEDAS,1,2700,0,2700,2452,248
3/6/2021 16:30,8992628510158,SIMAS PALMIA,1,6000,0,6000,4832,1168
3/6/2021 17:35,8997013790108,BIMURA KACANG TELUR 25G,3,1000,0,3000,2625,375
3/6/2021 17:35,8991102989534,WFR TANGO LONG VNL 24G GTG,3,1000,0,3000,2016,984
3/6/2021 18:19,8998866201964,MINYAK GORENG SABRINA 2L POUCH,1,28000,0,28000,26753,1247
3/6/2021 18:37,089686043273,INDOMIE SAMBAL RICA,1,2700,0,2700,2452,248
3/6/2021 18:37,8998989100120,GUDANG GARAM MINI,1,18000,0,18000,16600,1400
3/6/2021 19:09,8998866202671,NOODLE SEDAAP MIE KOREAN SPICY SOUP CUP,1,5000,0,5000,3917,1083
3/6/2021 19:09,8992761139018,ADES 600ML,1,3500,0,3500,2292,1208
3/6/2021 19:50,8998989300261,GUDANG GARAM SURYA 12 FILTER,1,18000,0,18000,16450,1550
3/6/2021 20:22,8999909982000,SAMPOERNA 12 FILTER,1,18000,0,18000,16200,1800
3/6/2021 21:13,8998866200325,NOODLE SEDAAP MIE SOTO,4,2200,0,8800,7808,992
3/6/2021 21:13,8998866200578,NOODLE SEDAAP KARI KENTAL SPC 75 GR,4,2300,0,9200,7808,1392
3/6/2021 21:17,8850507002968,A1 KING TRUCK,1,16500,0,16500,15500,1000
3/6/2021 21:17,8850507001152,MOTU ATV,1,10000,0,10000,8000,2000
3/6/2021 21:17,8998009010590,ULTRA CHO 125,2,3000,0,6000,4856,1144
3/6/2021 21:17,8992775311615,CHOCOLATOS,1,12000,0,12000,9983,2017
3/6/2021 21:17,8996001304020,SLAI OLAI NANAS,1,8500,0,8500,7700,800
3/6/2021 21:18,8998866202466,JAPOTA HAPPY HONEY BUTTER,1,5000,0,5000,4150,850
3/6/2021 21:18,RT ISI 6,ROTI ISI 6,1,5000,0,5000,4500,500
3/6/2021 21:18,8998866202435,JAPOTA UMAMI JAPANESE SEAWEED 35GR,1,5000,0,5000,4150,850
3/6/2021 21:22,8998989300261,GUDANG GARAM SURYA 12 FILTER,1,18000,0,18000,16450,1550
3/6/2021 21:22,123124,KOREK BIASA,1,2000,0,2000,1800,200
3/6/2021 21:32,8999999530495,AXE HIGH HOLD MATTE WAX 75G,1,23200,0,23200,20845,2355
3/6/2021 21:42,8994834003752,TOCTIC,5,2000,0,10000,8500,1500
3/6/2021 21:42,8991102384841,WFR TANGO LONG CKLT 130G,2,5000,0,10000,7546,2454
3/6/2021 21:42,8998866201469,POTABEE REGULER BBQ BEEF 68 GR,1,8000,0,8000,7200,800
3/6/2021 21:42,8992775001691,GARUDA ROSTA WAGYU BEEF,1,8000,0,8000,7176,824
3/6/2021 21:42,8996001600375,LE MINERAL 330ML,2,2000,0,4000,2834,1166
3/6/2021 21:42,8996001600269,LE MINERAL 600ML,1,3000,0,3000,1688,1312
3/6/2021 21:42,8992761139018,ADES 600ML,1,3500,0,3500,2292,1208
3/6/2021 21:43,8993470279651,JOGER CHOCKY BAR,3,1000,0,3000,2601,399
3/6/2021 21:43,JGR SHN,JOGER SHINY SACHET,1,500,0,500,437,63
3/6/2021 21:58,8992775311325,GERY SNACK&SEREAL 100G,1,7000,0,7000,5892,1108
3/6/2021 21:58,8991102989534,WFR TANGO LONG VNL 24G GTG,3,1000,0,3000,2016,984
3/6/2021 22:14,8996001600269,LE MINERAL 600ML,1,3000,0,3000,1688,1312
3/6/2021 22:20,8996001312353,MALKIST KELAPA KOPYOR,1,6700,0,6700,5400,1300
3/6/2021 22:20,8996001304013,SLAI OLAI PACK,1,8500,0,8500,7700,800
3/6/2021 22:24,8992959953020,SWEETY BRONZE M1,1,3000,0,3000,2671,329
3/6/2021 22:53,8998898101409,TOLAK ANGIN SIDOMUNCUL,2,3500,0,7000,5416,1584
3/6/2021 22:53,8992761164546,NUTRIBOOST STRAWBERRY 300ML,1,6500,0,6500,5300,1200
3/6/2021 23:02,GL,GULA 1 LITER,1,11500,0,11500,10500,1000
3/6/2021 23:24,8992696523067,MILO ACTVGO UHT 180ML,4,4500,0,18000,14060,3940
3/6/2021 23:24,8996001600269,LE MINERAL 600ML,1,3000,0,3000,1688,1312
3/6/2021 23:24,8997013790108,BIMURA KACANG TELUR 25G,2,1000,0,2000,1750,250
3/6/2021 23:24,GL,GULA 1 LITER,2,11500,0,23000,21000,2000
3/7/2021 0:29,RT ISI 6,ROTI ISI 6,1,5000,0,5000,4500,500
3/7/2021 0:29,8997028590014,ARGUS 220ML,5,500,0,2500,1510,990
3/7/2021 0:29,PUDING,VITA PUDDING,1,5000,0,5000,3750,1250
3/7/2021 0:29,8998866200813,NOODLE SEDAAP MIE GORENG CUP 85 GR,1,5000,0,5000,3917,1083
3/7/2021 0:31,8998009010590,ULTRA CHO 125,1,3000,0,3000,2428,572
3/7/2021 0:31,8998866202244,EKOMIE BUMBU KALDU AYAM,1,1000,0,1000,860,140
3/7/2021 11:24,089686834055,FREISS JERUK,2,11000,0,22000,17500,4500
3/7/2021 11:24,711844150027,ABC NANAS,1,15000,0,15000,12241,2759
3/7/2021 11:24,GL,GULA 1 LITER,8,11500,0,92000,84000,8000
3/7/2021 11:29,8996001600146,TEH PUCUK HARUM 350ML,1,3000,0,3000,2314,686
3/7/2021 11:29,8992957220087,COKLAT SINGA,1,2000,0,2000,1700,300
3/7/2021 11:29,RAINBOW,MINICOCO RAINBOW,1,500,0,500,450,50
3/7/2021 11:29,COKLAT,COKLAT COIN,1,500,0,500,400,100
3/7/2021 11:29,8998866202619,SEDAAP MIE KOREAN SPICY SOUP BAG 77 GR,2,2300,0,4600,4054,546
3/7/2021 11:29,8999999050009,SUNLIGHT LIME NEW POUCH 95ML,1,2000,0,2000,1600,400
3/7/2021 11:29,8998866200301,NOODLE SEDAAP GORENG  90 GR,2,2500,0,5000,4046,954
3/7/2021 11:29,8992957220117,COKLAT BERUANG,1,2000,0,2000,1700,300
3/7/2021 11:29,RT 1000,ROTI 1000,1,1000,0,1000,750,250
3/7/2021 11:30,8994867000162,ROKOK PUNDIMAS KRETEK16,1,10000,0,10000,8600,1400
3/7/2021 13:41,8999999059316,LIFEBOUY TS MILDCARE 75G,1,3000,0,3000,2500,500
3/7/2021 13:41,8998866500708,FLORIDINA ORANGE,1,3000,0,3000,2500,500
3/7/2021 13:41,8998989300261,GUDANG GARAM SURYA 12 FILTER,1,18000,0,18000,16450,1550
3/7/2021 14:07,8997009510116,LEMON WATER,1,7000,0,7000,5694,1306
3/7/2021 14:07,9556001025272,NESCAFE LATTE 240ML,1,8500,0,8500,7437,1063
3/7/2021 14:07,8994834003752,TOCTIC,1,2000,0,2000,1700,300
3/7/2021 14:07,8996001600610,TORA MILKY LATTE 180ML,1,3500,0,3500,2750,750
3/7/2021 14:07,8991102384841,WFR TANGO LONG CKLT 130G,1,5000,0,5000,3773,1227
3/7/2021 14:07,8994834006128,TOCTIC PEDAS,2,2000,0,4000,3400,600
3/7/2021 14:53,8998866200882,SUKSESMIE GORENG AYAM KRMS 133GR,2,3500,0,7000,6000,1000
3/7/2021 14:54,8992388101092,NU GREEN TE HONEY 330ML,1,3500,0,3500,2854,646
3/7/2021 17:07,8998866200561,EKOMIE SUPER 600GR,1,10000,0,10000,8615,1385
3/7/2021 17:07,089686043273,INDOMIE SAMBAL RICA,1,2700,0,2700,2452,248
3/7/2021 17:43,8999999531485,MOLTO EDP PINK ROSE SC 10ML,2,5500,0,11000,9600,1400
3/7/2021 17:43,8996001350515,ZUPERRR KEJU CHOCO,1,10000,0,10000,8000,2000
3/7/2021 17:43,8992694242502,ZWITZAL SOAP CALSSIC 70G,1,3800,0,3800,3410,390
3/7/2021 17:43,8991102281416,PERMEN MINTZ PPMINT,1,4500,0,4500,4000,500
3/7/2021 17:43,8997027490018,LADAMAS MERICA BUBUK,1,9500,0,9500,8898,602
3/7/2021 17:43,8991002105409,KOPI KAPAL API,1,20000,0,20000,18888,1112
3/7/2021 17:43,8992959117569,SFX DS REG FLOW NW 8,1,4000,0,4000,3530,470
3/7/2021 17:43,8999999192150,ROYCO FDS CHICKEN 100GR,1,5000,0,5000,4300,700
3/7/2021 17:49,8992957214307,SAFARI MECES,1,5500,0,5500,4500,1000
3/7/2021 18:23,8992696404441,BEAR BRAND 189ML,1,8500,0,8500,7887,613
3/7/2021 18:23,8992959953181,SWEETY BRONZE L30+2,1,55000,0,55000,53410,1590
3/7/2021 18:26,8992696523081,MILO UHT 110ML,1,2500,0,2500,1962,538
3/7/2021 18:28,8998866200578,NOODLE SEDAAP KARI KENTAL SPC 75 GR,2,2300,0,4600,3904,696
3/7/2021 18:33,8991102385060,TANGO WAFFLE CHOX,1,8000,0,8000,6212,1788
3/7/2021 18:41,8994834003752,TOCTIC,1,2000,0,2000,1700,300
3/7/2021 18:41,8999999520151,PEPSODENT TB FAMILY SOFT,1,2100,0,2100,1900,200
3/7/2021 19:22,GL,GULA 1 LITER,3,11500,0,34500,31500,3000
3/7/2021 19:22,8995333032113,TERIGU GATOT KACA 1 KG,1,8500,0,8500,8012,488
3/7/2021 19:22,8994834006128,TOCTIC PEDAS,1,2000,0,2000,1700,300
3/7/2021 19:22,8996001600146,TEH PUCUK HARUM 350ML,1,3000,0,3000,2314,686
3/7/2021 19:59,8998866202244,EKOMIE BUMBU KALDU AYAM,5,1000,0,5000,4300,700
3/7/2021 20:12,089686021127,INTER MIE KALDU,20,875,0,17500,16260,1240
3/7/2021 20:12,089686021219,INTER MIE GORENG,20,875,0,17500,17700,-200
3/7/2021 20:12,8998866200325,NOODLE SEDAAP MIE SOTO,4,2200,0,8800,7808,992
3/7/2021 20:12,089686010107,INDOMIE KALDU AYAM,4,2500,0,10000,8600,1400
3/7/2021 20:12,8999999558086,RINSO MOLTO FERFUME ESSENSE PWD 44G,6,1000,0,6000,4830,1170
3/7/2021 20:24,8995333032113,TERIGU GATOT KACA 1 KG,1,8500,0,8500,8012,488
3/7/2021 20:24,8992775001691,GARUDA ROSTA WAGYU BEEF,1,8000,0,8000,7176,824
3/7/2021 20:24,8992761139018,ADES 600ML,1,3500,0,3500,2292,1208
3/7/2021 20:24,8997021870052,FRESH CARE GREEN TEA 10ML,1,12000,0,12000,10000,2000
3/7/2021 20:24,8995333060772,TERIGU GATOT KACA 500GR,1,4500,0,4500,4065,435
3/7/2021 21:04,8998866693660,SOKLIN FLOORCLENER KUNING 900ML,1,14000,0,14000,12436,1564
3/7/2021 21:04,8998866608084,KECAP MANIS SEDAAP POUCH 550ML,1,19000,0,19000,17000,2000
3/7/2021 21:04,8998866200851,NOODLE SEDAAP MIE BAKSO SPESIAL CUP 77 GR,1,4500,0,4500,3650,850
3/7/2021 21:27,089686010824,INDOMIE GORENG SPESIAL,2,2700,0,5400,4904,496
3/7/2021 21:27,089686011036,INDOMIE GORENG PEDAS,1,2700,0,2700,2452,248
3/7/2021 21:27,089686010343,INDOMIE SOTO MIE,2,2600,0,5200,4734,466
3/7/2021 21:27,8999999514006,BANGO MANIS 60ML,1,3000,0,3000,2400,600
3/7/2021 21:27,8993072254056,MELROSE COTTON BUDS KCL,1,3000,0,3000,2450,550
3/7/2021 21:27,8850507002968,A1 KING TRUCK,1,16500,0,16500,15500,1000
3/7/2021 22:01,8998989110167,SURYA GUDANG GARAM 16 FILTER,1,24000,0,24000,22100,1900
3/7/2021 22:01,TG,TEH GELAS,2,1000,0,2000,1458,542
3/7/2021 22:01,8993470671752,JOGER STICK DUO KACANG,3,1000,0,3000,2550,450
3/7/2021 22:01,089686010107,INDOMIE KALDU AYAM,1,2500,0,2500,2150,350
3/7/2021 22:01,089686021127,INTER MIE KALDU,1,1000,0,1000,813,187
3/8/2021 11:14,8993989311279,CLAS MILD 12,1,17000,0,17000,15700,1300
3/8/2021 11:32,8996001600146,TEH PUCUK HARUM 350ML,1,3000,0,3000,2314,686
3/8/2021 11:35,8999999706173,PEPSODENT WHITE 120G,3,6700,0,20100,17820,2280
3/8/2021 11:35,8999999045913,LIFEBUOY MILDCARE 110GR,3,4000,0,12000,10500,1500
3/8/2021 12:18,8998866608008,KECAP MANIS SEDAAP BOTOL 135 ML,1,6300,0,6300,5615,685
3/8/2021 12:55,8999999706081,PEPSODENT WHITE 75G,1,5000,0,5000,3850,1150
3/8/2021 14:12,8992761145033,FANTA STRAW PET 250ML,1,3500,0,3500,2417,1083
3/8/2021 14:42,JGR SHN,JOGER SHINY SACHET,1,500,0,500,437,63
3/8/2021 14:42,ARG,ARGUS 220ML,1,14500,0,14500,12500,2000
3/8/2021 14:59,8996001600146,TEH PUCUK HARUM 350ML,1,3000,0,3000,2314,686
3/8/2021 15:10,8992959953037,SWEETY BRONZE L1,2,3000,0,6000,5342,658
3/8/2021 15:39,8996001305041,ROMA SANDWICH CKLT,1,7000,0,7000,5000,2000
3/8/2021 15:44,8995333060703,TERIGU KOMPAS 1KG,1,10500,0,10500,9816,684
3/8/2021 15:44,8996001301142,ROMA KELAPA,1,8000,0,8000,6628,1372
3/8/2021 16:00,PUDING,VITA PUDDING,1,5000,0,5000,3750,1250
3/8/2021 16:52,8998989300261,GUDANG GARAM SURYA 12 FILTER,1,18000,0,18000,16450,1550
3/8/2021 17:31,8997025911706,HATARI SHP MARGARINE,1,5000,0,5000,4800,200
3/8/2021 17:52,8994867000162,ROKOK PUNDIMAS KRETEK16,1,10000,0,10000,8600,1400
3/8/2021 18:27,8998866200813,NOODLE SEDAAP MIE GORENG CUP 85 GR,1,5000,0,5000,3917,1083
3/8/2021 18:31,8998866200578,MIE SEDAAP KARI KENTAL,1,2500,0,2500,1952,548
3/8/2021 19:02,6907992823966,JD BLUEBERRY,1,3500,0,3500,3000,500
3/8/2021 19:02,6907992823911,JD CRUNCHY HONEYDEW MELON,1,8000,0,8000,6800,1200
3/8/2021 19:02,8998866202725,MILKU COKLAT PREMIUM 200ML,1,3000,0,3000,2375,625
3/8/2021 19:02,6907992823829,JD MILKY MILK,1,3000,0,3000,2600,400
3/8/2021 19:02,8991102714495,TANGO DRINK COKLAT,1,5000,0,5000,3818,1182
3/8/2021 20:06,6907992823652,JD CHOCOLATE MILKSHAKE,1,6000,0,6000,5200,800
3/8/2021 20:06,TG,TEH GELAS,1,1000,0,1000,729,271
3/8/2021 20:06,TG APEL,TEH GELAS APEL,1,2000,0,2000,1178,822
3/8/2021 20:06,8997028590014,ARGUS 220ML,2,500,0,1000,604,396
3/8/2021 20:23,6907992823911,JD CRUNCHY HONEYDEW MELON,1,8000,0,8000,6800,1200
3/8/2021 20:26,8997018250218,JAHE MERAH,2,1000,0,2000,1666,334
3/8/2021 21:08,8992628510158,SIMAS PALMIA,1,6000,0,6000,4832,1168
3/8/2021 21:08,8995333032113,TERIGU GATOT KACA 1 KG,1,8500,0,8500,8012,488
3/8/2021 21:08,8998866501026,MINYAK GORENG SEDAAP POUCH 1 L,1,15500,0,15500,14110,1390
3/8/2021 21:08,8998866202343,MIE SEDAAP KOREAN SPICY,1,2500,0,2500,2023,477
3/8/2021 21:08,089686010824,INDOMIE GORENG SPESIAL,1,2700,0,2700,2452,248
3/8/2021 21:08,8992388111145,MIE ABC SELERA PEDAS- SUP TOMAT PEDAS,1,2500,0,2500,2023,477
3/8/2021 21:08,8998866202244,EKOMIE BUMBU KALDU AYAM,2,1000,0,2000,1720,280
3/8/2021 21:08,8998898830125,KKB ENER-G ANGGUR,1,5500,0,5500,4824,676
3/8/2021 22:44,089686010343,INDOMIE SOTO MIE,1,2600,0,2600,2367,233
3/8/2021 22:44,089686010824,INDOMIE GORENG SPESIAL,1,2700,0,2700,2452,248
3/8/2021 22:45,8992761145033,FANTA STRAW PET 250ML,1,3500,0,3500,2417,1083
3/8/2021 22:47,8999999027261,LIFEBUOY BW LEMONFRESH LD REFF 450 ML,1,25000,0,25000,22110,2890
3/8/2021 22:47,8999999007768,FAIR&LOVELY MULTIVITAMIN  CREAM 9 ML,1,4500,0,4500,3200,1300
3/8/2021 22:48,8998866202435,JAPOTA UMAMI JAPANESE SEAWEED 35GR,2,5000,0,10000,8300,1700
3/9/2021 0:37,8991102714594,TANGO DRINK BLCK VNL,1,5000,0,5000,3818,1182
3/9/2021 0:37,8991102228053,TEH GELAS BOTOL,1,3000,0,3000,1922,1078
3/9/2021 0:37,TG MARKISA,TEH GELAS MARKISA,1,2000,0,2000,1178,822
3/9/2021 0:37,RT ISI 6,ROTI ISI 6,1,5000,0,5000,4500,500
3/9/2021 11:34,8997025911706,HATARI SHP MARGARINE,1,5000,0,5000,4800,200
3/9/2021 11:34,8998009010231,ULTRA CHO 250,1,6000,0,6000,4784,1216
3/9/2021 11:34,8992696405417,DNCO  SHC 27G,1,3000,0,3000,2647,353
3/9/2021 11:34,8992628022156,BIMOLI KLASIK TOUCH 1 LT,1,16000,0,16000,14350,1650
3/9/2021 11:34,8998866601429,POWDET DAIA BUNGA BAG 290GR,2,5000,0,10000,8900,1100
3/9/2021 11:34,8999999556341,MOLTO EDP PINK ROSE 20ML,2,1000,0,2000,1600,400
3/9/2021 11:34,8990800016757,BB TUTI FRUITTY COSMO,1,8500,0,8500,7600,900
3/9/2021 11:34,RT BAKPIA,ROTI BAKPIA,1,1000,0,1000,750,250
3/9/2021 11:34,JGR SHN,JOGER SHINY SACHET,1,500,0,500,437,63
3/9/2021 11:34,TG MARKISA,TEH GELAS MARKISA,1,2000,0,2000,1178,822
3/9/2021 11:35,8991102281430,PERMEN MINTZ DUOMINT,1,4500,0,4500,4000,500
3/9/2021 11:56,089686011494,INDOMIE SOTO PADANG,2,2600,0,5200,4634,566
3/9/2021 11:56,RT 1000,ROTI 1000,2,1000,0,2000,1500,500
3/9/2021 14:51,8992761111540,FANTA STRAWBERY SLIM CAM 250ML,1,5000,0,5000,3750,1250
3/9/2021 14:51,8992957220025,GOLDEN CITY MINI,1,3000,0,3000,2500,500
3/9/2021 14:51,8997013790108,BIMURA KACANG TELUR 25G,2,1000,0,2000,1750,250
3/9/2021 14:51,8992761139018,ADES 600ML,1,3500,0,3500,2292,1208
3/9/2021 14:51,8992957220186,COKLAT RUSA,2,2000,0,4000,3400,600
3/9/2021 15:22,8998989300261,GUDANG GARAM SURYA 12 FILTER,1,18000,0,18000,16450,1550
3/9/2021 15:39,6907992823935,JD SWEETCORN,1,3500,0,3500,3000,500
3/9/2021 16:24,8998989500128,GUDANG GARAM MERAH KECIL 12KS,1,13000,0,13000,11900,1100
3/9/2021 17:28,8998989500128,GUDANG GARAM MERAH KECIL 12KS,1,13000,0,13000,11900,1100
3/9/2021 17:31,8998989100120,GUDANG GARAM MINI,1,18000,0,18000,16600,1400
3/9/2021 17:42,8998898830125,KKB ENER-G ANGGUR,1,5500,0,5500,4824,676
3/9/2021 17:55,GL,GULA 1 LITER,2,11500,0,23000,21000,2000
3/9/2021 18:03,RT CD,ROTI COKLAT DURIAN,1,7000,0,7000,6200,800
3/9/2021 18:03,8992696404441,BEAR BRAND 189ML,1,8500,0,8500,7887,613
3/9/2021 19:44,089686021127,INTER MIE KALDU,5,1000,0,5000,4065,935
3/9/2021 19:44,8998866202244,EKOMIE BUMBU KALDU AYAM,5,1000,0,5000,4300,700
3/9/2021 19:44,8998989300261,GUDANG GARAM SURYA 12 FILTER,1,18000,0,18000,16450,1550
3/9/2021 19:59,GL,GULA 1 LITER,1,11500,0,11500,10500,1000
3/9/2021 19:59,RT BAKPIA,ROTI BAKPIA,1,1000,0,1000,750,250
3/9/2021 20:24,BRS,BERAS BUMN 10KG,2,128000,0,256000,180000,76000
3/9/2021 20:24,8994867000162,ROKOK PUNDIMAS KRETEK16,1,10000,0,10000,8600,1400
3/9/2021 20:24,8991102384841,WFR TANGO LONG CKLT 130G,1,5000,0,5000,3773,1227
3/9/2021 20:36,8998866200301,MIE SEDAAP GORENG,2,2500,0,5000,4046,954
3/9/2021 20:36,8999999504656,SARI MURNI 20X1.8G,1,5000,0,5000,4200,800
3/9/2021 20:36,8998866501026,MINYAK GORENG SEDAAP POUCH 1 L,1,15500,0,15500,14110,1390
3/9/2021 20:36,8998866602563,NUVO FAMILY HIJAU 76G,1,2000,0,2000,1820,180
3/9/2021 20:36,8998866610742,NOVO FAMILY PINK 76G,1,2000,0,2000,1820,180
3/9/2021 20:36,8999999030179,PEPSODENT ACTION 123 COMPLETE 75G,1,6700,0,6700,5170,1530
3/9/2021 20:36,8999999534752,PEPSODENT ACTION123 CHARCOAL 65G,1,7400,0,7400,6710,690
3/9/2021 20:36,GL,GULA 1 LITER,1,11500,0,11500,10500,1000
3/9/2021 20:39,8998866201827,JAVANA GULA BATU 350ML,1,3000,0,3000,2150,850
3/9/2021 21:00,8999999005580,DOVE DEO WMN RONOURISH & SMOOTH 40 ML,1,17800,0,17800,16050,1750
3/9/2021 21:00,6907992823911,JD CRUNCHY HONEYDEW MELON,1,8000,0,8000,6800,1200
3/9/2021 21:00,PRG,PARAGO,2,500,0,1000,800,200
3/9/2021 21:00,RT BAKPIA,ROTI BAKPIA,1,1000,0,1000,750,250
3/9/2021 21:06,8886013213208,FRENCH FREIS 2000,2,5000,0,10000,7500,2500
3/9/2021 21:06,001,PASEO SMART FACIAL SF 250S GT,1,10000,0,10000,9500,500
3/9/2021 21:06,8998009010569,ULTRA CHO 200,1,5000,0,5000,3830,1170
3/9/2021 21:06,8992628020152,BIMOLI POUCH 2L,1,30000,0,30000,28983,1017
3/9/2021 21:06,8998866200301,MIE SEDAAP GORENG,1,2500,0,2500,2023,477
3/9/2021 21:16,RT BAKPIA,ROTI BAKPIA,5,1000,0,5000,3750,1250
3/10/2021 8:51,8991102987639,WFR TANGO LONG VNL 130G,1,5000,0,5000,3773,1227
3/10/2021 8:51,8997025914059,HATARI SEE HONG,1,5000,0,5000,4800,200
3/10/2021 9:02,8991102228053,TEH GELAS BOTOL,1,3000,0,3000,1922,1078
3/10/2021 9:02,8996001600146,TEH PUCUK HARUM 350ML,2,3000,0,6000,4628,1372
3/10/2021 9:02,8998866202725,MILKU COKLAT PREMIUM 200ML,1,3000,0,3000,2375,625
3/10/2021 9:02,8996001600641,TORA CAPPUCINO,1,3500,0,3500,2750,750
3/10/2021 9:02,8991102381024,FULLO VNL PCK,1,10000,0,10000,9000,1000
3/10/2021 9:18,RT BAKPIA,ROTI BAKPIA,2,1000,0,2000,1500,500
3/10/2021 9:18,8998866201865,KRISBEE PILLOW CHOCOLAVA 120 GR,1,8000,0,8000,7250,750
3/10/2021 10:17,8991102213189,BLASTER UNGU,1,5000,0,5000,3106,1894
3/10/2021 10:17,089686400816,SAMBAL EXTRA PEDAS 135ML,2,5500,0,11000,9232,1768
3/10/2021 10:17,GL,GULA 1 LITER,2,11500,0,23000,21000,2000
3/10/2021 11:12,8998866200561,EKOMIE SUPER 600GR,1,10000,0,10000,8615,1385
3/10/2021 11:14,HT,HOT-HOT,2,500,0,1000,700,300
3/10/2021 12:14,BRS5,BERAS BUMN 5KG,1,64000,0,64000,45000,19000
3/10/2021 12:16,8991102384841,WFR TANGO LONG CKLT 130G,1,5000,0,5000,3773,1227
3/10/2021 13:19,8997009510055,YOU C1000,1,8000,0,8000,4846,3154
3/10/2021 13:19,8992761139018,ADES 600ML,1,3500,0,3500,2292,1208
3/10/2021 13:38,RT KJ,ROTI KASUR JUMBO,1,7000,0,7000,6200,800
3/10/2021 13:40,8992761145033,FANTA STRAW PET 250ML,2,3500,0,7000,4834,2166
3/10/2021 13:40,8992761145026,SPRITE PET 250ML,2,3500,0,7000,4834,2166
3/10/2021 13:40,8994834006128,TOCTIC PEDAS,1,2000,0,2000,1700,300
3/10/2021 13:44,8999909982000,SAMPOERNA 12 FILTER,2,18000,0,36000,32400,3600
3/10/2021 15:31,8996001318911,BETTER ISI 4,1,2000,0,2000,1700,300
3/10/2021 15:52,8998989300261,GUDANG GARAM SURYA 12 FILTER,1,18000,0,18000,16450,1550
3/10/2021 15:52,PRG,PARAGO,3,500,0,1500,1200,300
3/10/2021 15:52,HT,HOT-HOT,1,500,0,500,350,150
3/10/2021 17:43,GL,GULA 1 LITER,1,11500,0,11500,10500,1000
3/10/2021 17:43,PT,POTO-POTO SINJAI,2,6000,0,12000,10000,2000
3/10/2021 17:43,8998866602273,HERSPROTEX SOFTCARE MAX,1,3500,0,3500,2950,550
3/10/2021 17:43,8999999719395,VASELINE HW UV LIGHTENING 100ML,1,12900,0,12900,11805,1095
3/10/2021 17:43,8999999502393,ROYCO FDS CHICKEN 8G,1,5000,0,5000,4500,500
3/10/2021 19:34,8998989300261,GUDANG GARAM SURYA 12 FILTER,1,18000,0,18000,16450,1550
3/10/2021 20:02,8998866200820,NOODLE SEDAAP MIE AYAM BAWANG TLR CUP 77 GR,2,4500,0,9000,7300,1700
3/10/2021 20:02,RT BAKPIA,ROTI BAKPIA,1,1000,0,1000,750,250
3/10/2021 20:02,RT 1000,ROTI 1000,3,1000,0,3000,2250,750
3/10/2021 20:02,8993470671752,JOGER STICK DUO KACANG,1,1000,0,1000,850,150
3/10/2021 20:02,TG,TEH GELAS,2,1000,0,2000,1458,542
3/10/2021 20:02,PRG,PARAGO,3,500,0,1500,1200,300
3/10/2021 20:10,8886013213208,FRENCH FREIS 2000,2,5000,0,10000,7500,2500
3/10/2021 20:10,8998009040023,TEH KOTAK,1,5000,0,5000,2827,2173
3/10/2021 20:10,8996001600269,LE MINERAL 600ML,1,3000,0,3000,1688,1312
3/10/2021 20:10,8997025911058,HATARI SHP KELAPA,1,5000,0,5000,4800,200
3/10/2021 20:55,GL,GULA 1 LITER,1,11500,0,11500,10500,1000
3/10/2021 20:55,PRG,PARAGO,6,500,0,3000,2400,600
3/10/2021 20:55,8999909096004,SAMPOERNA 16 FILTER,1,24000,0,24000,23000,1000
3/10/2021 20:55,COKLAT,COKLAT COIN,6,500,0,3000,2400,600
3/10/2021 20:55,8997013790108,BIMURA KACANG TELUR 25G,3,1000,0,3000,2625,375
3/10/2021 21:44,8992736980164,SASA TEPUNG KENTUCKY 80G,2,3000,0,6000,4362,1638
3/10/2021 21:44,8992753100101,BKM FULL CREAM GOLD 370,3,15500,0,46500,44400,2100
3/10/2021 21:44,8996001355237,SUPER STAR,1,11000,0,11000,9900,1100
3/10/2021 21:44,8998866200851,NOODLE SEDAAP MIE BAKSO SPESIAL CUP 77 GR,1,4500,0,4500,3650,850
3/10/2021 21:46,8992775311486,CHOCOLATOS DARK 16G,1,18000,0,18000,15173,2827
3/10/2021 22:06,8993989311279,CLAS MILD 12,1,17000,0,17000,15700,1300
3/10/2021 22:21,089686021127,INTER MIE KALDU,1,1000,0,1000,813,187
3/10/2021 22:21,8997028590014,ARGUS 220ML,1,500,0,500,302,198
3/10/2021 22:37,8994023000050,MEGKEJU SERBAGUNA 165G,1,12000,0,12000,10339,1661
3/10/2021 22:38,8997210107877,VORTEX SMART 3,1,5000,0,5000,9500,-4500
3/10/2021 22:38,8992959508992,SWEETY SILVER PANTS L 28,1,56800,0,56800,51819,4981
3/10/2021 22:41,8992959020012,SWEETY SILVER PANTS XL 34,1,78000,0,78000,73637,4363
3/10/2021 22:41,8999999049454,REXONA WMN RO FREE SPIRIT 45 ML,1,15000,0,15000,13550,1450
3/11/2021 9:51,GL,GULA 1 LITER,1,11500,0,11500,10500,1000
3/11/2021 9:51,001,PASEO SMART FACIAL SF 250S GT,1,10000,0,10000,9500,500
3/11/2021 9:51,8999999059781,SUNLIGHT LIME NEW POUCH 210ML,1,5000,0,5000,4300,700
3/11/2021 9:51,8997021870151,FRESH CARE STRONG 110ML,1,12000,0,12000,10000,2000
3/11/2021 9:51,8999999519872,DOVE DEO WMN RO POMEGRANATE 40 ML,1,16500,0,16500,15000,1500
3/11/2021 9:51,8998866201841,GOLDA DOLCE LATTE 200ML,1,3000,0,3000,2500,500
3/11/2021 9:51,089686017748,SARIMIE GORENG ISI 2,1,3500,0,3500,3120,380
3/11/2021 9:51,COKLAT,COKLAT COIN,1,500,0,500,400,100
3/11/2021 9:51,089686041705,INDOMIE GORENG JUMBO,1,3500,0,3500,3143,357
3/11/2021 9:51,089686043204,INDOMIE MIE ACEH,1,2700,0,2700,2452,248
3/11/2021 9:51,8996001600399,LE MINERAL 1500ML,1,5000,0,5000,4042,958
3/11/2021 10:00,GL,GULA 1 LITER,5,11500,0,57500,52500,5000
3/11/2021 10:00,8999999195656,SARI WANGI 50X1.85,2,10000,0,20000,17400,2600
3/11/2021 10:22,8997027300089,NOMOS,1,4000,0,4000,2963,1037
3/11/2021 10:22,8991102281416,PERMEN MINTZ PPMINT,1,4500,0,4500,4000,500
3/11/2021 10:22,RT 1000,ROTI 1000,1,1000,0,1000,750,250
3/11/2021 10:36,GL,GULA 1 LITER,2,11500,0,23000,21000,2000
3/11/2021 10:36,8999999195649,SARI WANGI 25X1.86G,1,6000,0,6000,5050,950
3/11/2021 10:36,GL,GULA 1 LITER,2,11500,0,23000,21000,2000
3/11/2021 10:36,8999999195649,SARI WANGI 25X1.86G,1,6000,0,6000,5050,950
3/11/2021 10:38,8993083929837,BISKITOP BLACK COOKIES,1,27000,0,27000,23700,3300
3/11/2021 11:26,9556001004673,MILO NESTLE MALAYSIA ACTIVE GO,1,85000,0,85000,80000,5000
3/11/2021 11:26,8992933216110,NUTRIJELL MANGO,1,6000,0,6000,4950,1050
3/11/2021 11:26,8992933214116,NUTRIJELL MELON,1,6000,0,6000,5041,959
3/11/2021 12:13,8992959953013,SWEETY BRONZE S1,5,2000,0,10000,6895,3105
3/11/2021 13:52,8998009010231,ULTRA CHO 250,1,6000,0,6000,4784,1216
3/11/2021 13:52,8998989300261,GUDANG GARAM SURYA 12 FILTER,1,18000,0,18000,16450,1550
3/11/2021 13:52,089686043204,INDOMIE MIE ACEH,1,2700,0,2700,2452,248
3/11/2021 13:58,8999999555191,SAHAJA PENCUCI PRG JRUK NIPIS  BTL 650ML,1,19000,0,19000,17250,1750
3/11/2021 13:58,8998866201841,GOLDA DOLCE LATTE 200ML,1,3000,0,3000,2500,500
3/11/2021 13:58,8998989300261,GUDANG GARAM SURYA 12 FILTER,1,18000,0,18000,16450,1550
3/11/2021 14:44,8994867000162,ROKOK PUNDIMAS KRETEK16,1,10000,0,10000,8600,1400
3/11/2021 14:45,8991102384841,WFR TANGO LONG CKLT 130G,1,5000,0,5000,3773,1227
3/11/2021 15:34,089686010343,INDOMIE SOTO MIE,1,2600,0,2600,2367,233
3/11/2021 15:56,8996001600375,LE MINERAL 330ML,1,2000,0,2000,1417,583
3/11/2021 15:56,HT,HOT-HOT,2,500,0,1000,700,300
3/11/2021 15:56,8992957220063,COKLAT BANGO,1,2000,0,2000,1700,300
3/11/2021 17:15,089686011494,INDOMIE SOTO PADANG,2,2600,0,5200,4634,566
3/11/2021 17:15,8998866610261,POWDET DAIA SOFTENER BAG 290 GR,1,5000,0,5000,4450,550
3/11/2021 17:17,8996001312445,MALKIST CAPPUCINO,1,6500,0,6500,5400,1100
3/11/2021 17:17,089686010107,INDOMIE KALDU AYAM,2,2500,0,5000,4300,700
3/11/2021 17:17,8886013213208,FRENCH FREIS 2000,1,5000,0,5000,3750,1250
3/11/2021 17:32,8998989500166,GUDANG GARAM MERAH BESAR 16KS,1,17000,0,17000,15300,1700
3/11/2021 17:34,8998989500166,GUDANG GARAM MERAH BESAR 16KS,2,17000,0,34000,30600,3400
3/11/2021 17:34,8999999524722,SUNLIGHT LIME NEW PCH 435ML,1,10000,0,10000,9100,900
3/11/2021 17:40,8999999502003,"SARIMURNI RL RB 1,8G",5,1500,0,7500,6035,1465
3/11/2021 17:40,8992957220186,COKLAT RUSA,2,2000,0,4000,3400,600
3/11/2021 17:40,8992957220025,GOLDEN CITY MINI,2,3000,0,6000,5000,1000
3/11/2021 17:40,089686041705,INDOMIE GORENG JUMBO,2,3500,0,7000,6286,714
3/11/2021 17:40,089686043204,INDOMIE MIE ACEH,2,2700,0,5400,4904,496
3/11/2021 17:40,8992696523081,MILO UHT 110ML,1,2500,0,2500,1962,538
3/11/2021 17:50,8996001600269,LE MINERAL 600ML,1,3000,0,3000,1688,1312
3/11/2021 17:50,HT,HOT-HOT,2,500,0,1000,700,300
3/11/2021 18:12,8999801700030,SUSU FOYU,1,11500,0,11500,10000,1500
3/11/2021 18:12,8991111102832,JB POWDER BEDTIME 300G,1,14500,0,14500,13120,1380
3/11/2021 18:12,HT,HOT-HOT,8,500,0,4000,2800,1200
3/11/2021 18:18,8992761139018,ADES 600ML,1,3500,0,3500,2292,1208
3/11/2021 18:18,8992957220025,GOLDEN CITY MINI,1,3000,0,3000,2500,500
3/11/2021 20:44,8993007003063,ENAAK 500G,1,11000,0,11000,9625,1375
3/11/2021 20:46,TG,TEH GELAS,1,1000,0,1000,729,271
3/11/2021 20:46,8991102228053,TEH GELAS BOTOL,1,3000,0,3000,1922,1078
3/11/2021 20:46,8992696405417,DNCO  SHC 27G,1,3000,0,3000,2647,353
3/11/2021 20:46,8996001312445,MALKIST CAPPUCINO,1,6500,0,6500,5400,1100
3/11/2021 20:46,HT,HOT-HOT,1,500,0,500,350,150
3/11/2021 20:46,8999801700030,SUSU FOYU,1,11500,0,11500,10000,1500
3/11/2021 20:46,8991004011906,KOPI BORONG,1,10000,0,10000,8333,1667
3/11/2021 21:01,8999999001179,LIFEBUOY BW COOLFRESH LD REFF 450 ML,1,25000,0,25000,22110,2890
3/11/2021 21:01,8998989300391,SURYA PRO PUTIH,1,20000,0,20000,18600,1400
3/11/2021 21:09,8992761145033,FANTA STRAW PET 250ML,4,3500,0,14000,9668,4332
3/11/2021 21:09,8992761145019,COCA COLA PET 250ML,1,3500,0,3500,2417,1083
3/11/2021 21:09,8998866201889,KRISBEE PILLOW STRAWBERRY ICE CREAM 120GR,1,8000,0,8000,7250,750
3/11/2021 22:11,8992959974018,SFX SIRIH 36CM 12+1,1,12000,0,12000,10686,1314
3/11/2021 22:11,6907992823850,JD CHOCO CIRLE,1,5500,0,5500,4700,800
3/11/2021 22:11,76239878,MARLBORO GOLD,1,30000,0,30000,27700,2300
3/11/2021 22:13,8992761145026,SPRITE PET 250ML,2,3500,0,7000,4834,2166
3/11/2021 22:13,8998866202244,EKOMIE BUMBU KALDU AYAM,1,1000,0,1000,860,140
3/11/2021 22:13,8992957220117,COKLAT BERUANG,1,2000,0,2000,1700,300
3/11/2021 22:22,089686010190,INDOMIE KARI AYAM,2,2800,0,5600,5044,556
3/11/2021 22:22,GL,GULA 1 LITER,1,11500,0,11500,10500,1000
3/11/2021 22:22,8997013790108,BIMURA KACANG TELUR 25G,2,1000,0,2000,1750,250
3/11/2021 22:22,8998866610070,SOKLIN SOFTERGEN 280G PURPLE,1,5000,0,5000,4425,575
3/11/2021 22:37,8990800004563,MENTOS 40X50 BUAH IND,1,5500,0,5500,5150,350
3/11/2021 22:44,8999999401238,RINSO ANTI NODA 770G,1,21200,0,21200,19338,1862
3/11/2021 23:51,089686010343,INDOMIE SOTO MIE,1,2600,0,2600,2367,233
3/12/2021 11:12,8998989121163,SURYA PRO MERAH,1,20000,0,20000,18600,1400
3/12/2021 11:12,8998866200882,SUKSESMIE GORENG AYAM KRMS 133GR,1,3500,0,3500,3000,500
3/12/2021 11:12,8998866608718,DAIA SOFTENER PINK,1,5000,0,5000,4450,550
3/12/2021 11:12,8996001355237,SUPER STAR,1,11000,0,11000,9900,1100
3/12/2021 11:12,8991102384841,WFR TANGO LONG CKLT 130G,1,5000,0,5000,3773,1227
3/12/2021 11:12,8996001318911,BETTER ISI 4,1,2000,0,2000,1700,300
3/12/2021 11:12,MLTO PINK,MOLTO ALL IN ONE,4,1000,0,4000,3200,800
3/12/2021 11:12,8991001780133,TWISTER BLACK,1,5000,0,5000,4600,400
3/12/2021 11:12,8998989300261,GUDANG GARAM SURYA 12 FILTER,1,18000,0,18000,16450,1550
3/12/2021 11:28,HT,HOT-HOT,1,500,0,500,350,150
3/12/2021 13:09,6907992823867,JD CRUNCHY CHOCOLATE MALT,1,5500,0,5500,4700,800
3/12/2021 13:09,8886013213208,FRENCH FREIS 2000,1,5000,0,5000,3750,1250
3/12/2021 13:09,8998866202060,POTABEE AYAM BAKAR PEDAS 35 GR,1,5000,0,5000,4150,850
3/12/2021 13:09,8998866202619,MIE SEDAAP KOREAN SPICY SOUP,1,2500,0,2500,1952,548
3/12/2021 13:09,089686043273,INDOMIE SAMBAL RICA,1,2700,0,2700,2452,248
3/12/2021 14:09,089686043273,INDOMIE SAMBAL RICA,1,2700,0,2700,2452,248
3/12/2021 14:24,6907992823652,JD CHOCOLATE MILKSHAKE,1,6000,0,6000,5200,800
3/12/2021 14:24,6907992823591,JD STRAW MILKSHAKE,3,5000,0,15000,12900,2100
3/12/2021 14:42,8998866202725,MILKU COKLAT PREMIUM 200ML,1,3000,0,3000,2375,625
3/12/2021 14:42,8992957220063,COKLAT BANGO,1,2000,0,2000,1700,300
3/12/2021 14:56,8994867006997,ROKOK PENA BOLD 20BTG,1,17000,0,17000,15000,2000
3/12/2021 15:05,8996001318911,BETTER ISI 4,1,2000,0,2000,1700,300
3/12/2021 15:09,8991188943062,SASA 250G,2,10000,0,20000,16000,4000
3/12/2021 15:29,089686010343,INDOMIE SOTO MIE,1,2600,0,2600,2367,233
3/12/2021 15:54,089686041705,INDOMIE GORENG JUMBO,1,3500,0,3500,3143,357
3/12/2021 15:54,8993989311279,CLAS MILD 12,1,17000,0,17000,15700,1300
3/12/2021 16:21,6907992823591,JD STRAW MILKSHAKE,3,5000,0,15000,12900,2100
3/12/2021 17:48,RT CD,ROTI COKLAT DURIAN,1,7000,0,7000,6200,800
3/12/2021 17:48,8992761139018,ADES 600ML,1,3500,0,3500,2292,1208
3/12/2021 17:49,8999999195649,SARI WANGI 25X1.86G,1,6000,0,6000,5050,950
3/12/2021 17:49,GL,GULA 1 LITER,1,11500,0,11500,10500,1000
3/12/2021 17:49,8998989500166,GUDANG GARAM MERAH BESAR 16KS,1,17000,0,17000,15300,1700
3/12/2021 21:55,089686834307,FREISS LECI,1,11000,0,11000,8750,2250
3/12/2021 21:55,8999801700030,SUSU FOYU,1,11500,0,11500,10000,1500
3/12/2021 21:55,8992933243116,NUTRIJELLL KELAPA,2,6000,0,12000,9666,2334
3/12/2021 21:55,8992933214116,NUTRIJELL MELON,1,6000,0,6000,5041,959
3/12/2021 22:18,711844610095,LARISSA UDANG 500 GR,1,11000,0,11000,9790,1210
3/12/2021 22:18,8997013790092,BIMURA KERUPUK BAWANG 25G,2,1000,0,2000,1748,252
3/12/2021 22:18,8997013790108,BIMURA KACANG TELUR 25G,3,1000,0,3000,2625,375
3/12/2021 22:18,8996001318980,BETTER 120G,1,6000,0,6000,5100,900
3/13/2021 11:13,089686043204,INDOMIE MIE ACEH,1,2700,0,2700,2452,248
3/13/2021 11:13,8998989300261,GUDANG GARAM SURYA 12 FILTER,1,18000,0,18000,16450,1550
3/13/2021 11:13,8993571004732,SALAS SALEP CAP19 6G,1,7000,0,7000,6000,1000
3/13/2021 13:04,6907992823904,JD CRUNCHY CHOCOLATE VAN,2,8000,0,16000,13600,2400
3/13/2021 13:04,6907992823935,JD SWEETCORN,2,3500,0,7000,6000,1000
3/13/2021 13:04,6907992823911,JD CRUNCHY HONEYDEW MELON,1,8000,0,8000,6800,1200
3/13/2021 13:06,GL,GULA 1 LITER,1,11500,0,11500,10500,1000
3/13/2021 13:06,8992759120264,LARISST 220,1,10000,0,10000,9200,800
3/13/2021 13:06,8999999031602,SARI MURNI 20X1.6G,1,6000,0,6000,5400,600
3/13/2021 13:22,8999909096004,SAMPOERNA 16 FILTER,1,24000,0,24000,23000,1000
3/13/2021 13:22,8992761166038,MMP ORANGE 300ML,1,5000,0,5000,3750,1250
3/13/2021 13:22,8996001318911,BETTER ISI 4,1,2000,0,2000,1700,300
3/13/2021 14:00,8999999561123,MOLTO PEWANGI PURPLE 820ML,1,12500,0,12500,11275,1225
3/13/2021 14:11,MOLTO PINK,MOLTO ALL IN ONE 11 ML,2,500,0,1000,800,200
3/13/2021 16:04,8999999531485,MOLTO EDP PINK ROSE SC 10ML,1,5500,0,5500,4800,700
3/13/2021 16:08,8994834006128,TOCTIC PEDAS,1,2000,0,2000,1700,300
3/13/2021 16:08,8997009510055,YOU C1000,1,8000,0,8000,4846,3154
3/13/2021 17:20,8998866201469,POTABEE REGULER BBQ BEEF 68 GR,2,8000,0,16000,14400,1600
3/13/2021 17:20,8999999195656,SARI WANGI 50X1.85,2,10000,0,20000,17400,2600
3/13/2021 17:20,8991004011906,KOPI BORONG,1,10000,0,10000,8333,1667
3/13/2021 17:20,8991002105409,KOPI KAPAL API,2,20000,0,40000,37776,2224
3/13/2021 17:20,GL,GULA 1 LITER,2,11500,0,23000,21000,2000
3/13/2021 17:31,GL,GULA 1 LITER,1,11500,0,11500,10500,1000
3/13/2021 17:31,8886013213208,FRENCH FREIS 2000,1,5000,0,5000,3750,1250
3/13/2021 17:31,8992761166205,FRESTEA GREEN HONEY 350ML,1,4500,0,4500,3000,1500
3/13/2021 18:41,8998866202343,MIE SEDAAP KOREAN SPICY,1,2500,0,2500,2023,477
3/13/2021 18:41,089686043273,INDOMIE SAMBAL RICA,2,2700,0,5400,4904,496
3/13/2021 18:41,8992761139018,ADES 600ML,1,3500,0,3500,2292,1208
3/13/2021 18:42,8992761139018,ADES 600ML,1,3500,0,3500,2292,1208
3/13/2021 18:42,8998866202671,NOODLE SEDAAP MIE KOREAN SPICY SOUP CUP,1,5000,0,5000,3917,1083
3/13/2021 18:47,8998989500166,GUDANG GARAM MERAH BESAR 16KS,1,17000,0,17000,15300,1700
3/13/2021 20:00,8998009040023,TEH KOTAK,4,5000,0,20000,11308,8692
3/13/2021 20:00,8997025914059,HATARI SEE HONG,1,5000,0,5000,4800,200
3/13/2021 20:01,8992753101207,BENDERA KENTAL MANIS 370G,2,11500,0,23000,19400,3600
3/13/2021 20:30,RT 1000,ROTI 1000,1,1000,0,1000,750,250
3/13/2021 20:30,8991002103764,GOOD DAY CPUCINO 10X25G,4,1500,0,6000,5580,420
3/13/2021 22:00,8998989110167,SURYA GUDANG GARAM 16 FILTER,2,24000,0,48000,44200,3800
3/13/2021 22:08,76239878,MARLBORO GOLD,1,30000,0,30000,27700,2300
3/13/2021 22:08,8998866201841,GOLDA DOLCE LATTE 200ML,1,3000,0,3000,2500,500
3/13/2021 22:08,9556001047175,NESCAFE ORI 240ML,1,8500,0,8500,7337,1163
3/13/2021 22:10,8991002103764,GOOD DAY CPUCINO 10X25G,1,1500,0,1500,1395,105
3/13/2021 22:10,089686010824,INDOMIE GORENG SPESIAL,2,2700,0,5400,4904,496
3/13/2021 22:10,089686010343,INDOMIE SOTO MIE,2,2600,0,5200,4734,466
3/13/2021 22:10,089686011036,INDOMIE GORENG PEDAS,1,2700,0,2700,2452,248
3/13/2021 22:10,8999999059316,LIFEBOUY TS MILDCARE 75G,1,3000,0,3000,2500,500
3/13/2021 22:10,8992946511790,SHINZUI 85G,1,5000,0,5000,3475,1525
3/13/2021 22:25,8999999401238,RINSO ANTI NODA 770G,3,21200,0,63600,58014,5586
3/13/2021 22:25,8998866608725,DAIA SOFTENER BAG 850G,1,18000,0,18000,15627,2373
3/13/2021 22:35,8996001305041,ROMA SANDWICH CKLT,1,7000,0,7000,5000,2000
3/13/2021 22:41,8998866202237,NOODLE SEDAAP TASTY AYAM GEPREK 124 GR,1,5000,0,5000,4167,833
3/14/2021 0:11,089686011036,INDOMIE GORENG PEDAS,1,2700,0,2700,2452,248
3/14/2021 0:11,8998866202404,NOODLE SEDAAP MIE KOREAN SPICY CHICKEN CUP,1,5000,0,5000,3917,1083
3/14/2021 0:11,8993470671752,JOGER STICK DUO KACANG,2,1000,0,2000,1700,300
3/14/2021 0:11,8998866201827,JAVANA GULA BATU 350ML,1,3000,0,3000,2150,850
3/14/2021 11:07,8998866608558,SOKLIN SOFTERGENT 770G & PIRING,1,18000,0,18000,16055,1945
3/14/2021 11:07,8999999529291,MOLTO PURE SACHET 10ML,1,6000,0,6000,4800,1200
3/14/2021 11:07,8998866692663,SOKLIN FLOORCLENER KUNING 450ML,1,7000,0,7000,6385,615
3/14/2021 11:07,8998866608718,DAIA SOFTENER PINK,1,5000,0,5000,4450,550
3/14/2021 11:07,8999999502003,"SARIMURNI RL RB 1,8G",2,1500,0,3000,2414,586
3/14/2021 11:07,8999999195656,SARI WANGI 50X1.85,1,10000,0,10000,8700,1300
3/14/2021 11:07,GL,GULA 1 LITER,3,11500,0,34500,31500,3000
3/14/2021 11:07,8851019015132,POCKY DOUBLE CHOCOLATE 47G,1,7300,0,7300,5671,1629
3/14/2021 11:07,8851019210117,POCKY CHOCOLATE 47G,1,7300,0,7300,5671,1629
3/14/2021 11:07,8991102228053,TEH GELAS BOTOL,1,3000,0,3000,1922,1078
3/14/2021 11:07,HT,HOT-HOT,2,500,0,1000,700,300
3/14/2021 11:07,COKLAT,COKLAT COIN,1,500,0,500,400,100
3/14/2021 11:07,8998989500166,GUDANG GARAM MERAH BESAR 16KS,2,17000,0,34000,30600,3400
3/14/2021 11:07,8992761139018,ADES 600ML,1,3500,0,3500,2292,1208
3/14/2021 11:07,8995333032113,TERIGU GATOT KACA 1 KG,1,8500,0,8500,8012,488
3/14/2021 11:07,8998989300261,GUDANG GARAM SURYA 12 FILTER,1,18000,0,18000,16450,1550
3/14/2021 11:35,8992761139018,ADES 600ML,1,3500,0,3500,2292,1208
3/14/2021 11:35,8992761145033,FANTA STRAW PET 250ML,1,3500,0,3500,2417,1083
3/14/2021 13:17,8996001600146,TEH PUCUK HARUM 350ML,3,3000,0,9000,6942,2058
3/14/2021 13:26,GL,GULA 1 LITER,1,11500,0,11500,10500,1000
3/14/2021 13:26,8992759120264,LARISST 220,1,10000,0,10000,9200,800
3/14/2021 15:17,8991111112206,C&C DEEP ACTION CLEANSER 50G,1,14000,0,14000,12900,1100
3/14/2021 15:45,8993176110081,MINYAK KAYU PUTIH 30ML,1,12000,0,12000,9091,2909
3/14/2021 15:45,6907992823591,JD STRAW MILKSHAKE,1,5000,0,5000,4300,700
3/14/2021 15:45,8996001301142,ROMA KELAPA,1,8000,0,8000,6628,1372
3/14/2021 15:45,8997013790108,BIMURA KACANG TELUR 25G,2,1000,0,2000,1750,250
3/14/2021 16:28,8998866202725,MILKU COKLAT PREMIUM 200ML,1,3000,0,3000,2375,625
3/14/2021 16:28,PRG,PARAGO,4,500,0,2000,1600,400
3/14/2021 16:31,GL,GULA 1 LITER,1,11500,0,11500,10500,1000
3/14/2021 16:31,8998009020520,BUAVITA MINI GUAVA 125ML,2,6000,0,12000,10500,1500
3/14/2021 17:44,8992959971093,SFX COMFORT SLIME 6,2,8500,0,17000,15596,1404
3/14/2021 18:14,8991102281430,PERMEN MINTZ DUOMINT,1,4500,0,4500,4000,500
3/14/2021 18:14,6907992823850,JD CHOCO CIRLE,1,5500,0,5500,4700,800
3/14/2021 18:20,8995333000822,TERIGU KOMPAS SOFT 500GR,1,5500,0,5500,4967,533
3/14/2021 18:20,8998866608046,KECAP MANIS SEDAAP POUCH 225ML,1,8300,0,8300,7375,925
3/14/2021 18:43,8992959953044,SWEETY BRONZE XL1,6,2500,0,15000,13500,1500
3/14/2021 18:43,8992753102303,BKM SCT CKLT 40G,1,7500,0,7500,6900,600
3/14/2021 20:02,8998989300261,GUDANG GARAM SURYA 12 FILTER,1,18000,0,18000,16450,1550
3/14/2021 20:22,8992761145033,FANTA STRAW PET 250ML,2,3500,0,7000,4834,2166
3/14/2021 20:23,8996001600641,TORA CAPPUCINO,2,3500,0,7000,5500,1500
3/14/2021 20:23,8992761166212,FRESTEA APPLE 350ML,1,4500,0,4500,3000,1500
3/14/2021 20:23,HT,HOT-HOT,1,500,0,500,350,150
3/14/2021 20:23,8851019210193,POCKY CHOCO BANANA 47G,1,7300,0,7300,5671,1629
3/14/2021 20:35,8995333032113,TERIGU GATOT KACA 1 KG,1,8500,0,8500,8012,488
3/14/2021 20:35,8995333060772,TERIGU GATOT KACA 500GR,1,4500,0,4500,4065,435
3/14/2021 20:59,GL,GULA 1 LITER,1,11500,0,11500,10500,1000
3/14/2021 20:59,8886013213208,FRENCH FREIS 2000,2,5000,0,10000,7500,2500
3/14/2021 20:59,8992628022156,BIMOLI KLASIK TOUCH 1 LT,1,16000,0,16000,14350,1650
3/14/2021 20:59,8998009010569,ULTRA CHO 200,1,5000,0,5000,3830,1170
3/14/2021 20:59,8996001305041,ROMA SANDWICH CKLT,1,7000,0,7000,5000,2000
3/14/2021 20:59,HT,HOT-HOT,1,500,0,500,350,150
3/14/2021 21:24,8998866201452,POTABEE REGULER BBQ BEEF 35GR,1,4800,0,4800,4150,650
3/14/2021 21:51,8998866202060,POTABEE AYAM BAKAR PEDAS 35 GR,1,5000,0,5000,4150,850
3/14/2021 21:51,HT,HOT-HOT,4,500,0,2000,1400,600
3/14/2021 23:26,089686061024,POP MIE MINI SOTO RL,1,3000,0,3000,2702,298
3/14/2021 23:27,089686061079,POP MIE MINI AY BAWANG RL,1,3000,0,3000,2702,298
3/14/2021 23:27,8886057883665,KRATING DAENG,1,6000,0,6000,4286,1714
3/15/2021 9:38,8996001600399,LE MINERAL 1500ML,1,5000,0,5000,4042,958
3/15/2021 9:38,089686041705,INDOMIE GORENG JUMBO,1,3500,0,3500,3143,357
3/15/2021 9:38,089686011036,INDOMIE GORENG PEDAS,1,2700,0,2700,2452,248
3/15/2021 9:38,8851019210117,POCKY CHOCOLATE 47G,1,7300,0,7300,5671,1629
3/15/2021 9:38,8851019015132,POCKY DOUBLE CHOCOLATE 47G,1,7300,0,7300,5671,1629
3/15/2021 9:38,8998989100120,GUDANG GARAM MINI,1,18000,0,18000,16600,1400
3/15/2021 9:38,8991001503114,CHACHA MILK CHOCOLATE 35G,1,5500,0,5500,4900,600
3/15/2021 9:38,8992761139018,ADES 600ML,2,3500,0,7000,4584,2416
3/15/2021 9:38,8998866608558,SOKLIN SOFTERGENT 770G & PIRING,1,18000,0,18000,16055,1945
3/15/2021 9:38,8999999529291,MOLTO PURE SACHET 10ML,1,6000,0,6000,4800,1200
3/15/2021 9:38,8998866692663,SOKLIN FLOORCLENER KUNING 450ML,1,7000,0,7000,6385,615
3/15/2021 9:38,8998866610261,POWDET DAIA SOFTENER BAG 290 GR,1,5000,0,5000,4450,550
3/15/2021 9:38,8999999502003,"SARIMURNI RL RB 1,8G",2,1500,0,3000,2414,586
3/15/2021 9:38,GL,GULA 1 LITER,3,11500,0,34500,31500,3000
3/15/2021 9:38,8851019210193,POCKY CHOCO BANANA 47G,1,7300,0,7300,5671,1629
3/15/2021 9:38,8996001600146,TEH PUCUK HARUM 350ML,1,3000,0,3000,2314,686
3/15/2021 9:38,HT,HOT-HOT,2,500,0,1000,700,300
3/15/2021 9:38,COKLAT,COKLAT COIN,2,500,0,1000,800,200
3/15/2021 9:38,8998989500166,GUDANG GARAM MERAH BESAR 16KS,2,17000,0,34000,30600,3400
3/15/2021 9:38,76164217,MARLBORO MERAH,1,30000,0,30000,27700,2300
3/15/2021 9:38,8995333032113,TERIGU GATOT KACA 1 KG,1,8500,0,8500,8012,488
3/15/2021 9:39,8992957220117,COKLAT BERUANG,1,2000,0,2000,1700,300
3/15/2021 9:39,8996001600146,TEH PUCUK HARUM 350ML,1,3000,0,3000,2314,686
3/15/2021 10:32,GL,GULA 1 LITER,1,11500,0,11500,10500,1000
3/15/2021 11:09,8998866202619,MIE SEDAAP KOREAN SPICY SOUP,1,2500,0,2500,1952,548
3/15/2021 11:09,8998866202343,MIE SEDAAP KOREAN SPICY,1,2500,0,2500,2023,477
3/15/2021 12:01,8886030322907,PORSTEX BIRU 500ML,1,15500,0,15500,13000,2500
3/15/2021 12:01,8998866605106,CLING BIRU BTL 440ML,1,8500,0,8500,7600,900
3/15/2021 12:01,8995333000822,TERIGU KOMPAS SOFT 500GR,1,5500,0,5500,4967,533
3/15/2021 12:01,001,PASEO SMART FACIAL SF 250S GT,1,10000,0,10000,9500,500
3/15/2021 12:01,8992628022156,BIMOLI KLASIK TOUCH 1 LT,1,16000,0,16000,14350,1650
3/15/2021 13:55,8998866201964,MINYAK GORENG SABRINA 2L POUCH,1,28000,0,28000,26753,1247
3/15/2021 15:05,GL,GULA 1 LITER,2,11500,0,23000,21000,2000
3/15/2021 15:07,GL,GULA 1 LITER,1,11500,0,11500,10500,1000
3/15/2021 15:07,RT 1000,ROTI 1000,1,1000,0,1000,750,250
3/15/2021 15:16,8999999059781,SUNLIGHT LIME NEW POUCH 210ML,1,5000,0,5000,4300,700
3/15/2021 15:38,8996001600146,TEH PUCUK HARUM 350ML,1,3000,0,3000,2314,686
3/15/2021 15:38,8996001318911,BETTER ISI 4,1,2000,0,2000,1700,300
3/15/2021 16:02,BRS,BERAS BUMN 10KG,1,128000,0,128000,90000,38000
3/15/2021 16:02,GL,GULA 1 LITER,2,11500,0,23000,21000,2000
3/15/2021 16:02,8999999195649,SARI WANGI 25X1.86G,1,6000,0,6000,5050,950
3/15/2021 16:02,8992753100101,BKM FULL CREAM GOLD 370,1,15500,0,15500,14800,700
3/15/2021 16:10,6907992823874,JD CRUNCHY CHOCO BLUEBERRY,1,5500,0,5500,4700,800
3/15/2021 16:10,6907992823591,JD STRAW MILKSHAKE,2,5000,0,10000,8600,1400
3/15/2021 16:54,6907992823843,JD MOCHA CRISPY,1,5000,0,5000,4400,600
3/15/2021 17:47,8998866201841,GOLDA DOLCE LATTE 200ML,1,3000,0,3000,2500,500
3/15/2021 17:47,COKLAT,COKLAT COIN,1,500,0,500,400,100
3/15/2021 18:03,8998866501033,MINYAK GORENG SEDAAP POUCH 2L,1,29000,0,29000,27746,1254
3/15/2021 18:29,8992946511790,SHINZUI 85G,1,5000,0,5000,3475,1525
3/15/2021 18:30,8992696404441,BEAR BRAND 189ML,1,8500,0,8500,7887,613
3/15/2021 18:30,8999908204202,MY BABY MINYAK TELON 60ML,1,15000,0,15000,13545,1455
3/15/2021 18:34,8998866200325,MIE SEDAAP SOTO,2,2500,0,5000,3904,1096
3/15/2021 20:00,8998866106351,ZINC MEN ACTIVE COOL 70ML,1,8500,0,8500,7550,950
3/15/2021 20:07,6901997923072,SILET SEAGULL,1,6000,0,6000,5500,500
3/15/2021 20:07,8991004011906,KOPI BORONG,1,10000,0,10000,8333,1667
3/15/2021 20:07,ABC SPW,BATERAI ABC SPW,1,4500,0,4500,3893,607
3/15/2021 20:35,8995333032113,TERIGU GATOT KACA 1 KG,1,8500,0,8500,8012,488
3/15/2021 20:35,8995333060772,TERIGU GATOT KACA 500GR,1,4500,0,4500,4065,435
3/15/2021 20:35,8991102384841,WFR TANGO LONG CKLT 130G,1,5000,0,5000,3773,1227
3/15/2021 20:35,8998898830125,KKB ENER-G ANGGUR,1,5500,0,5500,4824,676
3/15/2021 20:35,GL,GULA 1 LITER,1,11500,0,11500,10500,1000
3/15/2021 20:54,8999999034702,PONDS MEN ACNE SOLUTION 50G,1,18500,0,18500,17160,1340
3/15/2021 20:54,8998866500708,FLORIDINA ORANGE,1,3000,0,3000,2500,500
3/15/2021 21:13,8992959072202,HN PANTS L 20,1,35000,0,35000,32576,2424
3/15/2021 21:18,GL,GULA 1 LITER,2,11500,0,23000,21000,2000
3/15/2021 21:18,8998866200578,MIE SEDAAP KARI KENTAL,2,2500,0,5000,3904,1096
3/15/2021 21:35,8998866201841,GOLDA DOLCE LATTE 200ML,1,3000,0,3000,2500,500
3/15/2021 21:35,8992761164546,NUTRIBOOST STRAWBERRY 300ML,1,6500,0,6500,5300,1200
3/15/2021 22:17,8999801700030,SUSU FOYU,1,11500,0,11500,10000,1500
3/15/2021 22:22,8998898101409,TOLAK ANGIN SIDOMUNCUL,3,3500,0,10500,8124,2376
3/15/2021 22:22,8997021870014,FRESH CARE CITRUS 10ML,1,12000,0,12000,10000,2000
3/15/2021 22:22,8992696404441,BEAR BRAND 189ML,1,8500,0,8500,7887,613
3/15/2021 22:22,8997009510055,YOU C1000,1,8000,0,8000,4846,3154
3/15/2021 22:23,8997009510055,YOU C1000,1,8000,0,8000,4846,3154
3/15/2021 22:23,8992696404441,BEAR BRAND 189ML,1,8500,0,8500,7887,613
3/15/2021 22:23,8997021870014,FRESH CARE CITRUS 10ML,1,12000,0,12000,10000,2000
3/15/2021 22:23,8998898101409,TOLAK ANGIN SIDOMUNCUL,3,3500,0,10500,8124,2376
3/15/2021 22:43,ARG,ARGUS 220ML,1,14500,0,14500,12500,2000
3/15/2021 22:43,HT,HOT-HOT,1,500,0,500,350,150
3/15/2021 22:58,8998989110167,SURYA GUDANG GARAM 16 FILTER,1,24000,0,24000,22100,1900
3/15/2021 22:58,8998989300391,SURYA PRO PUTIH,1,20000,0,20000,18600,1400
3/16/2021 10:32,8995333032113,TERIGU GATOT KACA 1 KG,1,8500,0,8500,8012,488
3/16/2021 10:32,8995333060772,TERIGU GATOT KACA 500GR,1,4500,0,4500,4065,435
3/16/2021 10:32,8999999502409,ROYCO FDS BEEF 9G,2,500,0,1000,750,250
3/16/2021 10:32,8997025914059,HATARI SEE HONG,1,5000,0,5000,4800,200
3/16/2021 10:32,8998989300261,GUDANG GARAM SURYA 12 FILTER,1,18000,0,18000,16450,1550
3/16/2021 10:32,8998866608008,KECAP MANIS SEDAAP BOTOL 135 ML,1,6300,0,6300,5615,685
3/16/2021 10:32,8995333060703,TERIGU KOMPAS 1KG,1,10500,0,10500,9816,684
3/16/2021 10:32,8992761166038,MMP ORANGE 300ML,1,5000,0,5000,3750,1250
3/16/2021 10:35,711844610095,LARISSA UDANG 500 GR,1,11000,0,11000,9790,1210
3/16/2021 10:52,711844610095,LARISSA UDANG 500 GR,2,11000,0,22000,19580,2420
3/16/2021 10:52,8998866201933,MINYAK GORENG SEDAAP 5 L,1,72000,0,72000,70230,1770
3/16/2021 11:05,8991188943062,SASA 250G,1,10000,0,10000,8000,2000
3/16/2021 11:05,8991002105409,KOPI KAPAL API,1,20000,0,20000,18888,1112
3/16/2021 11:05,8998989300261,GUDANG GARAM SURYA 12 FILTER,1,18000,0,18000,16450,1550
3/16/2021 11:50,6907992823676,JD PEACH,1,2000,0,2000,1700,300
3/16/2021 11:52,8999999502409,ROYCO FDS BEEF 9G,2,500,0,1000,750,250
3/16/2021 11:52,089686021141,INTER MIE SOTO,6,1000,0,6000,5124,876
3/16/2021 11:52,8998866500708,FLORIDINA ORANGE,1,3000,0,3000,2500,500
3/16/2021 11:52,8996001600146,TEH PUCUK HARUM 350ML,1,3000,0,3000,2314,686
3/16/2021 11:52,6907992823874,JD CRUNCHY CHOCO BLUEBERRY,1,5500,0,5500,4700,800
3/16/2021 12:21,8998866201841,GOLDA DOLCE LATTE 200ML,1,3000,0,3000,2500,500
3/16/2021 12:32,8993007003063,ENAAK 500G,1,11000,0,11000,9625,1375
3/16/2021 12:51,8993007003063,ENAAK 500G,1,11000,0,11000,9625,1375
3/16/2021 12:52,8998866500708,FLORIDINA ORANGE,1,3000,0,3000,2500,500
3/16/2021 12:57,8996001600375,LE MINERAL 330ML,2,2000,0,4000,2834,1166
3/16/2021 12:57,8998866500708,FLORIDINA ORANGE,1,3000,0,3000,2500,500
3/16/2021 12:57,8994834006128,TOCTIC PEDAS,2,2000,0,4000,3400,600
3/16/2021 12:57,COKLAT,COKLAT COIN,1,500,0,500,400,100
3/16/2021 14:48,GL,GULA 1 LITER,1,11500,0,11500,10500,1000
3/16/2021 14:48,RT 1000,ROTI 1000,2,1000,0,2000,1500,500
3/16/2021 15:54,089686821086,ICHI OCHA MELATI,1,3000,0,3000,2250,750
3/16/2021 15:54,8992761139018,ADES 600ML,1,3500,0,3500,2292,1208
3/16/2021 15:54,RT 1000,ROTI 1000,1,1000,0,1000,750,250
3/16/2021 15:54,8993470671752,JOGER STICK DUO KACANG,2,1000,0,2000,1700,300
3/16/2021 15:54,8997009510055,YOU C1000,1,8000,0,8000,4846,3154
3/16/2021 16:11,GL,GULA 1 LITER,4,11500,0,46000,42000,4000
3/16/2021 16:11,8998866501033,MINYAK GORENG SEDAAP POUCH 2L,1,29000,0,29000,27746,1254
3/16/2021 16:31,8992628010139,BIMOLI 5L,1,75000,0,75000,72100,2900
3/16/2021 16:34,8998866202619,MIE SEDAAP KOREAN SPICY SOUP,1,2500,0,2500,1952,548
3/16/2021 16:34,8992761145026,SPRITE PET 250ML,1,3500,0,3500,2417,1083
3/16/2021 16:47,089686834253,FREISS MELON,1,16000,0,16000,14200,1800
3/16/2021 17:38,9556040040038,SUSU F&N,1,33000,0,33000,30000,3000
3/16/2021 17:38,8992761139018,ADES 600ML,1,3500,0,3500,2292,1208
3/16/2021 17:43,8998866500135,HERSPROTEX SOFTCARE WINGS,1,5500,0,5500,4820,680
3/16/2021 17:47,8992946511790,SHINZUI 85G,1,5000,0,5000,3475,1525
3/16/2021 17:47,8992959953181,SWEETY BRONZE L30+2,1,55000,0,55000,53410,1590
3/16/2021 17:47,8998866612173,SOKLIN SOFTERGENT 770G & PIRING,1,18000,0,18000,16055,1945
3/16/2021 17:47,8998866200301,MIE SEDAAP GORENG,1,2500,0,2500,2023,477
3/16/2021 17:47,8998866202619,MIE SEDAAP KOREAN SPICY SOUP,1,2500,0,2500,1952,548
3/16/2021 17:47,8998866202343,MIE SEDAAP KOREAN SPICY,2,2500,0,5000,4046,954
3/16/2021 17:47,8992702000063,INDOMILK COKLAT 370G,1,10000,0,10000,9020,980
3/16/2021 17:47,089686400816,SAMBAL EXTRA PEDAS 135ML,1,5500,0,5500,4616,884
3/16/2021 17:47,8997009510055,YOU C1000,1,8000,0,8000,4846,3154
3/16/2021 19:05,8992696523081,MILO UHT 110ML,1,2500,0,2500,1962,538
3/16/2021 19:05,8998989500166,GUDANG GARAM MERAH BESAR 16KS,2,17000,0,34000,30600,3400
3/16/2021 19:05,8999999031602,SARI MURNI 20X1.6G,1,6000,0,6000,5400,600
3/16/2021 19:08,8998866202404,NOODLE SEDAAP MIE KOREAN SPICY CHICKEN CUP,1,5000,0,5000,3917,1083
3/16/2021 19:08,8998866200844,NOODLE SEDAAP MIE KARI SPESIAL CUP 81 GR,1,4500,0,4500,3650,850
3/16/2021 19:08,8992761139018,ADES 600ML,1,3500,0,3500,2292,1208
3/16/2021 19:43,8994867000179,ROKOK PENA MILD 16,1,14500,0,14500,13000,1500
3/16/2021 19:45,8991102987639,WFR TANGO LONG VNL 130G,1,5000,0,5000,3773,1227
3/16/2021 19:45,8996001355237,SUPER STAR,1,11000,0,11000,9900,1100
3/16/2021 19:45,8991002103764,GOOD DAY CPUCINO 10X25G,2,1500,0,3000,2790,210
3/16/2021 19:45,SNTN,SANTAN BUBUK,2,2500,0,5000,3000,2000
3/16/2021 19:47,8999999710866,PEPSODENT 123 HERBAL 190G,1,18000,0,18000,17500,500
3/16/2021 19:47,8991102384841,WFR TANGO LONG CKLT 130G,1,5000,0,5000,3773,1227
3/16/2021 19:50,8998866613262,SUKSESMIE SOTO 111 GR,1,3500,0,3500,2770,730
3/16/2021 19:50,8992752112013,MIZONE,1,5000,0,5000,3800,1200
3/16/2021 19:50,8886013213208,FRENCH FREIS 2000,1,5000,0,5000,3750,1250
3/16/2021 19:50,6907992824963,JD MILKY CHOCOLATE,1,3000,0,3000,2600,400
3/16/2021 19:50,8992761145026,SPRITE PET 250ML,1,3500,0,3500,2417,1083
3/16/2021 19:50,8998009010590,ULTRA CHO 125,1,3000,0,3000,2428,572
3/16/2021 19:50,8993470671752,JOGER STICK DUO KACANG,2,1000,0,2000,1700,300
3/16/2021 19:50,TG,TEH GELAS,1,1000,0,1000,729,271
3/16/2021 19:50,HT,HOT-HOT,1,500,0,500,350,150
3/16/2021 19:50,COKLAT,COKLAT COIN,2,500,0,1000,800,200
3/16/2021 21:01,6907992823935,JD SWEETCORN,4,3500,0,14000,12000,2000
3/16/2021 21:06,8992959953136,SWEETY BRONZE L20,1,40000,0,40000,36770,3230
3/16/2021 21:06,8992957220117,COKLAT BERUANG,1,2000,0,2000,1700,300
3/16/2021 21:06,8992957220025,GOLDEN CITY MINI,1,3000,0,3000,2500,500
3/16/2021 21:19,6907992823904,JD CRUNCHY CHOCOLATE VAN,1,8000,0,8000,6800,1200
3/16/2021 21:19,6907992823935,JD SWEETCORN,3,3500,0,10500,9000,1500
3/16/2021 21:19,6907992825076,JD WATERMELON APPLE,1,2000,0,2000,1700,300
3/16/2021 21:19,6907992823966,JD BLUEBERRY,3,3500,0,10500,9000,1500
3/16/2021 21:57,8998866501026,MINYAK GORENG SEDAAP POUCH 1 L,1,15500,0,15500,14110,1390
3/16/2021 22:22,GL,GULA 1 LITER,2,11500,0,23000,21000,2000
3/17/2021 9:30,089686043204,INDOMIE MIE ACEH,1,2700,0,2700,2452,248
3/17/2021 9:30,8999999059323,LIFEBOUY LEMONFRESH DG 75G,1,3000,0,3000,2500,500
3/17/2021 9:30,8996001600146,TEH PUCUK HARUM 350ML,1,3000,0,3000,2314,686
3/17/2021 10:11,8992759120264,LARISST 220,5,10000,0,50000,46000,4000
3/17/2021 10:11,8999999008475,SUNLIGHT LIME NEW REF 1600ML,1,33000,0,33000,29800,3200
3/17/2021 10:11,8999999059781,SUNLIGHT LIME NEW POUCH 210ML,1,5000,0,5000,4300,700
3/17/2021 12:11,8992761145033,FANTA STRAW PET 250ML,1,3500,0,3500,2417,1083
3/17/2021 12:40,8998866500708,FLORIDINA ORANGE,1,3000,0,3000,2500,500
3/17/2021 15:30,8996001301142,ROMA KELAPA,1,8000,0,8000,6628,1372
3/17/2021 15:30,8996001312353,MALKIST KELAPA KOPYOR,1,6700,0,6700,5400,1300
3/17/2021 15:30,8996001350423,ZUPER KEJU,1,9200,0,9200,8360,840
3/17/2021 15:33,6907992823935,JD SWEETCORN,1,3500,0,3500,3000,500
3/17/2021 15:33,8996001600375,LE MINERAL 330ML,3,2000,0,6000,4251,1749
3/17/2021 15:33,8886057883665,KRATING DAENG,1,6000,0,6000,4286,1714
3/17/2021 15:33,8992388101092,NU GREEN TE HONEY 330ML,1,3500,0,3500,2854,646
3/17/2021 15:33,8998866201483,POTABEE REGULER GRILLED SEAWEED 35GR,1,5000,0,5000,4150,850
3/17/2021 15:33,8886013213208,FRENCH FREIS 2000,1,5000,0,5000,3750,1250
3/17/2021 15:33,SF TAWAR PND,SAFFANAH TAWAR PANDAN,1,9000,0,9000,9500,-500
3/17/2021 15:47,8998009040023,TEH KOTAK,3,5000,0,15000,8481,6519
3/17/2021 15:47,8997028590014,ARGUS 220ML,12,500,0,6000,3624,2376
3/17/2021 16:01,8992761147143,SPRITE WATERLYMON 425ML,1,5500,0,5500,4300,1200
3/17/2021 16:17,8998009040023,TEH KOTAK,1,5000,0,5000,2827,2173
3/17/2021 16:23,8999909096004,SAMPOERNA 16 FILTER,1,24000,0,24000,23000,1000
3/17/2021 16:23,8992761111540,FANTA STRAWBERY SLIM CAM 250ML,1,5000,0,5000,3750,1250
3/17/2021 16:23,SF BOX,SAFFANAH ROTI BOX,1,12000,0,12000,10500,1500
3/17/2021 17:34,8996001318911,BETTER ISI 4,1,2000,0,2000,1700,300
3/17/2021 18:11,SF TAWAR ORI,SAFFANAH TAWAR ORI,1,8500,0,8500,9000,-500
3/17/2021 18:11,8991102385060,TANGO WAFFLE CHOX,1,8000,0,8000,6212,1788
3/17/2021 18:44,YP,YUPI,4,250,0,1000,832,168
3/17/2021 18:44,KJ,KINDER JOY,2,2000,0,4000,3166,834
3/17/2021 18:59,GL,GULA 1 LITER,1,11500,0,11500,10500,1000
3/17/2021 18:59,8999999195649,SARI WANGI 25X1.86G,1,6000,0,6000,5050,950
3/17/2021 18:59,8996001600399,LE MINERAL 1500ML,1,5000,0,5000,4042,958
3/17/2021 20:18,8992775312469,GERY SALUT COKELAT,1,11000,0,11000,9983,1017
3/17/2021 20:18,089686017748,SARIMIE GORENG ISI 2,1,3500,0,3500,3120,380
3/17/2021 20:18,089686041705,INDOMIE GORENG JUMBO,1,3500,0,3500,3143,357
3/17/2021 20:18,089686010107,INDOMIE KALDU AYAM,1,2500,0,2500,2150,350
3/17/2021 20:41,GL,GULA 1 LITER,3,11500,0,34500,31500,3000
3/17/2021 20:41,8996001312445,MALKIST CAPPUCINO,1,6500,0,6500,5400,1100
3/17/2021 20:41,8996001600269,LE MINERAL 600ML,1,3000,0,3000,1688,1312
3/17/2021 20:41,089686010107,INDOMIE KALDU AYAM,2,2500,0,5000,4300,700
3/17/2021 20:41,089686010343,INDOMIE SOTO MIE,2,2600,0,5200,4734,466
3/17/2021 20:41,8999999195656,SARI WANGI 50X1.85,1,10000,0,10000,8700,1300
3/17/2021 21:33,8995333032113,TERIGU GATOT KACA 1 KG,1,8500,0,8500,8012,488
3/17/2021 21:33,8995333060772,TERIGU GATOT KACA 500GR,1,4500,0,4500,4065,435
3/17/2021 21:33,8999999195649,SARI WANGI 25X1.86G,1,6000,0,6000,5050,950
3/17/2021 21:33,8998866202343,MIE SEDAAP KOREAN SPICY,2,2500,0,5000,4046,954
3/17/2021 21:33,089686010824,INDOMIE GORENG SPESIAL,1,2700,0,2700,2452,248
3/17/2021 21:33,8998866108317,EMERON HJB ANTDNDF 10ML,1,5000,0,5000,4185,815
3/17/2021 21:33,8998866608718,DAIA SOFTENER PINK,1,5000,0,5000,4450,550
3/17/2021 21:33,8934868015024,REXONA DEO LOTION FREE SPIRIT 9G,2,4500,0,9000,7800,1200
3/17/2021 21:33,8997021870151,FRESH CARE STRONG 110ML,1,12000,0,12000,10000,2000
3/17/2021 21:43,SF BOX,SAFFANAH ROTI BOX,13,12000,0,156000,136500,19500
3/17/2021 21:43,ARG,ARGUS 220ML,1,14500,0,14500,12500,2000
3/17/2021 21:49,SF SOSIS,SAFFANAH ROTI SOSIS,1,6000,0,6000,5500,500
3/17/2021 22:05,8998866200882,SUKSESMIE GORENG AYAM KRMS 133GR,1,3500,0,3500,3000,500
3/17/2021 22:05,8998866613262,SUKSESMIE SOTO 111 GR,1,3500,0,3500,2770,730
3/17/2021 22:10,TG MARKISA,TEH GELAS MARKISA,1,2000,0,2000,1178,822
3/17/2021 22:10,YP,YUPI,6,250,0,1500,1248,252
3/17/2021 22:10,MARS,MARSHMELLOW,3,500,0,1500,1299,201
3/17/2021 22:12,8999999049409,REXONA MEN ICE COOL 45 ML,1,15000,0,15000,13550,1450
3/17/2021 22:12,8998866200844,NOODLE SEDAAP MIE KARI SPESIAL CUP 81 GR,1,4500,0,4500,3650,850
3/17/2021 22:12,8992775311325,GERY SNACK&SEREAL 100G,2,7000,0,14000,11784,2216
3/17/2021 22:13,JGR SHN,JOGER SHINY SACHET,4,500,0,2000,1748,252
3/17/2021 22:13,8993470671752,JOGER STICK DUO KACANG,2,1000,0,2000,1700,300
3/17/2021 22:13,COKLAT,COKLAT COIN,3,500,0,1500,1200,300
3/17/2021 22:17,6907992824963,JD MILKY CHOCOLATE,2,3000,0,6000,5200,800
3/17/2021 22:41,8991102989534,WFR TANGO LONG VNL 24G GTG,5,1000,0,5000,3360,1640
3/18/2021 9:45,8992761122331,FRESTEA APPEL 500ML,1,6500,0,6500,4708,1792
3/18/2021 9:45,089686043273,INDOMIE SAMBAL RICA,1,2700,0,2700,2452,248
3/18/2021 9:45,089686041705,INDOMIE GORENG JUMBO,1,3500,0,3500,3143,357
3/18/2021 9:56,8992628022156,BIMOLI KLASIK TOUCH 1 LT,1,16000,0,16000,14350,1650
3/18/2021 9:56,8850507000094,POLICE BONCHA,2,2000,0,4000,1600,2400
3/18/2021 9:59,8998866608459,POWDET DAIA PUTIH BAG 290GR,1,5000,0,5000,4450,550
3/18/2021 9:59,8999999558086,RINSO MOLTO FERFUME ESSENSE PWD 44G,1,1000,0,1000,805,195
3/18/2021 9:59,8998866201841,GOLDA DOLCE LATTE 200ML,1,3000,0,3000,2500,500
3/18/2021 9:59,8991002103764,GOOD DAY CPUCINO 10X25G,3,1500,0,4500,4185,315
3/18/2021 10:02,YP,YUPI,4,250,0,1000,832,168
3/18/2021 10:02,MARS,MARSHMELLOW,2,500,0,1000,866,134
3/18/2021 11:13,8999908284907,MY BABY MINYAK TELON 90ML,1,25000,0,25000,22700,2300
3/18/2021 11:30,8998866201841,GOLDA DOLCE LATTE 200ML,1,3000,0,3000,2500,500
3/18/2021 12:47,8996001600269,LE MINERAL 600ML,1,3000,0,3000,1688,1312
3/18/2021 12:47,001,PASEO SMART FACIAL SF 250S GT,1,10000,0,10000,9500,500
3/18/2021 13:07,8998989300261,GUDANG GARAM SURYA 12 FILTER,1,18000,0,18000,16450,1550
3/18/2021 13:07,SF TAWAR PND,SAFFANAH TAWAR PANDAN,1,9000,0,9000,9500,-500
3/18/2021 13:07,8998866608046,KECAP MANIS SEDAAP POUCH 225ML,1,8300,0,8300,7375,925
3/18/2021 13:07,8999908284907,MY BABY MINYAK TELON 90ML,1,25000,0,25000,22700,2300
3/18/2021 13:08,8998866201827,JAVANA GULA BATU 350ML,1,3000,0,3000,2150,850
3/18/2021 13:10,SST,SUPERSTAR,1,1000,0,1000,916,84
3/18/2021 13:10,ff,FULLO BLASTO,1,1000,0,1000,995,5
3/18/2021 13:34,8996001318430,BETTER 1000,3,1000,0,3000,2460,540
3/18/2021 13:56,8998866608718,DAIA SOFTENER PINK,1,5000,0,5000,4450,550
3/18/2021 13:56,8850507000094,POLICE BONCHA,1,2000,0,2000,800,1200
3/18/2021 13:56,MARS,MARSHMELLOW,1,500,0,500,433,67
3/18/2021 13:56,JGR SHN,JOGER SHINY SACHET,1,500,0,500,437,63
3/18/2021 14:09,8997013790108,BIMURA KACANG TELUR 25G,2,1000,0,2000,1750,250
3/18/2021 14:09,8999999524524,MOLTO EDP PINK LUXURY ROSE 800ML,1,29200,0,29200,26600,2600
3/18/2021 14:57,8996001301142,ROMA KELAPA,1,8000,0,8000,6628,1372
3/18/2021 14:57,8996001304129,SLAI OLAI STROBERI,1,12000,0,12000,9900,2100
3/18/2021 14:57,GL,GULA 1 LITER,2,11500,0,23000,21000,2000
3/18/2021 15:43,8998989300261,GUDANG GARAM SURYA 12 FILTER,1,18000,0,18000,16450,1550
3/18/2021 15:43,PRG,PARAGO,4,500,0,2000,1600,400
3/18/2021 17:43,8991102022347,SIKAT GIGI FORMULA RIPPLE,1,5000,0,5000,4583,417
3/18/2021 17:43,8997025911058,HATARI SHP KELAPA,1,5000,0,5000,4800,200
3/18/2021 17:43,8996001305041,ROMA SANDWICH CKLT,1,7000,0,7000,5000,2000
3/18/2021 18:53,YP,YUPI,4,250,0,1000,832,168
3/18/2021 19:20,8998866501033,MINYAK GORENG SEDAAP POUCH 2L,1,29000,0,29000,27746,1254
3/18/2021 19:26,8998866202619,MIE SEDAAP KOREAN SPICY SOUP,1,2500,0,2500,1952,548
3/18/2021 19:26,HT,HOT-HOT,1,500,0,500,350,150
3/18/2021 20:08,8992761145033,FANTA STRAW PET 250ML,1,3500,0,3500,2417,1083
3/18/2021 20:08,8991102022347,SIKAT GIGI FORMULA RIPPLE,1,5000,0,5000,4583,417
3/18/2021 21:20,8993989311279,CLAS MILD 12,1,17000,0,17000,15700,1300
3/18/2021 22:03,SF KEMASAN,SAFFANAH ROTI KEMASAN,1,3500,0,3500,3000,500
3/18/2021 22:03,SF SOSIS,SAFFANAH ROTI SOSIS,1,6000,0,6000,5500,500
3/18/2021 22:03,YP,YUPI,4,250,0,1000,832,168
3/19/2021 10:52,8998989110167,SURYA GUDANG GARAM 16 FILTER,1,24000,0,24000,22100,1900
3/19/2021 10:52,8999909096004,SAMPOERNA 16 FILTER,1,24000,0,24000,23000,1000
3/19/2021 10:52,8999999192150,ROYCO FDS CHICKEN 100GR,1,5000,0,5000,4300,700
3/19/2021 10:52,8998866202299,KECAP MANIS SEDAAP SPC REFILL 220ML,1,9500,0,9500,8500,1000
3/19/2021 10:57,8995333032113,TERIGU GATOT KACA 1 KG,1,8500,0,8500,8012,488
3/19/2021 10:57,8995333060772,TERIGU GATOT KACA 500GR,1,4500,0,4500,4065,435
3/19/2021 10:57,8997012321204,MAXX BUMBU BALADO,1,5000,0,5000,4100,900
3/19/2021 10:57,8999999502409,ROYCO FDS BEEF 9G,2,500,0,1000,750,250
3/19/2021 10:57,RT 1000,ROTI 1000,1,1000,0,1000,750,250
3/19/2021 10:57,8996001355237,SUPER STAR,1,11000,0,11000,9900,1100
3/19/2021 10:57,8991102380805,FULLO  CKL PCK 8G,1,10000,0,10000,9000,1000
3/19/2021 10:57,COKLAT,COKLAT COIN,8,500,0,4000,3200,800
3/19/2021 10:57,JGR SHN,JOGER SHINY SACHET,8,500,0,4000,3496,504
3/19/2021 10:57,SNTN,SANTAN BUBUK,1,2500,0,2500,1500,1000
3/19/2021 11:11,6907992823959,JD HAWTHORN BERRY,1,2000,0,2000,1700,300
3/19/2021 11:11,6907992823966,JD BLUEBERRY,1,3500,0,3500,3000,500
3/19/2021 11:11,089686021219,INTER MIE GORENG,1,1000,0,1000,885,115
3/19/2021 11:11,8998866202244,EKOMIE BUMBU KALDU AYAM,1,1000,0,1000,860,140
3/19/2021 12:24,8994834005923,SPIX 1000,1,1000,0,1000,850,150
3/19/2021 12:24,8991002103764,GOOD DAY CPUCINO 10X25G,1,1500,0,1500,1395,105
3/19/2021 12:24,6907992825076,JD WATERMELON APPLE,1,2000,0,2000,1700,300
3/19/2021 12:24,8993379200886,SABUN HARMONY ORANGE 70G,1,2000,0,2000,1652,348
3/19/2021 13:12,8992761145026,SPRITE PET 250ML,1,3500,0,3500,2417,1083
3/19/2021 13:12,8994834003752,TICTIC,1,2000,0,2000,1700,300
3/19/2021 13:35,SS,SUPER SNAPS,1,1500,0,1500,1333,167
3/19/2021 13:35,PRG,PARAGO,1,500,0,500,400,100
3/19/2021 13:42,8994867007161,ROKOK PENA GOLD 20,1,17000,0,17000,15000,2000
3/19/2021 13:42,8998866609043,DAIA SOFTENER GUSSET 565G,1,10000,0,10000,8700,1300
3/19/2021 14:07,8992959953167,SWEETY BRONZE S36,1,48000,0,48000,45682,2318
3/19/2021 14:07,SF SOSIS,SAFFANAH ROTI SOSIS,1,6000,0,6000,5500,500
3/19/2021 14:38,8992775310212,GERY PASTA COKELAT,1,18000,0,18000,16029,1971
3/19/2021 14:50,GL,GULA 1 LITER,1,11500,0,11500,10500,1000
3/19/2021 16:17,8999909982000,SAMPOERNA 12 FILTER,1,18000,0,18000,16200,1800
3/19/2021 16:17,8992761145033,FANTA STRAW PET 250ML,3,3500,0,10500,7251,3249
3/19/2021 16:56,089686010824,INDOMIE GORENG SPESIAL,1,2700,0,2700,2452,248
3/19/2021 16:56,8992696405417,DNCO  SHC 27G,4,3000,0,12000,10588,1412
3/19/2021 16:56,8997025914059,HATARI SEE HONG,1,5000,0,5000,4800,200
3/19/2021 16:56,8992696523081,MILO UHT 110ML,2,2500,0,5000,3924,1076
3/19/2021 16:56,8994834003752,TICTIC,1,2000,0,2000,1700,300
3/19/2021 16:56,8996001305041,ROMA SANDWICH CKLT,1,7000,0,7000,5000,2000
3/19/2021 16:58,8997013790108,BIMURA KACANG TELUR 25G,3,1000,0,3000,2625,375
3/19/2021 16:58,8994834005923,SPIX 1000,2,1000,0,2000,1700,300
3/19/2021 17:06,8998866200882,SUKSESMIE GORENG AYAM KRMS 133GR,3,3500,0,10500,9000,1500
3/19/2021 17:23,8998866602273,HERSPROTEX SOFTCARE MAX,1,3500,0,3500,2950,550
3/19/2021 17:29,8992761147143,SPRITE WATERLYMON 425ML,1,5500,0,5500,4300,1200
3/19/2021 17:29,6907992823904,JD CRUNCHY CHOCOLATE VAN,3,8000,0,24000,20400,3600
3/19/2021 17:29,8998866201483,POTABEE REGULER GRILLED SEAWEED 35GR,1,5000,0,5000,4150,850
3/19/2021 17:29,8998866200813,NOODLE SEDAAP MIE GORENG CUP 85 GR,1,5000,0,5000,3917,1083
3/19/2021 17:29,8998866202664,POTABEE WAGYU BEEF STEAK 68 GR,1,8000,0,8000,7200,800
3/19/2021 17:29,SF TAWAR PND,SAFFANAH TAWAR PANDAN,1,9000,0,9000,9500,-500
3/19/2021 17:29,8998866202312,NOODLE SEDAAP TASTY BAKMI AYAM 129 GR,1,5000,0,5000,4167,833
3/19/2021 17:33,8996001350829,WAFELLO COKLAT,2,17000,0,34000,32000,2000
3/19/2021 17:33,8996001351888,WFR WAFELLO,1,17000,0,17000,15500,1500
3/19/2021 17:33,8998866202237,NOODLE SEDAAP TASTY AYAM GEPREK 124 GR,1,5000,0,5000,4167,833
3/19/2021 17:33,8991102160711,COOKIEZ,1,16000,0,16000,14500,1500
3/19/2021 17:33,8992775001820,CHOCOLATOS WAFER CREAM,1,17500,0,17500,15761,1739
3/19/2021 17:33,8991102308861,FULLO BLASTO,1,16000,0,16000,14545,1455
3/19/2021 17:37,8993470671752,JOGER STICK DUO KACANG,1,28000,0,28000,25500,2500
3/19/2021 17:37,JGRP,JOGER PASTA STICK MOBIL,2,13000,0,26000,23500,2500
3/19/2021 18:07,8994834005923,SPIX 1000,2,1000,0,2000,1700,300
3/19/2021 18:07,8998866500708,FLORIDINA ORANGE,1,3000,0,3000,2500,500
3/19/2021 18:07,8991001121615,SILVERQUEEN NUT,1,15000,0,15000,13200,1800
3/19/2021 18:23,SKT,SIKAT CUCI,1,6000,0,6000,5000,1000
3/19/2021 18:23,8997013790108,BIMURA KACANG TELUR 25G,1,1000,0,1000,875,125
3/19/2021 19:21,8999801700030,SUSU FOYU,1,11500,0,11500,10000,1500
3/19/2021 19:53,8999909982000,SAMPOERNA 12 FILTER,1,18000,0,18000,16200,1800
3/19/2021 19:53,8999999001124,LIFEBUOY MILD CARE REF 250ML,1,15000,0,15000,13550,1450
3/19/2021 19:55,8999908204202,MY BABY MINYAK TELON 60ML,1,15000,0,15000,13545,1455
3/19/2021 19:55,8992959953174,SWEETY BRONZE M34+2,1,58000,0,58000,53182,4818
3/19/2021 19:55,8850007090267,JB BATH MILK 400ML (REFILL),1,24500,0,24500,23390,1110
3/19/2021 19:55,8994834003752,TICTIC,1,2000,0,2000,1700,300
3/19/2021 19:55,8999099920714,SGM 1+ VANILA 900,1,80000,0,80000,78510,1490
3/19/2021 20:08,8991102385060,TANGO WAFFLE CHOX,1,8000,0,8000,6212,1788
3/19/2021 20:08,089686400427,SAMBAL PEDAS 135ML,1,5500,0,5500,4616,884
3/19/2021 20:08,8992959117613,SFX DAUN SIRIH WING 1,3,5000,0,15000,12390,2610
3/19/2021 20:08,8996001301142,ROMA KELAPA,1,8000,0,8000,6628,1372
3/19/2021 20:08,8998866200882,SUKSESMIE GORENG AYAM KRMS 133GR,1,3500,0,3500,3000,500
3/19/2021 20:08,8998866202619,MIE SEDAAP KOREAN SPICY SOUP,1,2500,0,2500,1952,548
3/19/2021 20:08,8998866200325,MIE SEDAAP SOTO,1,2500,0,2500,1952,548
3/19/2021 20:08,8999999048280,SUNSILK SHP RFR ANTI DDRF 9 ML,2,1000,0,2000,18600,-16600
3/19/2021 20:08,8991111111964,C&C FACIAL WASH 50ML,1,12000,0,12000,10870,1130
3/19/2021 20:36,GL,GULA 1 LITER,3,11500,0,34500,31500,3000
3/19/2021 20:50,8998866501026,MINYAK GORENG SEDAAP POUCH 1 L,1,15500,0,15500,14110,1390
3/19/2021 20:50,8992628605151,AMANDA MARGARINE,1,5000,0,5000,3806,1194
3/19/2021 20:50,8995333060772,TERIGU GATOT KACA 500GR,1,4500,0,4500,4065,435
3/19/2021 20:50,8995333032113,TERIGU GATOT KACA 1 KG,1,8500,0,8500,8012,488
3/19/2021 20:52,8992753100101,BKM FULL CREAM GOLD 370,1,15500,0,15500,14800,700
3/19/2021 20:52,8992957220186,COKLAT RUSA,1,2000,0,2000,1700,300
3/19/2021 21:22,8999999195656,SARI WANGI 50X1.85,4,10000,0,40000,34800,5200
3/19/2021 21:22,8999999710873,PEPSODENT ACTION123 HERBAL 120G,4,11400,0,45600,41600,4000
3/19/2021 21:22,8999999059316,LIFEBOUY TS MILDCARE 75G,8,3000,0,24000,20000,4000
3/19/2021 21:22,8999999059309,LIFEBOUY TS TOTAL 10 DG 75G,8,3000,0,24000,20000,4000
3/19/2021 21:22,8999999518998,RINSO MOLTO PERFUME ESSENSE 770GR,4,21300,0,85200,77352,7848
3/19/2021 21:22,8996001301142,ROMA KELAPA,6,8000,0,48000,39768,8232
3/19/2021 21:22,8996001305249,ROMA KELAPA CREAM,2,6800,0,13600,11028,2572
3/19/2021 21:22,8992702000018,INDOMILK 370G,4,10000,0,40000,36080,3920
3/19/2021 21:22,8992753101207,BENDERA KENTAL MANIS 370G,8,11500,0,92000,77600,14400
3/19/2021 21:22,GL,GULA 1 LITER,40,11500,0,460000,420000,40000
3/19/2021 21:22,8998866501026,MINYAK GORENG SEDAAP POUCH 1 L,20,15500,0,310000,282200,27800
3/19/2021 21:22,089686010107,INDOMIE KALDU AYAM,320,2500,0,800000,688000,112000
3/19/2021 21:22,8991102384841,WFR TANGO LONG CKLT 130G,2,5000,0,10000,7546,2454
3/19/2021 21:22,8991102987639,WFR TANGO LONG VNL 130G,1,5000,0,5000,3773,1227
3/19/2021 21:22,8997013790108,BIMURA KACANG TELUR 25G,2,1000,0,2000,1750,250
3/19/2021 21:26,8998866501033,MINYAK GORENG SEDAAP POUCH 2L,1,29000,0,29000,27746,1254
3/19/2021 22:14,SF TAWAR ORI,SAFFANAH TAWAR ORI,2,9000,0,18000,17000,1000
3/19/2021 22:18,8991111101507,JB POWDER BLOSSOM 50G,1,3500,0,3500,3000,500
3/19/2021 22:18,8991004011906,KOPI BORONG,1,10000,0,10000,8333,1667
3/19/2021 22:18,8999999059934,PONDS AGE MIRACLE NIGHT CREAM 10G,1,32000,0,32000,29040,2960
3/19/2021 22:19,8850507001176,HERO RACING,1,12000,0,12000,10600,1400
3/19/2021 22:58,8998989300261,GUDANG GARAM SURYA 12 FILTER,1,18000,0,18000,16450,1550
3/19/2021 23:01,8991102228053,TEH GELAS BOTOL,1,3000,0,3000,1922,1078
3/19/2021 23:01,8994834005923,SPIX 1000,1,1000,0,1000,850,150
3/19/2021 23:01,8886013213208,FRENCH FREIS 2000,1,5000,0,5000,3750,1250
3/19/2021 23:08,8999999519735,PEPSODENT TB BAMBOO SALT,1,13200,0,13200,11990,1210
3/19/2021 23:08,8999999534769,PEPSODENT ACTION123 CHARCOAL 160G,1,16800,0,16800,15345,1455
3/19/2021 23:08,8999999053048,PONDS FACIAL FOAM 100G,1,27000,0,27000,24900,2100
3/19/2021 23:08,8999999559861,AXE DARK POCKET FRAG 17ML,1,10000,0,10000,8000,2000
3/19/2021 23:08,8999999549312,VASELINE SUPERFOOD GREEN TEA 200ML,1,26000,0,26000,23940,2060
3/19/2021 23:08,8999999049669,REXONA MEN RO INVISIBLE DRY 45 ML,1,15000,0,15000,13550,1450
3/19/2021 23:08,8992222054973,GATSBY STYLING POMADE 30GR,1,15000,0,15000,13000,2000
3/19/2021 23:08,8999999567576,LIFEBUOY HAND SANITIZER 100ML,1,19000,0,19000,17600,1400
3/19/2021 23:12,8998866106481,POSH WHISES 150ML,1,19500,0,19500,17500,2000
3/19/2021 23:12,8999999707835,CLOSEUP GREEN 65G,1,7000,0,7000,6000,1000
3/19/2021 23:12,8850007652564,C&C NATURAL BRIGHT 50ML,1,14000,0,14000,12900,1100
3/19/2021 23:12,8999999037765,PEPSODENT WHITE 225G,1,12000,0,12000,10750,1250
3/19/2021 23:12,8999999549305,VASELINE SUPERFOOD CRANBERRY 200ML,1,26000,0,26000,23940,2060
3/19/2021 23:12,4800888141125,AXE DEO BODYSPRAY DARK 150ML,1,20000,0,20000,10615,9385
3/19/2021 23:39,8992761145033,FANTA STRAW PET 250ML,1,3500,0,3500,2417,1083
3/19/2021 23:39,089686017748,SARIMIE GORENG ISI 2,1,3500,0,3500,3120,380
3/19/2021 23:53,8998989300261,GUDANG GARAM SURYA 12 FILTER,1,18000,0,18000,16450,1550
3/19/2021 23:53,8994834005923,SPIX 1000,8,1000,0,8000,6800,1200
3/22/2021 9:55,8998009010569,ULTRA CHO 200,1,5000,0,5000,3830,1170
3/22/2021 9:55,8991001780140,TWISTER CHOCO,1,5000,0,5000,4600,400
3/22/2021 9:55,8996001302323,MALKIST ABON,1,6500,0,6500,4800,1700
3/22/2021 9:55,8998866202237,NOODLE SEDAAP TASTY AYAM GEPREK 124 GR,1,5000,0,5000,4167,833
3/22/2021 9:55,8992775211410,PILUS GARUDA PEDAS,1,5500,0,5500,4713,787
3/22/2021 9:55,8997013790108,BIMURA KACANG TELUR 25G,1,1000,0,1000,875,125
3/22/2021 9:55,089686061024,POP MIE MINI SOTO RL,2,3000,0,6000,5404,596
3/22/2021 9:55,8998866202404,NOODLE SEDAAP MIE KOREAN SPICY CHICKEN CUP,1,5000,0,5000,3917,1083
3/22/2021 9:55,8992696404441,BEAR BRAND 189ML,2,8500,0,17000,15774,1226
3/22/2021 9:55,ff,FULLO BLASTO,6,1000,0,6000,5970,30
3/22/2021 9:55,8993470279651,JOGER CHOCKY BAR,1,1000,0,1000,867,133
3/22/2021 9:55,8994834005923,SPIX 1000,1,1000,0,1000,850,150
3/22/2021 9:55,089686011494,INDOMIE SOTO PADANG,2,2600,0,5200,4634,566
3/22/2021 9:55,089686010343,INDOMIE SOTO MIE,2,2600,0,5200,4734,466
3/22/2021 9:55,GL,GULA 1 LITER,2,11500,0,23000,21000,2000
3/22/2021 9:59,6907992825076,JD WATERMELON APPLE,1,2000,0,2000,1700,300
3/22/2021 9:59,8992775310212,GERY PASTA COKELAT,1,18000,0,18000,16029,1971
3/22/2021 9:59,8997013790108,BIMURA KACANG TELUR 25G,1,1000,0,1000,875,125
3/22/2021 9:59,8996001318430,BETTER 1000,1,1000,0,1000,820,180
3/22/2021 9:59,089686010107,INDOMIE KALDU AYAM,1,2500,0,2500,2150,350
3/22/2021 9:59,8998989100120,GUDANG GARAM MINI,1,18000,0,18000,16600,1400
3/22/2021 9:59,8996001600399,LE MINERAL 1500ML,1,5000,0,5000,4042,958
3/22/2021 10:05,PRG,PARAGO,1,500,0,500,400,100
3/22/2021 10:05,8999999559854,AXE BLACK POCKET FRAG 17ML,1,10000,0,10000,8000,2000
3/22/2021 10:05,8992775712603,MYTEA POCI OOLONG,1,5000,0,5000,4410,590
3/22/2021 10:05,8998989110167,SURYA GUDANG GARAM 16 FILTER,3,24000,0,72000,66300,5700
3/22/2021 10:05,SF SOSIS,SAFFANAH ROTI SOSIS,5,6000,0,30000,27500,2500
3/22/2021 10:05,8992761164546,NUTRIBOOST STRAWBERRY 300ML,2,6500,0,13000,10600,2400
3/22/2021 10:06,8998866201841,GOLDA DOLCE LATTE 200ML,1,3000,0,3000,2500,500
3/22/2021 10:06,bb,BENG-BENG,1,1500,0,1500,1450,50
3/22/2021 10:06,PRG,PARAGO,1,500,0,500,400,100
3/22/2021 10:08,8996001302323,MALKIST ABON,1,6500,0,6500,4800,1700
3/22/2021 10:08,8995333032113,TERIGU GATOT KACA 1 KG,1,8500,0,8500,8012,488
3/22/2021 10:08,8994867007161,ROKOK PENA GOLD 20,1,17000,0,17000,15000,2000
3/22/2021 10:08,8992959971109,SFX COMFORT SLIM 36CM 12+1,1,16500,0,16500,15152,1348
3/22/2021 10:08,8997009510055,YOU C1000,1,8000,0,8000,4846,3154
3/22/2021 10:08,RT 1000,ROTI 1000,1,1000,0,1000,750,250
3/22/2021 10:08,8998009010590,ULTRA CHO 125,3,3000,0,9000,7284,1716
3/22/2021 10:12,8999999059316,LIFEBOUY TS MILDCARE 75G,1,3000,0,3000,2500,500
3/22/2021 10:31,8996001600399,LE MINERAL 1500ML,2,5000,0,10000,8084,1916
3/22/2021 10:58,8997218380074,ICHITAN MILK TEA,1,8000,0,8000,6583,1417
3/22/2021 10:58,8997218380135,ICHITAN GREEN TEA,2,8000,0,16000,13166,2834
3/22/2021 10:58,8992775305164,MALKIST GREEN TEA,1,6500,0,6500,5500,1000
3/22/2021 10:58,TBM,NESTA TBM,1,5000,0,5000,4000,1000
3/22/2021 14:06,8994834005923,SPIX 1000,1,1000,0,1000,850,150
3/22/2021 14:06,GL,GULA 1 LITER,1,11500,0,11500,10500,1000
3/22/2021 14:06,YP,YUPI,4,250,0,1000,832,168
3/22/2021 14:19,8998989300261,GUDANG GARAM SURYA 12 FILTER,1,18000,0,18000,16450,1550
3/22/2021 15:07,8992222052979,GATSBY WATER GLOSS MERAH,1,5000,0,5000,3700,1300
3/22/2021 15:53,ff,FULLO BLASTO,3,1000,0,3000,2985,15
3/22/2021 15:53,8998989500166,GUDANG GARAM MERAH BESAR 16KS,1,17000,0,17000,15300,1700
3/22/2021 15:53,8998989300261,GUDANG GARAM SURYA 12 FILTER,1,18000,0,18000,16450,1550
3/22/2021 16:17,8992761145026,SPRITE PET 250ML,1,3500,0,3500,2417,1083
3/22/2021 16:17,COKLAT,COKLAT COIN,3,500,0,1500,1200,300
3/22/2021 16:39,089686043273,INDOMIE SAMBAL RICA,1,2700,0,2700,2452,248
3/22/2021 17:28,8999999059316,LIFEBOUY TS MILDCARE 75G,1,3000,0,3000,2500,500
3/22/2021 17:35,8998866201964,MINYAK GORENG SABRINA 2L POUCH,1,28000,0,28000,26753,1247
3/22/2021 17:35,8995333060703,TERIGU KOMPAS 1KG,1,10500,0,10500,9816,684
3/22/2021 17:44,8998989110167,SURYA GUDANG GARAM 16 FILTER,1,24000,0,24000,22100,1900
3/22/2021 17:44,8996001301579,MALKIST CKLT KELAPA PACK,1,11000,0,11000,9900,1100
3/22/2021 17:44,8992761145026,SPRITE PET 250ML,2,3500,0,7000,4834,2166
3/22/2021 17:44,RT 1000,ROTI 1000,2,1000,0,2000,1500,500
3/22/2021 18:18,8999999520892,FAIR&LOVELY POWDER CREAM 20 G,1,18500,0,18500,16830,1670
3/22/2021 18:18,089686010343,INDOMIE SOTO MIE,1,2600,0,2600,2367,233
3/22/2021 18:24,089686017748,SARIMIE GORENG ISI 2,1,3500,0,3500,3120,380
3/22/2021 18:34,GL,GULA 1 LITER,1,11500,0,11500,10500,1000
3/22/2021 18:34,089686011036,INDOMIE GORENG PEDAS,2,2700,0,5400,4904,496
3/22/2021 18:38,GL,GULA 1 LITER,1,11500,0,11500,10500,1000
3/22/2021 18:38,089686043051,INDOMIE COTO MAKASSAR,1,2800,0,2800,2525,275
3/22/2021 18:48,MG,MINYAK GOSOK SAFERTABAT,1,28000,0,28000,25000,3000
3/22/2021 19:43,GL,GULA 1 LITER,2,11500,0,23000,21000,2000
3/22/2021 20:24,ff,FULLO BLASTO,3,1000,0,3000,2985,15
3/22/2021 20:24,8998866605816,SOKLIN  SMART COLOR CARE 800 & PIRING,1,20000,0,20000,18100,1900
3/22/2021 20:24,SF TAWAR ORI,SAFFANAH TAWAR ORI,1,9000,0,9000,8500,500
3/22/2021 20:26,8992753102204,BKM COKLAT 370G,1,11300,0,11300,9500,1800
3/22/2021 20:44,8994867007161,ROKOK PENA GOLD 20,1,17000,0,17000,15000,2000
3/22/2021 21:36,8994834005923,SPIX 1000,1,1000,0,1000,850,150
3/22/2021 21:36,POTO,KERUPUK PANJANG,1,5000,0,5000,4000,1000
3/22/2021 22:34,6907992823607,JD CHOCO CAPTAIN,1,5500,0,5500,4700,800
3/22/2021 22:34,8994834006128,TICTIC PEDAS,1,2000,0,2000,1700,300
3/22/2021 22:35,8998989110167,SURYA GUDANG GARAM 16 FILTER,1,24000,0,24000,22100,1900
3/22/2021 22:36,089686043273,INDOMIE SAMBAL RICA,1,2700,0,2700,2452,248
3/22/2021 22:36,8998866202343,MIE SEDAAP KOREAN SPICY,1,2500,0,2500,2023,477
3/22/2021 22:36,8998866200301,MIE SEDAAP GORENG,1,2500,0,2500,2023,477
3/23/2021 10:13,8998009010231,ULTRA CHO 250,1,6000,0,6000,4784,1216
3/23/2021 10:13,SF KEMASAN,SAFFANAH ROTI KEMASAN,2,3500,0,7000,6000,1000
3/23/2021 12:13,8994867000162,ROKOK PUNDIMAS KRETEK16,1,10000,0,10000,8600,1400
3/23/2021 12:37,8996001600269,LE MINERAL 600ML,1,3000,0,3000,1688,1312
3/23/2021 12:52,8998866602273,HERSPROTEX SOFTCARE MAX,1,3500,0,3500,2950,550
3/23/2021 12:56,8998989300261,GUDANG GARAM SURYA 12 FILTER,1,18000,0,18000,16450,1550
3/23/2021 12:56,123124,KOREK BIASA,1,2000,0,2000,1800,200
3/23/2021 13:10,711844610095,LARISSA UDANG 500 GR,2,11000,0,22000,19580,2420
3/23/2021 13:28,8999999538446,SUNSILK SHP BLKSHINE 55 ML3750,1,4500,0,4500,3750,750
3/23/2021 13:28,8998866106542,EMERON LOVELY NAT PINK 200ML,1,6000,0,6000,5075,925
3/23/2021 14:56,MARS,MARSHMELLOW,1,500,0,500,433,67
3/23/2021 14:56,SF BOX,SAFFANAH ROTI BOX,1,12000,0,12000,10500,1500
3/23/2021 15:14,8999999050009,SUNLIGHT LIME NEW POUCH 95ML,1,2000,0,2000,1600,400
3/23/2021 15:25,8991004011906,KOPI BORONG,1,10000,0,10000,8333,1667
3/23/2021 15:25,8999999195656,SARI WANGI 50X1.85,1,10000,0,10000,8700,1300
3/23/2021 15:25,8994834005923,SPIX 1000,3,1000,0,3000,2550,450
3/23/2021 15:25,8999999557447,PEPSODENT ACTION123 SIWAK 110G,1,9000,0,9000,8000,1000
3/23/2021 15:25,8999999502409,ROYCO FDS BEEF 9G,6,500,0,3000,2250,750
3/23/2021 15:31,089686021141,INTER MIE SOTO,1,1000,0,1000,854,146
3/23/2021 15:55,MARS,MARSHMELLOW,2,500,0,1000,866,134
3/23/2021 15:59,8998866500708,FLORIDINA ORANGE,1,3000,0,3000,2500,500
3/23/2021 16:00,089686041705,INDOMIE GORENG JUMBO,1,3500,0,3500,3143,357
3/23/2021 16:00,8996001305041,ROMA SANDWICH CKLT,1,7000,0,7000,5000,2000
3/23/2021 16:25,MARS,MARSHMELLOW,4,500,0,2000,1732,268
3/23/2021 16:26,GL,GULA 1 LITER,3,11500,0,34500,31500,3000
3/23/2021 16:39,8997013790108,BIMURA KACANG TELUR 25G,10,1000,0,10000,8750,1250
3/23/2021 16:39,8992775001042,PILUS GARUDA MI GORENG,1,5500,0,5500,4713,787
3/23/2021 16:39,8992775211410,PILUS GARUDA PEDAS,1,5500,0,5500,4713,787
3/23/2021 16:39,KR,KRESEK,10,100,0,1000,990,10
3/23/2021 16:40,8996001600269,LE MINERAL 600ML,1,3000,0,3000,1688,1312
3/23/2021 16:40,8992761166205,FRESTEA GREEN HONEY 350ML,2,4500,0,9000,6000,3000
3/23/2021 16:42,8991102281416,PERMEN MINTZ PPMINT,1,4500,0,4500,4000,500
3/23/2021 16:42,8996001600269,LE MINERAL 600ML,1,3000,0,3000,1688,1312
3/23/2021 16:42,HT,HOT-HOT,1,500,0,500,350,150
3/23/2021 17:39,8999999559861,AXE DARK POCKET FRAG 17ML,1,10000,0,10000,8000,2000
3/23/2021 17:43,8998989110167,SURYA GUDANG GARAM 16 FILTER,1,24000,0,24000,22100,1900
3/23/2021 17:43,8998866202244,EKOMIE BUMBU KALDU AYAM,1,1000,0,1000,860,140
3/23/2021 17:43,8998866201841,GOLDA DOLCE LATTE 200ML,1,3000,0,3000,2500,500
3/23/2021 17:45,8994834006128,TICTIC PEDAS,1,2000,0,2000,1700,300
3/23/2021 17:45,8999999027049,LIFEBUOY PRWTN RMBT RNTK 9ML,2,1000,0,2000,9000,-7000
3/23/2021 17:45,8992959304235,SFX COMFORT SLIM 29CM 8S,1,8000,0,8000,7387,613
3/23/2021 17:46,8998898337440,TOLAK ANGIN CARE 10ML,1,10000,0,10000,7893,2107
3/23/2021 17:51,8998866202244,EKOMIE BUMBU KALDU AYAM,3,1000,0,3000,2580,420
3/23/2021 18:40,8999999531485,MOLTO EDP PINK ROSE SC 10ML,1,5500,0,5500,4800,700
3/23/2021 18:40,8992696404441,BEAR BRAND 189ML,1,8500,0,8500,7887,613
3/23/2021 18:40,8997009510055,YOU C1000,1,8000,0,8000,4846,3154
3/23/2021 18:40,6907992823652,JD CHOCOLATE MILKSHAKE,1,6000,0,6000,5200,800
3/23/2021 18:40,8998866200301,MIE SEDAAP GORENG,1,2500,0,2500,2023,477
3/23/2021 19:08,8997013790108,BIMURA KACANG TELUR 25G,1,1000,0,1000,875,125
3/23/2021 19:08,8997013790092,BIMURA KERUPUK BAWANG 25G,1,1000,0,1000,874,126
3/23/2021 19:08,8998989300261,GUDANG GARAM SURYA 12 FILTER,1,18000,0,18000,16450,1550
3/23/2021 19:55,8992775310212,GERY PASTA COKELAT,1,18000,0,18000,16029,1971
3/23/2021 19:59,8999909096004,SAMPOERNA 16 FILTER,1,24000,0,24000,23000,1000
3/23/2021 22:33,8998989300261,GUDANG GARAM SURYA 12 FILTER,1,18000,0,18000,16450,1550
3/24/2021 10:06,8999999549480,SUNLIGHT LIME CRM SCH 270G,1,5000,0,5000,4500,500
3/24/2021 10:06,8999999027261,LIFEBUOY BW LEMONFRESH LD REFF 450 ML,1,25000,0,25000,22110,2890
3/24/2021 10:06,8991001503114,CHACHA MILK CHOCOLATE 35G,1,5500,0,5500,4900,600
3/24/2021 10:06,8998866202244,EKOMIE BUMBU KALDU AYAM,3,1000,0,3000,2580,420
3/24/2021 10:06,SF TAWAR ORI,SAFFANAH TAWAR ORI,1,9000,0,9000,8500,500
3/24/2021 10:06,8992753031900,BKM SCT PUTIH 40G,1,7500,0,7500,6900,600
3/24/2021 10:06,8994834003752,TICTIC,2,2000,0,4000,3400,600
3/24/2021 10:06,YP,YUPI,4,250,0,1000,832,168
3/24/2021 10:06,8996001318430,BETTER 1000,1,1000,0,1000,820,180
3/24/2021 10:15,11,PASEO SMART FHSTD PERF 6P 12S,1,5000,0,5000,4264,736
3/24/2021 10:31,8996001600269,LE MINERAL 600ML,1,3000,0,3000,1688,1312
3/24/2021 10:54,8993072254056,MELROSE COTTON BUDS KCL,1,3000,0,3000,2450,550
3/24/2021 11:40,8998866201841,GOLDA DOLCE LATTE 200ML,2,3000,0,6000,5000,1000
3/24/2021 12:04,8996001600399,LE MINERAL 1500ML,1,5000,0,5000,4042,958
3/24/2021 12:22,8998989300261,GUDANG GARAM SURYA 12 FILTER,1,18000,0,18000,16450,1550
3/24/2021 12:22,8994867000162,ROKOK PUNDIMAS KRETEK16,1,10000,0,10000,8600,1400
3/24/2021 12:33,8998866610087,JAVANA ORIGINAL 350ML,1,3000,0,3000,2150,850
3/24/2021 12:33,8994834003752,TICTIC,1,2000,0,2000,1700,300
3/24/2021 14:24,ARG,ARGUS 220ML,3,14500,0,43500,37500,6000
3/24/2021 16:00,6907992823874,JD CRUNCHY CHOCO BLUEBERRY,1,5500,0,5500,4700,800
3/24/2021 16:00,6907992823867,JD CRUNCHY CHOCOLATE MALT,1,5500,0,5500,4700,800
3/24/2021 17:53,8996001600375,LE MINERAL 330ML,1,2000,0,2000,1417,583
3/24/2021 17:57,6907992823669,JD MILKY STRAW,1,3000,0,3000,2600,400
3/24/2021 17:57,6907992823935,JD SWEETCORN,1,3500,0,3500,3000,500
3/24/2021 17:57,8850507000094,POLICE BONCHA,1,2000,0,2000,800,1200
3/24/2021 17:57,YP,YUPI,2,250,0,500,416,84
3/24/2021 18:25,8999999528218,CITRA NATURAL WHITE BTL 220ML,1,17000,0,17000,15450,1550
3/24/2021 18:46,8992761139018,ADES 600ML,2,3500,0,7000,4584,2416
3/24/2021 18:46,089686043273,INDOMIE SAMBAL RICA,1,2700,0,2700,2452,248
3/24/2021 19:12,8999999706111,PEPSODENT WHITE 25G,1,2000,0,2000,1450,550
3/24/2021 19:12,8998866103985,CIPT SIKP,1,3000,0,3000,2552,448
3/24/2021 19:12,8999999559557,LUX BW MAGICAL ORCHID 85ML,1,5000,0,5000,4000,1000
3/24/2021 19:12,8992761166052,FRESTEA MELATI 350ML,1,4500,0,4500,3000,1500
3/24/2021 19:12,JGR SHN,JOGER SHINY SACHET,1,500,0,500,437,63
3/24/2021 20:05,8998866501033,MINYAK GORENG SEDAAP POUCH 2L,1,29000,0,29000,27746,1254
3/24/2021 20:31,8999801700030,SUSU FOYU,1,11500,0,11500,10000,1500
3/24/2021 20:41,8992959971093,SFX COMFORT SLIME 6,1,8500,0,8500,7798,702
3/24/2021 20:41,SF BOX,SAFFANAH ROTI BOX,1,12000,0,12000,10500,1500
3/24/2021 20:41,123124,KOREK BIASA,1,2000,0,2000,1800,200
3/24/2021 20:51,8999909096004,SAMPOERNA 16 FILTER,1,24000,0,24000,23000,1000
3/24/2021 20:51,123124,KOREK BIASA,1,2000,0,2000,1800,200
3/24/2021 20:52,8999999195656,SARI WANGI 50X1.85,1,10000,0,10000,8700,1300
3/24/2021 21:05,RT SUSU,ROTI SUSU,2,8000,0,16000,15000,1000
3/24/2021 21:05,RT KJ,ROTI KASUR JUMBO,2,7000,0,14000,12400,1600
3/24/2021 21:05,8851019510132,POCKY,1,7300,0,7300,7000,300
3/24/2021 21:05,8992752112013,MIZONE,1,5000,0,5000,3800,1200
3/24/2021 21:06,8998866500708,FLORIDINA ORANGE,1,3000,0,3000,2500,500
3/24/2021 21:58,8997027300089,NOMOS,1,4000,0,4000,2963,1037
3/24/2021 22:18,089686010107,INDOMIE KALDU AYAM,4,2500,0,10000,8600,1400
3/24/2021 22:18,8996001312278,MALKIST KEJU MANIS,1,6500,0,6500,5400,1100
3/24/2021 22:18,8999999037765,PEPSODENT WHITE 225G,1,12000,0,12000,10750,1250
3/24/2021 22:18,6907992823904,JD CRUNCHY CHOCOLATE VAN,1,8000,0,8000,6800,1200
3/24/2021 22:18,6907992823607,JD CHOCO CAPTAIN,1,5500,0,5500,4700,800
3/24/2021 22:18,6907992823966,JD BLUEBERRY,1,3500,0,3500,3000,500
3/25/2021 16:55,8999999001155,LIFEBUOY BW TOTAL10 300ML,1,24000,0,24000,21550,2450
3/25/2021 16:55,8999999033170,LIFEBUOY SHP  KUAT&BERKILAU 170ML,1,16500,0,16500,14950,1550
3/25/2021 16:55,089686400427,SAMBAL PEDAS 135ML,1,5500,0,5500,4616,884
3/25/2021 16:55,8999999059781,SUNLIGHT LIME NEW POUCH 210ML,1,5000,0,5000,4300,700
3/25/2021 16:55,8992779289101,KIT CHAIN LUBE,1,22000,0,22000,19900,2100
3/25/2021 16:55,8998866610070,SOKLIN SOFTERGEN 280G PURPLE,1,5000,0,5000,4425,575
3/25/2021 16:55,8996001320051,KOPIKO COFFE CANDY,1,6200,0,6200,5600,600
3/25/2021 16:55,8997025914059,HATARI SEE HONG,1,5000,0,5000,4800,200
3/25/2021 16:55,8996001305041,ROMA SANDWICH CKLT,1,7000,0,7000,5000,2000
3/25/2021 16:59,8994834006128,TICTIC PEDAS,1,2000,0,2000,1700,300
3/25/2021 16:59,8994834003752,TICTIC,1,2000,0,2000,1700,300
3/25/2021 16:59,8997218380135,ICHITAN GREEN TEA,1,8000,0,8000,6583,1417
3/25/2021 16:59,SF KEMASAN,SAFFANAH ROTI KEMASAN,1,3500,0,3500,3000,500
3/25/2021 16:59,8992759120264,LARISST 220,1,10000,0,10000,9200,800
3/25/2021 16:59,8998866200325,MIE SEDAAP SOTO,2,2500,0,5000,3904,1096
3/25/2021 16:59,YP,YUPI,2,250,0,500,416,84
3/25/2021 17:00,8999999059323,LIFEBOUY LEMONFRESH DG 75G,2,3000,0,6000,5000,1000
3/25/2021 17:00,8998008151065,MIWON 100 GR,1,3300,0,3300,2996,304
3/25/2021 17:00,8999999192150,ROYCO FDS CHICKEN 100GR,1,5000,0,5000,4300,700
3/25/2021 17:05,8997027300089,NOMOS,1,4000,0,4000,2963,1037
3/25/2021 17:05,8998989300261,GUDANG GARAM SURYA 12 FILTER,1,18000,0,18000,16450,1550
3/25/2021 17:05,8997218380074,ICHITAN MILK TEA,1,8000,0,8000,6583,1417
3/25/2021 17:05,ff,FULLO BLASTO,3,1000,0,3000,2985,15
3/25/2021 17:05,SF BOX,SAFFANAH ROTI BOX,1,12000,0,12000,10500,1500
3/25/2021 17:05,8998866201964,MINYAK GORENG SABRINA 2L POUCH,1,28000,0,28000,26753,1247
3/25/2021 17:05,8886013213208,FRENCH FREIS 2000,1,5000,0,5000,3750,1250
3/25/2021 17:05,8992761145026,SPRITE PET 250ML,1,3500,0,3500,2417,1083
3/25/2021 17:05,HT,HOT-HOT,1,500,0,500,350,150
3/25/2021 17:30,8999999195649,SARI WANGI 25X1.86G,1,6000,0,6000,5050,950
3/25/2021 17:30,8992761164546,NUTRIBOOST STRAWBERRY 300ML,1,6500,0,6500,5300,1200
3/25/2021 17:52,8997009510055,YOU C1000,1,8000,0,8000,4846,3154
3/25/2021 18:02,8998866201827,JAVANA GULA BATU 350ML,1,3000,0,3000,2150,850
3/25/2021 18:02,SST,SUPERSTAR,1,1000,0,1000,916,84
3/25/2021 21:17,8998866200301,MIE SEDAAP GORENG,2,2500,0,5000,4046,954
3/25/2021 21:17,8998866202343,MIE SEDAAP KOREAN SPICY,2,2500,0,5000,4046,954
3/25/2021 21:17,089686043273,INDOMIE SAMBAL RICA,2,2700,0,5400,4904,496
3/25/2021 21:17,8998866200882,SUKSESMIE GORENG AYAM KRMS 133GR,2,3500,0,7000,6000,1000
3/25/2021 21:17,8998009010569,ULTRA CHO 200,1,5000,0,5000,3830,1170
3/25/2021 21:17,8992761164539,NUTRIBOOST ORANGE 300ML,1,6500,0,6500,5300,1200
3/25/2021 21:17,8996001305249,ROMA KELAPA CREAM,1,6800,0,6800,5514,1286
3/25/2021 21:17,SF TAWAR PND,SAFFANAH TAWAR PANDAN,1,9000,0,9000,9500,-500
3/25/2021 21:20,8992984820717,SODA KUE,1,6000,0,6000,5000,1000
3/25/2021 21:20,8997218380135,ICHITAN GREEN TEA,1,8000,0,8000,6583,1417
3/25/2021 21:20,8991102022347,SIKAT GIGI FORMULA RIPPLE,1,5000,0,5000,4583,417
3/25/2021 21:38,8993989311279,CLAS MILD 12,1,17000,0,17000,15700,1300
3/25/2021 21:41,8999909096004,SAMPOERNA 16 FILTER,1,24000,0,24000,23000,1000
3/26/2021 10:17,8996001600269,LE MINERAL 600ML,1,3000,0,3000,1688,1312
3/26/2021 10:17,8993989311279,CLAS MILD 12,1,17000,0,17000,15700,1300
3/26/2021 10:21,8997218380135,ICHITAN GREEN TEA,1,8000,0,8000,6583,1417
3/26/2021 10:24,8991102385336,TANGO WAFFLE MILK,1,8000,0,8000,6212,1788
3/26/2021 10:24,8992775001042,PILUS GARUDA MI GORENG,1,5500,0,5500,4713,787
3/26/2021 10:24,8997013790092,BIMURA KERUPUK BAWANG 25G,1,1000,0,1000,874,126
3/26/2021 10:24,8886013213208,FRENCH FREIS 2000,1,5000,0,5000,3750,1250
3/26/2021 10:24,8992696404441,BEAR BRAND 189ML,2,8500,0,17000,15774,1226
3/26/2021 10:24,8997013790108,BIMURA KACANG TELUR 25G,1,1000,0,1000,875,125
3/26/2021 10:24,8990800004563,MENTOS 40X50 BUAH IND,1,5500,0,5500,5150,350
3/26/2021 10:24,8851019510132,POCKY,1,7300,0,7300,7000,300
3/26/2021 10:24,8998866201469,POTABEE REGULER BBQ BEEF 68 GR,1,8000,0,8000,7200,800
3/26/2021 10:24,8992870311091,SALONPAS,1,6000,0,6000,4806,1194
3/26/2021 10:27,GL,GULA 1 LITER,12,11500,0,138000,126000,12000
3/26/2021 10:27,8998866501033,MINYAK GORENG SEDAAP POUCH 2L,6,29000,0,174000,166476,7524
3/26/2021 10:27,6907992823843,JD MOCHA CRISPY,1,5000,0,5000,4400,600
3/26/2021 10:27,8996001355237,SUPER STAR,1,11000,0,11000,9900,1100
3/26/2021 10:27,9556001047175,NESCAFE ORI 240ML,1,8500,0,8500,7337,1163
3/26/2021 10:27,9999,ISOLASI LAKBAN,1,8000,0,8000,6500,1500
3/26/2021 10:27,8997009510055,YOU C1000,1,8000,0,8000,4846,3154
3/26/2021 10:29,8999999195656,SARI WANGI 50X1.85,1,10000,0,10000,8700,1300
3/26/2021 10:29,8999999544409,MOLTO DETERGEN CARE PURPLE PCH 700ML,1,20500,0,20500,18570,1930
3/26/2021 10:29,8998989110167,SURYA GUDANG GARAM 16 FILTER,5,24000,0,120000,110500,9500
3/26/2021 10:35,001,PASEO SMART FACIAL SF 250S GT,2,10000,0,20000,19000,1000
3/26/2021 10:35,8992959107515,SFX NON WING 23CM 8,1,4000,0,4000,3288,712
3/26/2021 10:35,8991102989534,WFR TANGO LONG VNL 24G GTG,2,1000,0,2000,1344,656
3/26/2021 10:35,AMPLOP,AMPLOP,6,250,0,1500,840,660
3/26/2021 10:35,8991001121615,SILVERQUEEN NUT,1,15000,0,15000,13200,1800
3/26/2021 10:35,GL,GULA 1 LITER,1,11500,0,11500,10500,1000
3/26/2021 10:35,8992753631209,OMELA 370,1,9500,0,9500,8400,1100
3/26/2021 10:35,8998866610261,POWDET DAIA SOFTENER BAG 290 GR,1,5000,0,5000,4450,550
3/26/2021 10:35,8999999534097,PEPSODENT PGB FCM 75G,1,5000,0,5000,3850,1150
3/26/2021 10:35,8999999050009,SUNLIGHT LIME NEW POUCH 95ML,1,2000,0,2000,1600,400
3/26/2021 10:35,8993470279651,JOGER CHOCKY BAR,1,1000,0,1000,867,133
3/26/2021 10:37,BALON,BALON CABUTR,1,1000,0,1000,900,100
3/26/2021 11:19,8886013213208,FRENCH FREIS 2000,1,5000,0,5000,3750,1250
3/26/2021 11:32,6907992823676,JD PEACH,1,2000,0,2000,1700,300
3/26/2021 11:32,8992761111540,FANTA STRAWBERY SLIM CAM 250ML,1,5000,0,5000,3750,1250
3/26/2021 11:53,8995333000822,TERIGU KOMPAS SOFT 500GR,1,5500,0,5500,4967,533
3/26/2021 12:30,8994834003752,TICTIC,2,2000,0,4000,3400,600
3/26/2021 12:30,PRG,PARAGO,4,500,0,2000,1600,400
3/26/2021 12:30,YP,YUPI,8,250,0,2000,1664,336
3/26/2021 12:30,8850507000094,POLICE BONCHA,1,2000,0,2000,800,1200
3/26/2021 12:42,MARS,MARSHMELLOW,4,500,0,2000,1732,268
3/30/2021 11:53,8992725910417,LISTERINE FRESH BURST 100ML,1,7500,0,7500,6800,700
3/30/2021 11:53,8991111152073,LISTERINE GREEN TEA 100ML,1,8000,0,8000,7600,400
3/30/2021 11:53,8996001351888,WFR WAFELLO,1,17000,0,17000,15500,1500
3/30/2021 11:53,8991102385060,TANGO WAFFLE CHOX,2,8000,0,16000,12424,3576
3/30/2021 11:53,8992775001820,CHOCOLATOS WAFER CREAM,1,17500,0,17500,15761,1739
3/30/2021 11:53,8996001355237,SUPER STAR,1,11000,0,11000,9900,1100
3/30/2021 11:53,8991102994422,TANGO WALUT CHOCOBNN 18G,2,8200,0,16400,14544,1856
3/30/2021 11:53,8991102385121,WFR TANGO VNL 7G,1,8300,0,8300,7455,845
3/30/2021 11:53,8991102989312,WFR TANGO SBJ 7G,1,8300,0,8300,7455,845
3/30/2021 11:53,8992775311486,CHOCOLATOS DARK 16G,1,18000,0,18000,15173,2827
3/30/2021 11:53,8998866202237,NOODLE SEDAAP TASTY AYAM GEPREK 124 GR,3,5000,0,15000,12501,2499
3/30/2021 11:53,8991102218085,CANNON BALL,1,10000,0,10000,9090,910
3/30/2021 12:07,8998866200837,NOODLE SEDAAPMIE SOTO CUP 81 GR,1,4500,0,4500,3650,850
3/30/2021 12:07,HT,HOT-HOT,1,500,0,500,350,150
3/30/2021 12:07,BALON,BALON CABUTR,1,1000,0,1000,900,100
3/30/2021 12:21,711844610095,LARISSA UDANG 500 GR,1,11000,0,11000,9790,1210
3/30/2021 12:21,ARG,ARGUS 220ML,2,14500,0,29000,25000,4000
3/30/2021 12:37,8998866202237,NOODLE SEDAAP TASTY AYAM GEPREK 124 GR,1,5000,0,5000,4167,833
3/30/2021 12:37,8998866202312,NOODLE SEDAAP TASTY BAKMI AYAM 129 GR,2,5000,0,10000,8334,1666
3/31/2021 12:16,8998866602570,NUVO FAMILY KUNING 76G,1,2000,0,2000,1820,180
3/31/2021 12:16,8993379241858,SABUN HARMONY LEMON 70G,1,2000,0,2000,1652,348
3/31/2021 12:16,8993379200879,SABUN HARMONY MELON 70G,1,2000,0,2000,1652,348
3/31/2021 12:16,8998866602563,NUVO FAMILY HIJAU 76G,1,2000,0,2000,1820,180
3/31/2021 12:16,SOSIS,SO NICE SAPI,3,1000,0,3000,2820,180
3/31/2021 12:29,8992959508312,SWEETY SILVER PANTS XL RTG,1,15500,0,15500,13944,1556
3/31/2021 12:29,COKLAT,COKLAT COIN,2,500,0,1000,800,200
3/31/2021 12:29,HT,HOT-HOT,1,500,0,500,350,150
3/31/2021 12:38,SOSIS,SO NICE SAPI,5,1000,0,5000,4700,300
3/31/2021 12:55,8992761166205,FRESTEA GREEN HONEY 350ML,2,4500,0,9000,6000,3000
3/31/2021 12:59,GL,GULA 1 LITER,1,11500,0,11500,10500,1000
3/31/2021 12:59,8998989110167,SURYA GUDANG GARAM 16 FILTER,1,24000,0,24000,22100,1900
3/31/2021 12:59,8998989500166,GUDANG GARAM MERAH BESAR 16KS,1,17000,0,17000,15300,1700
3/31/2021 12:59,123124,KOREK BIASA,1,2000,0,2000,1800,200
3/31/2021 14:08,ARG,ARGUS 220ML,3,14500,0,43500,37500,6000
3/31/2021 14:14,8992694247163,ZWITSAL SOAP RICH N HON 70G,1,4000,0,4000,3410,590
3/31/2021 14:14,8998866200301,MIE SEDAAP GORENG,1,2500,0,2500,2023,477
3/31/2021 16:00,8996001603376,ENERGEN KURMA,1,18000,0,18000,15000,3000
3/31/2021 16:00,8998866200844,NOODLE SEDAAP MIE KARI SPESIAL CUP 81 GR,3,4500,0,13500,10950,2550
3/31/2021 16:22,8992959953334,SWEETY BRONZE XL42,1,80000,0,80000,75455,4545
3/31/2021 16:22,8999999533434,CLEAR SHP COOL SPORT MNTL MEN 9 ML,1,10300,0,10300,9300,1000
3/31/2021 16:22,8999999531478,MOLTO BLACK PURPLE,1,5500,0,5500,4800,700
3/31/2021 16:22,8994023000050,MEGKEJU SERBAGUNA 165G,1,12000,0,12000,10339,1661
3/31/2021 16:22,GL,GULA 1 LITER,1,11500,0,11500,10500,1000
3/31/2021 16:22,8992957214307,SAFARI MECES,1,5500,0,5500,4500,1000
3/31/2021 16:22,8850507000094,POLICE BONCHA,1,2000,0,2000,800,1200
3/31/2021 16:22,8992775001042,PILUS GARUDA MI GORENG,1,5500,0,5500,4713,787
3/31/2021 16:22,8992770034151,MASAKO 250GR,1,10000,0,10000,8000,2000
3/31/2021 16:22,089686021219,INTER MIE GORENG,2,1000,0,2000,1770,230
3/31/2021 16:39,8992959304235,SFX COMFORT SLIM 29CM 8S,1,8000,0,8000,7387,613
3/31/2021 16:39,RT 1000,ROTI 1000,2,1000,0,2000,1500,500
3/31/2021 16:39,8992761111533,SPRITE SLIM CAM250ML,1,5000,0,5000,3750,1250
3/31/2021 16:39,8997018250218,JAHE MERAH,1,1000,0,1000,833,167
3/31/2021 16:39,8998009010590,ULTRA CHO 125,1,3000,0,3000,2428,572
3/31/2021 16:39,8991102384841,WFR TANGO LONG CKLT 130G,2,5000,0,10000,7546,2454
3/31/2021 16:39,SF KEMASAN,SAFFANAH ROTI KEMASAN,4,3500,0,14000,12000,2000
3/31/2021 16:39,8996001414002,TORA BIKA CAPPUCINO,1,13000,0,13000,12270,730
3/31/2021 16:39,8998866106979,CIPTADENT TB CHARCOAL PROTEC,1,6000,0,6000,5250,750
3/31/2021 16:39,8992761139018,ADES 600ML,1,3500,0,3500,2292,1208
3/31/2021 16:39,PRG,PARAGO,2,500,0,1000,800,200
3/31/2021 16:39,8998866201841,GOLDA DOLCE LATTE 200ML,1,3000,0,3000,2500,500
3/31/2021 16:39,6907992824963,JD MILKY CHOCOLATE,1,3000,0,3000,2600,400
3/31/2021 16:39,8993989311279,CLAS MILD 12,1,17000,0,17000,15700,1300
3/31/2021 16:39,8850507000094,POLICE BONCHA,6,2000,0,12000,4800,7200
3/31/2021 16:39,KJ,KINDER JOY,1,2000,0,2000,1583,417
3/31/2021 16:39,6907992823676,JD PEACH,2,2000,0,4000,3400,600
3/31/2021 16:39,YP,YUPI,4,250,0,1000,832,168
3/31/2021 16:39,6907992823669,JD MILKY STRAW,1,3000,0,3000,2600,400
3/31/2021 16:39,MARS,MARSHMELLOW,4,500,0,2000,1732,268
3/31/2021 16:39,GL,GULA 1 LITER,1,11500,0,11500,10500,1000
3/31/2021 16:39,8997009510055,YOU C1000,1,8000,0,8000,4846,3154
3/31/2021 16:39,BALON,BALON CABUTR,3,1000,0,3000,2700,300
3/31/2021 16:40,HT,HOT-HOT,2,500,0,1000,700,300
3/31/2021 16:40,YP,YUPI,4,250,0,1000,832,168
3/31/2021 16:40,8996001318430,BETTER 1000,2,1000,0,2000,1640,360
3/31/2021 17:05,8996001600399,LE MINERAL 1500ML,1,5000,0,5000,4042,958
3/31/2021 17:05,8992736424293,SASA BUMBU NASI GORENG 20G,3,2000,0,6000,3408,2592
3/31/2021 17:05,8993379200886,SABUN HARMONY ORANGE 70G,1,2000,0,2000,1652,348
3/31/2021 17:05,8850507002968,A1 KING TRUCK,1,16500,0,16500,15500,1000
3/31/2021 17:05,SOSIS,SO NICE SAPI,6,1000,0,6000,5640,360
3/31/2021 17:05,8999999017804,CITRA BW NATURAL WHITE LD 400ML,1,21000,0,21000,19000,2000
3/31/2021 17:05,8998866107099,WET WIPES KODOMO BABY 50SHT CLSSC,1,15000,0,15000,13650,1350
3/31/2021 17:05,8998866107464,POSH FRESH SPIRIT 150ML,1,19500,0,19500,17500,2000
3/31/2021 17:05,8999999719401,VASELINE HW UV LIGHTENING PJ 400ML,1,43800,0,43800,39734,4066
3/31/2021 17:05,8997210107877,VORTEX SMART 3,1,10000,0,10000,9500,500
3/31/2021 17:05,8993365131538,MADU TJ MURNI 150G,1,14800,0,14800,13430,1370
3/31/2021 17:05,8998866200301,MIE SEDAAP GORENG,3,2500,0,7500,6069,1431
3/31/2021 17:05,BALON,BALON CABUTR,3,1000,0,3000,2700,300
3/31/2021 17:05,8992761147143,SPRITE WATERLYMON 425ML,1,5500,0,5500,4300,1200
3/31/2021 17:05,8994834006128,TICTIC PEDAS,4,2000,0,8000,6800,1200
3/31/2021 17:05,8994834003752,TICTIC,1,2000,0,2000,1700,300
3/31/2021 17:05,6907992823973,JD PINEAPPLE,1,5000,0,5000,4300,700
3/31/2021 17:05,8998866501033,MINYAK GORENG SEDAAP POUCH 2L,1,28000,0,28000,27746,254
3/31/2021 17:05,COKLAT,COKLAT COIN,2,500,0,1000,800,200
3/31/2021 17:05,8997025911058,HATARI SHP KELAPA,1,5000,0,5000,4800,200
3/31/2021 17:05,8991102384841,WFR TANGO LONG CKLT 130G,2,5000,0,10000,7546,2454
3/31/2021 17:05,8999999050009,SUNLIGHT LIME NEW POUCH 95ML,1,2000,0,2000,1600,400
3/31/2021 17:05,8993072153595,LARISST COTTON 35G,1,5000,0,5000,3300,1700
3/31/2021 17:05,8992753631209,OMELA 370,1,9500,0,9500,8400,1100
3/31/2021 17:05,4800888141125,AXE DEO BODYSPRAY DARK 150ML,1,20000,0,20000,10615,9385
3/31/2021 17:05,8994037703749,WENIS JERUK,1,8000,0,8000,6500,1500
3/31/2021 17:05,8998866202770,MIE SEDAAP SALERO PADANG,1,2500,0,2500,2362,138
3/31/2021 17:05,8998989300261,GUDANG GARAM SURYA 12 FILTER,1,18000,0,18000,16450,1550
3/31/2021 17:05,123124,KOREK BIASA,1,2000,0,2000,1800,200
3/31/2021 17:05,SST,SUPERSTAR,2,1000,0,2000,1832,168
3/31/2021 17:05,089686021127,INTER MIE KALDU,17,1000,0,17000,13821,3179
3/31/2021 17:05,ARG,ARGUS 220ML,1,14500,0,14500,12500,2000
3/31/2021 17:05,MARS,MARSHMELLOW,1,500,0,500,433,67
3/31/2021 17:11,GL,GULA 1 LITER,1,11500,0,11500,10500,1000
3/31/2021 17:11,001,PASEO SMART FACIAL SF 250S GT,1,10000,0,10000,9500,500
3/31/2021 17:11,8999999057640,MOLTO EDP BLK PURPLE 20ML,6,1000,0,6000,4800,1200
3/31/2021 17:11,8997218380135,ICHITAN GREEN TEA,1,8000,0,8000,6583,1417
3/31/2021 17:11,TG,TEH GELAS,1,1000,0,1000,729,271
3/31/2021 17:11,6907992824963,JD MILKY CHOCOLATE,5,3000,0,15000,13000,2000
3/31/2021 17:11,PRG,PARAGO,1,500,0,500,400,100
3/31/2021 17:11,6907992823966,JD BLUEBERRY,1,3500,0,3500,3000,500
3/31/2021 17:11,8992694246340,ZWITSAL SHP NAT AVKS 100ML,1,11800,0,11800,10395,1405
3/31/2021 17:11,8998866202435,JAPOTA UMAMI JAPANESE SEAWEED 35GR,1,5000,0,5000,4150,850
3/31/2021 17:11,8992761002015,COCA COLA PET 390ML,1,5500,0,5500,4333,1167
3/31/2021 17:11,8992775001042,PILUS GARUDA MI GORENG,1,5500,0,5500,4713,787
3/31/2021 17:11,8992736424293,SASA BUMBU NASI GORENG 20G,1,2000,0,2000,1136,864
3/31/2021 17:11,BALON,BALON CABUTR,2,1000,0,2000,1800,200
3/31/2021 17:11,MARS,MARSHMELLOW,4,500,0,2000,1732,268
3/31/2021 17:11,8999999524722,SUNLIGHT LIME NEW PCH 435ML,1,10000,0,10000,9100,900
3/31/2021 17:11,8998989300261,GUDANG GARAM SURYA 12 FILTER,1,18000,0,18000,16450,1550
3/31/2021 17:11,COKLAT,COKLAT COIN,4,500,0,2000,1600,400
3/31/2021 17:11,8998989500166,GUDANG GARAM MERAH BESAR 16KS,2,17000,0,34000,30600,3400
3/31/2021 17:11,8994834003752,TICTIC,1,2000,0,2000,1700,300
3/31/2021 17:11,8999999049492,REXONA WMN RO POWDER DRY 45 ML,1,15000,0,15000,13500,1500
3/31/2021 17:14,8992696404441,BEAR BRAND 189ML,1,8500,0,8500,7887,613
3/31/2021 17:14,089686021127,INTER MIE KALDU,2,1000,0,2000,1626,374
3/31/2021 17:14,8992696523081,MILO UHT 110ML,2,2500,0,5000,3924,1076
3/31/2021 17:14,8997009510055,YOU C1000,2,8000,0,16000,9692,6308
3/31/2021 17:14,8996001320051,KOPIKO COFFE CANDY,1,6200,0,6200,5600,600
3/31/2021 17:14,8996001338056,TAMARIN,1,6000,0,6000,5100,900
3/31/2021 17:15,8999999049454,REXONA WMN RO FREE SPIRIT 45 ML,1,15000,0,15000,13550,1450
3/31/2021 17:15,089686021141,INTER MIE SOTO,1,1000,0,1000,854,146
3/31/2021 17:15,MOLTO PINK,MOLTO ALL IN ONE 11 ML,1,500,0,500,400,100
3/31/2021 17:15,PRG,PARAGO,1,500,0,500,400,100
3/31/2021 17:17,8998866608312,GIV PAPAYA KOTAK 76GR,1,2000,0,2000,1820,180
3/31/2021 17:17,8998866611725,EKONOMI PENCUCI PIRING  LIQ 290ML,1,5000,0,5000,4200,800
3/31/2021 17:17,8998866501026,MINYAK GORENG SEDAAP POUCH 1 L,1,15000,0,15000,14110,890
3/31/2021 17:17,8991111101507,JB POWDER BLOSSOM 50G,1,3500,0,3500,3000,500
3/31/2021 17:17,8996001600399,LE MINERAL 1500ML,1,5000,0,5000,4042,958
3/31/2021 17:18,8850507001176,HERO RACING,1,12000,0,12000,10600,1400
3/31/2021 17:18,KJ,KINDER JOY,1,2000,0,2000,1583,417
3/31/2021 17:18,BALON,BALON CABUTR,2,1000,0,2000,1800,200
3/31/2021 17:18,8850507000094,POLICE BONCHA,1,2000,0,2000,800,1200
3/31/2021 17:30,8992696523081,MILO UHT 110ML,1,2500,0,2500,1962,538
3/31/2021 17:30,8992957220025,GOLDEN CITY MINI,1,3000,0,3000,2500,500
3/31/2021 17:30,BALON,BALON CABUTR,3,1000,0,3000,2700,300
3/31/2021 17:30,8991102989428,WFR TANGO LONG CKLT 24G GTG,1,1000,0,1000,672,328
3/31/2021 17:30,8850507002968,A1 KING TRUCK,1,16500,0,16500,15500,1000
3/31/2021 17:30,PRG,PARAGO,4,500,0,2000,1600,400
3/31/2021 17:30,8998989500166,GUDANG GARAM MERAH BESAR 16KS,2,17000,0,34000,30600,3400
3/31/2021 17:30,8992761139018,ADES 600ML,1,3500,0,3500,2292,1208
3/31/2021 17:30,8998866201452,POTABEE REGULER BBQ BEEF 35GR,1,5000,0,5000,4150,850
3/31/2021 17:30,8993470411433,JOGER CLASSIC,1,1000,0,1000,850,150
3/31/2021 17:30,HT,HOT-HOT,1,500,0,500,350,150
3/31/2021 17:30,8998866601429,POWDET DAIA BUNGA BAG 290GR,1,5000,0,5000,4450,550
3/31/2021 17:30,MOLTO PINK,MOLTO ALL IN ONE 11 ML,4,500,0,2000,1600,400
3/31/2021 17:30,8992957220117,COKLAT BERUANG,1,2000,0,2000,1700,300
3/31/2021 17:30,8991102989534,WFR TANGO LONG VNL 24G GTG,1,1000,0,1000,672,328
3/31/2021 17:30,8998989300261,GUDANG GARAM SURYA 12 FILTER,1,18000,0,18000,16450,1550
3/31/2021 17:30,8998866202312,NOODLE SEDAAP TASTY BAKMI AYAM 129 GR,1,5000,0,5000,4167,833
3/31/2021 17:34,8998989300261,GUDANG GARAM SURYA 12 FILTER,2,18000,0,36000,32900,3100
3/31/2021 17:34,8998009010569,ULTRA CHO 200,1,5000,0,5000,3830,1170
3/31/2021 17:34,8998009010590,ULTRA CHO 125,1,3000,0,3000,2428,572
3/31/2021 17:34,8998866202343,MIE SEDAAP KOREAN SPICY,1,2500,0,2500,2023,477
3/31/2021 17:34,8999999706081,PEPSODENT WHITE 75G,1,5000,0,5000,3850,1150
3/31/2021 17:34,6907992823676,JD PEACH,1,2000,0,2000,1700,300
3/31/2021 17:34,HT,HOT-HOT,2,500,0,1000,700,300
3/31/2021 17:34,BALON,BALON CABUTR,3,1000,0,3000,2700,300
3/31/2021 17:34,YP,YUPI,4,250,0,1000,832,168
3/31/2021 17:34,KJ,KINDER JOY,1,2000,0,2000,1583,417
3/31/2021 17:34,8995333032113,TERIGU GATOT KACA 1 KG,1,8500,0,8500,8012,488
3/31/2021 17:34,MARS,MARSHMELLOW,1,500,0,500,433,67
3/31/2021 17:45,8998989300261,GUDANG GARAM SURYA 12 FILTER,1,18000,0,18000,16450,1550
3/31/2021 17:45,089686021127,INTER MIE KALDU,2,1000,0,2000,1626,374
3/31/2021 17:45,8998866200325,MIE SEDAAP SOTO,2,2500,0,5000,3904,1096
3/31/2021 17:45,8997009510055,YOU C1000,6,8000,0,48000,29076,18924
3/31/2021 17:45,089686021141,INTER MIE SOTO,2,1000,0,2000,1708,292
3/31/2021 17:45,8998866200578,MIE SEDAAP KARI KENTAL,20,2500,0,50000,45260,4740
3/31/2021 17:45,8992628010139,BIMOLI 5L,1,75000,0,75000,72100,2900
3/31/2021 17:45,8996001600399,LE MINERAL 1500ML,2,5000,0,10000,8084,1916
3/31/2021 17:45,8998866501026,MINYAK GORENG SEDAAP POUCH 1 L,1,15000,0,15000,14110,890
3/31/2021 17:45,8991002105409,KOPI KAPAL API,1,20000,0,20000,18888,1112
3/31/2021 17:45,ff,FULLO BLASTO,1,1000,0,1000,995,5
3/31/2021 17:51,8994834003752,TICTIC,2,2000,0,4000,3400,600
3/31/2021 17:51,BALON,BALON CABUTR,1,1000,0,1000,900,100
3/31/2021 17:55,8997021870014,FRESH CARE CITRUS 10ML,1,12000,0,12000,10000,2000
3/31/2021 17:55,8998866200578,MIE SEDAAP KARI KENTAL,2,2500,0,5000,4526,474
3/31/2021 17:55,8998866200301,MIE SEDAAP GORENG,2,2500,0,5000,4046,954
3/31/2021 17:55,089686061024,POP MIE MINI SOTO RL,1,3000,0,3000,2702,298
3/31/2021 17:55,8998866609043,DAIA SOFTENER GUSSET 565G,1,10000,0,10000,8700,1300
3/31/2021 17:55,8991102385091,WFR TANGO CKLT 7G,1,8300,0,8300,7455,845
3/31/2021 17:58,8992753182206,FF MILKY CKLT 180ML,1,4500,0,4500,3250,1250
3/31/2021 17:58,8998009010569,ULTRA CHO 200,1,5000,0,5000,3830,1170
3/31/2021 17:58,8992696404441,BEAR BRAND 189ML,1,8500,0,8500,7887,613
3/31/2021 17:58,8995333032113,TERIGU GATOT KACA 1 KG,1,8500,0,8500,8012,488
3/31/2021 18:07,8999999024772,VASELINE HW PERFECT 10 100 ML,1,19000,0,19000,17600,1400
3/31/2021 18:07,8998866608725,DAIA SOFTENER BAG 850G,1,18000,0,18000,15627,2373
3/31/2021 18:48,089686043051,INDOMIE COTO MAKASSAR,1,2800,0,2800,2525,275
3/31/2021 18:48,089686021127,INTER MIE KALDU,2,1000,0,2000,1626,374
3/31/2021 18:48,089686010824,INDOMIE GORENG SPESIAL,1,2700,0,2700,2452,248
3/31/2021 18:48,8995333060772,TERIGU GATOT KACA 500GR,1,4500,0,4500,4065,435
3/31/2021 19:07,8991102987639,WFR TANGO LONG VNL 130G,1,5000,0,5000,3773,1227
3/31/2021 19:07,8992775305164,MALKIST GREEN TEA,1,6500,0,6500,5500,1000
3/31/2021 19:07,RT 1000,ROTI 1000,2,1000,0,2000,1500,500
3/31/2021 19:07,8997218380135,ICHITAN GREEN TEA,1,8000,0,8000,6583,1417
3/31/2021 19:07,8886013213208,FRENCH FREIS 2000,1,5000,0,5000,3750,1250
3/31/2021 19:07,8998866202664,POTABEE WAGYU BEEF STEAK 68 GR,1,8000,0,8000,7200,800
3/31/2021 19:07,8998866610377,ISOPLUS,1,3000,0,3000,2350,650
3/31/2021 19:07,8991002103764,GOOD DAY CAPPUCINO 10X25G,1,1500,0,1500,1395,105
3/31/2021 19:07,6907992823904,JD CRUNCHY CHOCOLATE VAN,1,8000,0,8000,6800,1200
3/31/2021 20:47,8991102384841,WFR TANGO LONG CKLT 130G,1,5000,0,5000,3773,1227
3/31/2021 20:51,GL,GULA 1 LITER,1,11500,0,11500,10500,1000
3/31/2021 20:51,8999999502393,ROYCO FDS CHICKEN 8G,1,5000,0,5000,4500,500
3/31/2021 20:51,8992628022156,BIMOLI KLASIK TOUCH 1 LT,1,15500,0,15500,14350,1150
3/31/2021 20:51,8998866202770,MIE SEDAAP SALERO PADANG,1,2500,0,2500,2362,138
3/31/2021 20:51,8991004011906,KOPI BORONG,1,10000,0,10000,8333,1667
3/31/2021 20:51,8998866202619,MIE SEDAAP KOREAN SPICY SOUP,1,2500,0,2500,2273,227
3/31/2021 20:52,8994834003752,TICTIC,1,2000,0,2000,1700,300
3/31/2021 20:52,8994834006128,TICTIC PEDAS,1,2000,0,2000,1700,300
3/31/2021 21:12,8998989110167,SURYA GUDANG GARAM 16 FILTER,1,24000,0,24000,22100,1900
3/31/2021 21:20,8994867000162,ROKOK PUNDIMAS KRETEK16,1,10000,0,10000,8600,1400
3/31/2021 21:20,8998989300261,GUDANG GARAM SURYA 12 FILTER,1,18000,0,18000,16450,1550
3/31/2021 22:14,8999999007768,FAIR&LOVELY MULTIVITAMIN  CREAM 9 ML,1,4500,0,4500,3200,1300
3/31/2021 22:23,8998866105491,EMERON LOVELY SMOTH&BRIGHT 100ML,1,4300,0,4300,3800,500
3/31/2021 22:47,8998866604963,POWDET DAIA LEMON 290GR,4,5000,0,20000,17800,2200
3/31/2021 23:00,8997009510055,YOU C1000,1,8000,0,8000,4846,3154
3/31/2021 23:00,8993989311279,CLAS MILD 12,1,17000,0,17000,15700,1300
3/31/2021 23:01,8992753100101,BKM FULL CREAM GOLD 370,2,15500,0,31000,29600,1400
3/31/2021 23:01,089686400816,SAMBAL EXTRA PEDAS 135ML,1,5500,0,5500,4950,550
3/31/2021 23:01,GL,GULA 1 LITER,3,11500,0,34500,31500,3000
3/31/2021 23:01,8998989121163,SURYA PRO MERAH,1,20000,0,20000,18600,1400
3/31/2021 23:01,8994867000162,ROKOK PUNDIMAS KRETEK16,1,10000,0,10000,8600,1400
3/31/2021 23:01,YP,YUPI,4,250,0,1000,832,168
3/31/2021 23:01,SOSIS,SO NICE SAPI,1,1000,0,1000,940,60
4/1/2021 11:10,8998989110167,SURYA GUDANG GARAM 16 FILTER,1,24000,0,24000,22100,1900
4/1/2021 11:10,8998866610261,POWDET DAIA SOFTENER BAG 290 GR,1,5000,0,5000,4450,550
4/1/2021 11:11,8998989110167,SURYA GUDANG GARAM 16 FILTER,4,24000,0,96000,88400,7600
4/1/2021 11:16,8996001355237,SUPER STAR,1,11000,0,11000,9900,1100
4/1/2021 11:16,8997025914059,HATARI SEE HONG,1,5000,0,5000,4800,200
4/1/2021 11:16,SST,SUPERSTAR,2,1000,0,2000,1832,168
4/1/2021 11:16,SOSIS,SO NICE SAPI,1,1000,0,1000,940,60
4/1/2021 11:16,ff,FULLO BLASTO,2,1000,0,2000,1990,10
4/1/2021 11:58,8999999195656,SARI WANGI 50X1.85,1,10000,0,10000,8700,1300
4/1/2021 11:58,8992628022156,BIMOLI KLASIK TOUCH 1 LT,1,15500,0,15500,14350,1150
4/1/2021 15:54,8998989110167,SURYA GUDANG GARAM 16 FILTER,1,24000,0,24000,22100,1900
4/1/2021 15:55,8998989300261,GUDANG GARAM SURYA 12 FILTER,1,18000,0,18000,16450,1550
4/1/2021 15:55,089686011036,INDOMIE GORENG PEDAS,1,2700,0,2700,2452,248
4/1/2021 15:55,089686043273,INDOMIE SAMBAL RICA,1,2700,0,2700,2452,248
4/1/2021 15:55,BALON,BALON CABUTR,2,1000,0,2000,1800,200
4/1/2021 16:35,8999801700030,SUSU FOYU,1,11500,0,11500,10000,1500
4/1/2021 16:35,8998866501033,MINYAK GORENG SEDAAP POUCH 2L,1,28000,0,28000,27746,254
4/1/2021 16:36,8991102281416,PERMEN MINTZ PPMINT,1,4500,0,4500,4000,500
4/1/2021 17:03,8998989110167,SURYA GUDANG GARAM 16 FILTER,2,24000,0,48000,44200,3800
4/1/2021 17:11,8999999049492,REXONA WMN RO POWDER DRY 45 ML,1,15000,0,15000,13500,1500
4/1/2021 17:17,8997218380074,ICHITAN MILK TEA,1,8000,0,8000,6583,1417
4/1/2021 17:17,089686821086,ICHI OCHA MELATI,1,3000,0,3000,2250,750
4/1/2021 17:17,kp,KALPA,1,2000,0,2000,1666,334
4/1/2021 17:17,YP,YUPI,4,250,0,1000,832,168
4/1/2021 17:17,FUZO,KUACI FUZO,1,1000,0,1000,850,150
4/1/2021 17:21,8992761111533,SPRITE SLIM CAM250ML,1,5000,0,5000,3750,1250
4/1/2021 17:42,8993379210854,SABUN HARMONY APPLE 70G,1,2000,0,2000,1652,348
4/1/2021 18:30,8999999034023,VASELINE MEN ANTI ACNE 50G,1,17000,0,17000,15400,1600
4/1/2021 19:36,8994420107789,SARDEN SAUS TOMAT,1,7000,0,7000,5833,1167
4/1/2021 19:36,8996001414002,TORA BIKA CAPPUCINO,2,1500,0,3000,2454,546
4/1/2021 19:37,8998866201964,MINYAK GORENG SABRINA 2L POUCH,1,28000,0,28000,26753,1247
4/1/2021 19:37,8998866201865,KRISBEE PILLOW CHOCOLAVA 120 GR,1,8000,0,8000,7250,750
4/1/2021 20:13,8995333060772,TERIGU GATOT KACA 500GR,1,4500,0,4500,4065,435
4/1/2021 20:13,8995333032113,TERIGU GATOT KACA 1 KG,1,8500,0,8500,8012,488
4/1/2021 20:31,8991102384841,WFR TANGO LONG CKLT 130G,2,5000,0,10000,7546,2454
4/1/2021 20:31,8991102987639,WFR TANGO LONG VNL 130G,2,5000,0,10000,7546,2454
4/1/2021 20:31,8992753102204,BKM COKLAT 370G,1,11300,0,11300,9500,1800
4/1/2021 20:31,8991102994422,TANGO WALUT CHOCOBNN 18G,1,8200,0,8200,7272,928
4/1/2021 21:36,8998008151065,MIWON 100 GR,1,3300,0,3300,2996,304
4/2/2021 12:09,8997009510055,YOU C1000,1,8000,0,8000,4846,3154
4/2/2021 12:09,8992753031900,BKM SCT PUTIH 40G,1,7500,0,7500,6900,600
4/2/2021 12:09,8998866202060,POTABEE AYAM BAKAR PEDAS 35 GR,1,5000,0,5000,4150,850
4/2/2021 12:09,089686021219,INTER MIE GORENG,4,1000,0,4000,3540,460
4/2/2021 12:09,8996001301142,ROMA KELAPA,1,8000,0,8000,6628,1372
4/2/2021 12:09,8996001305041,ROMA SANDWICH CKLT,1,7000,0,7000,5000,2000
4/2/2021 12:09,GL,GULA 1 LITER,1,11500,0,11500,10500,1000
4/2/2021 12:09,8996001301579,MALKIST CKLT KELAPA PACK,1,6500,0,6500,5400,1100
4/2/2021 12:09,8998866105637,EMERON LOVELY MOIST&BRIGHT 200ML,1,7500,0,7500,6475,1025
4/2/2021 12:09,TUSTEL,TUSUK TELINGA,1,1000,0,1000,833,167
4/2/2021 12:09,8999999502409,ROYCO FDS BEEF 9G,8,500,0,4000,3000,1000
4/2/2021 12:12,SOSIS,SO NICE SAPI,3,1000,0,3000,2820,180
4/2/2021 12:26,BRS5,BERAS BUMN 5KG,1,64000,0,64000,50500,13500
4/2/2021 12:26,8992959953136,SWEETY BRONZE L20,1,40000,0,40000,36770,3230
4/2/2021 12:27,8994867000162,ROKOK PUNDIMAS KRETEK16,1,10000,0,10000,8600,1400
4/2/2021 13:48,8934868015031,REXONA DEO LOTION ICE COOL,1,4500,0,4500,3900,600
4/2/2021 13:48,8996001320051,KOPIKO COFFE CANDY,1,6200,0,6200,5600,600
4/2/2021 13:48,8992761139018,ADES 600ML,1,3500,0,3500,2292,1208
4/2/2021 14:17,8998989300261,GUDANG GARAM SURYA 12 FILTER,1,18000,0,18000,16450,1550
4/2/2021 14:21,089686041705,INDOMIE GORENG JUMBO,1,3500,0,3500,3143,357
4/2/2021 14:21,089686043051,INDOMIE COTO MAKASSAR,1,2800,0,2800,2525,275
4/2/2021 14:21,8999999049447,REXONA WMN RO ADVANCED WHITE 45 ML,1,16500,0,16500,14900,1600
4/2/2021 14:21,8998866202244,EKOMIE BUMBU KALDU AYAM,5,1000,0,5000,3990,1010
4/2/2021 14:50,8997218380135,ICHITAN GREEN TEA,1,8000,0,8000,6583,1417
4/2/2021 14:50,8998866202343,MIE SEDAAP KOREAN SPICY,1,2500,0,2500,2023,477
4/2/2021 15:05,8998866202343,MIE SEDAAP KOREAN SPICY,1,2500,0,2500,2023,477
4/2/2021 15:13,089686043204,INDOMIE MIE ACEH,1,2700,0,2700,2452,248
4/2/2021 15:13,089686011036,INDOMIE GORENG PEDAS,1,2700,0,2700,2452,248
4/2/2021 15:13,8998866202619,MIE SEDAAP KOREAN SPICY SOUP,1,2500,0,2500,2273,227
4/2/2021 15:13,8998866202343,MIE SEDAAP KOREAN SPICY,1,2500,0,2500,2023,477
4/2/2021 15:54,8998866500708,FLORIDINA ORANGE,1,3000,0,3000,2500,500
4/2/2021 15:54,8992753182206,FF MILKY CKLT 180ML,1,4500,0,4500,3250,1250
4/2/2021 15:54,8992753184200,FF MILKY STRY 180ML,1,4500,0,4500,3250,1250
4/2/2021 15:54,8991102987639,WFR TANGO LONG VNL 130G,1,5000,0,5000,3773,1227
4/2/2021 15:54,8991001780133,TWISTER BLACK,1,5000,0,5000,4600,400
4/2/2021 15:54,8991001503107,CHACHA PEANUT 35GR,1,5500,0,5500,4900,600
4/2/2021 15:54,MARS,MARSHMELLOW,1,500,0,500,433,67
4/2/2021 16:04,8998866201841,GOLDA DOLCE LATTE 200ML,1,3000,0,3000,2500,500
4/2/2021 16:32,SST,SUPERSTAR,5,1000,0,5000,4580,420
4/2/2021 16:32,8991001121400,SILVERQUEEN ALMOND 65G,1,15000,0,15000,13200,1800
4/2/2021 17:14,8998989110167,SURYA GUDANG GARAM 16 FILTER,1,24000,0,24000,22100,1900
4/2/2021 17:43,8998866100243,KODOMO TP GRAPE TUBE 45G,1,5200,0,5200,4700,500
4/2/2021 17:43,8999908284907,MY BABY MINYAK TELON 90ML,1,25000,0,25000,22700,2300
4/2/2021 17:43,8991102385336,TANGO WAFFLE MILK,1,8000,0,8000,6212,1788
4/2/2021 17:43,8999999707835,CLOSEUP GREEN 65G,1,7000,0,7000,6000,1000
4/2/2021 17:43,RAINBOW,MINICOCO RAINBOW,7,500,0,3500,3150,350
4/2/2021 17:43,8998009010590,ULTRA CHO 125,2,3000,0,6000,4856,1144
4/2/2021 17:43,KJ,KINDER JOY,2,2000,0,4000,3166,834
4/2/2021 18:01,8993324850449,BABY LOVE COTTON BUDS,1,5000,0,5000,4500,500
4/2/2021 18:01,8996001355985,BENG-BENG SHARE IT,1,27000,0,27000,25000,2000
4/2/2021 18:01,089686048704,SARIMIE GORENG AYAM KCP ISI 2,1,3500,0,3500,3120,380
4/2/2021 18:01,089686017748,SARIMIE GORENG ISI 2,1,3500,0,3500,3120,380
4/2/2021 18:01,8998866501026,MINYAK GORENG SEDAAP POUCH 1 L,1,15000,0,15000,14110,890
4/2/2021 18:01,8997218380074,ICHITAN MILK TEA,1,8000,0,8000,6583,1417
4/2/2021 18:01,8992959508916,SWEETY SILVER PANTS XXL 18,1,54500,0,54500,49546,4954
4/2/2021 18:01,SF BOX,SAFFANAH ROTI BOX,1,12000,0,12000,10500,1500
4/2/2021 18:36,089686043273,INDOMIE SAMBAL RICA,1,2700,0,2700,2452,248
4/2/2021 18:36,8992761139018,ADES 600ML,1,3500,0,3500,2292,1208
4/2/2021 18:36,8998989300261,GUDANG GARAM SURYA 12 FILTER,1,18000,0,18000,16450,1550
4/2/2021 18:37,8998866501033,MINYAK GORENG SEDAAP POUCH 2L,1,28000,0,28000,27746,254
4/2/2021 18:46,8996001600399,LE MINERAL 1500ML,1,5000,0,5000,4042,958
4/2/2021 19:04,8995333032113,TERIGU GATOT KACA 1 KG,1,8500,0,8500,8012,488
4/2/2021 19:04,8998866501033,MINYAK GORENG SEDAAP POUCH 2L,1,28000,0,28000,27746,254
4/2/2021 19:19,8997009510055,YOU C1000,1,8000,0,8000,4846,3154
4/2/2021 19:19,8998009010590,ULTRA CHO 125,1,3000,0,3000,2428,572
4/2/2021 19:22,8996001312353,MALKIST KELAPA KOPYOR,1,6700,0,6700,5400,1300
4/2/2021 19:22,8998989110167,SURYA GUDANG GARAM 16 FILTER,1,24000,0,24000,22100,1900
4/2/2021 19:22,SF SOSIS,SAFFANAH ROTI SOSIS,1,6000,0,6000,5500,500
4/2/2021 19:22,8991002103764,GOOD DAY CAPPUCINO 10X25G,1,1500,0,1500,1395,105
4/2/2021 19:37,YP,YUPI,8,250,0,2000,1664,336
4/2/2021 19:37,8992742360844,POLITEX SABUT STENLESS,2,4000,0,8000,4400,3600
4/2/2021 20:08,8998989300261,GUDANG GARAM SURYA 12 FILTER,1,18000,0,18000,16450,1550
4/3/2021 11:15,8998866803694,SOKLIN SOFTERGENT PURPLE BAG 770 & PIRING,1,18000,0,18000,16680,1320
4/3/2021 11:15,8999999531492,MOLTO GLAMOUR,1,5000,0,5000,4800,200
4/3/2021 11:15,BTS,BIMURA TARO SEAWEED 250G,1,10000,0,10000,9300,700
4/3/2021 11:15,SF SOSIS,SAFFANAH ROTI SOSIS,5,6000,0,30000,27500,2500
4/3/2021 11:15,8998866501033,MINYAK GORENG SEDAAP POUCH 2L,2,28000,0,56000,55492,508
4/3/2021 11:15,BALON,BALON CABUTR,1,1000,0,1000,900,100
4/3/2021 11:15,ff,FULLO BLASTO,1,1000,0,1000,995,5
4/3/2021 11:15,8999999524838,SUNLIGHT MINT POUCH 755ML,1,17000,0,17000,15400,1600
4/3/2021 11:15,8999999500665,"RINSO MOLTO ROSE FRESH PWD 1,8KG",1,44700,0,44700,40726,3974
4/3/2021 11:15,8993176110074,MINYAK KAYU PUTIH 60ML,1,20000,0,20000,17333,2667
4/3/2021 11:15,8999999526856,MOLTO ALL IN ONE BLUE 11ML,1,5500,0,5500,4800,700
4/3/2021 11:15,8934868015024,REXONA DEO LOTION FREE SPIRIT 9G,1,4500,0,4500,3900,600
4/3/2021 11:15,8992222050418,GATSBY NORMAL 38GR,1,5000,0,5000,3850,1150
4/3/2021 11:15,8998866603553,SOKLIN FLOORCLENER UNGU 900ML,1,14000,0,14000,12436,1564
4/3/2021 11:15,8996001305003,SARI GANDUM SANDWICH,1,6000,0,6000,5100,900
4/3/2021 11:15,8992388133345,NU MILK TEA TEH TARIK 330ML,1,6000,0,6000,5125,875
4/3/2021 11:31,8996001600399,LE MINERAL 1500ML,1,5000,0,5000,4042,958
4/3/2021 12:46,SF TAWAR KUPAS,SAFFANAH ROTI TAWAR KUPAS,1,10000,0,10000,9000,1000
4/3/2021 13:07,8997009510055,YOU C1000,1,8000,0,8000,4846,3154
4/3/2021 14:13,8998866600101,CREAM EKONOMI LEMON 455G,1,5500,0,5500,4750,750
4/3/2021 14:13,8993379200855,SABUN HARMONY STRAWBERRY 70G,1,2000,0,2000,1652,348
4/3/2021 14:36,8997218380074,ICHITAN MILK TEA,1,8000,0,8000,6583,1417
4/3/2021 14:36,8992761002022,SPRITE PET 390ML,1,5500,0,5500,4300,1200
4/3/2021 14:38,GL,GULA 1 LITER,1,11500,0,11500,10500,1000
4/3/2021 15:30,8998989300261,GUDANG GARAM SURYA 12 FILTER,1,18000,0,18000,16450,1550
4/3/2021 15:38,8992959971109,SFX COMFORT SLIM 36CM 12+1,1,16500,0,16500,15152,1348
4/3/2021 15:46,8992761145033,FANTA STRAW PET 250ML,1,3500,0,3500,2417,1083
4/3/2021 15:46,8992761122331,FRESTEA APPEL 500ML,1,6500,0,6500,4708,1792
4/3/2021 15:54,8992761166205,FRESTEA GREEN HONEY 350ML,1,4500,0,4500,3000,1500
4/3/2021 17:21,8992761166212,FRESTEA APPLE 350ML,1,4500,0,4500,3000,1500
4/3/2021 17:21,8997009510055,YOU C1000,1,8000,0,8000,4846,3154
4/3/2021 17:21,8991001780133,TWISTER BLACK,1,5000,0,5000,4600,400
4/3/2021 17:21,SF TAWAR COKLAT,SAFFANAH ROTI TAWAR COKLAT,1,13500,0,13500,12000,1500
4/3/2021 17:21,8994834003752,TICTIC,1,2000,0,2000,1700,300
4/3/2021 17:21,8998866201483,POTABEE REGULER GRILLED SEAWEED 35GR,1,5000,0,5000,4150,850
4/3/2021 17:21,8998866201469,POTABEE REGULER BBQ BEEF 68 GR,1,8000,0,8000,7200,800
4/3/2021 17:22,MADU,MADU FLORES,1,135000,0,135000,130000,5000
4/3/2021 17:22,8998989110167,SURYA GUDANG GARAM 16 FILTER,2,24000,0,48000,44200,3800
4/3/2021 19:47,BTS,BIMURA TARO SEAWEED 250G,2,10000,0,20000,18600,1400
4/3/2021 19:47,8991102385060,TANGO WAFFLE CHOX,1,8000,0,8000,6212,1788
4/3/2021 19:47,8998866102605,KODOMO TB REG 2IN1,1,7500,0,7500,6600,900
4/3/2021 19:47,SF TAWAR ORI,SAFFANAH TAWAR ORI,1,9000,0,9000,8000,1000
4/3/2021 19:47,8999999524722,SUNLIGHT LIME NEW PCH 435ML,1,10000,0,10000,9100,900
4/3/2021 19:47,8992959117569,SFX DS REG FLOW NW 8,1,4000,0,4000,3530,470
4/3/2021 19:47,8992946511790,SHINZUI 85G,1,5000,0,5000,3475,1525
4/3/2021 19:47,8992736980164,SASA TEPUNG KENTUCKY 80G,1,3000,0,3000,2181,819
4/3/2021 19:47,8998866501033,MINYAK GORENG SEDAAP POUCH 2L,1,28000,0,28000,27746,254
4/3/2021 19:47,8994834003752,TICTIC,3,2000,0,6000,5100,900
4/3/2021 19:47,8991102385091,WFR TANGO CKLT 7G,1,8300,0,8300,7455,845
4/3/2021 19:47,8991102385336,TANGO WAFFLE MILK,1,8000,0,8000,6212,1788
4/3/2021 19:47,SF TAWAR COKLAT,SAFFANAH ROTI TAWAR COKLAT,1,13500,0,13500,12000,1500
4/3/2021 19:47,8999999549138,CLEAR HIJAB AD SHP HF TMT 160ML,1,25000,0,25000,23870,1130
4/3/2021 19:47,089686043051,INDOMIE COTO MAKASSAR,2,2800,0,5600,5050,550
4/3/2021 19:47,6907992823904,JD CRUNCHY CHOCOLATE VAN,1,8000,0,8000,6800,1200
4/7/2021 10:23,SF TAWAR KUPAS,SAFFANAH ROTI TAWAR KUPAS,1,10000,0,10000,9000,1000
4/7/2021 10:23,8992753102204,BKM COKLAT 370G,1,11300,0,11300,9500,1800
4/7/2021 10:45,8997028590014,ARGUS 220ML,4,500,0,2000,1208,792
4/7/2021 10:45,8998866200851,NOODLE SEDAAP MIE BAKSO SPESIAL CUP 77 GR,1,4500,0,4500,3650,850
4/7/2021 10:47,8994834003752,TICTIC,1,2000,0,2000,1700,300
4/7/2021 10:47,6907992823676,JD PEACH,2,2000,0,4000,3400,600
4/7/2021 10:53,6907992823935,JD SWEETCORN,1,3500,0,3500,3000,500
4/7/2021 11:17,BTS,BIMURA TARO SEAWEED 250G,1,10000,0,10000,9300,700
4/7/2021 11:17,8992946511790,SHINZUI 85G,1,5000,0,5000,3475,1525
4/7/2021 11:35,GL,GULA 1 LITER,1,11500,0,11500,10500,1000
4/7/2021 11:36,8998989500166,GUDANG GARAM MERAH BESAR 16KS,1,17000,0,17000,15300,1700
4/7/2021 12:55,8992761164539,NUTRIBOOST ORANGE 300ML,2,6500,0,13000,10600,2400
4/7/2021 12:55,8992761145026,SPRITE PET 250ML,3,3500,0,10500,7251,3249
4/7/2021 14:41,YP,YUPI,10,250,0,2500,2080,420
4/7/2021 14:41,8992696404441,BEAR BRAND 189ML,1,8500,0,8500,7887,613
4/7/2021 14:41,8994834005923,SPIX 1000,1,1000,0,1000,850,150
4/7/2021 14:41,TG,TEH GELAS,1,1000,0,1000,729,271
4/7/2021 14:41,TUSTEL,TUSUK TELINGA,1,1000,0,1000,833,167
4/7/2021 14:41,YOUTOP,YOUTOP,1,1000,0,1000,875,125
4/7/2021 14:57,GL,GULA 1 LITER,2,11500,0,23000,21000,2000
4/7/2021 14:59,ff,FULLO BLASTO,3,1000,0,3000,2985,15
4/7/2021 14:59,PRG,PARAGO,8,500,0,4000,3200,800
4/7/2021 15:05,8996001600269,LE MINERAL 600ML,1,3000,0,3000,1688,1312
4/7/2021 15:42,8999999042646,RINSO MOLTO ROSE FRESH LIQ 40ML,1,5500,0,5500,4817,683
4/7/2021 15:42,8998866202343,MIE SEDAAP KOREAN SPICY,2,2500,0,5000,4046,954
4/7/2021 15:42,089686010107,INDOMIE KALDU AYAM,2,2500,0,5000,4300,700
4/7/2021 16:17,6921101219235,YAKUAT JELLY,1,2000,0,2000,1750,250
4/7/2021 16:17,6907992823676,JD PEACH,1,2000,0,2000,1700,300
4/7/2021 16:45,8993365140356,MADU KURMA TJ 150G,3,14800,0,44400,40290,4110
4/7/2021 16:45,8999999001209,LIFEBUOY BW MILDCARE LD REFF 450 ML,1,25000,0,25000,22110,2890
4/7/2021 16:51,8997028590014,ARGUS 220ML,4,500,0,2000,1208,792
4/7/2021 16:51,8996001600375,LE MINERAL 330ML,1,2000,0,2000,1417,583
4/7/2021 16:51,9556001025272,NESCAFE LATTE 240ML,1,8500,0,8500,7437,1063
4/7/2021 17:42,8999999519872,DOVE DEO WMN RO POMEGRANATE 40 ML,1,16500,0,16500,15000,1500
4/7/2021 17:42,8998866606158,NUVO ACTIVE COOL 110G,2,3000,0,6000,5200,800
4/7/2021 17:42,SF TAWAR COKLAT,SAFFANAH ROTI TAWAR COKLAT,2,13500,0,27000,24000,3000
4/7/2021 17:43,SF TAWAR ORI,SAFFANAH TAWAR ORI,1,9000,0,9000,8000,1000
4/7/2021 17:43,GL,GULA 1 LITER,1,11500,0,11500,10500,1000
4/7/2021 17:45,089686021219,INTER MIE GORENG,1,1000,0,1000,885,115
4/7/2021 17:45,8998866202770,MIE SEDAAP SALERO PADANG,3,2500,0,7500,7086,414
4/7/2021 17:45,8998866200578,MIE SEDAAP KARI KENTAL,1,2500,0,2500,2263,237
4/7/2021 18:43,ARG,ARGUS 220ML,1,14500,0,14500,12500,2000
4/7/2021 18:43,8998866501026,MINYAK GORENG SEDAAP POUCH 1 L,1,15000,0,15000,14110,890
4/7/2021 18:43,bb,BENG-BENG,2,1500,0,3000,2900,100
4/7/2021 19:15,bb,BENG-BENG,1,1500,0,1500,1450,50
4/7/2021 19:15,8998866201964,MINYAK GORENG SABRINA 2L POUCH,1,27500,0,27500,26753,747
4/7/2021 19:16,8992775001653,GERY SALUT CHOCOLATE COCONUT,1,2000,0,2000,1476,524
4/7/2021 19:35,8997028590014,ARGUS 220ML,4,500,0,2000,1208,792
4/7/2021 19:48,8991001121615,SILVERQUEEN NUT,1,15000,0,15000,13200,1800
4/7/2021 20:13,8998989300261,GUDANG GARAM SURYA 12 FILTER,1,18000,0,18000,16450,1550
4/7/2021 21:00,8993989311279,CLAS MILD 12,1,17000,0,17000,15700,1300
4/7/2021 21:14,8991002105409,KOPI KAPAL API,1,20000,0,20000,18888,1112
4/7/2021 21:30,8994867007161,ROKOK PENA GOLD 20,1,17000,0,17000,15000,2000
4/7/2021 21:30,8996001305126,ARDEN,1,18000,0,18000,16300,1700
4/7/2021 21:30,001,PASEO SMART FACIAL SF 250S GT,1,10000,0,10000,9500,500
4/7/2021 21:30,8996001301142,ROMA KELAPA,1,8000,0,8000,6628,1372
4/7/2021 21:30,8991115012021,BB STRAWBERRY CREAM,1,8500,0,8500,7600,900
4/7/2021 21:30,8991102228053,TEH GELAS BOTOL,1,3000,0,3000,1922,1078
4/7/2021 21:30,8992388133345,NU MILK TEA TEH TARIK 330ML,1,6000,0,6000,5125,875
4/7/2021 21:30,8996001305041,ROMA SANDWICH CKLT,1,7000,0,7000,5000,2000
4/7/2021 21:30,SNTN,SANTAN BUBUK,1,2500,0,2500,1500,1000
4/7/2021 21:30,8998989300261,GUDANG GARAM SURYA 12 FILTER,2,18000,0,36000,32900,3100
4/7/2021 21:30,8991102384841,WFR TANGO LONG CKLT 130G,1,5000,0,5000,3773,1227
4/7/2021 21:30,8992761166038,MMP ORANGE 300ML,1,5000,0,5000,3750,1250
4/7/2021 21:30,8992761145019,COCA COLA PET 250ML,1,3500,0,3500,2417,1083
4/7/2021 21:30,8992761139018,ADES 600ML,2,3500,0,7000,4584,2416
4/7/2021 21:30,8998866202770,MIE SEDAAP SALERO PADANG,2,2500,0,5000,4724,276
4/7/2021 21:30,ARG,ARGUS 220ML,1,14500,0,14500,12500,2000
4/7/2021 21:30,ff,FULLO BLASTO,1,1000,0,1000,995,5
4/7/2021 21:30,SF TAWAR ORI,SAFFANAH TAWAR ORI,1,9000,0,9000,8000,1000
4/7/2021 21:30,8997018250218,JAHE MERAH,1,1000,0,1000,833,167
4/7/2021 21:30,8998866202343,MIE SEDAAP KOREAN SPICY,1,2500,0,2500,2023,477
4/7/2021 21:30,8998866202619,MIE SEDAAP KOREAN SPICY SOUP,1,2500,0,2500,2273,227
4/7/2021 21:45,8998989500166,GUDANG GARAM MERAH BESAR 16KS,3,17000,0,51000,45900,5100
4/7/2021 21:45,SOSIS,SO NICE SAPI,1,1000,0,1000,940,60
4/7/2021 21:45,8997021870892,HOT IN CREAM STRONG 120G,1,18500,0,18500,17000,1500
4/7/2021 21:45,8991004011906,KOPI BORONG,1,10000,0,10000,8333,1667
4/7/2021 21:45,8994834003752,TICTIC,1,2000,0,2000,1700,300
4/7/2021 21:45,089686041705,INDOMIE GORENG JUMBO,1,3500,0,3500,3143,357
4/7/2021 21:45,8999999059781,SUNLIGHT LIME NEW POUCH 210ML,1,5000,0,5000,4300,700
4/7/2021 21:45,8886013213208,FRENCH FREIS 2000,1,5000,0,5000,3750,1250
4/7/2021 21:45,6907992825069,JD FRUITY,1,5000,0,5000,4400,600
4/7/2021 21:45,8999999034726,PONDS MEN WHITE BOOST 50G,1,18500,0,18500,17160,1340
4/7/2021 21:45,8991102385336,TANGO WAFFLE MILK,1,8000,0,8000,6212,1788
4/7/2021 21:45,8996001440049,ENERGEN,4,1500,0,6000,4800,1200
4/7/2021 21:45,8996001304143,SLAI OLAI NANAS,1,12000,0,12000,9900,2100
4/7/2021 21:45,8999999552473,PEPSODENT ACTION123 SIWAK 65G,1,6200,0,6200,5600,600
4/7/2021 21:45,8991102384841,WFR TANGO LONG CKLT 130G,1,5000,0,5000,3773,1227
4/7/2021 21:45,8997218380135,ICHITAN GREEN TEA,1,8000,0,8000,6583,1417
4/7/2021 21:45,8993007003063,ENAAK 500G,1,11000,0,11000,9625,1375
4/7/2021 21:45,8998866200882,SUKSESMIE GORENG AYAM KRMS 133GR,1,3500,0,3500,3047,453
4/7/2021 21:45,089686021141,INTER MIE SOTO,1,1000,0,1000,854,146
4/7/2021 21:45,8998866202619,MIE SEDAAP KOREAN SPICY SOUP,1,2500,0,2500,2273,227
4/7/2021 21:45,TG APEL,TEH GELAS APEL,1,2000,0,2000,1178,822
4/7/2021 21:45,8993470279651,JOGER CHOCKY BAR,1,1000,0,1000,867,133
4/7/2021 21:45,JGR SHN,JOGER SHINY SACHET,1,500,0,500,437,63
4/7/2021 21:45,8996001370063,CHOKI-CHOKI,1,18200,0,18200,16500,1700
4/7/2021 21:45,8851019210193,POCKY CHOCO BANANA 47G,1,7300,0,7300,5671,1629
4/7/2021 21:45,8992775001660,WAFER CREAM COKLAT TABUR KEJU,1,19000,0,19000,17721,1279
4/7/2021 21:45,8992696404441,BEAR BRAND 189ML,1,8500,0,8500,7887,613
4/7/2021 21:45,BALON,BALON CABUTR,2,1000,0,2000,1800,200
4/7/2021 21:45,8992946511790,SHINZUI 85G,1,5000,0,5000,3475,1525
4/7/2021 21:45,8999999024772,VASELINE HW PERFECT 10 100 ML,1,19000,0,19000,17600,1400
4/7/2021 21:45,8991111109121,JB POWDER BLOSSOM 75+25G,1,6000,0,6000,5430,570
4/7/2021 21:45,8998989300261,GUDANG GARAM SURYA 12 FILTER,2,18000,0,36000,32900,3100
4/7/2021 21:45,123124,KOREK BIASA,1,2000,0,2000,1800,200
4/7/2021 21:50,8997027300089,NOMOS,1,4000,0,4000,2963,1037
4/7/2021 21:50,8999909096004,SAMPOERNA 16 FILTER,1,24000,0,24000,23000,1000
4/7/2021 21:50,ff,FULLO BLASTO,1,1000,0,1000,995,5
4/7/2021 21:50,11,PASEO SMART FHSTD PERF 6P 12S,1,5000,0,5000,4264,736
4/7/2021 21:50,8998866609487,SOKLIN SOFTERGEN 280G,1,5000,0,5000,4425,575
4/7/2021 21:50,8998866604512,FRES&NATURAL SOAP VIOLET 65G,2,1800,0,3600,2850,750
4/7/2021 21:50,8998866501033,MINYAK GORENG SEDAAP POUCH 2L,1,28000,0,28000,27746,254
4/7/2021 22:03,BTS,BIMURA TARO SEAWEED 250G,1,10000,0,10000,9300,700
4/7/2021 22:03,8993989311279,CLAS MILD 12,1,17000,0,17000,15700,1300
4/7/2021 22:03,8996001600269,LE MINERAL 600ML,1,3000,0,3000,1688,1312
4/7/2021 22:03,8992761111533,SPRITE SLIM CAM250ML,2,5000,0,10000,7500,2500
4/7/2021 22:03,HT,HOT-HOT,1,500,0,500,350,150
4/7/2021 22:03,8994834005923,SPIX 1000,7,1000,0,7000,5950,1050
4/7/2021 22:03,SOSIS,SO NICE SAPI,3,1000,0,3000,2820,180
4/7/2021 22:03,8992696404441,BEAR BRAND 189ML,1,8500,0,8500,7887,613
4/7/2021 22:03,8997009510055,YOU C1000,2,8000,0,16000,9692,6308
4/7/2021 22:03,8997218380135,ICHITAN GREEN TEA,1,8000,0,8000,6583,1417
4/7/2021 22:03,089686021219,INTER MIE GORENG,3,1000,0,3000,2655,345
4/7/2021 22:03,8996001312278,MALKIST KEJU MANIS,1,6500,0,6500,5400,1100
4/7/2021 22:03,YP,YUPI,2,250,0,500,416,84
4/7/2021 22:03,kp,KALPA,2,2000,0,4000,3332,668
4/7/2021 22:03,VTM,VITAMIN,6,500,0,3000,2550,450
4/7/2021 22:03,8993226365522,GARAM MEJA GYURI 200GR,2,2000,0,4000,3400,600
4/7/2021 22:03,8992717781001,NATA DE COCO,3,13000,0,39000,36249,2751
4/7/2021 22:03,8993007003063,ENAAK 500G,2,11000,0,22000,19250,2750
4/7/2021 22:03,8994021000915,CINCAO,6,3000,0,18000,11748,6252
4/7/2021 22:03,8997011700345,MIE KERING LANGIT BIRU,1,23000,0,23000,21000,2000
4/7/2021 22:03,YOUTOP,YOUTOP,1,1000,0,1000,875,125
4/7/2021 22:03,8993379152017,SABUN CUCI SURYA 200G,1,3000,0,3000,2281,719
4/7/2021 22:03,6921101219235,YAKUAT JELLY,1,2000,0,2000,1750,250
4/7/2021 22:03,8998989300261,GUDANG GARAM SURYA 12 FILTER,1,18000,0,18000,16450,1550
4/7/2021 22:03,ff,FULLO BLASTO,1,1000,0,1000,995,5
4/7/2021 22:03,8994867000179,ROKOK PENA MILD 16,1,14500,0,14500,13000,1500
4/7/2021 22:03,MARS,MARSHMELLOW,1,500,0,500,433,67
4/7/2021 22:03,8998009010590,ULTRA CHO 125,1,3000,0,3000,2428,572
4/7/2021 22:03,6907992823652,JD CHOCOLATE MILKSHAKE,3,6000,0,18000,15600,2400
4/7/2021 22:03,8991102989312,WFR TANGO SBJ 7G,1,8300,0,8300,7455,845
4/7/2021 22:03,8992870311091,SALONPAS,1,6000,0,6000,4806,1194
4/7/2021 22:10,SOSIS,SO NICE SAPI,2,1000,0,2000,1880,120
4/7/2021 22:10,6921101219235,YAKUAT JELLY,2,2000,0,4000,3500,500
4/7/2021 22:10,8998866202770,MIE SEDAAP SALERO PADANG,4,2500,0,10000,9448,552
4/7/2021 22:10,8991102385060,TANGO WAFFLE CHOX,1,8000,0,8000,6212,1788
4/7/2021 22:10,8991102385336,TANGO WAFFLE MILK,1,8000,0,8000,6212,1788
4/7/2021 22:10,JGR,JOGER CHOCKY PASTA,1,20000,0,20000,18190,1810
4/7/2021 22:10,PUL,PULPEN,5,1500,0,7500,4165,3335
4/7/2021 22:10,6907992825069,JD FRUITY,1,5000,0,5000,4400,600
4/7/2021 22:10,8996001603376,ENERGEN KURMA,1,2000,0,2000,1500,500
4/7/2021 22:10,VTM,VITAMIN,1,500,0,500,425,75
4/7/2021 22:10,8998866202244,EKOMIE BUMBU KALDU AYAM,1,1000,0,1000,798,202
4/7/2021 22:10,8996001305126,ARDEN,1,18000,0,18000,16300,1700
4/7/2021 22:10,8999999524722,SUNLIGHT LIME NEW PCH 435ML,1,10000,0,10000,9100,900
4/7/2021 22:10,GL,GULA 1 LITER,2,11500,0,23000,21000,2000
4/7/2021 22:10,8999999401221,RINSO ANTI NODA CLASSIC 430G,1,10800,0,10800,9806,994
4/7/2021 22:10,8998989300261,GUDANG GARAM SURYA 12 FILTER,1,18000,0,18000,16450,1550
4/7/2021 22:29,MOBIL,GULA GULA HP,1,2000,0,2000,1700,300
4/7/2021 22:29,8998989110167,SURYA GUDANG GARAM 16 FILTER,1,24000,0,24000,22100,1900
4/7/2021 22:29,8996001305041,ROMA SANDWICH CKLT,1,7000,0,7000,5000,2000
4/7/2021 22:29,8998989500166,GUDANG GARAM MERAH BESAR 16KS,1,17000,0,17000,15300,1700
4/7/2021 22:29,8998866202671,NOODLE SEDAAP MIE KOREAN SPICY SOUP CUP,1,5000,0,5000,4002,998
4/7/2021 22:29,089686048704,SARIMIE GORENG AYAM KCP ISI 2,1,3500,0,3500,3120,380
4/7/2021 22:29,8999999559045,SUNLIGHT LIME CREAM 110G,1,2000,0,2000,1800,200
4/7/2021 22:29,8998866202404,NOODLE SEDAAP MIE KOREAN SPICY CHICKEN CUP,1,5000,0,5000,4002,998
4/7/2021 22:29,8992628020152,BIMOLI POUCH 2L,1,30000,0,30000,28983,1017
4/7/2021 22:29,8996001600399,LE MINERAL 1500ML,1,5000,0,5000,4042,958
4/7/2021 22:29,SOSIS,SO NICE SAPI,2,1000,0,2000,1880,120
4/7/2021 22:29,8998866202244,EKOMIE BUMBU KALDU AYAM,5,1000,0,5000,3990,1010
4/7/2021 22:29,8993176110074,MINYAK KAYU PUTIH 60ML,1,20000,0,20000,17333,2667
4/7/2021 22:29,SONICE,SONICE SOSIS AYAM,1,24000,0,24000,23500,500
4/7/2021 22:29,8998866202732,MILKU STROBERI 200ML,1,3000,0,3000,2375,625
4/7/2021 22:29,GL,GULA 1 LITER,1,11500,0,11500,10500,1000
4/7/2021 22:29,8999999037765,PEPSODENT WHITE 225G,1,12000,0,12000,10750,1250
4/7/2021 22:29,8999999529550,CLEAR COMPLETE SOFT CARE 80ML,1,11200,0,11200,10120,1080
4/7/2021 22:29,8991102022347,SIKAT GIGI FORMULA RIPPLE,1,5000,0,5000,4583,417
4/7/2021 22:29,8991102384841,WFR TANGO LONG CKLT 130G,2,5000,0,10000,7546,2454
4/7/2021 22:29,8993083929806,BISKITOP COKLAT,1,30000,0,30000,27000,3000
4/7/2021 22:29,001,PASEO SMART FACIAL SF 250S GT,1,10000,0,10000,9500,500
4/7/2021 22:29,BTS,BIMURA TARO SEAWEED 250G,1,10000,0,10000,9300,700
4/7/2021 22:29,8992705045122,AGAR-AGAR SATELIT HIJAU,1,3500,0,3500,2604,896
4/7/2021 22:29,8992705035123,AGAR-AGAR SATELIT COKLAT,1,3500,0,3500,2604,896
4/7/2021 22:29,8992705025124,AGAR-AGAR SATELIT MERAH,1,3500,0,3500,2604,896
4/7/2021 22:29,8998866610087,JAVANA ORIGINAL 350ML,1,3000,0,3000,2150,850
4/7/2021 22:29,8992696405486,DNCO FULL CREAM 400G,1,42000,0,42000,39537,2463
4/7/2021 22:29,8996001305003,SARI GANDUM SANDWICH,1,6000,0,6000,5100,900
4/7/2021 22:29,8998866200301,MIE SEDAAP GORENG,3,2500,0,7500,6069,1431
4/7/2021 22:29,8992761122331,FRESTEA APPEL 500ML,1,6500,0,6500,4708,1792
4/7/2021 22:29,JGR SHN,JOGER SHINY SACHET,1,500,0,500,437,63
4/7/2021 22:29,089686043051,INDOMIE COTO MAKASSAR,2,2800,0,5600,5050,550
4/7/2021 22:29,8999999059316,LIFEBOUY TS MILDCARE 75G,1,3000,0,3000,2500,500
4/7/2021 22:29,8995333032113,TERIGU GATOT KACA 1 KG,1,8500,0,8500,8012,488
4/7/2021 22:29,FUZO,KUACI FUZO,1,1000,0,1000,850,150
4/7/2021 22:29,8999999195656,SARI WANGI 50X1.85,1,10000,0,10000,8700,1300
4/7/2021 22:29,8994834003752,TICTIC,1,2000,0,2000,1700,300
4/7/2021 22:29,8998866202060,POTABEE AYAM BAKAR PEDAS 35 GR,1,5000,0,5000,4150,850
4/7/2021 22:29,8999999048167,SUNSILK SHP BLACK SHINE 9ML,1,10500,0,10500,9300,1200
4/7/2021 22:29,8997028590014,ARGUS 220ML,2,500,0,1000,604,396
4/7/2021 22:29,ff,FULLO BLASTO,3,1000,0,3000,2985,15
4/7/2021 22:39,8998866202695,KOPI MAYOR,2,6000,0,12000,9000,3000
4/7/2021 22:39,8993379152017,SABUN CUCI SURYA 200G,1,3000,0,3000,2281,719
4/7/2021 22:39,SF TAWAR ORI,SAFFANAH TAWAR ORI,1,9000,0,9000,8000,1000
4/7/2021 22:39,8992702000018,INDOMILK 370G,1,10000,0,10000,9020,980
4/7/2021 22:39,8992388133017,NU MILK TEA ORI 330ML,1,5000,0,5000,5125,-125
4/7/2021 22:39,8886013213208,FRENCH FREIS 2000,1,5000,0,5000,3750,1250
4/7/2021 22:39,BTS,BIMURA TARO SEAWEED 250G,1,10000,0,10000,9300,700
4/7/2021 22:39,SF BOX,SAFFANAH ROTI BOX,1,12000,0,12000,10500,1500
4/7/2021 22:39,GL,GULA 1 LITER,2,11500,0,23000,21000,2000
4/7/2021 22:39,8997009510116,LEMON WATER,1,7000,0,7000,5694,1306
4/7/2021 22:39,8992761164546,NUTRIBOOST STRAWBERRY 300ML,1,6500,0,6500,5300,1200
4/11/2021 11:44,GL,GULA 1 LITER,2,11500,0,23000,21000,2000
4/11/2021 11:44,8999801700030,SUSU FOYU,3,11500,0,34500,31350,3150
4/11/2021 11:44,8997021300092,LARISSA BAWANG 250GR,1,5500,0,5500,5125,375
4/11/2021 11:44,8992770061034,SAJIKU,2,2000,0,4000,3000,1000
4/11/2021 11:44,089686440287,OPOR AYAM,2,5000,0,10000,9000,1000
4/11/2021 11:44,8850507002968,A1 KING TRUCK,1,16500,0,16500,15500,1000
4/11/2021 11:44,BALON,BALON CABUTR,3,1000,0,3000,2700,300
4/11/2021 12:09,8992959508848,SWEETY SILVER PANTS L 18,1,41500,0,41500,37728,3772
4/11/2021 12:15,089686821086,ICHI OCHA MELATI,1,3000,0,3000,2250,750
4/11/2021 12:15,8998866609487,SOKLIN SOFTERGEN 280G,1,5000,0,5000,4425,575
4/11/2021 12:15,8999999045265,RINSO MOLTO ROSE FRESH PWD 770GR,1,21600,0,21600,19338,2262
4/11/2021 12:15,8999999524722,SUNLIGHT LIME NEW PCH 435ML,1,10000,0,10000,9100,900
4/11/2021 12:15,001,PASEO SMART FACIAL SF 250S GT,1,10000,0,10000,9500,500
4/11/2021 12:15,8998989300261,GUDANG GARAM SURYA 12 FILTER,1,18000,0,18000,16450,1550
4/11/2021 12:15,123124,KOREK BIASA,1,2000,0,2000,1800,200
4/11/2021 12:15,089686834055,FREISS JERUK,1,11000,0,11000,8750,2250
4/11/2021 12:15,8993989311279,CLAS MILD 12,1,17000,0,17000,15700,1300
4/11/2021 12:15,GL,GULA 1 LITER,1,11500,0,11500,10500,1000
4/11/2021 12:15,8992775310212,GERY PASTA COKELAT,1,18000,0,18000,16029,1971
4/11/2021 12:15,8998866202237,NOODLE SEDAAP TASTY AYAM GEPREK 124 GR,1,5000,0,5000,4167,833
4/11/2021 12:15,KJ,KINDER JOY,1,2000,0,2000,1583,417
4/11/2021 12:15,8995333060703,TERIGU KOMPAS 1KG,1,10500,0,10500,9816,684
4/11/2021 12:15,HT,HOT-HOT,2,500,0,1000,700,300
4/11/2021 12:16,8999999059309,LIFEBOUY TS TOTAL 10 DG 75G,2,3000,0,6000,5000,1000
4/11/2021 12:16,8997028590014,ARGUS 220ML,1,500,0,500,302,198
4/11/2021 12:31,JGR SHN,JOGER SHINY SACHET,2,500,0,1000,874,126
4/11/2021 12:31,8998989300261,GUDANG GARAM SURYA 12 FILTER,1,18000,0,18000,16450,1550
4/11/2021 12:31,MARS,MARSHMELLOW,4,500,0,2000,1732,268
4/11/2021 12:31,8993989311279,CLAS MILD 12,1,17000,0,17000,15700,1300
4/11/2021 12:31,8996001355237,SUPER STAR,1,11000,0,11000,9900,1100
4/11/2021 12:31,8999999045265,RINSO MOLTO ROSE FRESH PWD 770GR,1,21600,0,21600,19338,2262
4/11/2021 12:31,8999999524722,SUNLIGHT LIME NEW PCH 435ML,1,10000,0,10000,9100,900
4/11/2021 12:31,8993007003063,ENAAK 500G,1,11000,0,11000,9625,1375
4/11/2021 12:31,8999999195649,SARI WANGI 25X1.86G,1,6000,0,6000,5050,950
4/11/2021 12:31,SF TAWAR ORI,SAFFANAH TAWAR ORI,1,9000,0,9000,8000,1000
4/11/2021 12:31,8991004011906,KOPI BORONG,1,10000,0,10000,8333,1667
4/11/2021 12:31,8992388101085,NU GREEN TEA ORIGINAL 330ML,1,3500,0,3500,2854,646
4/11/2021 12:31,SS,SUPER SNAPS,1,1500,0,1500,1333,167
4/11/2021 12:31,TG,TEH GELAS,1,1000,0,1000,729,271
4/11/2021 12:31,8992694247255,ZWITSAL BATH NAT HAIR&BODY 200ML,1,20500,0,20500,18810,1690
4/11/2021 12:31,8999909010567,234 16 FILTER,1,22000,0,22000,21500,500
4/11/2021 12:31,9556001004673,MILO NESTLE MALAYSIA ACTIVE GO,1,85000,0,85000,80000,5000
4/11/2021 12:32,6907992823652,JD CHOCOLATE MILKSHAKE,2,6000,0,12000,10400,1600
4/11/2021 12:59,8998866200578,MIE SEDAAP KARI KENTAL,2,2500,0,5000,4526,474
4/11/2021 12:59,8998866613729,EMERON LOVELY NTRL 100ML,1,3500,0,3500,2900,600
4/11/2021 12:59,8998866808729,ROYALE SOFT WHITE,1,5000,0,5000,4500,500
4/11/2021 12:59,8999999531478,MOLTO BLACK PURPLE,1,5500,0,5500,4800,700
4/11/2021 12:59,8998989500128,GUDANG GARAM MERAH KECIL 12KS,2,13000,0,26000,23800,2200
4/11/2021 12:59,8999999706180,PEPSODENT WHITE 190GR,2,10000,0,20000,18700,1300
4/11/2021 12:59,8886013213208,FRENCH FREIS 2000,2,5000,0,10000,7500,2500
4/11/2021 12:59,001,PASEO SMART FACIAL SF 250S GT,1,10000,0,10000,9500,500
4/11/2021 12:59,8999801700030,SUSU FOYU,3,11500,0,34500,31350,3150
4/11/2021 12:59,8998866606158,NUVO ACTIVE COOL 110G,2,3000,0,6000,5200,800
4/11/2021 12:59,8999999526863,MOLTO ALL IN ONE PINK 11ML,1,5500,0,5500,4800,700
4/11/2021 12:59,8998866201841,GOLDA DOLCE LATTE 200ML,1,3000,0,3000,2500,500
4/11/2021 12:59,8999999502393,ROYCO FDS CHICKEN 8G,1,5000,0,5000,4500,500
4/11/2021 12:59,8992736980164,SASA TEPUNG KENTUCKY 80G,2,3000,0,6000,4362,1638
4/11/2021 12:59,8992736025162,SASA TEPUNG PISANG GORENG,1,5000,0,5000,4455,545
4/11/2021 12:59,8992742360844,POLYTEX SABUT STENLESS,2,4000,0,8000,4400,3600
4/11/2021 12:59,8992761139018,ADES 600ML,1,3500,0,3500,2292,1208
4/11/2021 12:59,VTM,VITAMIN,1,500,0,500,425,75
4/11/2021 12:59,8997018250218,JAHE MERAH,2,1000,0,2000,1666,334
4/11/2021 12:59,8994834005923,SPIX 1000,5,1000,0,5000,4250,750
4/11/2021 12:59,8999999558086,RINSO MOLTO FERFUME ESSENSE PWD 44G,6,1000,0,6000,4830,1170
4/11/2021 12:59,8997028590014,ARGUS 220ML,4,500,0,2000,1208,792
4/11/2021 12:59,8998866202770,MIE SEDAAP SALERO PADANG,1,2500,0,2500,2362,138
4/11/2021 12:59,8991102987639,WFR TANGO LONG VNL 130G,1,5000,0,5000,3773,1227
4/11/2021 12:59,8992775001653,GERY SALUT CHOCOLATE COCONUT,1,2000,0,2000,1476,524
4/11/2021 12:59,8998989300261,GUDANG GARAM SURYA 12 FILTER,1,18000,0,18000,16450,1550
4/11/2021 12:59,8998866608718,DAIA SOFTENER PINK,1,5000,0,5000,4450,550
4/11/2021 12:59,MOLTO PINK,MOLTO ALL IN ONE 11 ML,4,500,0,2000,1600,400
4/11/2021 12:59,8995333060703,TERIGU KOMPAS 1KG,1,10500,0,10500,9816,684
4/11/2021 12:59,GL,GULA 1 LITER,2,11500,0,23000,21000,2000
4/11/2021 12:59,8991004011906,KOPI BORONG,1,10000,0,10000,8333,1667
4/11/2021 12:59,089686043051,INDOMIE COTO MAKASSAR,2,2800,0,5600,5050,550
4/11/2021 12:59,089686010107,INDOMIE KALDU AYAM,2,2500,0,5000,4300,700
4/11/2021 12:59,8996001302323,MALKIST ABON,1,6500,0,6500,4800,1700
4/11/2021 12:59,8996001301579,MALKIST CKLT KELAPA PACK,1,6500,0,6500,5400,1100
4/11/2021 12:59,8996001305041,ROMA SANDWICH CKLT,1,7000,0,7000,5000,2000
4/11/2021 12:59,8996001301142,ROMA KELAPA,1,8000,0,8000,6628,1372
4/11/2021 12:59,8996001312353,MALKIST KELAPA KOPYOR,1,6700,0,6700,5400,1300
4/11/2021 12:59,8992775312469,GERY SALUT COKELAT,1,11000,0,11000,9983,1017
4/11/2021 12:59,089686821086,ICHI OCHA MELATI,1,3000,0,3000,2250,750
4/11/2021 13:01,8997021870892,HOT IN CREAM STRONG 120G,1,18500,0,18500,17000,1500
4/11/2021 13:01,089686400816,SAMBAL EXTRA PEDAS 135ML,1,5500,0,5500,4950,550
4/11/2021 13:01,8998866608008,KECAP MANIS SEDAAP BOTOL 135 ML,1,6500,0,6500,5875,625
4/11/2021 14:01,MRC,MERICA LADA,6,1000,0,6000,5334,666
4/11/2021 14:01,8996001305041,ROMA SANDWICH CKLT,1,7000,0,7000,5000,2000
4/11/2021 14:01,8996001301142,ROMA KELAPA,1,8000,0,8000,6628,1372
4/11/2021 14:01,8991102281430,PERMEN MINTZ DUOMINT,1,4500,0,4500,4000,500
4/11/2021 14:01,001,PASEO SMART FACIAL SF 250S GT,1,10000,0,10000,9500,500
4/11/2021 14:01,8992959117613,SFX DAUN SIRIH WING 1,1,5000,0,5000,4130,870
4/11/2021 14:01,8998866604963,POWDET DAIA LEMON 290GR,1,5000,0,5000,4450,550
4/11/2021 14:01,8999999059781,SUNLIGHT LIME NEW POUCH 210ML,1,5000,0,5000,4300,700
4/11/2021 14:01,8992702000063,INDOMILK COKLAT 370G,1,10000,0,10000,9020,980
4/11/2021 14:01,8992696404441,BEAR BRAND 189ML,1,8500,0,8500,7887,613
4/11/2021 14:01,8999999030186,PEPSODENT ACTION 123 COMPLETE 190G,1,14000,0,14000,13200,800
4/11/2021 14:01,8999999526856,MOLTO ALL IN ONE BLUE 11ML,1,5500,0,5500,4800,700
4/11/2021 14:01,8999999017804,CITRA BW NATURAL WHITE LD 400ML,1,21000,0,21000,19000,2000
4/11/2021 14:01,8998866200325,MIE SEDAAP SOTO,4,2500,0,10000,7808,2192
4/11/2021 14:01,8998866200301,MIE SEDAAP GORENG,2,2500,0,5000,4046,954
4/11/2021 14:01,8998866603546,SOKLIN FLOORCLENER UNGU 450ML,1,7000,0,7000,6385,615
4/11/2021 14:05,8994867007161,ROKOK PENA GOLD 20,1,17000,0,17000,15000,2000
4/11/2021 14:05,8999909096004,SAMPOERNA 16 FILTER,1,24000,0,24000,23000,1000
4/11/2021 15:12,8994834005923,SPIX 1000,2,1000,0,2000,1700,300
4/11/2021 15:12,8992761139018,ADES 600ML,1,3500,0,3500,2292,1208
4/11/2021 15:12,8998866501026,MINYAK GORENG SEDAAP POUCH 1 L,3,15000,0,45000,42330,2670
4/11/2021 15:12,089686010824,INDOMIE GORENG SPESIAL,3,2700,0,8100,7356,744
4/11/2021 15:12,089686017748,SARIMIE GORENG ISI 2,2,3500,0,7000,6240,760
4/11/2021 15:12,JGR SHN,JOGER SHINY SACHET,1,500,0,500,437,63
4/11/2021 15:12,HT,HOT-HOT,2,500,0,1000,700,300
4/11/2021 15:12,SOSIS,SO NICE SAPI,2,1000,0,2000,1880,120
4/11/2021 15:12,SF TAWAR ORI,SAFFANAH TAWAR ORI,1,9000,0,9000,8000,1000
4/11/2021 15:12,9556001047175,NESCAFE ORI 240ML,1,8500,0,8500,7337,1163
4/11/2021 15:12,SF SOSIS,SAFFANAH ROTI SOSIS,2,6000,0,12000,11000,1000
4/11/2021 15:12,089686021219,INTER MIE GORENG,4,1000,0,4000,3540,460
4/11/2021 15:12,8997028590014,ARGUS 220ML,5,500,0,2500,1510,990
4/11/2021 15:12,6907992825069,JD FRUITY,1,5000,0,5000,4400,600
4/11/2021 15:12,8998866610087,JAVANA ORIGINAL 350ML,1,3000,0,3000,2150,850
4/11/2021 15:12,8996001318430,BETTER 1000,1,1000,0,1000,820,180
4/11/2021 15:42,8997013790092,BIMURA KERUPUK BAWANG 25G,1,1000,0,1000,874,126
4/11/2021 15:42,6907992823652,JD CHOCOLATE MILKSHAKE,3,6000,0,18000,15600,2400
4/11/2021 15:42,089686010107,INDOMIE KALDU AYAM,1,2500,0,2500,2150,350
4/11/2021 15:42,089686011036,INDOMIE GORENG PEDAS,1,2700,0,2700,2452,248
4/11/2021 15:42,8998866613699,EMERON LOVELY COOLBRIGHT 100ML,1,4300,0,4300,3800,500
4/11/2021 15:42,8998866108126,POSH HIJAB WINTER MAGIC 150ML,1,19500,0,19500,17500,2000
4/11/2021 15:42,8998866201841,GOLDA DOLCE LATTE 200ML,1,3000,0,3000,2500,500
4/11/2021 15:42,JGR SHN,JOGER SHINY SACHET,4,500,0,2000,1748,252
4/11/2021 15:42,8999999059781,SUNLIGHT LIME NEW POUCH 210ML,1,5000,0,5000,4300,700
4/11/2021 15:42,8996001600375,LE MINERAL 330ML,2,2000,0,4000,2834,1166
4/11/2021 15:42,8999909010567,234 16 FILTER,2,22000,0,44000,43000,1000
4/11/2021 15:42,11222,LEM KOREA,1,9000,0,9000,8000,1000
4/11/2021 15:42,8995102703534,TERASI DUO 6 GR,1,4000,0,4000,3720,280
4/11/2021 15:42,8994867000179,ROKOK PENA MILD 16,1,14500,0,14500,13000,1500
4/11/2021 15:42,8998866608756,SOKLIN SOFTENER TWILIGHT BLUE 14SCH,1,5000,0,5000,4560,440
4/11/2021 15:42,8998866202343,MIE SEDAAP KOREAN SPICY,2,2500,0,5000,4046,954
4/11/2021 15:42,8998866200301,MIE SEDAAP GORENG,3,2500,0,7500,6069,1431
4/11/2021 15:42,089686021127,INTER MIE KALDU,1,1000,0,1000,813,187
4/11/2021 15:42,089686021141,INTER MIE SOTO,2,1000,0,2000,1708,292
4/11/2021 15:42,8997028590014,ARGUS 220ML,14,500,0,7000,4228,2772
4/11/2021 15:42,8997013790108,BIMURA KACANG TELUR 25G,1,1000,0,1000,875,125
4/11/2021 15:42,089686043051,INDOMIE COTO MAKASSAR,1,2800,0,2800,2525,275
4/11/2021 15:42,8999801700030,SUSU FOYU,1,11500,0,11500,10450,1050
4/11/2021 15:42,GL,GULA 1 LITER,1,11500,0,11500,10500,1000
4/11/2021 15:42,8992736980164,SASA TEPUNG KENTUCKY 80G,1,3000,0,3000,2181,819
4/11/2021 15:42,8995333000822,TERIGU KOMPAS SOFT 500GR,1,5500,0,5500,4967,533
4/11/2021 15:42,8999999401238,RINSO ANTI NODA 770G,1,21200,0,21200,19338,1862
4/11/2021 15:42,8999999518998,RINSO MOLTO PERFUME ESSENSE 770GR,1,21300,0,21300,19338,1962
4/11/2021 15:42,8993560026066,DETTOL COOL,1,20000,0,20000,18524,1476
4/11/2021 15:42,8998866603546,SOKLIN FLOORCLENER UNGU 450ML,1,7000,0,7000,6385,615
4/11/2021 15:42,MG,MINYAK GOSOK SAFERTABAT,1,28000,0,28000,25000,3000
4/11/2021 15:42,8999909096004,SAMPOERNA 16 FILTER,1,24000,0,24000,23000,1000
4/11/2021 15:42,8991102987639,WFR TANGO LONG VNL 130G,1,5000,0,5000,3773,1227
4/11/2021 15:42,8999999526863,MOLTO ALL IN ONE PINK 11ML,1,5500,0,5500,4800,700
4/11/2021 15:42,8994867006997,ROKOK PENA BOLD 20BTG,1,17000,0,17000,15000,2000
4/11/2021 15:42,SF TAWAR ORI,SAFFANAH TAWAR ORI,1,9000,0,9000,8000,1000
4/11/2021 15:42,8992753102204,BKM COKLAT 370G,1,11300,0,11300,9500,1800
4/11/2021 15:42,8999999059323,LIFEBOUY LEMONFRESH DG 75G,1,3000,0,3000,2500,500
4/11/2021 15:42,8999999560584,LUX TS VELVET JASMINE 110G,1,4000,0,4000,3100,900
4/11/2021 15:42,8994834005923,SPIX 1000,2,1000,0,2000,1700,300
4/11/2021 15:42,SOSIS,SO NICE SAPI,1,1000,0,1000,940,60
4/11/2021 15:42,8998989300261,GUDANG GARAM SURYA 12 FILTER,1,18000,0,18000,16450,1550
4/11/2021 15:42,8994834003752,TICTIC,1,2000,0,2000,1700,300
4/11/2021 15:42,8992959953334,SWEETY BRONZE XL42,1,80000,0,80000,75455,4545
4/11/2021 15:42,8999909000544,MARLBORO F BLACK,1,29001,0,29001,27800,1201
4/11/2021 15:42,HT,HOT-HOT,1,500,0,500,350,150
4/11/2021 15:42,8993226365522,GARAM MEJA GYURI 200GR,1,2000,0,2000,1700,300
4/11/2021 15:42,8997009510116,LEMON WATER,1,7000,0,7000,5694,1306
4/11/2021 15:42,8998866201377,KRISBEE FRIES KENTANG GORENG 68 GR,1,5500,0,5500,4620,880
4/11/2021 15:42,8998866201711,KRISBEE KRUNCHY JAGUNG BAKAR MENTEGA 75 GR,1,5500,0,5500,4400,1100
4/11/2021 15:42,8998866693578,SOKLIN FLOORCLENER PINK 900ML,1,14000,0,14000,12436,1564
4/11/2021 15:42,8996001355237,SUPER STAR,1,11000,0,11000,9900,1100
4/11/2021 15:42,8996001351901,ZUPER KEJU SUSU,1,17000,0,17000,15500,1500
4/11/2021 15:42,8998866609029,DAIA PUTIH GUSSWET 565G,2,10000,0,20000,17400,2600
4/11/2021 15:42,8998866610278,DAIA VIOLET GUSSET 565G,1,10000,0,10000,8700,1300
4/11/2021 15:42,8995333060772,TERIGU GATOT KACA 500GR,6,4500,0,27000,24390,2610
4/11/2021 15:42,8998866200882,SUKSESMIE GORENG AYAM KRMS 133GR,6,3500,0,21000,18282,2718
4/11/2021 15:42,089686041705,INDOMIE GORENG JUMBO,4,3500,0,14000,12572,1428
4/11/2021 15:42,8999999504656,SARI MURNI 20X1.8G,1,5000,0,5000,4200,800
4/11/2021 16:06,8992761122331,FRESTEA APPEL 500ML,1,6500,0,6500,4708,1792
4/11/2021 16:21,089686021127,INTER MIE KALDU,1,1000,0,1000,813,187
4/11/2021 16:21,8999999707859,CLOSEUP GREEN 160G,1,15000,0,15000,13600,1400
4/11/2021 16:21,8993365131538,MADU TJ MURNI 150G,1,14800,0,14800,13430,1370
4/11/2021 17:11,8992388133345,NU MILK TEA TEH TARIK 330ML,1,6000,0,6000,5125,875
4/11/2021 17:11,8992696404441,BEAR BRAND 189ML,1,8500,0,8500,7887,613
4/11/2021 17:11,SF GULUNG,SAFFANAH ROTI GULUNG,1,6000,0,6000,5500,500
4/11/2021 18:12,8992761002039,FANTA STRAWBERRY PET 390 ML,1,5500,0,5500,4300,1200
4/11/2021 18:12,8992761002039,FANTA STRAWBERRY PET 390 ML,1,5500,0,5500,4300,1200
4/11/2021 18:13,8992761166038,MMP ORANGE 300ML,2,5000,0,10000,7500,2500
4/11/2021 18:21,8993072153595,LARISST COTTON 35G,1,5000,0,5000,3300,1700
4/11/2021 18:58,8992761139018,ADES 600ML,1,3500,0,3500,2292,1208
4/11/2021 18:58,JGR SHN,JOGER SHINY SACHET,3,500,0,1500,1311,189
4/11/2021 19:04,GL,GULA 1 LITER,2,11500,0,23000,21000,2000
4/11/2021 19:41,8997009510116,LEMON WATER,1,7000,0,7000,5694,1306
4/11/2021 20:28,8994867000162,ROKOK PUNDIMAS KRETEK16,2,10000,0,20000,17200,2800
4/11/2021 20:41,8991102380805,FULLO  CKL PCK 8G,1,10000,0,10000,9000,1000
4/11/2021 20:41,8991001121400,SILVERQUEEN ALMOND 65G,1,15000,0,15000,13200,1800
4/11/2021 20:41,KJ,KINDER JOY,3,2000,0,6000,4749,1251
4/11/2021 21:35,8992761166038,MMP ORANGE 300ML,2,5000,0,10000,7500,2500
4/11/2021 21:45,8992761166038,MMP ORANGE 300ML,1,5000,0,5000,3750,1250
4/11/2021 21:47,8992761111519,COCA COLA SLIM CAM 250ML,5,5000,0,25000,18750,6250
4/11/2021 21:47,8992761111540,FANTA STRAWBERY SLIM CAM 250ML,5,5000,0,25000,18750,6250
4/11/2021 21:47,8992761111533,SPRITE SLIM CAM250ML,5,5000,0,25000,18750,6250
4/11/2021 22:09,8992761145026,SPRITE PET 250ML,1,3500,0,3500,2417,1083
4/11/2021 22:09,8999909010567,234 16 FILTER,2,22000,0,44000,43000,1000
4/12/2021 10:37,8999999706111,PEPSODENT WHITE 25G,1,2000,0,2000,1450,550
4/12/2021 10:37,8998866103985,CIPT SIKP,1,3000,0,3000,2552,448
4/12/2021 10:45,8998009010590,ULTRA CHO 125,1,3000,0,3000,2428,572
4/12/2021 10:45,ff,FULLO BLASTO,2,1000,0,2000,1990,10
4/12/2021 10:45,kp,KALPA,1,2000,0,2000,1666,334
4/12/2021 11:30,8992761166205,FRESTEA GREEN HONEY 350ML,1,4500,0,4500,3000,1500
4/12/2021 11:30,VTM,VITAMIN,1,500,0,500,425,75
4/12/2021 12:12,8996001355237,SUPER STAR,1,11000,0,11000,9900,1100
4/12/2021 12:12,COKLAT,COKLAT COIN,3,500,0,1500,1200,300
4/12/2021 12:12,MARS,MARSHMELLOW,2,500,0,1000,866,134
4/12/2021 12:12,JGR SHN,JOGER SHINY SACHET,1,500,0,500,437,63
4/12/2021 12:27,8998989500128,GUDANG GARAM MERAH KECIL 12KS,1,13000,0,13000,11900,1100
4/12/2021 12:27,6907992823676,JD PEACH,2,2000,0,4000,3400,600
4/12/2021 13:12,8999909096004,SAMPOERNA 16 FILTER,1,24000,0,24000,23000,1000
4/12/2021 13:58,8998866201933,MINYAK GORENG SEDAAP 5 L,1,72000,0,72000,70230,1770
4/12/2021 14:00,8992717781001,NATA DE COCO,2,13000,0,26000,24166,1834
4/12/2021 14:00,711844130128,ABC SAUS TOMAT 275 ML,1,10000,0,10000,8800,1200
4/12/2021 14:00,711844120419,SAMBAL ABC 275 ML,1,12000,0,12000,10800,1200
4/12/2021 14:33,8992761166205,FRESTEA GREEN HONEY 350ML,1,4500,0,4500,3000,1500
4/12/2021 15:25,8992959117583,SFX DS REG FLOW WING 20,1,5000,0,5000,4288,712
4/12/2021 15:25,8996001350423,ZUPER KEJU,1,9200,0,9200,8360,840
4/12/2021 16:21,8886013213208,FRENCH FREIS 2000,1,5000,0,5000,3750,1250
4/12/2021 16:21,8998866693608,SOKLIN FLOORCLENER HIJAU 900ML,1,14000,0,14000,12436,1564
4/12/2021 16:21,8992702000018,INDOMILK 370G,1,10000,0,10000,9020,980
4/12/2021 16:21,8991001780492,SELAMAT COKLAT,1,13000,0,13000,11800,1200
4/12/2021 16:21,8998866100717,MAMALIME POUCH 780ML,1,15500,0,15500,13850,1650
4/12/2021 16:39,8998866200813,NOODLE SEDAAP MIE GORENG CUP 85 GR,1,5000,0,5000,3917,1083
4/12/2021 16:55,8998866201469,POTABEE REGULER BBQ BEEF 68 GR,1,8000,0,8000,7200,800
4/12/2021 16:55,6907992823867,JD CRUNCHY CHOCOLATE MALT,1,5500,0,5500,4700,800
4/12/2021 16:55,TG,TEH GELAS,2,1000,0,2000,1458,542
4/12/2021 16:56,JGR SHN,JOGER SHINY SACHET,1,500,0,500,437,63
4/12/2021 17:39,GL,GULA 1 LITER,2,11500,0,23000,21000,2000
4/12/2021 17:39,BALON,BALON CABUT,1,1000,0,1000,900,100
4/12/2021 17:39,6921101219235,YAKUAT JELLY,1,2000,0,2000,1750,250
4/12/2021 18:18,SOSIS,SO NICE SAPI,1,1000,0,1000,940,60
4/12/2021 18:18,8994834005923,SPIX 1000,1,1000,0,1000,850,150
4/12/2021 18:18,8996200900092,HEROCYN 85GR,1,13000,0,13000,11650,1350
4/12/2021 18:18,SF SOSIS,SAFFANAH ROTI SOSIS,1,6000,0,6000,5500,500
4/12/2021 18:18,6907992825069,JD FRUITY,1,5000,0,5000,4400,600
4/12/2021 18:18,8998989110167,SURYA GUDANG GARAM 16 FILTER,1,24000,0,24000,22100,1900
4/12/2021 18:20,8998866202671,NOODLE SEDAAP MIE KOREAN SPICY SOUP CUP,2,5000,0,10000,8004,1996
4/12/2021 18:34,8992761145026,SPRITE PET 250ML,1,3500,0,3500,2417,1083
4/12/2021 18:34,COKLAT,COKLAT COIN,1,500,0,500,400,100
4/12/2021 19:12,8998989300261,GUDANG GARAM SURYA 12 FILTER,1,18000,0,18000,16450,1550
4/12/2021 19:12,kp,KALPA,1,2000,0,2000,1666,334
4/12/2021 20:22,8998989500166,GUDANG GARAM MERAH BESAR 16KS,2,17000,0,34000,30600,3400
4/12/2021 20:24,8998009010590,ULTRA CHO 125,1,3000,0,3000,2428,572
4/12/2021 20:24,8992696404441,BEAR BRAND 189ML,1,8500,0,8500,7887,613
4/12/2021 20:24,089686021219,INTER MIE GORENG,3,1000,0,3000,2655,345
4/12/2021 20:38,SF TAWAR PND,SAFFANAH TAWAR PANDAN,1,9500,0,9500,8500,1000
4/12/2021 20:38,8998866102605,KODOMO TB REG 2IN1,1,7500,0,7500,6600,900
4/12/2021 21:19,8992761145019,COCA COLA PET 250ML,2,3500,0,7000,4834,2166
4/12/2021 21:19,8992761166212,FRESTEA APPLE 350ML,1,4500,0,4500,3000,1500
4/12/2021 21:19,8998866500708,FLORIDINA ORANGE,1,3000,0,3000,2500,500
4/12/2021 22:28,GL,GULA 1 LITER,1,11500,0,11500,10500,1000
4/12/2021 22:29,GL,GULA 1 LITER,5,11500,0,57500,52500,5000
4/12/2021 22:29,9556001047175,NESCAFE ORI 240ML,1,8500,0,8500,7337,1163
4/12/2021 22:29,8991102384841,WFR TANGO LONG CKLT 130G,1,5000,0,5000,3773,1227
4/12/2021 22:29,9556001025272,NESCAFE LATTE 240ML,1,8500,0,8500,7437,1063
4/12/2021 22:29,8994834005923,SPIX 1000,1,1000,0,1000,850,150
4/12/2021 22:31,ARG,ARGUS 220ML,10,14500,0,145000,125000,20000
4/13/2021 11:27,8999801700030,SUSU FOYU,1,11500,0,11500,10450,1050
4/13/2021 11:27,8992933214116,NUTRIJELL MELON,1,6000,0,6000,5041,959
4/13/2021 11:27,8992933213119,NUTRIJELL LECI,1,6000,0,6000,5041,959
4/13/2021 11:27,9556001004673,MILO NESTLE MALAYSIA ACTIVE GO,1,85000,0,85000,80000,5000
4/13/2021 11:27,8998866200325,MIE SEDAAP SOTO,2,2500,0,5000,3904,1096
4/13/2021 13:29,9556040040038,SUSU F&N,1,33000,0,33000,30000,3000
4/13/2021 13:29,8992696404441,BEAR BRAND 189ML,1,8500,0,8500,7887,613
4/13/2021 13:29,SF BOX,SAFFANAH ROTI BOX,1,12000,0,12000,10500,1500
4/13/2021 13:29,6907992823591,JD STRAW MILKSHAKE,1,5000,0,5000,4300,700
4/13/2021 13:29,8995333032113,TERIGU GATOT KACA 1 KG,1,8500,0,8500,8012,488
4/13/2021 13:29,8997028590014,ARGUS 220ML,4,500,0,2000,1208,792
4/13/2021 13:29,8992736980164,SASA TEPUNG KENTUCKY 80G,1,3000,0,3000,2181,819
4/13/2021 13:29,8997018250218,JAHE MERAH,1,1000,0,1000,833,167
4/13/2021 13:29,GL,GULA 1 LITER,1,11500,0,11500,10500,1000
4/13/2021 13:29,HT,HOT-HOT,1,500,0,500,350,150
4/13/2021 13:29,BRS,BERAS BUMN 10KG,1,128000,0,128000,100000,28000
4/13/2021 13:29,8991102385091,WFR TANGO CKLT 7G,1,8300,0,8300,7455,845
4/13/2021 13:29,8992761145026,SPRITE PET 250ML,1,3500,0,3500,2417,1083
4/13/2021 13:29,8990800020013,MENTOS MINT HALAL IND,1,5700,0,5700,5150,550
4/13/2021 14:29,8999801700030,SUSU FOYU,1,11500,0,11500,10450,1050
4/13/2021 14:29,8997018720018,SIRUP DHT,1,23000,0,23000,20958,2042
4/13/2021 14:29,8998866607315,SOKLIN SOFTERGENT SAKURA 770G & PIRING,1,18000,0,18000,16680,1320
4/13/2021 14:29,8997211400038,SANTAN COCONUT CREAM,1,4000,0,4000,3000,1000
4/13/2021 14:29,8998008151065,MIWON 100 GR,1,3300,0,3300,2996,304
4/13/2021 14:29,8992628605151,AMANDA MARGARINE,1,5000,0,5000,3806,1194
4/13/2021 14:34,089686021219,INTER MIE GORENG,4,1000,0,4000,3540,460
4/13/2021 15:03,8997211400038,SANTAN COCONUT CREAM,2,4000,0,8000,6000,2000
4/13/2021 15:03,SNTN,SANTAN BUBUK,1,2500,0,2500,1500,1000
4/13/2021 15:55,8997018720018,SIRUP DHT,1,23000,0,23000,20958,2042
4/13/2021 15:58,ARG,ARGUS 220ML,10,14500,0,145000,125000,20000
4/13/2021 16:23,8994867000162,ROKOK PUNDIMAS KRETEK16,1,10000,0,10000,8600,1400
4/13/2021 16:58,8992753101207,BENDERA KENTAL MANIS 370G,1,11500,0,11500,9700,1800
4/13/2021 16:58,8999999052959,PONDS WHITE BEAUTY FACIAL FOAM 50G,1,17000,0,17000,15600,1400
4/13/2021 16:58,8999999538453,SUNSILK SHP SOFT AND  SMOOTH 55 ML,1,5000,0,5000,3750,1250
4/13/2021 16:58,8999999549565,PONDS ROSE MICELLAR WTR 100ML,1,25000,0,25000,22800,2200
4/13/2021 17:00,001,PASEO SMART FACIAL SF 250S GT,1,10000,0,10000,9500,500
4/13/2021 17:00,9556040040038,SUSU F&N,1,33000,0,33000,30000,3000
4/13/2021 17:00,8993007003063,ENAAK 500G,1,11000,0,11000,9625,1375
4/14/2021 11:25,TGL,TEH GELAS DOS,1,20000,0,20000,17496,2504
4/14/2021 11:40,GL,GULA 1 LITER,6,11500,0,69000,63000,6000
4/14/2021 11:40,8998866608459,POWDET DAIA PUTIH BAG 290GR,1,5000,0,5000,4450,550
4/14/2021 11:40,8998866888615,GIV BIRU KOTAK 76G,2,2000,0,4000,3640,360
4/14/2021 11:40,SF SOSIS,SAFFANAH ROTI SOSIS,1,6000,0,6000,5500,500
4/14/2021 11:55,8998989300261,GUDANG GARAM SURYA 12 FILTER,1,18000,0,18000,16450,1550
4/14/2021 11:55,SF SOSIS,SAFFANAH ROTI SOSIS,1,6000,0,6000,5500,500
4/14/2021 11:55,8999999537180,CLEAR SHP LEMON FRESH 9 ML,1,10500,0,10500,9300,1200
4/14/2021 11:55,8998866202664,POTABEE WAGYU BEEF STEAK 68 GR,1,8000,0,8000,7200,800
4/14/2021 11:55,8998866202060,POTABEE AYAM BAKAR PEDAS 35 GR,2,5000,0,10000,8300,1700
4/14/2021 11:55,8886013213208,FRENCH FREIS 2000,1,5000,0,5000,3750,1250
4/14/2021 11:55,8998866202671,NOODLE SEDAAP MIE KOREAN SPICY SOUP CUP,1,5000,0,5000,4002,998
4/14/2021 11:55,8999999007768,FAIR&LOVELY MULTIVITAMIN  CREAM 9 ML,1,4500,0,4500,3200,1300
4/14/2021 12:02,8999999706111,PEPSODENT WHITE 25G,1,2000,0,2000,1450,550
4/14/2021 12:02,8992725910400,LISTERINE COOLMINT 100ML,1,7500,0,7500,6800,700
4/14/2021 12:02,8991111101507,JB POWDER BLOSSOM 50G,1,3500,0,3500,3000,500
4/14/2021 12:02,8998866106504,EMERON LOVELY NAT PINK,1,3500,0,3500,2900,600
4/14/2021 12:02,8991111101316,JB OIL 50ML,1,9500,0,9500,8700,800
4/14/2021 12:04,8992717900310,KARA SUN,1,2500,0,2500,2000,500
4/14/2021 12:21,bb,BENG-BENG,2,1500,0,3000,2900,100
4/14/2021 12:21,8992775001653,GERY SALUT CHOCOLATE COCONUT,1,2000,0,2000,1476,524
4/14/2021 12:27,8997018720018,SIRUP DHT,1,23000,0,23000,20958,2042
4/14/2021 12:27,8996001603376,ENERGEN KURMA,10,2000,0,20000,15000,5000
4/14/2021 12:27,6291100212866,KURMA KHALAS,1,85000,0,85000,80000,5000
4/14/2021 12:27,8996001440087,ENERGEN KACANG HIJAU,10,1500,0,15000,11500,3500
4/14/2021 12:27,8998866200325,MIE SEDAAP SOTO,10,2500,0,25000,19520,5480
4/14/2021 12:30,ARG,ARGUS 220ML,2,14500,0,29000,25000,4000
4/14/2021 13:59,089686010107,INDOMIE KALDU AYAM,5,2500,0,12500,10750,1750
4/14/2021 13:59,089686010824,INDOMIE GORENG SPESIAL,5,2700,0,13500,12260,1240
4/14/2021 13:59,8995333032113,TERIGU GATOT KACA 1 KG,1,8500,0,8500,8012,488
4/14/2021 13:59,8992753031900,BKM SCT PUTIH 40G,1,7500,0,7500,6900,600
4/14/2021 14:25,001,PASEO SMART FACIAL SF 250S GT,1,10000,0,10000,9500,500
4/14/2021 14:33,8999999706111,PEPSODENT WHITE 25G,1,2000,0,2000,1450,550
4/14/2021 14:33,8998866106498,EMERON  LOVELY NTRL VT 100ML,1,3500,0,3500,2900,600
4/14/2021 14:33,8998866610742,NOVO FAMILY PINK 76G,1,2000,0,2000,1820,180
4/14/2021 14:33,8998866103985,CIPT SIKP,1,3000,0,3000,2552,448
4/14/2021 14:33,8991111101507,JB POWDER BLOSSOM 50G,1,3500,0,3500,3000,500
4/14/2021 14:33,089686043273,INDOMIE SAMBAL RICA,1,2700,0,2700,2452,248
4/14/2021 14:33,8992775001042,PILUS GARUDA MI GORENG,1,5500,0,5500,4713,787
4/14/2021 14:33,8992775311325,GERY SNACK&SEREAL 100G,1,7000,0,7000,5892,1108
4/14/2021 14:35,8992761002015,COCA COLA PET 390ML,1,5500,0,5500,4333,1167
4/14/2021 15:31,8998866501033,MINYAK GORENG SEDAAP POUCH 2L,1,28000,0,28000,27746,254
4/14/2021 16:42,8998866201964,MINYAK GORENG SABRINA 2L POUCH,1,27500,0,27500,26753,747
4/14/2021 16:52,001,PASEO SMART FACIAL SF 250S GT,1,10000,0,10000,9500,500
4/14/2021 18:07,8996001301579,MALKIST CKLT KELAPA PACK,1,6500,0,6500,5400,1100
4/14/2021 18:07,8996001302323,MALKIST ABON,1,6500,0,6500,4800,1700
4/14/2021 18:08,8999801700030,SUSU FOYU,1,11500,0,11500,10450,1050
4/14/2021 18:08,8994834005923,SPIX 1000,5,1000,0,5000,4250,750
4/14/2021 18:09,8994834005923,SPIX 1000,1,1000,0,1000,850,150
4/14/2021 18:12,8992761166212,FRESTEA APPLE 350ML,1,4500,0,4500,3000,1500
4/14/2021 18:12,8994834005923,SPIX 1000,3,1000,0,3000,2550,450
4/14/2021 18:12,HT,HOT-HOT,1,500,0,500,350,150
4/14/2021 18:18,8992753102204,BKM COKLAT 370G,1,11300,0,11300,9500,1800
4/14/2021 18:18,8999801700030,SUSU FOYU,2,11500,0,23000,20900,2100
4/14/2021 18:18,8992628010139,BIMOLI 5L,1,75000,0,75000,72100,2900
4/14/2021 18:25,711844610095,LARISSA UDANG 500 GR,2,11000,0,22000,19580,2420
4/14/2021 19:37,GL,GULA 1 LITER,3,11500,0,34500,31500,3000
4/14/2021 19:37,8998866201865,KRISBEE PILLOW CHOCOLAVA 120 GR,1,8000,0,8000,7250,750
4/14/2021 21:11,8992761145019,COCA COLA PET 250ML,1,3500,0,3500,2417,1083
4/14/2021 21:11,PRG,PARAGO,3,500,0,1500,1200,300
4/14/2021 21:47,8998989300261,GUDANG GARAM SURYA 12 FILTER,2,18000,0,36000,32900,3100
4/14/2021 21:47,8994834005923,SPIX 1000,2,1000,0,2000,1700,300
4/14/2021 21:59,8998989110167,SURYA GUDANG GARAM 16 FILTER,2,24000,0,48000,44200,3800
4/14/2021 21:59,8886013213208,FRENCH FREIS 2000,1,5000,0,5000,3750,1250
4/14/2021 21:59,8992388133017,NU MILK TEA ORI 330ML,1,6000,0,6000,5125,875
4/14/2021 22:01,8886013213208,FRENCH FREIS 2000,1,5000,0,5000,3750,1250
4/14/2021 22:01,8851019210117,POCKY CHOCOLATE 47G,1,7300,0,7300,5671,1629
4/14/2021 22:01,8991001770301,SELAMAT CLACK VANILA,1,13000,0,13000,11800,1200
4/14/2021 22:01,8991001502933,CHACHA TUBE,2,7500,0,15000,12800,2200
4/15/2021 13:56,8996001320051,KOPIKO COFFE CANDY,1,6200,0,6200,5600,600
4/15/2021 15:24,001,PASEO SMART FACIAL SF 250S GT,1,10000,0,10000,9500,500
4/15/2021 15:33,8996001600269,LE MINERAL 600ML,1,3000,0,3000,1688,1312
4/15/2021 15:33,8998866603546,SOKLIN FLOORCLENER UNGU 450ML,1,7000,0,7000,6385,615
4/15/2021 15:33,8993470279651,JOGER CHOCKY BAR,3,1000,0,3000,2601,399
4/15/2021 15:33,8997021300092,LARISSA BAWANG 250GR,2,5500,0,11000,10250,750
4/15/2021 15:33,711844610064,LARISSA SINGKONG 250GR,1,5000,0,5000,4545,455
4/15/2021 15:33,8997002060168,KRP SINGKOG PDS PANDA DUO,1,8000,0,8000,7300,700
4/15/2021 15:33,8992753102303,BKM SCT CKLT 40G,2,7500,0,15000,13800,1200
4/15/2021 15:33,711844610095,LARISSA UDANG 500 GR,1,11000,0,11000,9790,1210
4/15/2021 15:33,089686041705,INDOMIE GORENG JUMBO,2,3500,0,7000,6286,714
4/15/2021 15:33,8993007000680,INDOMILK 1L,1,16500,0,16500,14792,1708
4/15/2021 15:33,8998898830125,KKB ENER-G ANGGUR,4,5500,0,22000,19296,2704
4/15/2021 15:33,8999999524722,SUNLIGHT LIME NEW PCH 435ML,1,10000,0,10000,9100,900
4/15/2021 15:33,8999999037765,PEPSODENT WHITE 225G,1,12000,0,12000,10750,1250
4/15/2021 15:33,8999999030179,PEPSODENT ACTION 123 COMPLETE 75G,1,6700,0,6700,5170,1530
4/15/2021 15:33,18998866103982,CIPTADENT TB CRYSTAL CLEAN MED,1,3000,0,3000,2585,415
4/15/2021 15:33,8998866888622,GIV MERAH KOTAK 76G,1,2000,0,2000,1820,180
4/15/2021 15:57,8999999045616,MOLTO AIO PINK SCH,6,1000,0,6000,4800,1200
4/15/2021 15:57,8993176110135,MINYAK TELON LANG 30ML,1,10000,0,10000,8167,1833
4/15/2021 15:57,8992694247255,ZWITSAL BATH NAT HAIR&BODY 200ML,1,20500,0,20500,18810,1690
4/15/2021 15:57,8996001350850,SUPER STAR SNAPS,1,16300,0,16300,14800,1500
4/15/2021 15:57,8992775312469,GERY SALUT COKELAT,1,11000,0,11000,9983,1017
4/15/2021 15:57,8998866608725,DAIA SOFTENER BAG 850G,1,18000,0,18000,15627,2373
4/15/2021 16:01,8998866107495,ZINC HAIRFALL TREATH SHT 10ML,1,5000,0,5000,4500,500
4/15/2021 16:01,8999999042646,RINSO MOLTO ROSE FRESH LIQ 40ML,1,5000,0,5000,4817,183
4/15/2021 16:19,8993379254469,SABUN LERVIA 90G,1,3500,0,3500,2966,534
4/15/2021 16:19,8999999036492,LUX BW PINK SOFT BTL 100ML,1,10000,0,10000,8690,1310
4/15/2021 16:50,8991102281430,PERMEN MINTZ DUOMINT,1,4500,0,4500,4000,500
4/15/2021 17:58,8992761139018,ADES 600ML,3,3500,0,10500,6876,3624
4/15/2021 17:58,8996001600269,LE MINERAL 600ML,1,3000,0,3000,1688,1312
4/15/2021 17:59,8999909000377,SAMPOERNA AVOLUTION,1,30000,0,30000,28450,1550
4/15/2021 18:00,8998989300261,GUDANG GARAM SURYA 12 FILTER,1,18000,0,18000,16450,1550
4/15/2021 18:00,123124,KOREK BIASA,1,2000,0,2000,1800,200
4/15/2021 18:21,8998866202671,NOODLE SEDAAP MIE KOREAN SPICY SOUP CUP,2,5000,0,10000,8004,1996
4/15/2021 18:21,089686043051,INDOMIE COTO MAKASSAR,1,2800,0,2800,2525,275
4/15/2021 18:21,JGR SHN,JOGER SHINY SACHET,1,500,0,500,437,63
4/15/2021 18:21,bb,BENG-BENG,1,1500,0,1500,1450,50
4/15/2021 18:33,8996001600269,LE MINERAL 600ML,1,3000,0,3000,1688,1312
4/15/2021 19:02,8997028590014,ARGUS 220ML,2,500,0,1000,604,396
4/15/2021 19:02,JGR SHN,JOGER SHINY SACHET,2,500,0,1000,874,126
4/15/2021 21:28,8998989300261,GUDANG GARAM SURYA 12 FILTER,1,18000,0,18000,16450,1550
4/15/2021 21:50,8999909096004,SAMPOERNA 16 FILTER,1,24000,0,24000,23000,1000
4/15/2021 21:59,8992959953082,SWEETY BRONZE L8,1,17000,0,17000,15380,1620
4/15/2021 22:09,8999999520151,PEPSODENT TB FAMILY SOFT,1,2100,0,2100,1900,200
4/15/2021 22:09,8999999706111,PEPSODENT WHITE 25G,1,2000,0,2000,1450,550
4/15/2021 22:30,6907992823904,JD CRUNCHY CHOCOLATE VAN,1,8000,0,8000,6800,1200
4/15/2021 22:30,6907992823867,JD CRUNCHY CHOCOLATE MALT,1,5500,0,5500,4700,800
4/15/2021 22:30,6907992823843,JD MOCHA CRISPY,1,5000,0,5000,4400,600
4/15/2021 22:31,SOSIS,SO NICE SAPI,2,1000,0,2000,1880,120
4/15/2021 22:31,8991111101408,JB POWSER 50G,1,3500,0,3500,3000,500
4/15/2021 22:31,8992759120264,LARISST 220,1,10000,0,10000,9200,800
4/15/2021 22:31,8992761164539,NUTRIBOOST ORANGE 300ML,1,6500,0,6500,5300,1200
4/15/2021 22:32,8999999048266,SUNSILK SHP SOFT&SMTH 170ML,1,19900,0,19900,18150,1750
4/16/2021 11:39,8992628020152,BIMOLI POUCH 2L,1,30000,0,30000,29000,1000
4/16/2021 11:39,GL,GULA 1 LITER,2,11500,0,23000,21000,2000
4/16/2021 11:39,711844150027,ABC NANAS,1,15000,0,15000,12241,2759
4/16/2021 11:39,8995333060703,TERIGU KOMPAS 1KG,1,10500,0,10500,9816,684
4/16/2021 11:39,8993083929806,BISKITOP COKLAT,1,30000,0,30000,27000,3000
4/16/2021 11:47,GL,GULA 1 LITER,15,11500,0,172500,157500,15000
4/16/2021 11:58,8999801700030,SUSU FOYU,3,11500,0,34500,31350,3150
4/16/2021 11:58,JGR,JOGER CHOCKY PASTA,1,20000,0,20000,18190,1810
4/16/2021 11:58,8998899995120,BAYGON TEA BLOSSOM,1,38000,0,38000,35000,3000
4/16/2021 11:58,711844150027,ABC NANAS,3,15000,0,45000,36723,8277
4/16/2021 11:58,8998866202619,MIE SEDAAP KOREAN SPICY SOUP,2,2500,0,5000,4546,454
4/16/2021 11:58,8850507001152,MOTU ATV,1,10000,0,10000,8000,2000
4/16/2021 11:58,8998866693660,SOKLIN FLOORCLENER KUNING 900ML,1,14000,0,14000,12436,1564
4/16/2021 11:58,8999999528881,CITRA HBL NAT GLOWING WHITE UV,1,20000,0,20000,17703,2297
4/16/2021 12:01,8992761164546,NUTRIBOOST STRAWBERRY 300ML,1,6500,0,6500,5300,1200
4/16/2021 12:03,8995333060703,TERIGU KOMPAS 1KG,2,10500,0,21000,19632,1368
4/16/2021 12:38,8999999027056,LIFEBUOY ANTI KETOMBE 9ML,1,5000,0,5000,4500,500
4/16/2021 12:38,8999999045623,MOLTO AIO BLUE SCH,5,1000,0,5000,4000,1000
4/16/2021 12:38,8999999558062,RINSO ANTI NODA CLASSIC PWD 44G,5,1000,0,5000,4025,975
4/16/2021 12:38,8999999050009,SUNLIGHT LIME NEW POUCH 95ML,2,2000,0,4000,3200,800
4/16/2021 12:38,8999999059781,SUNLIGHT LIME NEW POUCH 210ML,3,5000,0,15000,12900,2100
4/16/2021 12:38,711844610095,LARISSA UDANG 500 GR,1,11000,0,11000,9790,1210
4/16/2021 12:38,8992628022156,BIMOLI KLASIK TOUCH 1 LT,1,15500,0,15500,14350,1150
4/16/2021 12:38,001,PASEO SMART FACIAL SF 250S GT,1,10000,0,10000,9500,500
4/16/2021 12:38,8999999017804,CITRA BW NATURAL WHITE LD 400ML,1,21000,0,21000,19000,2000
4/16/2021 12:38,8992770034175,MASAKO 100GR,1,5000,0,5000,3500,1500
4/16/2021 12:38,8995333060703,TERIGU KOMPAS 1KG,1,10500,0,10500,9816,684
4/16/2021 12:38,GL,GULA 1 LITER,1,11500,0,11500,10500,1000
4/16/2021 12:56,GL,GULA 1 LITER,4,11500,0,46000,42000,4000
4/16/2021 12:56,8999999502393,ROYCO FDS CHICKEN 8G,1,5000,0,5000,4500,500
4/16/2021 13:29,8992959953334,SWEETY BRONZE XL42,1,80000,0,80000,75455,4545
4/16/2021 14:29,8998899995120,BAYGON TEA BLOSSOM,1,38000,0,38000,35000,3000
4/16/2021 14:29,8997002060168,KRP SINGKOG PDS PANDA DUO,2,8000,0,16000,14600,1400
4/16/2021 14:29,8995333032113,TERIGU GATOT KACA 1 KG,2,8500,0,17000,16024,976
4/16/2021 14:29,8998866202312,NOODLE SEDAAP TASTY BAKMI AYAM 129 GR,2,5000,0,10000,8334,1666
4/16/2021 15:29,8998866611718,EKONOMI PENCUCI PIRING  LIQ 780ML,1,12000,0,12000,10900,1100
4/16/2021 15:29,8998866107495,ZINC HAIRFALL TREATH SHT 10ML,2,5000,0,10000,9000,1000
4/16/2021 15:29,8993072153595,LARISST COTTON 35G,1,5000,0,5000,3300,1700
4/16/2021 15:29,8999909003439,MARLBORO CRAFTED 12,2,8000,0,16000,10874,5126
4/16/2021 15:29,123124,KOREK BIASA,1,2000,0,2000,1800,200
4/16/2021 16:54,089686834253,FREISS MELON,1,16000,0,16000,14200,1800
4/16/2021 17:17,8996001301579,MALKIST CKLT KELAPA PACK,2,6500,0,13000,10800,2200
4/16/2021 17:17,8992775211434,PILUS GARUDA SAPI PANGGANG,1,5500,0,5500,4713,787
4/16/2021 17:17,8992775211410,PILUS GARUDA PEDAS,1,5500,0,5500,4713,787
4/16/2021 17:17,089686061079,POP MIE MINI AY BAWANG RL,2,3000,0,6000,5404,596
4/16/2021 17:17,8991001780126,SELAMAT CKLAT 60G,4,5000,0,20000,17200,2800
4/16/2021 17:31,8992222091961,PUCELLE MIST COL SPRAY 75ML,1,13000,0,13000,11650,1350
4/16/2021 17:39,8994867000162,ROKOK PUNDIMAS KRETEK16,1,10000,0,10000,8600,1400
4/16/2021 17:45,8996001320136,KOPIKO CAPP CANDY,1,6200,0,6200,5600,600
4/16/2021 17:48,9556040040038,SUSU F&N,1,33000,0,33000,30000,3000
4/16/2021 17:48,8993470671752,JOGER STICK DUO KACANG,1,1000,0,1000,850,150
4/16/2021 18:05,8998866202237,NOODLE SEDAAP TASTY AYAM GEPREK 124 GR,2,5000,0,10000,8334,1666
4/16/2021 19:27,8999999706449,CLOSEUP ICY WHITE 65G,1,9000,0,9000,7865,1135
4/16/2021 19:38,8996001320136,KOPIKO CAPP CANDY,1,6200,0,6200,5600,600
4/16/2021 21:03,8998866610087,JAVANA ORIGINAL 350ML,1,3000,0,3000,2150,850
4/16/2021 21:30,8998866200882,SUKSESMIE GORENG AYAM KRMS 133GR,1,3500,0,3500,3047,453
4/16/2021 21:30,8994834005923,SPIX 1000,6,1000,0,6000,5100,900
4/16/2021 21:35,8992761147143,SPRITE WATERLYMON 425ML,3,5500,0,16500,12900,3600
4/16/2021 21:35,8992761164539,NUTRIBOOST ORANGE 300ML,1,6500,0,6500,5300,1200
4/16/2021 21:35,8992761164546,NUTRIBOOST STRAWBERRY 300ML,1,6500,0,6500,5300,1200
4/16/2021 21:44,8993571003827,CAP 19 BEDAK SALICYL MENTHOL 100G,2,8000,0,16000,14000,2000
4/16/2021 21:44,8996001301579,MALKIST CKLT KELAPA PACK,2,6500,0,13000,10800,2200
4/16/2021 21:44,8992761145026,SPRITE PET 250ML,1,3500,0,3500,2417,1083
4/16/2021 22:33,9556001025272,NESCAFE LATTE 240ML,1,8500,0,8500,7437,1063
4/16/2021 22:33,8993470279651,JOGER CHOCKY BAR,1,1000,0,1000,867,133
4/16/2021 22:34,123,BETREI JAM,1,5500,0,5500,5000,500
4/17/2021 11:45,SF TAWAR ORI,SAFFANAH TAWAR ORI,1,9000,0,9000,8000,1000
4/17/2021 11:45,8992957214307,SAFARI MECES,1,5500,0,5500,4500,1000
4/17/2021 11:45,8999908284907,MY BABY MINYAK TELON 90ML,1,25000,0,25000,22700,2300
4/17/2021 11:45,SOSIS,SO NICE SAPI,1,1000,0,1000,940,60
4/17/2021 11:45,8998989500166,GUDANG GARAM MERAH BESAR 16KS,1,17000,0,17000,15300,1700
4/17/2021 12:45,8998866200578,MIE SEDAAP KARI KENTAL,2,2500,0,5000,4526,474
4/17/2021 13:23,JGR SHN,JOGER SHINY SACHET,1,500,0,500,437,63
4/17/2021 13:23,COKLAT,COKLAT COIN,1,500,0,500,400,100
4/17/2021 13:23,MARS,MARSHMELLOW,2,500,0,1000,866,134
4/17/2021 13:23,8997218380074,ICHITAN MILK TEA,1,8000,0,8000,6583,1417
4/17/2021 13:50,8998008151065,MIWON 100 GR,4,3300,0,13200,11984,1216
4/17/2021 13:50,8992753102204,BKM COKLAT 370G,2,11300,0,22600,19000,3600
4/17/2021 13:58,8997231980022,O'JELLY MINI STRAWBERRY,1,3000,0,3000,2250,750
4/17/2021 13:58,TUSTEL,TUSUK TELINGA,1,1000,0,1000,833,167
4/17/2021 13:58,SOSIS,SO NICE SAPI,2,1000,0,2000,1880,120
4/17/2021 13:58,8994037703749,WENIS JERUK,1,8000,0,8000,6500,1500
4/17/2021 16:42,089686834307,FREISS LECI,1,11000,0,11000,8750,2250
4/17/2021 16:42,8999999059781,SUNLIGHT LIME NEW POUCH 210ML,1,5000,0,5000,4300,700
4/17/2021 16:58,GL,GULA 1 LITER,10,11500,0,115000,105000,10000
4/17/2021 17:01,8992959053232,CONFIDENCE CLLASIC NIGHT M8,1,42000,0,42000,38182,3818
4/17/2021 17:03,8992775211410,PILUS GARUDA PEDAS,1,5500,0,5500,4713,787
4/17/2021 17:03,8996001301142,ROMA KELAPA,1,8000,0,8000,6628,1372
4/17/2021 17:03,8996001600399,LE MINERAL 1500ML,1,5000,0,5000,4042,958
4/17/2021 17:50,711844610095,LARISSA UDANG 500 GR,4,11000,0,44000,39160,4840
4/17/2021 17:50,8998989500166,GUDANG GARAM MERAH BESAR 16KS,1,17000,0,17000,15300,1700
4/17/2021 18:57,8992775001660,WAFER CREAM COKLAT TABUR KEJU,1,19000,0,19000,17721,1279
4/17/2021 18:57,8992761145026,SPRITE PET 250ML,1,3500,0,3500,2417,1083
4/17/2021 18:57,8851019210117,POCKY CHOCOLATE 47G,1,7300,0,7300,5671,1629
4/17/2021 20:08,8998866201520,KOPI TOP TORAJA MURNI,1,11000,0,11000,9600,1400
4/17/2021 20:12,8992761145026,SPRITE PET 250ML,2,3500,0,7000,4834,2166
4/17/2021 20:57,8998866201520,KOPI TOP TORAJA MURNI,1,11000,0,11000,9600,1400
4/17/2021 20:58,8997028590014,ARGUS 220ML,2,500,0,1000,604,396
4/17/2021 21:03,8999909000544,MARLBORO F BLACK,1,29001,0,29001,27800,1201
4/17/2021 21:03,123124,KOREK BIASA,1,2000,0,2000,1800,200
4/18/2021 11:58,8992696404441,BEAR BRAND 189ML,1,8500,0,8500,7887,613
4/18/2021 11:58,BTS,BIMURA TARO SEAWEED 250G,1,10000,0,10000,9300,700
4/18/2021 11:58,8998866610278,DAIA VIOLET GUSSET 565G,1,10000,0,10000,8700,1300
4/18/2021 11:58,711844140059,ABC SAUS TIRAM 135 ML,1,8500,0,8500,7750,750
4/18/2021 11:58,GL,GULA 1 LITER,10,11500,0,115000,105000,10000
4/18/2021 11:58,8998866501033,MINYAK GORENG SEDAAP POUCH 2L,4,28000,0,112000,110984,1016
4/18/2021 11:58,089686010107,INDOMIE KALDU AYAM,10,2500,0,25000,21500,3500
4/18/2021 12:56,089686021127,INTER MIE KALDU,1,1000,0,1000,813,187
4/18/2021 12:56,8993470411433,JOGER CLASSIC,1,1000,0,1000,850,150
4/18/2021 12:56,8997028590014,ARGUS 220ML,2,500,0,1000,604,396
4/18/2021 13:51,9999,ISOLASI LAKBAN,1,8000,0,8000,6500,1500
4/18/2021 13:51,001,PASEO SMART FACIAL SF 250S GT,2,10000,0,20000,19000,1000
4/18/2021 15:20,8999801700030,SUSU FOYU,1,11500,0,11500,10450,1050
4/18/2021 15:20,JGR SHN,JOGER SHINY SACHET,1,500,0,500,437,63
4/18/2021 16:03,8998866501033,MINYAK GORENG SEDAAP POUCH 2L,1,28000,0,28000,27746,254
4/18/2021 16:17,8998989300261,GUDANG GARAM SURYA 12 FILTER,1,18000,0,18000,16450,1550
4/18/2021 16:17,8996001301142,ROMA KELAPA,1,8000,0,8000,6628,1372
4/18/2021 16:58,8993365121539,MADU TJ SUPER 150G,1,16800,0,16800,15220,1580
4/18/2021 17:55,8998989300261,GUDANG GARAM SURYA 12 FILTER,1,18000,0,18000,16450,1550
4/18/2021 18:58,8997231980022,O'JELLY MINI STRAWBERRY,2,3000,0,6000,4500,1500
4/18/2021 21:29,6921101219235,YAKUAT JELLY,1,2000,0,2000,1750,250
4/18/2021 21:39,8991004011906,KOPI BORONG,1,10000,0,10000,8333,1667
4/18/2021 21:39,8991188943536,SASA SANTAN KELAPA 65ML,1,3000,0,3000,2437,563
4/18/2021 22:03,8997231980022,O'JELLY MINI STRAWBERRY,1,3000,0,3000,2250,750
4/18/2021 22:03,8994420107789,SARDEN SAUS TOMAT,1,7000,0,7000,5833,1167
4/18/2021 22:03,TG APEL,TEH GELAS APEL,1,2000,0,2000,1178,822
4/18/2021 22:03,ff,FULLO BLASTO,1,1000,0,1000,995,5
4/18/2021 22:03,SF TAWAR COKLAT,SAFFANAH ROTI TAWAR COKLAT,1,13500,0,13500,12000,1500
4/19/2021 11:18,8996001320136,KOPIKO CAPP CANDY,1,6200,0,6200,5600,600
4/19/2021 11:18,8994021000915,CINCAO,3,3000,0,9000,5874,3126
4/19/2021 11:18,8999999059316,LIFEBOUY TS MILDCARE 75G,3,3000,0,9000,7500,1500
4/19/2021 11:18,8999999531508,MOLTO HYGIENE SC 10ML,2,500,0,1000,960,40
4/19/2021 14:56,8992775712603,MYTEA POCI OOLONG,1,5000,0,5000,4410,590
4/19/2021 15:06,8997231980022,O'JELLY MINI STRAWBERRY,1,3000,0,3000,2250,750
4/19/2021 16:28,8998989500166,GUDANG GARAM MERAH BESAR 16KS,2,17000,0,34000,30600,3400
4/19/2021 16:28,GL,GULA 1 LITER,1,11500,0,11500,10500,1000
4/19/2021 16:39,8992775110140,GARUDA KACANG KULIT 160G,1,12000,0,12000,10012,1988
4/19/2021 16:39,8998866202343,MIE SEDAAP KOREAN SPICY,1,2500,0,2500,2023,477
4/19/2021 16:58,8997009510116,LEMON WATER,1,7000,0,7000,5694,1306
4/19/2021 17:18,089686834055,FREISS JERUK,1,11000,0,11000,8750,2250
4/19/2021 17:18,GL,GULA 1 LITER,2,11500,0,23000,21000,2000
4/19/2021 17:18,8999999504656,SARI MURNI 20X1.8G,1,5000,0,5000,4200,800
4/19/2021 17:38,8998989300261,GUDANG GARAM SURYA 12 FILTER,1,18000,0,18000,16450,1550
4/19/2021 18:11,8992761164539,NUTRIBOOST ORANGE 300ML,1,6500,0,6500,5300,1200
4/19/2021 18:11,8992761164546,NUTRIBOOST STRAWBERRY 300ML,1,6500,0,6500,5300,1200
4/19/2021 18:18,8999909010567,234 16 FILTER,1,22000,0,22000,21500,500
4/19/2021 18:19,8998989500128,GUDANG GARAM MERAH KECIL 12KS,1,13000,0,13000,11900,1100
4/19/2021 18:57,8999999531492,MOLTO GLAMOUR,1,5000,0,5000,4800,200
4/19/2021 18:57,8998989300261,GUDANG GARAM SURYA 12 FILTER,1,18000,0,18000,16450,1550
4/19/2021 18:57,123124,KOREK BIASA,1,2000,0,2000,1800,200
4/19/2021 18:59,TUSTEL,TUSUK TELINGA,1,1000,0,1000,833,167
4/19/2021 19:19,8991102281416,PERMEN MINTZ PPMINT,1,4500,0,4500,4000,500
4/19/2021 19:22,kp,KALPA,1,2000,0,2000,1666,334
4/19/2021 21:08,8999999524722,SUNLIGHT LIME NEW PCH 435ML,1,10000,0,10000,9100,900
4/19/2021 21:20,8996001318911,BETTER ISI 4,1,2000,0,2000,1700,300
4/19/2021 21:20,089686043051,INDOMIE COTO MAKASSAR,1,2800,0,2800,2525,275
4/19/2021 21:20,8997018250218,JAHE MERAH,2,1000,0,2000,1666,334
4/19/2021 21:25,34678,SENDAL JEPIT,1,15000,0,15000,13500,1500
4/19/2021 21:25,8998866613262,SUKSESMIE SOTO 111 GR,1,3500,0,3500,2770,730
4/19/2021 21:28,8996001600375,LE MINERAL 330ML,1,2000,0,2000,1417,583
4/19/2021 21:28,9556001174659,MILO ACT GO 240ML,1,8500,0,8500,7437,1063
4/19/2021 21:28,8998866201483,POTABEE REGULER GRILLED SEAWEED 35GR,1,5000,0,5000,4150,850
4/19/2021 21:34,8991102281416,PERMEN MINTZ PPMINT,1,4500,0,4500,4000,500
4/19/2021 22:29,8991102228053,TEH GELAS BOTOL,1,3000,0,3000,1695,1305
4/19/2021 22:29,BRS,BERAS BUMN 10KG,1,128000,0,128000,100000,28000
4/20/2021 12:51,GLK,GULATA 50KG,1,620000,0,620000,592000,28000
4/20/2021 12:51,8998866501026,MINYAK GORENG SEDAAP POUCH 1 L,12,15000,0,180000,169320,10680
4/20/2021 12:58,GL,GULA 1 LITER,1,11500,0,11500,10500,1000
4/20/2021 12:58,8998866607315,SOKLIN SOFTERGENT SAKURA 770G & PIRING,1,18000,0,18000,16680,1320
4/20/2021 12:58,kp,KALPA,1,2000,0,2000,1666,334
4/20/2021 12:58,8999999559533,LIFEBUOY BW TOTAL 10 90ML,1,5000,0,5000,4000,1000
4/20/2021 12:58,8992959509005,SWEETY SILVER PANTS XL26,1,61500,0,61500,55910,5590
4/20/2021 12:58,8992775203422,GARUDA ROSTA OVEN 100G,1,8000,0,8000,7322,678
4/20/2021 12:58,8850507000094,POLICE BONCHA,1,2000,0,2000,800,1200
4/20/2021 12:58,8997231980022,O'JELLY MINI STRAWBERRY,1,3000,0,3000,2250,750
4/20/2021 12:58,8992696523081,MILO UHT 110ML,1,2500,0,2500,1962,538
4/20/2021 12:58,8995102703534,TERASI DUO 6 GR,2,4000,0,8000,7440,560
4/20/2021 12:58,089686044249,SUPERMI NUTRIMI STEAK AYAM,4,3500,0,14000,11200,2800
4/20/2021 12:59,8996001600269,LE MINERAL 600ML,1,3000,0,3000,1688,1312
4/20/2021 12:59,089686044249,SUPERMI NUTRIMI STEAK AYAM,2,3500,0,7000,5600,1400
4/20/2021 14:21,8996001318430,BETTER 1000,3,1000,0,3000,2460,540
4/20/2021 14:22,8991102228053,TEH GELAS BOTOL,1,3000,0,3000,1695,1305
4/20/2021 15:31,8999999042639,RINSO ANTI NODA CLS LIQ 40ML,1,1000,0,1000,805,195
4/20/2021 15:31,8998866608718,DAIA SOFTENER PINK,1,5000,0,5000,4450,550
4/20/2021 15:31,8998866107495,ZINC HAIRFALL TREATH SHT 10ML,1,5000,0,5000,4500,500
4/20/2021 15:31,8998989300261,GUDANG GARAM SURYA 12 FILTER,1,18000,0,18000,16450,1550
4/20/2021 15:31,8998866611718,EKONOMI PENCUCI PIRING  LIQ 780ML,1,12000,0,12000,10900,1100
4/20/2021 16:24,8992628022156,BIMOLI KLASIK TOUCH 1 LT,1,15500,0,15500,14350,1150
4/20/2021 16:41,9556001004673,MILO NESTLE MALAYSIA ACTIVE GO,1,85000,0,85000,80000,5000
4/20/2021 17:50,8992736025162,SASA TEPUNG PISANG GORENG,1,5000,0,5000,4455,545
4/20/2021 18:34,8993058105013,EXTRA JOSS,1,12000,0,12000,9773,2227
4/20/2021 19:16,8998989500166,GUDANG GARAM MERAH BESAR 16KS,2,17000,0,34000,30600,3400
4/20/2021 19:16,8998989300261,GUDANG GARAM SURYA 12 FILTER,1,18000,0,18000,16450,1550
4/20/2021 21:42,089686021127,INTER MIE KALDU,2,1000,0,2000,1626,374
4/20/2021 21:42,089686043051,INDOMIE COTO MAKASSAR,1,2800,0,2800,2525,275
4/20/2021 21:42,8998866202312,NOODLE SEDAAP TASTY BAKMI AYAM 129 GR,1,5000,0,5000,4167,833
4/20/2021 21:56,8886013213208,FRENCH FREIS 2000,1,5000,0,5000,3750,1250
4/20/2021 22:42,8992696404441,BEAR BRAND 189ML,1,8500,0,8500,7887,613
4/20/2021 22:42,6907992823935,JD SWEETCORN,1,3500,0,3500,3000,500
4/21/2021 12:41,BTS,BIMURA TARO SEAWEED 250G,1,10000,0,10000,9300,700
4/21/2021 12:41,8991102385091,WFR TANGO CKLT 7G,1,8300,0,8300,7455,845
4/21/2021 12:41,8991001780492,SELAMAT COKLAT,1,13000,0,13000,11800,1200
4/21/2021 12:41,8998866500708,FLORIDINA ORANGE,2,3000,0,6000,5000,1000
4/21/2021 12:42,8998866610261,DAIA VIOLET GUSSET BAG 290 GR,1,5000,0,5000,4450,550
4/21/2021 12:42,MOLTO PINK,MOLTO ALL IN ONE 11 ML,2,500,0,1000,800,200
4/21/2021 13:00,8992959953082,SWEETY BRONZE L8,1,17000,0,17000,15380,1620
4/21/2021 13:03,8998989500166,GUDANG GARAM MERAH BESAR 16KS,1,17000,0,17000,15300,1700
4/21/2021 13:11,8850507002951,BONCHA EGG SQUISHY,2,12000,0,24000,21682,2318
4/21/2021 13:11,6907992825069,JD FRUITY,1,5000,0,5000,4400,600
4/21/2021 13:11,8996001600269,LE MINERAL 600ML,1,3000,0,3000,1688,1312
4/21/2021 13:11,8993274532105,BOLU,1,1000,0,1000,833,167
4/21/2021 13:11,PRG,PARAGO,1,500,0,500,400,100
4/21/2021 13:11,8992696404441,BEAR BRAND 189ML,1,8500,0,8500,7887,613
4/21/2021 13:11,9556001174659,MILO ACT GO 240ML,1,8500,0,8500,7437,1063
4/21/2021 13:11,6921101219235,YAKUAT JELLY,1,2000,0,2000,1750,250
4/21/2021 13:13,8999999558062,RINSO ANTI NODA CLASSIC PWD 44G,5,1000,0,5000,4025,975
4/21/2021 13:13,8998866608312,GIV PAPAYA KOTAK 76GR,1,2000,0,2000,1820,180
4/21/2021 13:13,8992866707488,ZINC,1,5000,0,5000,4000,1000
4/21/2021 13:32,8999909982000,SAMPOERNA 12 FILTER,1,18000,0,18000,16200,1800
4/21/2021 13:32,8994021000915,CINCAO,2,3000,0,6000,3916,2084
4/21/2021 14:00,8999909982000,SAMPOERNA 12 FILTER,1,18000,0,18000,16200,1800
4/21/2021 15:49,8998866501033,MINYAK GORENG SEDAAP POUCH 2L,1,28000,0,28000,27746,254
4/21/2021 16:31,8999999534097,PEPSODENT PGB FCM 75G,1,5000,0,5000,3850,1150
4/21/2021 16:31,8992993524477,COLATTA FINEZA COMPOUND DARK 250G,1,18500,0,18500,17179,1321
4/21/2021 17:55,BTS,BIMURA TARO SEAWEED 250G,1,10000,0,10000,9300,700
4/21/2021 17:55,8992736980164,SASA TEPUNG KENTUCKY 80G,1,3000,0,3000,2181,819
4/21/2021 18:05,123124,KOREK BIASA,1,2000,0,2000,1800,200
4/21/2021 18:05,6907992823676,JD PEACH,1,2000,0,2000,1700,300
4/21/2021 18:05,6907992823959,JD HAWTHORN BERRY,1,2000,0,2000,1700,300
4/21/2021 18:05,8993989311699,CLAS MILD 16 FILTER,1,23000,0,23000,21700,1300
4/21/2021 18:08,8996001600269,LE MINERAL 600ML,3,3000,0,9000,5064,3936
4/21/2021 18:08,8996001600375,LE MINERAL 330ML,1,2000,0,2000,1417,583
4/21/2021 21:25,8998989300261,GUDANG GARAM SURYA 12 FILTER,1,18000,0,18000,16450,1550
4/21/2021 21:25,8994834005923,SPIX 1000,2,1000,0,2000,1700,300
4/21/2021 22:31,COKLAT,COKLAT COIN,11,500,0,5500,4400,1100
4/21/2021 22:31,8991001503114,CHACHA MILK CHOCOLATE 35G,1,5500,0,5500,4900,600
4/21/2021 22:32,8992696422650,NESCAFE FRENCH VANILLA,1,5000,0,5000,4099,901
4/21/2021 22:32,6907992825045,JD CRUNCHY MATCHA CHEESE,1,8000,0,8000,7000,1000
4/21/2021 22:32,8998989110167,SURYA GUDANG GARAM 16 FILTER,2,24000,0,48000,44200,3800
4/21/2021 22:32,BMO,BERAS MERAH ORGANIK,1,25000,0,25000,23500,1500
4/22/2021 12:54,8998866202725,MILKU COKLAT PREMIUM 200ML,1,3000,0,3000,2375,625
4/22/2021 12:54,8998866202732,MILKU STROBERI 200ML,1,3000,0,3000,2375,625
4/22/2021 12:54,bb,BENG-BENG,1,1500,0,1500,1450,50
4/22/2021 12:54,kp,KALPA,1,2000,0,2000,1666,334
4/22/2021 12:56,8714700524002,MAIZENAKU,1,5000,0,5000,4200,800
4/22/2021 12:56,8998866201469,POTABEE REGULER BBQ BEEF 68 GR,1,8000,0,8000,7200,800
4/22/2021 12:56,8997011700123,BIHUN JAGUNG 300GR,1,6000,0,6000,4979,1021
4/22/2021 12:56,8992222091961,PUCELLE MIST COL SPRAY 75ML,1,13000,0,13000,11650,1350
4/22/2021 13:07,8996001318911,BETTER ISI 4,1,2000,0,2000,1700,300
4/22/2021 13:18,8991111109121,JB POWDER BLOSSOM 75+25G,1,6000,0,6000,5430,570
4/22/2021 13:18,MARS,MARSHMELLOW,1,500,0,500,433,67
4/22/2021 13:18,089686010107,INDOMIE KALDU AYAM,1,2500,0,2500,2150,350
4/22/2021 14:55,8992933211115,NUTRIJELL STRAWBERRY,2,6000,0,12000,10082,1918
4/22/2021 14:55,GL,GULA 1 LITER,1,11500,0,11500,10500,1000
4/22/2021 16:04,8991004011906,KOPI BORONG,1,10000,0,10000,8333,1667
4/22/2021 16:04,8998866200646,KOPI TOP MURNI,1,11000,0,11000,9600,1400
4/22/2021 16:04,8997011700123,BIHUN JAGUNG 300GR,1,6000,0,6000,4979,1021
4/22/2021 16:08,KJ,KINDER JOY,1,2000,0,2000,1583,417
4/22/2021 16:08,HT,HOT-HOT,2,500,0,1000,700,300
4/22/2021 17:04,GL,GULA 1 LITER,6,11500,0,69000,63000,6000
4/22/2021 17:23,8992775001653,GERY SALUT CHOCOLATE COCONUT,2,2000,0,4000,2952,1048
4/22/2021 17:23,8998866108102,POSH GREEN BLOSSOM 150,1,19500,0,19500,17500,2000
4/22/2021 17:23,8999999059309,LIFEBOUY TS TOTAL 10 DG 75G,1,3000,0,3000,2500,500
4/22/2021 17:23,8992759120264,LARISST 220,1,10000,0,10000,9200,800
4/22/2021 17:23,8992761145026,SPRITE PET 250ML,2,3500,0,7000,4834,2166
4/22/2021 17:23,8994834006128,TICTIC PEDAS,1,2000,0,2000,1700,300
4/22/2021 17:23,089686043204,INDOMIE MIE ACEH,1,2700,0,2700,2452,248
4/22/2021 17:23,8996001355237,SUPER STAR,1,11000,0,11000,9900,1100
4/22/2021 17:23,8996001305041,ROMA SANDWICH CKLT,1,7000,0,7000,5000,2000
4/22/2021 17:54,6907992823829,JD MILKY MILK,2,3000,0,6000,5200,800
4/22/2021 17:57,8998866202244,EKOMIE BUMBU KALDU AYAM,5,1000,0,5000,3990,1010
4/22/2021 18:00,SF TAWAR KUPAS,SAFFANAH ROTI TAWAR KUPAS,1,10000,0,10000,9000,1000
4/22/2021 18:12,8998866201841,GOLDA DOLCE LATTE 200ML,1,3000,0,3000,2500,500
4/22/2021 18:12,ff,FULLO BLASTO,1,1000,0,1000,995,5
4/22/2021 18:13,8998989110167,SURYA GUDANG GARAM 16 FILTER,1,24000,0,24000,22100,1900
4/22/2021 18:13,8992761164539,NUTRIBOOST ORANGE 300ML,1,6500,0,6500,5300,1200
4/22/2021 18:13,8992761145026,SPRITE PET 250ML,1,3500,0,3500,2417,1083
4/22/2021 18:19,8998989300261,GUDANG GARAM SURYA 12 FILTER,1,18000,0,18000,16450,1550
4/22/2021 19:42,8998866202312,NOODLE SEDAAP TASTY BAKMI AYAM 129 GR,1,5000,0,5000,4167,833
4/22/2021 19:42,8998866202237,NOODLE SEDAAP TASTY AYAM GEPREK 124 GR,1,5000,0,5000,4167,833
4/22/2021 19:48,8998866202237,NOODLE SEDAAP TASTY AYAM GEPREK 124 GR,1,5000,0,5000,4167,833
4/22/2021 21:51,8999999516208,ROYCO FDS CHICKEN NEW 230G,3,10000,0,30000,27000,3000
4/22/2021 21:51,8998009010590,ULTRA CHO 125,1,3000,0,3000,2428,572
4/22/2021 22:01,089686021219,INTER MIE GORENG,4,1000,0,4000,3540,460
4/22/2021 22:01,HT,HOT-HOT,2,500,0,1000,700,300
4/22/2021 22:01,TL,TELUR,3,1500,0,4500,3900,600
4/22/2021 22:01,8997013790108,BIMURA KACANG TELUR 25G,2,1000,0,2000,1750,250
4/22/2021 22:01,JGR SHN,JOGER SHINY SACHET,2,500,0,1000,874,126
4/22/2021 22:02,8992959953037,SWEETY BRONZE L1,1,3000,0,3000,2671,329
4/22/2021 22:03,8997009510055,YOU C1000,1,10000,0,10000,9166,834
4/22/2021 22:06,8992775211434,PILUS GARUDA SAPI PANGGANG,1,5500,0,5500,4713,787
4/22/2021 22:06,8997009510055,YOU C1000,2,10000,0,20000,18332,1668
4/22/2021 22:06,8992696404441,BEAR BRAND 189ML,1,8500,0,8500,7887,613
4/22/2021 22:06,8992775110157,GARUDA KACANG KULIT,1,5000,0,5000,3925,1075
4/22/2021 22:09,8998866201469,POTABEE REGULER BBQ BEEF 68 GR,1,8000,0,8000,7200,800
4/22/2021 22:09,ARG,ARGUS 220ML,1,14500,0,14500,12500,2000
4/22/2021 22:21,8996001312445,MALKIST CAPPUCINO,1,6500,0,6500,5400,1100
4/22/2021 22:21,089686010107,INDOMIE KALDU AYAM,1,2500,0,2500,2150,350
4/22/2021 22:21,8999999529710,CLEAR COOL SPORT MNTL 160ML,1,24800,0,24800,22700,2100
4/22/2021 22:21,8994420107789,SARDEN SAUS TOMAT,1,7000,0,7000,5833,1167
4/22/2021 22:23,8998989110167,SURYA GUDANG GARAM 16 FILTER,2,24000,0,48000,44200,3800
4/23/2021 12:14,8992628010139,BIMOLI 5L,1,75000,0,75000,72100,2900
4/23/2021 13:49,8997012321204,MAXX BUMBU BALADO,1,5000,0,5000,4100,900
4/23/2021 13:49,6291100212866,KURMA KHALAS,1,60000,0,60000,55000,5000
4/23/2021 13:49,8991004011906,KOPI BORONG,1,10000,0,10000,8333,1667
4/23/2021 13:52,SWAL,SENDAL SWALLOW,1,18000,0,18000,16500,1500
4/23/2021 14:48,8999999524722,SUNLIGHT LIME NEW PCH 435ML,1,10000,0,10000,9100,900
4/23/2021 15:06,8992759120264,LARISST 220,1,10000,0,10000,9200,800
4/23/2021 15:35,8999999558079,RINSO MOLTO ROSE FRESH PWD 44G,6,1000,0,6000,4830,1170
4/23/2021 16:27,GL,GULA 1 LITER,1,11500,0,11500,10500,1000
4/23/2021 16:27,8995333060703,TERIGU KOMPAS 1KG,1,10500,0,10500,9816,684
4/23/2021 16:28,8992959117583,SFX DS REG FLOW WING 20,1,5000,0,5000,4288,712
4/23/2021 16:28,8992761145019,COCA COLA PET 250ML,2,3500,0,7000,4834,2166
4/23/2021 16:28,COKLAT,COKLAT COIN,2,500,0,1000,800,200
4/23/2021 16:29,8994834003752,TICTIC,1,2000,0,2000,1700,300
4/23/2021 16:41,ABC,BATERAI ABC BIRU,1,8500,0,8500,7500,1000
4/23/2021 16:41,8993058105013,EXTRA JOSS,1,12000,0,12000,9773,2227
4/23/2021 16:54,8998866611725,EKONOMI PENCUCI PIRING  LIQ 290ML,1,5000,0,5000,4200,800
4/23/2021 17:10,8998989300261,GUDANG GARAM SURYA 12 FILTER,1,18000,0,18000,16450,1550
4/23/2021 17:10,8997013790108,BIMURA KACANG TELUR 25G,1,1000,0,1000,875,125
4/23/2021 17:10,8994834005923,SPIX 1000,1,1000,0,1000,850,150
4/23/2021 17:55,8997018720018,SIRUP DHT,1,23000,0,23000,20958,2042
4/23/2021 17:55,8992753100101,BKM FULL CREAM GOLD 370,1,15000,0,15000,14000,1000
4/23/2021 18:01,8993989311699,CLAS MILD 16 FILTER,1,23000,0,23000,21700,1300
4/23/2021 18:01,123124,KOREK BIASA,1,2000,0,2000,1800,200
4/23/2021 18:06,8996001600269,LE MINERAL 600ML,2,3000,0,6000,3376,2624
4/23/2021 18:06,8998866202725,MILKU COKLAT PREMIUM 200ML,1,3000,0,3000,2375,625
4/23/2021 18:34,8992959953044,SWEETY BRONZE XL1,1,2500,0,2500,2250,250
4/23/2021 18:34,8997231980022,O'JELLY MINI STRAWBERRY,1,3000,0,3000,2250,750
4/23/2021 18:34,8996001440049,ENERGEN,1,1500,0,1500,1200,300
4/23/2021 18:34,8998866202725,MILKU COKLAT PREMIUM 200ML,1,3000,0,3000,2375,625
4/24/2021 11:58,HT,HOT-HOT,2,500,0,1000,700,300
4/24/2021 11:58,VTM,VITAMIN,2,500,0,1000,850,150
4/24/2021 12:43,8999999524722,SUNLIGHT LIME NEW PCH 435ML,1,10000,0,10000,9100,900
4/24/2021 12:43,GL,GULA 1 LITER,1,11500,0,11500,10500,1000
4/24/2021 12:43,8999999031602,SARI MURNI 20X1.6G,1,6000,0,6000,5400,600
4/24/2021 12:43,8998989500166,GUDANG GARAM MERAH BESAR 16KS,1,17000,0,17000,15300,1700
4/24/2021 13:52,8998866100717,MAMALIME POUCH 780ML,1,15500,0,15500,13850,1650
4/24/2021 14:47,8997231980022,O'JELLY MINI STRAWBERRY,1,3000,0,3000,2250,750
4/24/2021 14:47,GL,GULA 1 LITER,1,11500,0,11500,10500,1000
4/24/2021 14:47,COKLAT,COKLAT COIN,1,500,0,500,400,100
4/24/2021 14:54,TG APEL,TEH GELAS APEL,1,2000,0,2000,1178,822
4/24/2021 14:54,8886013257400,TWISTKO,1,1000,0,1000,900,100
4/24/2021 14:54,8997231980022,O'JELLY MINI STRAWBERRY,1,3000,0,3000,2250,750
4/24/2021 14:54,COKLAT,COKLAT COIN,2,500,0,1000,800,200
4/24/2021 15:20,8999801700030,SUSU FOYU,1,11500,0,11500,10450,1050
4/24/2021 15:20,8995333032113,TERIGU GATOT KACA 1 KG,1,8500,0,8500,8012,488
4/24/2021 15:20,8997018720018,SIRUP DHT,1,23000,0,23000,20958,2042
4/24/2021 16:01,8998866501033,MINYAK GORENG SEDAAP POUCH 2L,1,28000,0,28000,27746,254
4/24/2021 16:01,JGR SHN,JOGER SHINY SACHET,2,500,0,1000,874,126
4/24/2021 16:24,8998866200837,NOODLE SEDAAPMIE SOTO CUP 81 GR,1,4500,0,4500,3650,850
4/24/2021 16:24,HT,HOT-HOT,1,500,0,500,350,150
4/24/2021 16:36,8991102987639,WFR TANGO LONG VNL 130G,1,5000,0,5000,3773,1227
4/24/2021 16:36,8996001301142,ROMA KELAPA,1,8000,0,8000,6628,1372
4/24/2021 16:49,8999999555122,MOLTO K-ROMANCE 20ML,1,1000,0,1000,800,200
4/24/2021 16:49,8992979190986,TOTAL PUTIH SOFTENER,1,13000,0,13000,11532,1468
4/24/2021 16:49,8998989300261,GUDANG GARAM SURYA 12 FILTER,1,18000,0,18000,16450,1550
4/24/2021 16:49,089686010824,INDOMIE GORENG SPESIAL,2,2700,0,5400,4904,496
4/24/2021 16:49,8998866202237,NOODLE SEDAAP TASTY AYAM GEPREK 124 GR,1,5000,0,5000,4167,833
4/24/2021 16:49,6907992823904,JD CRUNCHY CHOCOLATE VAN,1,8000,0,8000,6800,1200
4/24/2021 16:49,6907992823676,JD PEACH,1,2000,0,2000,1700,300
4/24/2021 16:49,8991102714495,TANGO DRINK COKLAT,1,5000,0,5000,3818,1182
4/24/2021 16:49,8991102228053,TEH GELAS BOTOL,1,3000,0,3000,1695,1305
4/24/2021 16:49,8999999559533,LIFEBUOY BW TOTAL 10 90ML,1,5000,0,5000,4000,1000
4/24/2021 16:49,8997011700123,BIHUN JAGUNG 300GR,1,6000,0,6000,4979,1021
4/24/2021 16:49,8991001780126,SELAMAT CKLAT 60G,1,5000,0,5000,4300,700
4/24/2021 16:49,8992933214116,NUTRIJELL MELON,2,6000,0,12000,10082,1918
4/24/2021 17:49,GL,GULA 1 LITER,1,11500,0,11500,10500,1000
4/24/2021 17:49,8999909096004,SAMPOERNA 16 FILTER,1,24000,0,24000,23000,1000
4/24/2021 17:49,123124,KOREK BIASA,1,2000,0,2000,1800,200
4/24/2021 18:31,GL,GULA 1 LITER,1,11500,0,11500,10500,1000
4/24/2021 18:31,8992761145026,SPRITE PET 250ML,1,3500,0,3500,2417,1083
4/24/2021 18:31,8992628010139,BIMOLI 5L,1,75000,0,75000,72100,2900
4/24/2021 18:58,GL,GULA 1 LITER,2,11500,0,23000,21000,2000
4/24/2021 18:58,8998989300261,GUDANG GARAM SURYA 12 FILTER,1,18000,0,18000,16450,1550
4/24/2021 18:58,123124,KOREK BIASA,1,2000,0,2000,1800,200
4/24/2021 18:59,8991102987639,WFR TANGO LONG VNL 130G,1,5000,0,5000,3773,1227
4/24/2021 19:44,GL,GULA 1 LITER,2,11500,0,23000,21000,2000
4/24/2021 19:51,8992222050418,GATSBY NORMAL 38GR,1,5000,0,5000,3850,1150
4/24/2021 19:51,8998866201841,GOLDA DOLCE LATTE 200ML,1,3000,0,3000,2500,500
4/24/2021 20:24,8999909010567,234 16 FILTER,1,22000,0,22000,21500,500
4/24/2021 20:24,123124,KOREK BIASA,1,2000,0,2000,1800,200
4/24/2021 21:50,8991001780133,TWISTER BLACK,1,5000,0,5000,4600,400
4/24/2021 21:50,8998866201841,GOLDA DOLCE LATTE 200ML,1,3000,0,3000,2500,500
4/24/2021 21:50,SF TAWAR ORI,SAFFANAH TAWAR ORI,1,9000,0,9000,8000,1000
4/25/2021 11:58,8998866201483,POTABEE REGULER GRILLED SEAWEED 35GR,1,5000,0,5000,4150,850
4/25/2021 11:58,8996001304136,SLAI OLAI BLUEBERRY,1,12000,0,12000,9900,2100
4/25/2021 11:58,8998866610261,DAIA VIOLET GUSSET BAG 290 GR,1,5000,0,5000,4450,550
4/25/2021 12:06,8996001318911,BETTER ISI 4,1,2000,0,2000,1700,300
4/25/2021 13:01,8997021870052,FRESH CARE GREEN TEA 10ML,1,12000,0,12000,10000,2000
4/25/2021 13:08,8992775002155,CHOCOLATOS DRINK,1,4000,0,4000,3520,480
4/25/2021 13:08,8886013257400,TWISTKO,2,1000,0,2000,1800,200
4/25/2021 13:08,8992696523067,MILO ACTVGO UHT 180ML,1,4500,0,4500,3515,985
4/25/2021 13:08,8998866610261,DAIA VIOLET GUSSET BAG 290 GR,1,5000,0,5000,4450,550
4/25/2021 13:08,8999999531508,MOLTO HYGIENE SC 10ML,2,500,0,1000,960,40
4/25/2021 13:08,8999999059323,LIFEBOUY LEMONFRESH DG 75G,1,3000,0,3000,2500,500
4/25/2021 13:08,MARS,MARSHMELLOW,1,500,0,500,433,67
4/25/2021 13:08,JGR SHN,JOGER SHINY SACHET,1,500,0,500,437,63
4/25/2021 13:08,ff,FULLO BLASTO,1,1000,0,1000,995,5
4/25/2021 13:08,8992696521797SCT,MILO UHT ACT GO 22G,1,2000,0,2000,1412,588
4/25/2021 13:08,8998866202060,POTABEE AYAM BAKAR PEDAS 35 GR,1,5000,0,5000,4150,850
4/25/2021 13:25,8994834005923,SPIX 1000,2,1000,0,2000,1700,300
4/25/2021 13:25,8998989300261,GUDANG GARAM SURYA 12 FILTER,1,18000,0,18000,16450,1550
4/25/2021 13:57,8992933211115,NUTRIJELL STRAWBERRY,1,6000,0,6000,5041,959
4/25/2021 14:00,8999999531508,MOLTO HYGIENE SC 10ML,4,500,0,2000,1920,80
4/25/2021 14:00,8999999558086,RINSO MOLTO FERFUME ESSENSE PWD 44G,3,1000,0,3000,2415,585
4/25/2021 14:59,8998866201865,KRISBEE PILLOW CHOCOLAVA 120 GR,1,8000,0,8000,7250,750
4/25/2021 14:59,8991102987639,WFR TANGO LONG VNL 130G,1,5000,0,5000,3773,1227
4/25/2021 14:59,8997013790108,BIMURA KACANG TELUR 25G,2,1000,0,2000,1750,250
4/25/2021 15:46,ARG,ARGUS 220ML,5,14500,0,72500,62500,10000
4/25/2021 15:49,8998866613569,SOFTENER SKL BLS FINE 14SHT,1,5000,0,5000,4560,440
4/25/2021 15:49,8993379152017,SABUN CUCI SURYA 200G,1,3000,0,3000,2281,719
4/25/2021 15:49,8996200900092,HEROCYN 85GR,1,13000,0,13000,11650,1350
4/25/2021 15:51,8992979130012,TOTAL LEMON SOFTENER,1,13000,0,13000,11532,1468
4/25/2021 15:51,8998866202404,NOODLE SEDAAP MIE KOREAN SPICY CHICKEN CUP,1,5000,0,5000,4002,998
4/25/2021 16:29,8995333000822,TERIGU KOMPAS SOFT 500GR,1,5500,0,5500,4967,533
4/25/2021 16:29,8993379152017,SABUN CUCI SURYA 200G,1,3000,0,3000,2281,719
4/25/2021 16:56,8993379152017,SABUN CUCI SURYA 200G,1,3000,0,3000,2281,719
4/25/2021 16:56,GL,GULA 1 LITER,3,11500,0,34500,31500,3000
4/25/2021 16:56,8998989110167,SURYA GUDANG GARAM 16 FILTER,1,24000,0,24000,22100,1900
4/25/2021 16:56,8998866608305,GIV BENGKOANG KOTAK 76G,1,2000,0,2000,1820,180
4/25/2021 16:56,8998866804516,GIV LEMON KOTAK 76G,1,2000,0,2000,1820,180
4/25/2021 18:08,8998989300261,GUDANG GARAM SURYA 12 FILTER,1,18000,0,18000,16450,1550
4/25/2021 18:08,8992761166205,FRESTEA GREEN HONEY 350ML,1,4500,0,4500,3000,1500
4/25/2021 18:08,8992761122331,FRESTEA APPEL 500ML,1,6500,0,6500,4708,1792
4/25/2021 18:09,8998989300261,GUDANG GARAM SURYA 12 FILTER,1,18000,0,18000,16450,1550
4/25/2021 18:09,8998989100120,GUDANG GARAM MINI,1,18000,0,18000,16600,1400
4/25/2021 18:16,123124,KOREK BIASA,1,2000,0,2000,1800,200
4/25/2021 18:16,089686043051,INDOMIE COTO MAKASSAR,1,2800,0,2800,2525,275
4/25/2021 22:17,8996001600269,LE MINERAL 600ML,1,3000,0,3000,1688,1312
4/25/2021 22:17,8997028590014,ARGUS 220ML,1,500,0,500,302,198
4/25/2021 22:17,JGR SHN,JOGER SHINY SACHET,1,500,0,500,437,63
4/25/2021 22:17,8992761002039,FANTA STRAWBERRY PET 390 ML,1,5500,0,5500,4300,1200
4/25/2021 22:26,ARG,ARGUS 220ML,1,14500,0,14500,12500,2000
4/25/2021 22:26,8992388133017,NU MILK TEA ORI 330ML,1,6000,0,6000,5125,875
4/25/2021 22:26,8886013213208,FRENCH FREIS 2000,1,5000,0,5000,3750,1250
4/26/2021 13:29,8992984850615,PEWARNA HIJAU TUA,1,6000,0,6000,5000,1000
4/26/2021 13:35,8999999710880,PEPSODENT ACTION123 HERBAL 75G,1,7500,0,7500,6650,850
4/26/2021 13:35,8999999706081,PEPSODENT WHITE 75G,1,5000,0,5000,3850,1150
4/26/2021 13:35,8999999500399,LUX TS CAMELLIA WHITE,2,3500,0,7000,5600,1400
4/26/2021 13:35,8998866609173,SOKLIN LIQUID SOFTERGENT POUCH 400ML,2,8500,0,17000,15430,1570
4/26/2021 14:45,6907992825069,JD FRUITY,1,5000,0,5000,4400,600
4/26/2021 15:01,8995102703534,TERASI DUO 6 GR,1,4000,0,4000,3720,280
4/26/2021 15:01,8999999042592,RINSO MOLTO PERFUME ESSENSE LIQ 4OML,1,5500,0,5500,4817,683
4/26/2021 15:01,8998866613569,SOFTENER SKL BLS FINE 14SHT,1,5000,0,5000,4560,440
4/26/2021 15:01,8998866608749,SOFTENER SKL BLS TW VIOLET 14SCT,1,5000,0,5000,4560,440
4/26/2021 15:21,8993470279651,JOGER CHOCKY BAR,30,1000,0,30000,26010,3990
4/26/2021 15:30,BTS,BIMURA TARO SEAWEED 250G,1,10000,0,10000,9300,700
4/26/2021 15:30,TL,TELUR,6,1500,0,9000,7800,1200
4/26/2021 15:31,8999999057640,MOLTO EDP BLK PURPLE 20ML,5,1000,0,5000,4000,1000
4/26/2021 15:31,BTS,BIMURA TARO SEAWEED 250G,1,10000,0,10000,9300,700
4/26/2021 16:29,8997231980022,O'JELLY MINI STRAWBERRY,1,3000,0,3000,2250,750
4/26/2021 16:42,089686043051,INDOMIE COTO MAKASSAR,3,2800,0,8400,7575,825
4/26/2021 16:42,089686010107,INDOMIE KALDU AYAM,4,2500,0,10000,8600,1400
4/26/2021 16:42,8998009010569,ULTRA CHO 200,4,5000,0,20000,15320,4680
4/26/2021 17:11,GL,GULA 1 LITER,4,11500,0,46000,42000,4000
4/26/2021 17:11,GL,GULA 1 LITER,4,11500,0,46000,42000,4000
4/26/2021 17:17,8997231980022,O'JELLY MINI STRAWBERRY,1,3000,0,3000,2250,750
4/26/2021 17:17,BAYFLAST,BAYPLAST,2,500,0,1000,700,300
4/26/2021 18:02,8996001600375,LE MINERAL 330ML,1,2000,0,2000,1417,583
4/26/2021 18:02,CLUB,AIR CLUB,1,3000,0,3000,1452,1548
4/26/2021 18:05,8997007780689,JIZZY MINERAL,1,3000,0,3000,1187,1813
4/26/2021 18:05,8993989311699,CLAS MILD 16 FILTER,1,23000,0,23000,21700,1300
4/26/2021 18:05,123124,KOREK BIASA,1,2000,0,2000,1800,200
4/26/2021 18:12,8993989311279,CLAS MILD 12,1,17000,0,17000,15700,1300
4/26/2021 18:12,123124,KOREK BIASA,1,2000,0,2000,1800,200
4/26/2021 18:12,089686821086,ICHI OCHA MELATI,2,3000,0,6000,4500,1500
4/26/2021 18:12,8992775001783,GERY SALUT MALKIST,1,6500,0,6500,5516,984
4/26/2021 18:12,8992984920110,CUKA DAPUR DUA BELIBIS,1,4500,0,4500,3250,1250
4/26/2021 18:57,8997021870076,FRESH CARE SANDAL WOOD 10ML,1,12000,0,12000,10000,2000
4/26/2021 18:57,8998989300261,GUDANG GARAM SURYA 12 FILTER,1,18000,0,18000,16450,1550
4/26/2021 19:18,8998989500166,GUDANG GARAM MERAH BESAR 16KS,1,17000,0,17000,15300,1700
4/26/2021 19:21,GL,GULA 1 LITER,1,11500,0,11500,10500,1000
4/26/2021 19:25,6907992823959,JD HAWTHORN BERRY,1,2000,0,2000,1700,300
4/26/2021 19:46,6907992825076,JD WATERMELON APPLE,1,2000,0,2000,1700,300
4/26/2021 20:10,HT,HOT-HOT,2,500,0,1000,700,300
4/26/2021 20:10,8993072153595,LARISST COTTON 35G,1,5000,0,5000,3300,1700
4/26/2021 20:10,6907992825076,JD WATERMELON APPLE,1,2000,0,2000,1700,300
4/26/2021 20:10,6907992823676,JD PEACH,1,2000,0,2000,1700,300
4/26/2021 20:11,MARS,MARSHMELLOW,4,500,0,2000,1732,268
4/26/2021 20:25,6907992824963,JD MILKY CHOCOLATE,3,3000,0,9000,7800,1200
4/26/2021 20:25,6921101219235,YAKUAT JELLY,1,2000,0,2000,1750,250
4/26/2021 20:25,6907992823669,JD MILKY STRAW,1,3000,0,3000,2600,400
4/26/2021 20:46,8999999559557,LUX BW MAGICAL ORCHID 85ML,1,5000,0,5000,4000,1000
4/26/2021 21:01,089686021141,INTER MIE SOTO,2,1000,0,2000,1708,292
4/26/2021 21:02,TG MARKISA,TEH GELAS MARKISA,1,2000,0,2000,1178,822
4/26/2021 21:02,PRG,PARAGO,2,500,0,1000,800,200
4/26/2021 21:05,PRG,PARAGO,1,500,0,500,400,100
4/26/2021 21:05,HT,HOT-HOT,1,500,0,500,350,150
4/26/2021 21:08,8996001600399,LE MINERAL 1500ML,1,5000,0,5000,4042,958
4/26/2021 21:32,8998989121163,SURYA PRO MERAH,1,20000,0,20000,18600,1400
4/26/2021 21:32,089686011036,INDOMIE GORENG PEDAS,1,2700,0,2700,2452,248
4/26/2021 21:36,GL,GULA 1 LITER,1,11500,0,11500,10500,1000
4/26/2021 21:36,8992747180225,VIXAL PEMB PORS BIRU 720ML,1,18000,0,18000,16940,1060
4/26/2021 21:36,8998866679572,SOKLIN LANTAI MERAH 780ML,1,12000,0,12000,10020,1980
4/26/2021 21:36,8992775001042,PILUS GARUDA MI GORENG,1,5000,0,5000,4810,190
4/26/2021 21:56,ABC,BATERAI ABC BIRU,1,8500,0,8500,7500,1000
4/26/2021 21:58,8998866106504,EMERON LOVELY NAT PINK,1,3500,0,3500,2900,600
4/26/2021 21:58,8998866202312,NOODLE SEDAAP TASTY BAKMI AYAM 129 GR,1,5000,0,5000,4167,833
4/26/2021 21:58,TUSTEL,TUSUK TELINGA,1,1000,0,1000,833,167
4/26/2021 21:58,HT,HOT-HOT,1,500,0,500,350,150
4/26/2021 22:13,GL,GULA 1 LITER,2,11500,0,23000,21000,2000
4/26/2021 22:31,8998866501033,MINYAK GORENG SEDAAP POUCH 2L,1,28000,0,28000,27746,254
4/26/2021 22:31,089686010107,INDOMIE KALDU AYAM,1,2500,0,2500,2150,350
4/26/2021 22:31,8997231980022,O'JELLY MINI STRAWBERRY,1,3000,0,3000,2250,750
4/26/2021 22:31,089686043204,INDOMIE MIE ACEH,1,2700,0,2700,2452,248
4/26/2021 22:31,8992388112401,MIE ABC SELERA PEDAS- GORENG AYAM PEDAS LIMAU,2,2600,0,5200,4736,464
4/26/2021 22:31,8998866200301,MIE SEDAAP GORENG,1,2500,0,2500,2023,477
4/26/2021 22:31,089686043273,INDOMIE SAMBAL RICA,1,2700,0,2700,2452,248
4/26/2021 22:31,089686011036,INDOMIE GORENG PEDAS,1,2700,0,2700,2452,248
4/26/2021 22:31,kp,KALPA,1,2000,0,2000,1666,334
4/26/2021 22:31,TL,TELUR,3,1500,0,4500,3900,600
4/27/2021 12:28,8997007780689,JIZZY MINERAL,1,3000,0,3000,1187,1813
4/27/2021 12:28,8998866200820,NOODLE SEDAAP MIE AYAM BAWANG TLR CUP 77 GR,2,4500,0,9000,7300,1700
4/27/2021 13:54,8998866201841,GOLDA DOLCE LATTE 200ML,1,3000,0,3000,2500,500
4/27/2021 14:58,6907992825069,JD FRUITY,1,5000,0,5000,4400,600
4/27/2021 15:31,8997018720018,SIRUP DHT,1,23000,0,23000,20958,2042
4/27/2021 15:44,8997021300092,LARISSA BAWANG 250GR,1,5500,0,5500,5125,375
4/27/2021 15:44,TL,TELUR,6,1500,0,9000,7800,1200
4/27/2021 15:45,8998866808729,ROYALE SOFT WHITE,1,5000,0,5000,4500,500
4/27/2021 16:01,8998866200837,NOODLE SEDAAPMIE SOTO CUP 81 GR,1,4500,0,4500,3650,850
4/27/2021 16:01,PRG,PARAGO,1,500,0,500,400,100
4/27/2021 16:32,8992775001042,PILUS GARUDA MI GORENG,1,5000,0,5000,4810,190
4/27/2021 16:32,8992775211434,PILUS GARUDA SAPI PANGGANG,1,5500,0,5500,4713,787
4/27/2021 16:32,8998866611237,FRES&NATURAL DARKBLUE 100ML,1,11500,0,11500,10310,1190
4/27/2021 16:43,8995333032113,TERIGU GATOT KACA 1 KG,1,8500,0,8500,8012,488
4/27/2021 16:43,6921101219235,YAKUAT JELLY,1,2000,0,2000,1750,250
4/27/2021 16:43,8999999559861,AXE DARK POCKET FRAG 17ML,1,10000,0,10000,8000,2000
4/27/2021 16:47,8999999558079,RINSO MOLTO ROSE FRESH PWD 44G,6,1000,0,6000,4830,1170
4/27/2021 17:00,8998866107099,WET WIPES KODOMO BABY 50SHT CLSSC,1,15000,0,15000,13650,1350
4/27/2021 17:05,CLUB,AIR CLUB,1,3000,0,3000,1452,1548
4/27/2021 17:05,8997007780689,JIZZY MINERAL,1,3000,0,3000,1187,1813
4/27/2021 17:05,8991001780126,SELAMAT CKLAT 60G,1,5000,0,5000,4300,700
4/27/2021 17:05,8992775913000GT,CHOCOLATOS CKLT DRINK,1,18000,0,18000,15862,2138
4/27/2021 17:05,8992775000250GT,CHOCOLATOS MATCHA DRINK,1,18000,0,18000,15862,2138
4/27/2021 17:05,8999999544416,MOLTO CARE,1,20000,0,20000,18570,1430
4/27/2021 17:05,8999999706180,PEPSODENT WHITE 190GR,1,10000,0,10000,9350,650
4/27/2021 17:05,SF TAWAR COKLAT,SAFFANAH ROTI TAWAR COKLAT,1,13500,0,13500,12000,1500
4/27/2021 17:05,8992761136185,FANTA 1L,1,10000,0,10000,9000,1000
4/27/2021 17:07,8992753631209,OMELA 370,1,9500,0,9500,8400,1100
4/27/2021 17:54,8999999195649,SARI WANGI 25X1.86G,1,6000,0,6000,5050,950
4/27/2021 17:54,8998989300261,GUDANG GARAM SURYA 12 FILTER,2,18000,0,36000,32900,3100
4/27/2021 17:54,8991188943062,SASA 250G,2,10000,0,20000,17000,3000
4/27/2021 18:05,8993007003063,ENAAK 500G,1,11000,0,11000,9625,1375
4/27/2021 18:05,8991002103764,GOOD DAY CAPPUCINO 10X25G,1,1500,0,1500,1395,105
4/27/2021 18:05,JGR SHN,JOGER SHINY SACHET,1,500,0,500,437,63
4/27/2021 18:07,8993989311699,CLAS MILD 16 FILTER,1,23000,0,23000,21700,1300
4/27/2021 18:07,123124,KOREK BIASA,1,2000,0,2000,1800,200
4/27/2021 18:07,8994867006997,ROKOK PENA BOLD 20BTG,1,17000,0,17000,15000,2000
4/27/2021 18:11,8992761147143,SPRITE WATERLYMON 425ML,1,5500,0,5500,4300,1200
4/27/2021 18:55,8998989500166,GUDANG GARAM MERAH BESAR 16KS,3,17000,0,51000,45900,5100
4/27/2021 18:55,8993274532105,BOLU,2,1000,0,2000,1666,334
4/27/2021 19:37,8999999526856,MOLTO ALL IN ONE BLUE 11ML,1,5500,0,5500,4800,700
4/27/2021 19:37,8998866609043,DAIA SOFTENER GUSSET 565G,1,10000,0,10000,8700,1300
4/27/2021 19:37,8996001338056,TAMARIN,1,6000,0,6000,5100,900
4/27/2021 19:47,MARS,MARSHMELLOW,4,500,0,2000,1732,268
4/27/2021 21:03,8998009040023,TEH KOTAK,1,5000,0,5000,2827,2173
4/27/2021 21:05,8998866202725,MILKU COKLAT PREMIUM 200ML,1,3000,0,3000,2375,625
4/27/2021 21:05,8886013257400,TWISTKO,1,1000,0,1000,900,100
4/27/2021 21:05,HT,HOT-HOT,3,500,0,1500,1050,450
4/27/2021 21:05,COKLAT,COKLAT COIN,3,500,0,1500,1200,300
4/27/2021 21:05,MARS,MARSHMELLOW,2,500,0,1000,866,134
4/27/2021 21:08,8998989100120,GUDANG GARAM MINI,1,18000,0,18000,16600,1400
4/27/2021 21:08,MARS,MARSHMELLOW,2,500,0,1000,866,134
4/27/2021 21:08,PRG,PARAGO,2,500,0,1000,800,200
4/27/2021 21:13,JGR SHN,JOGER SHINY SACHET,2,500,0,1000,874,126
4/27/2021 21:19,MARS,MARSHMELLOW,4,500,0,2000,1732,268
4/27/2021 21:20,RB,RED BOLD,1,19000,0,19000,17900,1100
4/27/2021 21:50,8998009010590,ULTRA CHO 125,1,3000,0,3000,2428,572
4/27/2021 21:53,8993989311279,CLAS MILD 12,1,17000,0,17000,15700,1300
4/27/2021 21:53,8993989311699,CLAS MILD 16 FILTER,1,23000,0,23000,21700,1300
4/27/2021 21:54,GL,GULA 1 LITER,5,11500,0,57500,52500,5000
4/27/2021 21:57,6907992824963,JD MILKY CHOCOLATE,1,3000,0,3000,2600,400
4/27/2021 21:57,6907992823652,JD CHOCOLATE MILKSHAKE,1,6000,0,6000,5200,800
4/28/2021 11:19,8996001318911,BETTER ISI 4,1,2000,0,2000,1700,300
4/28/2021 11:19,8996001318430,BETTER 1000,1,1000,0,1000,820,180
4/28/2021 12:38,8998866610087,JAVANA ORIGINAL 350ML,1,3000,0,3000,2150,850
4/28/2021 12:38,BTS,BIMURA TARO SEAWEED 250G,2,10000,0,20000,18600,1400
4/28/2021 12:38,8991102387286SCT,TANGO LONG CKLT 47G,1,2000,0,2000,1551,449
4/28/2021 12:39,8992717900310,KARA SUN,2,2500,0,5000,4000,1000
4/28/2021 12:39,8999909096004,SAMPOERNA 16 FILTER,1,24000,0,24000,23000,1000
4/28/2021 15:00,8998866202053,POTABEE AYAM BAKAR PEDAS 68GR,1,8000,0,8000,7200,800
4/28/2021 15:00,8992696521629,DNCO COKLT UHT 180ML,1,5000,0,5000,3533,1467
4/28/2021 15:00,8992696425316,NESCAFE BLACK,1,5000,0,5000,4099,901
4/28/2021 15:00,8992696419742,NESCAFE COFFE CREAM,1,5000,0,5000,4099,901
4/28/2021 15:00,8991102714631,TANGO TETRA CKLT,1,5000,0,5000,4545,455
4/28/2021 15:00,8992696422650,NESCAFE FRENCH VANILLA,1,5000,0,5000,4099,901
4/28/2021 15:16,8996001301142,ROMA KELAPA,1,8000,0,8000,6628,1372
4/28/2021 15:16,8998866608558,SOKLIN SOFTERGENT BIRU 770G & PIRING,1,18000,0,18000,16055,1945
4/28/2021 15:16,8995333000822,TERIGU KOMPAS SOFT 500GR,1,5500,0,5500,4967,533
4/28/2021 15:16,TBM,NESTA TBM,1,5000,0,5000,4000,1000
4/28/2021 15:16,8997011700123,BIHUN JAGUNG 300GR,1,6000,0,6000,4979,1021
4/28/2021 15:36,8998866107495,ZINC HAIRFALL TREATH SHT 10ML,1,5000,0,5000,4500,500
4/28/2021 15:36,8998866808729,ROYALE SOFT WHITE,1,5000,0,5000,4500,500
4/28/2021 15:36,8998866608749,SOFTENER SKL BLS TW VIOLET 14SCT,1,5000,0,5000,4560,440
4/28/2021 16:44,8992959053331,CONFIDENCE CLASSIC NIGHT L7,1,42000,0,42000,38182,3818
4/28/2021 17:07,8999999008475,SUNLIGHT LIME NEW REF 1600ML,1,33000,0,33000,29800,3200
4/28/2021 17:07,8998009020186,BUAVITA GUAVA 250ML,2,7000,0,14000,12166,1834
4/28/2021 17:07,8998866501033,MINYAK GORENG SEDAAP POUCH 2L,1,28000,0,28000,27746,254
4/28/2021 17:22,P,PAKET RAMADHAN 50 RIBU,1,50000,0,50000,50000,0
4/28/2021 17:26,8999999195649,SARI WANGI 25X1.86G,1,6000,0,6000,5050,950
4/28/2021 17:26,8992761136185,FANTA 1L,1,10000,0,10000,9000,1000
4/28/2021 17:26,8998866501026,MINYAK GORENG SEDAAP POUCH 1 L,1,15000,0,15000,14110,890
4/28/2021 17:26,8995333032113,TERIGU GATOT KACA 1 KG,1,8500,0,8500,8012,488
4/28/2021 17:26,GL,GULA 1 LITER,1,11500,0,11500,10500,1000
4/28/2021 18:13,8998989300261,GUDANG GARAM SURYA 12 FILTER,1,18000,0,18000,16450,1550
4/28/2021 18:13,8997028590014,ARGUS 220ML,4,500,0,2000,1208,792
4/28/2021 18:13,123124,KOREK BIASA,1,2000,0,2000,1800,200
4/28/2021 18:13,8996001600399,LE MINERAL 1500ML,2,5000,0,10000,8084,1916
4/28/2021 18:16,8991001780133,TWISTER BLACK,1,5000,0,5000,4600,400
4/28/2021 18:41,8999099920714,SGM 1+ VANILA 900,2,80000,0,160000,157020,2980
4/28/2021 18:41,8999099920691,SGM 1+ MADU 1000G,3,85000,0,255000,235530,19470
4/28/2021 19:24,BTS,BIMURA TARO SEAWEED 250G,1,10000,0,10000,9300,700
4/28/2021 19:24,8998866200301,MIE SEDAAP GORENG,2,2500,0,5000,4046,954
4/28/2021 19:24,TL,TELUR,6,1500,0,9000,7800,1200
4/28/2021 19:32,8998989300261,GUDANG GARAM SURYA 12 FILTER,1,18000,0,18000,16450,1550
4/28/2021 19:32,8997013790108,BIMURA KACANG TELUR 25G,1,1000,0,1000,875,125
4/28/2021 19:32,BTS,BIMURA TARO SEAWEED 250G,1,10000,0,10000,9300,700
4/28/2021 19:36,8995333000822,TERIGU KOMPAS SOFT 500GR,1,5500,0,5500,4967,533
4/28/2021 19:36,8991102022347,SIKAT GIGI FORMULA RIPPLE,1,5000,0,5000,4583,417
4/28/2021 19:44,TUSTEL,TUSUK TELINGA,1,1000,0,1000,833,167
4/28/2021 19:52,8992959509005,SWEETY SILVER PANTS XL26,1,61500,0,61500,55910,5590
4/28/2021 19:52,8999801700030,SUSU FOYU,1,11500,0,11500,10450,1050
4/28/2021 19:52,8992628020152,BIMOLI POUCH 2L,1,30000,0,30000,29000,1000
4/28/2021 19:52,711844120419,SAMBAL ABC 275 ML,1,12000,0,12000,10800,1200
4/28/2021 19:59,8997013790108,BIMURA KACANG TELUR 25G,1,1000,0,1000,875,125
4/28/2021 19:59,8994834005923,SPIX 1000,1,1000,0,1000,850,150
4/28/2021 20:44,8998989300261,GUDANG GARAM SURYA 12 FILTER,1,18000,0,18000,16450,1550
4/28/2021 20:44,001,PASEO SMART FACIAL SF 250S GT,1,10000,0,10000,9500,500
4/28/2021 20:56,ABC SPW,BATERAI ABC SPW,1,4500,0,4500,3893,607
4/28/2021 20:56,8992628020152,BIMOLI POUCH 2L,1,30000,0,30000,29000,1000
4/28/2021 21:06,MARS,MARSHMELLOW,2,500,0,1000,866,134
4/28/2021 21:10,089686043273,INDOMIE SAMBAL RICA,1,2700,0,2700,2452,248
4/28/2021 21:10,8992761145019,COCA COLA PET 250ML,1,3500,0,3500,2417,1083
4/28/2021 21:15,8993989311699,CLAS MILD 16 FILTER,1,23000,0,23000,21700,1300
4/28/2021 21:45,8992388112401,MIE ABC SELERA PEDAS- GORENG AYAM PEDAS LIMAU,2,2600,0,5200,4736,464
4/28/2021 21:45,PRG,PARAGO,1,500,0,500,400,100
4/28/2021 21:45,MARS,MARSHMELLOW,1,500,0,500,433,67
4/28/2021 21:59,8998866202725,MILKU COKLAT PREMIUM 200ML,1,3000,0,3000,2375,625
4/28/2021 21:59,KJ,KINDER JOY,2,2000,0,4000,3166,834
4/28/2021 21:59,ff,FULLO BLASTO,2,1000,0,2000,1990,10
4/28/2021 21:59,bb,BENG-BENG,1,1500,0,1500,1450,50
4/28/2021 22:12,089686017748,SARIMIE GORENG ISI 2,2,3500,0,7000,6240,760
4/28/2021 22:30,089686049053,SARIMI PUAS,1,3000,0,3000,2400,600
4/29/2021 11:51,8991102989428GT,TANGO CKLT 24G GT,2,7500,0,15000,12184,2816
4/29/2021 11:51,8991102385091,WFR TANGO CKLT 7G,1,8300,0,8300,7455,845
4/29/2021 11:51,8991102989312,WFR TANGO SBJ 7G,1,8300,0,8300,7455,845
4/29/2021 11:51,8995333060772,TERIGU GATOT KACA 500GR,3,4500,0,13500,12195,1305
4/29/2021 11:51,8998866202237,NOODLE SEDAAP TASTY AYAM GEPREK 124 GR,1,5000,0,5000,4167,833
4/29/2021 11:51,8998866202312,NOODLE SEDAAP TASTY BAKMI AYAM 129 GR,1,5000,0,5000,4167,833
4/29/2021 11:51,8992753031900,BKM SCT PUTIH 40G,4,7500,0,30000,27600,2400
4/29/2021 11:51,8998866609029,DAIA PUTIH GUSSWET 565G,1,10000,0,10000,8700,1300
4/29/2021 11:51,8998866609043,DAIA SOFTENER GUSSET 565G,1,10000,0,10000,8700,1300
4/29/2021 11:51,8998866610278,DAIA VIOLET GUSSET 565G,1,10000,0,10000,8700,1300
4/29/2021 11:51,8998866202770,MIE SEDAAP SALERO PADANG,5,2500,0,12500,11810,690
4/29/2021 13:12,8998866501033,MINYAK GORENG SEDAAP POUCH 2L,1,28000,0,28000,27746,254
4/29/2021 15:09,8998866501033,MINYAK GORENG SEDAAP POUCH 2L,1,28000,0,28000,27746,254
4/29/2021 15:09,8999801700054,SUSU FOYU 1 KG,1,22000,0,22000,20104,1896
4/29/2021 15:09,8995333032113,TERIGU GATOT KACA 1 KG,1,8500,0,8500,8012,488
4/29/2021 15:09,8997018720018,SIRUP DHT,1,23000,0,23000,20958,2042
4/29/2021 15:12,089686021127,INTER MIE KALDU,2,1000,0,2000,1626,374
4/29/2021 15:12,8992753100101,BKM FULL CREAM GOLD 370,1,15000,0,15000,14000,1000
4/29/2021 15:12,8992761145026,SPRITE PET 250ML,1,3500,0,3500,2417,1083
4/29/2021 15:12,8997013790092,BIMURA KERUPUK BAWANG 25G,2,1000,0,2000,1748,252
4/29/2021 15:12,MARS,MARSHMELLOW,1,500,0,500,433,67
4/29/2021 15:12,8997211400038,SANTAN COCONUT CREAM,1,4000,0,4000,3000,1000
4/29/2021 15:25,8999908204202,MY BABY MINYAK TELON 60ML,1,18000,0,18000,16900,1100
4/29/2021 16:16,8992984920110,CUKA DAPUR DUA BELIBIS,2,4500,0,9000,6500,2500
4/29/2021 16:34,8992959508893,SWEETY SILVER PANTS S 9,1,14500,0,14500,13107,1393
4/29/2021 16:36,089686834307,FREISS LECI,1,11000,0,11000,8750,2250
4/29/2021 17:04,089686021127,INTER MIE KALDU,1,1000,0,1000,813,187
4/29/2021 17:04,089686021127,INTER MIE KALDU,4,1000,0,4000,3252,748
4/29/2021 17:05,9556040040038,SUSU F&N,1,33000,0,33000,30000,3000
4/29/2021 17:05,8992775002735,CHOCOLATOS SUSU COKELAT,1,4000,0,4000,3520,480
4/29/2021 17:06,8992761136185,FANTA 1L,1,10000,0,10000,9000,1000
4/29/2021 17:06,GL,GULA 1 LITER,1,11500,0,11500,10500,1000
4/29/2021 17:06,8999999195649,SARI WANGI 25X1.86G,1,6000,0,6000,5050,950
4/29/2021 17:06,8995333032113,TERIGU GATOT KACA 1 KG,1,8500,0,8500,8012,488
4/29/2021 17:06,8998866501026,MINYAK GORENG SEDAAP POUCH 1 L,1,15000,0,15000,14110,890
4/29/2021 17:08,11222,LEM KOREA,1,9000,0,9000,8000,1000
4/29/2021 17:32,GL,GULA 1 LITER,4,11500,0,46000,42000,4000
4/29/2021 17:35,8851019210117,POCKY CHOCOLATE 47G,2,7300,0,14600,11342,3258
4/29/2021 17:51,8998989300261,GUDANG GARAM SURYA 12 FILTER,1,18000,0,18000,16450,1550
4/29/2021 17:56,089686043051,INDOMIE COTO MAKASSAR,1,2800,0,2800,2525,275
4/29/2021 17:56,089686021219,INTER MIE GORENG,2,1000,0,2000,1770,230
4/29/2021 17:56,8993989311699,CLAS MILD 16 FILTER,1,23000,0,23000,21700,1300
4/29/2021 18:02,8995150101696,M+SUSU ORIGINAL,1,5000,0,5000,4000,1000
4/29/2021 18:48,8991102281430,PERMEN MINTZ DUOMINT,1,4500,0,4500,4000,500
4/29/2021 19:10,8997009510116,LEMON WATER,1,7000,0,7000,5694,1306
4/29/2021 21:21,8992388112401,MIE ABC SELERA PEDAS- GORENG AYAM PEDAS LIMAU,1,2600,0,2600,2368,232
4/29/2021 21:21,JGR SHN,JOGER SHINY SACHET,1,500,0,500,437,63
4/29/2021 21:29,089686043273,INDOMIE SAMBAL RICA,3,2700,0,8100,7356,744
4/29/2021 21:29,8992761002022,SPRITE PET 390ML,1,5500,0,5500,4300,1200
4/29/2021 21:29,8999909096004,SAMPOERNA 16 FILTER,1,24000,0,24000,23000,1000
4/29/2021 21:53,8994420100018,SARDEN SAUS PEDAS,1,7000,0,7000,5833,1167
4/29/2021 21:53,089686021127,INTER MIE KALDU,3,1000,0,3000,2439,561
4/29/2021 21:53,TL,TELUR,3,1500,0,4500,3900,600
4/29/2021 21:56,8992775311486,CHOCOLATOS DARK 16G,1,18000,0,18000,15173,2827
4/29/2021 21:56,8992775305164,MALKIST GREEN TEA,1,6500,0,6500,5500,1000
4/29/2021 21:56,8996001305003,SARI GANDUM SANDWICH,1,6000,0,6000,5100,900
4/29/2021 21:56,8991102989381,TANGO LONG BUBBLEGUM 130G,1,5000,0,5000,4345,655
4/29/2021 21:56,8998009020186,BUAVITA GUAVA 250ML,1,7000,0,7000,6083,917
4/29/2021 21:56,8992775110157,GARUDA KACANG KULIT,1,5000,0,5000,3925,1075
4/29/2021 21:56,089686021219,INTER MIE GORENG,1,1000,0,1000,885,115
4/29/2021 22:29,8999999719418,VASELINE HW UV LIGHTENING 200ML,1,24200,0,24200,21853,2347
4/29/2021 22:29,8999999558062,RINSO ANTI NODA CLASSIC PWD 44G,1,5000,0,5000,4830,170
4/30/2021 11:28,8993470411433,JOGER CLASSIC,28,1000,0,28000,23800,4200
4/30/2021 13:07,8998866200837,NOODLE SEDAAPMIE SOTO CUP 81 GR,3,4500,0,13500,10950,2550
4/30/2021 13:07,HT,HOT-HOT,2,500,0,1000,700,300
4/30/2021 13:07,MARS,MARSHMELLOW,1,500,0,500,433,67
4/30/2021 13:07,8997013790092,BIMURA KERUPUK BAWANG 25G,2,1000,0,2000,1748,252
4/30/2021 14:06,GL,GULA 1 LITER,1,11500,0,11500,10500,1000
4/30/2021 14:06,COKLAT,COKLAT COIN,1,500,0,500,400,100
4/30/2021 14:50,8992761139018,ADES 600ML,1,3500,0,3500,2292,1208
4/30/2021 15:10,8992628010139,BIMOLI 5L,1,75000,0,75000,72100,2900
4/30/2021 15:10,8999801700054,SUSU FOYU 1 KG,1,22000,0,22000,20104,1896
4/30/2021 17:36,8992761111540,FANTA STRAWBERY SLIM CAM 250ML,1,5000,0,5000,3750,1250
4/30/2021 17:36,8998989110167,SURYA GUDANG GARAM 16 FILTER,1,24000,0,24000,22100,1900
4/30/2021 17:36,8998989300261,GUDANG GARAM SURYA 12 FILTER,1,18000,0,18000,16450,1550
4/30/2021 18:01,8998989300261,GUDANG GARAM SURYA 12 FILTER,1,18000,0,18000,16450,1550
4/30/2021 18:20,8992761139018,ADES 600ML,1,3500,0,3500,2292,1208
4/30/2021 18:20,8996001600375,LE MINERAL 330ML,3,2000,0,6000,4251,1749
4/30/2021 18:34,711844120433,SAMBAL ABC 600 ML,1,22000,0,22000,20300,1700
4/30/2021 19:52,SWAL,SENDAL SWALLOW,1,18000,0,18000,16500,1500
4/30/2021 19:52,8999909982000,SAMPOERNA 12 FILTER,1,18000,0,18000,16200,1800
4/30/2021 20:15,8998866201483,POTABEE REGULER GRILLED SEAWEED 35GR,1,5000,0,5000,4150,850
4/30/2021 20:15,8999999524722,SUNLIGHT LIME NEW PCH 435ML,1,10000,0,10000,9100,900
4/30/2021 20:15,8992770034151,MASAKO 250GR,1,10000,0,10000,8000,2000
4/30/2021 20:15,8999999049423,REXONA MEN RO SPORT DEFENSE 45 ML,1,15000,0,15000,13550,1450
4/30/2021 20:15,8992775110157,GARUDA KACANG KULIT,1,5000,0,5000,3925,1075
4/30/2021 20:15,8991102303309,WFR TANGO SBJ 176G,1,10000,0,10000,8694,1306
4/30/2021 20:38,8998989500166,GUDANG GARAM MERAH BESAR 16KS,2,17000,0,34000,30600,3400
4/30/2021 20:38,6907992823904,JD CRUNCHY CHOCOLATE VAN,2,8000,0,16000,13600,2400
4/30/2021 21:00,089686021141,INTER MIE SOTO,1,1000,0,1000,854,146
4/30/2021 21:00,089686021219,INTER MIE GORENG,1,1000,0,1000,885,115
4/30/2021 21:02,089686011036,INDOMIE GORENG PEDAS,1,2700,0,2700,2452,248
4/30/2021 21:02,089686021219,INTER MIE GORENG,2,1000,0,2000,1770,230
4/30/2021 21:03,6907992823829,JD MILKY MILK,1,3000,0,3000,2600,400
4/30/2021 21:03,6907992825076,JD WATERMELON APPLE,1,2000,0,2000,1700,300
4/30/2021 21:03,8997231980022,O'JELLY MINI STRAWBERRY,1,3000,0,3000,2250,750
4/30/2021 21:05,089686044249,SUPERMI NUTRIMI STEAK AYAM,1,3500,0,3500,2800,700
4/30/2021 21:24,8998866201469,POTABEE REGULER BBQ BEEF 68 GR,1,8000,0,8000,7200,800
4/30/2021 21:24,8991102308861,FULLO BLASTO,1,16000,0,16000,14545,1455
4/30/2021 21:24,8998866202664,POTABEE WAGYU BEEF STEAK 68 GR,1,8000,0,8000,7200,800
4/30/2021 21:25,8997231980022,O'JELLY MINI STRAWBERRY,1,3000,0,3000,2250,750
4/30/2021 21:26,8997231980022,O'JELLY MINI STRAWBERRY,1,3000,0,3000,2250,750
4/30/2021 21:48,8998866612173,SOKLIN SOFTERGENT 770G & PIRING,1,18000,0,18000,16055,1945
4/30/2021 21:48,001,PASEO SMART FACIAL SF 250S GT,1,10000,0,10000,9500,500
4/30/2021 21:56,089686021219,INTER MIE GORENG,1,1000,0,1000,885,115
4/30/2021 21:56,8997013790108,BIMURA KACANG TELUR 25G,1,1000,0,1000,875,125
4/30/2021 21:56,8997013790092,BIMURA KERUPUK BAWANG 25G,1,1000,0,1000,874,126
4/30/2021 22:00,089686021219,INTER MIE GORENG,3,1000,0,3000,2655,345
4/30/2021 22:00,TL,TELUR,2,1500,0,3000,2600,400
4/30/2021 22:01,8992775305164,MALKIST GREEN TEA,1,6500,0,6500,5500,1000
4/30/2021 22:01,8992775311325,GERY SNACK&SEREAL 100G,1,7000,0,7000,6012,988
4/30/2021 22:29,6921101219235,YAKUAT JELLY,1,2000,0,2000,1750,250
4/30/2021 22:37,8992761164539,NUTRIBOOST ORANGE 300ML,1,6500,0,6500,5300,1200
4/30/2021 22:37,8993470672827,SAKU-SAKU SAPI PANGGANG,1,2000,0,2000,1530,470
4/30/2021 22:37,8993470672858,SAKU-SAKU RASA BALADO,1,2000,0,2000,1530,470
5/1/2021 11:03,8992959107515,SFX NON WING 23CM 8,1,4000,0,4000,3288,712
5/1/2021 11:03,8997027300089,NOMOS,1,4000,0,4000,2963,1037
5/1/2021 11:03,8997013790092,BIMURA KERUPUK BAWANG 25G,1,1000,0,1000,874,126
5/1/2021 11:03,089686021141,INTER MIE SOTO,1,1000,0,1000,854,146
5/1/2021 11:03,089686021219,INTER MIE GORENG,1,1000,0,1000,885,115
5/1/2021 11:03,8997028590014,ARGUS 220ML,2,500,0,1000,604,396
5/1/2021 11:15,HT,HOT-HOT,2,500,0,1000,700,300
5/1/2021 11:15,MARS,MARSHMELLOW,1,500,0,500,433,67
5/1/2021 11:15,8991102989428SCT,TANGO CKLT 24G SCT,1,1000,0,1000,609,391
5/1/2021 11:47,GL,GULA 1 LITER,15,11500,0,172500,157500,15000
5/1/2021 11:47,8991102384841,WFR TANGO LONG CKLT 130G,1,5000,0,5000,4345,655
5/1/2021 11:47,8991102987639,WFR TANGO LONG VNL 130G,1,5000,0,5000,3773,1227
5/1/2021 13:04,GL,GULA 1 LITER,1,11500,0,11500,10500,1000
5/1/2021 13:05,8998866202770,MIE SEDAAP SALERO PADANG,1,2500,0,2500,2362,138
5/1/2021 13:05,8998866200578,MIE SEDAAP KARI KENTAL,1,2500,0,2500,2263,237
5/1/2021 13:05,8998866200301,MIE SEDAAP GORENG,1,2500,0,2500,2023,477
5/1/2021 13:05,8998866200325,MIE SEDAAP SOTO,1,2500,0,2500,1952,548
5/1/2021 14:46,089686011036,INDOMIE GORENG PEDAS,1,2700,0,2700,2452,248
5/1/2021 15:21,GL,GULA 1 LITER,1,11500,0,11500,10500,1000
5/1/2021 15:28,TL,TELUR,6,1500,0,9000,7800,1200
5/1/2021 15:28,8998866501026,MINYAK GORENG SEDAAP POUCH 1 L,1,15000,0,15000,14110,890
5/1/2021 15:28,8998009010569,ULTRA CHO 200,1,5000,0,5000,3830,1170
5/1/2021 15:28,8998866201889,KRISBEE PILLOW STRAWBERRY ICE CREAM 120GR,1,8000,0,8000,7250,750
5/1/2021 15:28,RBB,ROSE BRAND,1,9000,0,9000,8000,1000
5/1/2021 15:28,6907992823843,JD MOCHA CRISPY,1,5000,0,5000,4400,600
5/1/2021 16:23,8995102703534,TERASI DUO 6 GR,1,4000,0,4000,3720,280
5/1/2021 20:20,8991002103764,GOOD DAY CAPPUCINO 10X25G,2,1500,0,3000,2790,210
5/1/2021 20:20,089686021141,INTER MIE SOTO,3,1000,0,3000,2562,438
5/1/2021 20:20,089686021219,INTER MIE GORENG,1,1000,0,1000,885,115
5/1/2021 20:54,8992761145019,COCA COLA PET 250ML,1,3500,0,3500,2417,1083
5/1/2021 21:15,8993274532105,BOLU,4,1000,0,4000,3332,668
5/1/2021 21:15,6907992823829,JD MILKY MILK,1,3000,0,3000,2600,400
5/1/2021 21:16,8991102022347,SIKAT GIGI FORMULA RIPPLE,1,5000,0,5000,4583,417
5/1/2021 21:16,8998866888622,GIV MERAH KOTAK 76G,1,2000,0,2000,1820,180
5/1/2021 21:16,6907992825076,JD WATERMELON APPLE,1,2000,0,2000,1700,300
5/1/2021 21:16,6907992823959,JD HAWTHORN BERRY,1,2000,0,2000,1700,300
5/1/2021 21:16,MARS,MARSHMELLOW,2,500,0,1000,866,134
5/1/2021 21:38,089686021219,INTER MIE GORENG,3,1000,0,3000,2655,345
5/1/2021 21:38,8994420100018,SARDEN SAUS PEDAS,1,7000,0,7000,5833,1167
5/1/2021 22:52,089686010190,INDOMIE KARI AYAM,1,2800,0,2800,2522,278
5/2/2021 11:55,8991102213189,BLASTER UNGU,1,5000,0,5000,3106,1894
5/2/2021 12:16,8998866613729,EMERON LOVELY NTRL 100ML,1,3500,0,3500,2900,600
5/2/2021 12:53,8997009510116,LEMON WATER,1,7000,0,7000,5694,1306
5/2/2021 12:53,8994834005923,SPIX 1000,2,1000,0,2000,1700,300
5/2/2021 12:53,8886013257400,TWISTKO,1,1000,0,1000,900,100
5/2/2021 14:08,8992959074206,HN PANTS S20,1,25000,0,25000,22576,2424
5/2/2021 14:08,8998866601436,PODET DAIA BUNGA BAG 850GR & PIRING,1,18000,0,18000,15627,2373
5/2/2021 14:08,8992959610107,HN PANTS L 48,1,77000,0,77000,72425,4575
5/2/2021 14:08,P,PAKET RAMADHAN 50 RIBU,2,50000,0,100000,100000,0
5/2/2021 14:08,BMO,BERAS MERAH ORGANIK,1,25000,0,25000,23500,1500
5/2/2021 14:08,GL,GULA 1 LITER,1,11500,0,11500,10500,1000
5/2/2021 14:08,8992696521797GT,MILO ACT GO SCT 22G,1,17500,0,17500,15536,1964
5/2/2021 14:08,8998009040023,TEH KOTAK,1,5000,0,5000,2827,2173
5/2/2021 14:58,8998866200646,KOPI TOP MURNI,1,11000,0,11000,9600,1400
5/2/2021 15:22,8992761164546,NUTRIBOOST STRAWBERRY 300ML,1,6500,0,6500,5300,1200
5/2/2021 15:22,8991102387286SCT,TANGO LONG CKLT 47G,1,2000,0,2000,1551,449
5/2/2021 15:22,8993989311699,CLAS MILD 16 FILTER,1,23000,0,23000,21700,1300
5/2/2021 15:30,8999999514648,LUX BWSAKURA BLOOM LD REFF 450 ML,1,25000,0,25000,22110,2890
5/2/2021 15:30,8999999048501,SUNSILK RFR ANTI DDRF 170ML,1,22200,0,22200,20020,2180
5/2/2021 15:30,8993072254056,MELROSE COTTON BUDS KCL,1,3000,0,3000,2450,550
5/2/2021 15:30,TK,TOPUN KOTAN,1,14000,0,14000,13000,1000
5/2/2021 15:52,8991102384841,WFR TANGO LONG CKLT 130G,1,5000,0,5000,4345,655
5/2/2021 15:52,8991102987639,WFR TANGO LONG VNL 130G,1,5000,0,5000,3773,1227
5/2/2021 15:52,8991102989381,TANGO LONG BUBBLEGUM 130G,1,5000,0,5000,4345,655
5/2/2021 15:52,8992775610008,TING-TING GARUDA 2.5G,1,7500,0,7500,6296,1204
5/2/2021 16:18,8998866501033,MINYAK GORENG SEDAAP POUCH 2L,1,28000,0,28000,27746,254
5/2/2021 16:28,8992628010139,BIMOLI 5L,1,75000,0,75000,72100,2900
5/2/2021 17:27,8997018720018,SIRUP DHT,1,23000,0,23000,20958,2042
5/2/2021 17:27,8997218380074,ICHITAN MILK TEA,1,8000,0,8000,6583,1417
5/2/2021 18:01,8998989300261,GUDANG GARAM SURYA 12 FILTER,1,18000,0,18000,16450,1550
5/2/2021 18:01,123124,KOREK BIASA,1,2000,0,2000,1800,200
5/2/2021 18:01,8991102387286SCT,TANGO LONG CKLT 47G,1,2000,0,2000,1551,449
5/2/2021 18:03,8998989300261,GUDANG GARAM SURYA 12 FILTER,1,18000,0,18000,16450,1550
5/2/2021 19:10,8992388101085,NU GREEN TEA ORIGINAL 330ML,1,3500,0,3500,2854,646
5/2/2021 19:10,8997231980022,O'JELLY MINI STRAWBERRY,1,3000,0,3000,2250,750
5/2/2021 19:10,TG MARKISA,TEH GELAS MARKISA,1,2000,0,2000,1178,822
5/2/2021 19:17,8998989300261,GUDANG GARAM SURYA 12 FILTER,1,18000,0,18000,16450,1550
5/2/2021 19:23,8992761139018,ADES 600ML,2,3500,0,7000,4584,2416
5/2/2021 19:27,8998866611718,EKONOMI PENCUCI PIRING  LIQ 780ML,1,12000,0,12000,10900,1100
5/2/2021 20:57,8997009510055,YOU C1000,1,10000,0,10000,9166,834
5/2/2021 21:00,8994420100018,SARDEN SAUS PEDAS,1,7000,0,7000,5833,1167
5/2/2021 21:00,089686021219,INTER MIE GORENG,5,1000,0,5000,4425,575
5/2/2021 21:00,8999999558079,RINSO MOLTO ROSE FRESH PWD 44G,5,1000,0,5000,4025,975
5/2/2021 21:00,089686043051,INDOMIE COTO MAKASSAR,1,2800,0,2800,2525,275
5/2/2021 21:14,8999909003439,MARLBORO CRAFTED 12,1,8000,0,8000,5437,2563
5/2/2021 21:14,8997231980022,O'JELLY MINI STRAWBERRY,1,3000,0,3000,2250,750
5/2/2021 21:14,HT,HOT-HOT,2,500,0,1000,700,300
5/2/2021 21:17,6907992823829,JD MILKY MILK,1,3000,0,3000,2600,400
5/2/2021 21:17,6907992824963,JD MILKY CHOCOLATE,1,3000,0,3000,2600,400
5/2/2021 21:34,8997018250218,JAHE MERAH,2,1000,0,2000,1666,334
5/2/2021 21:34,SMC,BIMURA MAKARONI CINCIN 250G,1,10000,0,10000,9300,700
5/2/2021 21:34,TLR,TELUR,1,43000,0,43000,39000,4000
5/2/2021 21:36,BMO,BERAS MERAH ORGANIK,1,25000,0,25000,23500,1500
5/2/2021 21:41,8997231980022,O'JELLY MINI STRAWBERRY,2,3000,0,6000,4500,1500
5/2/2021 21:41,MARS,MARSHMELLOW,4,500,0,2000,1732,268
5/2/2021 21:51,BALON,BALON CABUT,2,1000,0,2000,1800,200
5/2/2021 21:51,KJ,KINDER JOY,1,2000,0,2000,1583,417
5/2/2021 22:17,8991001502933,CHACHA TUBE,2,7500,0,15000,12800,2200
5/2/2021 22:18,8992957220117,COKLAT BERUANG,1,2000,0,2000,1700,300
5/2/2021 22:18,8992957220087,COKLAT SINGA,1,2000,0,2000,1700,300
5/2/2021 22:31,8992761166052,FRESTEA MELATI 350ML,1,4500,0,4500,3000,1500
5/2/2021 22:31,8996001600399,LE MINERAL 1500ML,1,5000,0,5000,4042,958
5/2/2021 22:36,8997231980022,O'JELLY MINI STRAWBERRY,1,3000,0,3000,2250,750
5/3/2021 10:34,8991102989428GT,TANGO CKLT 24G GT,2,7500,0,15000,12184,2816
5/3/2021 10:34,8991102994422,TANGO WALUT CHOCOBNN 18G,1,9000,0,9000,8661,339
5/3/2021 10:34,8992753102303,BKM SCT CKLT 40G,2,7500,0,15000,13800,1200
5/3/2021 10:37,MOBIL,GULA GULA HP,2,2000,0,4000,3400,600
5/3/2021 11:02,8997013790108,BIMURA KACANG TELUR 25G,1,1000,0,1000,875,125
5/3/2021 11:02,8998866618298,DAIA CLEAN&FRESH HJB 320GR,1,5000,0,5000,4450,550
5/3/2021 11:58,8991111102832,JB POWDER BEDTIME 300G,1,14500,0,14500,13120,1380
5/3/2021 11:58,8992753102204,BKM COKLAT 370G,1,11300,0,11300,9500,1800
5/3/2021 11:58,089686017748,SARIMIE GORENG ISI 2,1,3500,0,3500,3120,380
5/3/2021 11:58,8998866200882,SUKSESMIE GORENG AYAM KRMS 133GR,1,3500,0,3500,3047,453
5/3/2021 11:58,8996001305041,ROMA SANDWICH CKLT,1,7000,0,7000,5000,2000
5/3/2021 12:00,8998866202770,MIE SEDAAP SALERO PADANG,1,2500,0,2500,2362,138
5/3/2021 12:00,JGR SHN,JOGER SHINY SACHET,1,500,0,500,437,63
5/3/2021 14:01,BC,BONIBOL COKELAT,1,85000,0,85000,70000,15000
5/3/2021 14:07,6907992823652,JD CHOCOLATE MILKSHAKE,1,6000,0,6000,5200,800
5/3/2021 14:07,8997028590014,ARGUS 220ML,4,500,0,2000,1208,792
5/3/2021 14:09,8997028590014,ARGUS 220ML,4,500,0,2000,1208,792
5/3/2021 14:09,089686021141,INTER MIE SOTO,3,1000,0,3000,2562,438
5/3/2021 14:18,8992933219111,NUTRIJELL CINCAU,1,6000,0,6000,5000,1000
5/3/2021 14:18,8992933214116,NUTRIJELL MELON,1,6000,0,6000,5041,959
5/3/2021 14:18,8992933218114,NUTRIJELL GRAPE,1,6000,0,6000,4950,1050
5/3/2021 14:28,8998866202343,MIE SEDAAP KOREAN SPICY,1,2500,0,2500,2023,477
5/3/2021 14:40,8996001600375,LE MINERAL 330ML,1,2000,0,2000,1417,583
5/3/2021 14:40,MARS,MARSHMELLOW,1,500,0,500,433,67
5/3/2021 14:43,8998866501033,MINYAK GORENG SEDAAP POUCH 2L,1,28000,0,28000,27746,254
5/3/2021 15:00,JGR SHN,JOGER SHINY SACHET,2,500,0,1000,874,126
5/3/2021 15:14,8997028590014,ARGUS 220ML,4,500,0,2000,1208,792
5/3/2021 15:47,9556001004673,MILO NESTLE MALAYSIA ACTIVE GO,1,85000,0,85000,80000,5000
5/3/2021 16:16,MARS,MARSHMELLOW,10,500,0,5000,4330,670
5/3/2021 16:16,MARS,MARSHMELLOW,1,500,0,500,433,67
5/3/2021 16:16,HT,HOT-HOT,1,500,0,500,350,150
5/3/2021 16:25,8999801700054,SUSU FOYU 1 KG,1,22000,0,22000,20104,1896
5/3/2021 16:52,GL,GULA 1 LITER,1,11500,0,11500,10500,1000
5/3/2021 17:36,8992628010139,BIMOLI 5L,1,75000,0,75000,72100,2900
5/3/2021 18:02,8992761139018,ADES 600ML,1,3500,0,3500,2292,1208
5/3/2021 18:38,711844120037,SAMBAL ABC 135 ML,1,7000,0,7000,5600,1400
5/3/2021 18:38,8999999048488,SUNSILK SHP REFRESH ANTI DDRF 70+21ML,1,10000,0,10000,9075,925
5/3/2021 19:15,8997231980022,O'JELLY MINI STRAWBERRY,1,3000,0,3000,2250,750
5/3/2021 19:15,8993274532105,BOLU,1,1000,0,1000,833,167
5/3/2021 19:26,8996001370063,CHOKI-CHOKI,1,18200,0,18200,16500,1700
5/3/2021 19:29,8997231980022,O'JELLY MINI STRAWBERRY,2,3000,0,6000,4500,1500
5/3/2021 19:30,8998866610278,DAIA VIOLET GUSSET 565G,1,10000,0,10000,8700,1300
5/3/2021 19:35,8992628010139,BIMOLI 5L,1,75000,0,75000,72100,2900
5/3/2021 19:37,8997231980022,O'JELLY MINI STRAWBERRY,2,3000,0,6000,4500,1500
5/3/2021 19:43,8993058105013,EXTRA JOSS,1,12000,0,12000,9773,2227
5/3/2021 19:47,8998898830125,KKB ENER-G ANGGUR,1,5500,0,5500,4824,676
5/3/2021 20:20,8994867007161,ROKOK PENA GOLD 20,1,17000,0,17000,15000,2000
5/3/2021 20:20,8997231980022,O'JELLY MINI STRAWBERRY,3,3000,0,9000,6750,2250
5/3/2021 20:27,8997021870052,FRESH CARE GREEN TEA 10ML,1,12000,0,12000,10000,2000
5/3/2021 20:27,6907992823843,JD MOCHA CRISPY,1,5000,0,5000,4400,600
5/3/2021 20:56,8991102213189,BLASTER UNGU,1,5000,0,5000,3106,1894
5/3/2021 20:56,8992761145019,COCA COLA PET 250ML,1,3500,0,3500,2417,1083
5/3/2021 20:59,BALON,BALON CABUT,3,1000,0,3000,2700,300
5/3/2021 20:59,PRG,PARAGO,2,500,0,1000,800,200
5/3/2021 20:59,JGR SHN,JOGER SHINY SACHET,2,500,0,1000,874,126
5/3/2021 21:13,8991102987639,WFR TANGO LONG VNL 130G,1,5000,0,5000,3773,1227
5/3/2021 21:13,711844150003,ABC ORANGE,1,12000,0,12000,9900,2100
5/3/2021 21:13,8993072153595,LARISST COTTON 35G,1,5000,0,5000,3300,1700
5/3/2021 21:14,6907992823829,JD MILKY MILK,1,3000,0,3000,2600,400
5/3/2021 21:19,8992696523081,MILO UHT 110ML,1,2500,0,2500,1962,538
5/3/2021 21:19,8886013257400,TWISTKO,1,1000,0,1000,900,100
5/3/2021 21:19,MOBIL,GULA GULA HP,1,2000,0,2000,1700,300
5/3/2021 21:42,8993989311279,CLAS MILD 12,1,17000,0,17000,15700,1300
5/3/2021 21:45,8998866610711,NOVO ACTIVE CLEAN 110G,1,3000,0,3000,2600,400
5/3/2021 21:45,8992694242502,ZWITZAL SOAP CALSSIC 70G,1,3800,0,3800,3410,390
5/3/2021 21:45,8992959953037,SWEETY BRONZE L1,1,3000,0,3000,2671,329
5/3/2021 21:46,8998866202244,EKOMIE BUMBU KALDU AYAM,5,1000,0,5000,3990,1010
5/3/2021 22:09,089686021127,INTER MIE KALDU,2,1000,0,2000,1626,374
5/3/2021 22:09,089686021219,INTER MIE GORENG,1,1000,0,1000,885,115
5/3/2021 22:09,089686021141,INTER MIE SOTO,1,1000,0,1000,854,146
5/3/2021 22:09,8998866202244,EKOMIE BUMBU KALDU AYAM,1,1000,0,1000,798,202
5/3/2021 22:14,089686011036,INDOMIE GORENG PEDAS,2,2700,0,5400,4904,496
5/3/2021 22:14,089686044249,SUPERMI NUTRIMI STEAK AYAM,1,3500,0,3500,2800,700
5/3/2021 22:44,8997013790108,BIMURA KACANG TELUR 25G,1,1000,0,1000,875,125
5/3/2021 22:44,MARS,MARSHMELLOW,2,500,0,1000,866,134
5/4/2021 11:14,8995333060703,TERIGU KOMPAS 1KG,4,10500,0,42000,39264,2736
5/4/2021 11:14,8992993523098,COLATTA CHOCO CHIPS 150G,1,11000,0,11000,9885,1115
5/4/2021 11:14,8992993260351,COLATTA COMPOUND DARK 250G,1,18500,0,18500,16714,1786
5/4/2021 11:25,8992946512223,SHINZUI,1,4000,0,4000,2500,1500
5/4/2021 11:25,8999999706111,PEPSODENT WHITE 25G,1,2000,0,2000,1450,550
5/4/2021 11:28,8991102387286SCT,TANGO LONG CKLT 47G,1,2000,0,2000,1551,449
5/4/2021 11:28,089686646047,SUNMARIE,1,7000,0,7000,6626,374
5/4/2021 11:31,MARS,MARSHMELLOW,1,500,0,500,433,67
5/4/2021 11:33,8997028590014,ARGUS 220ML,1,500,0,500,302,198
5/4/2021 11:33,8997028590014,ARGUS 220ML,1,500,0,500,302,198
5/4/2021 11:34,8997028590014,ARGUS 220ML,1,500,0,500,302,198
5/4/2021 11:35,8997028590014,ARGUS 220ML,1,500,0,500,302,198
5/4/2021 11:36,8997028590014,ARGUS 220ML,1,500,0,500,302,198
5/4/2021 12:29,8999999502409,ROYCO FDS BEEF 9G,1,500,0,500,375,125
5/4/2021 12:29,8991102387286SCT,TANGO LONG CKLT 47G,1,2000,0,2000,1551,449
5/4/2021 12:55,8992957352153,CHOCO CHIPS 45G,1,4500,0,4500,2850,1650
5/4/2021 12:55,8992770034151,MASAKO 250GR,1,10000,0,10000,8000,2000
5/4/2021 12:55,711844110083,KECAP ABC 275 ML,1,14500,0,14500,13400,1100
5/4/2021 12:55,8999999706180,PEPSODENT WHITE 190GR,1,10000,0,10000,9350,650
5/4/2021 12:55,8999999059781,SUNLIGHT LIME NEW POUCH 210ML,1,5000,0,5000,4300,700
5/4/2021 15:43,8999999049409,REXONA MEN ICE COOL 45 ML,1,15000,0,15000,13550,1450
5/4/2021 15:43,8994867007161,ROKOK PENA GOLD 20,1,17000,0,17000,15000,2000
5/4/2021 15:51,GL,GULA 1 LITER,1,11500,0,11500,10500,1000
5/4/2021 16:00,8999801700054,SUSU FOYU 1 KG,1,22000,0,22000,20104,1896
5/4/2021 16:07,8993176110081,MINYAK KAYU PUTIH 30ML,1,12000,0,12000,9091,2909
5/4/2021 16:41,BAYFLAST,BAYPLAST,2,500,0,1000,700,300
5/4/2021 16:54,8998866200561,EKOMIE SUPER 600GR,2,10000,0,20000,17230,2770
5/4/2021 17:18,8992959971109,SFX COMFORT SLIM 36CM 12+1,1,16500,0,16500,15152,1348
5/4/2021 17:19,8999909003439,MARLBORO CRAFTED 12,1,8000,0,8000,5437,2563
5/4/2021 17:42,6907992823973,JD PINEAPPLE,1,5000,0,5000,4300,700
5/4/2021 17:42,6907992823607,JD CHOCO CAPTAIN,1,5500,0,5500,4700,800
5/4/2021 17:42,8998989500166,GUDANG GARAM MERAH BESAR 16KS,2,17000,0,34000,30600,3400
5/4/2021 17:43,8998989300261,GUDANG GARAM SURYA 12 FILTER,1,18500,0,18500,17200,1300
5/4/2021 17:43,089686400816,SAMBAL EXTRA PEDAS 135ML,1,5500,0,5500,4950,550
5/4/2021 17:49,8998866200882,SUKSESMIE GORENG AYAM KRMS 133GR,1,3500,0,3500,3047,453
5/4/2021 17:49,8992775000250SCT,CHOCOLATOS MATCHA DRINK SCT,3,2000,0,6000,4758,1242
5/4/2021 17:51,8998989110167,SURYA GUDANG GARAM 16 FILTER,1,24000,0,24000,22100,1900
5/4/2021 17:55,8992957214307,SAFARI MECES,2,5500,0,11000,9000,2000
5/4/2021 19:23,6921101219235,YAKUAT JELLY,1,2000,0,2000,1750,250
5/4/2021 19:38,8998989300261,GUDANG GARAM SURYA 12 FILTER,1,18500,0,18500,17200,1300
5/4/2021 21:01,BALON,BALON CABUT,4,1000,0,4000,3600,400
5/4/2021 21:01,JGR SHN,JOGER SHINY SACHET,2,500,0,1000,874,126
5/4/2021 21:01,YOUTOP,YOUTOP,1,1000,0,1000,875,125
5/4/2021 21:01,COKLAT,COKLAT COIN,2,500,0,1000,800,200
5/4/2021 21:11,bb,BENG-BENG,1,1500,0,1500,1450,50
5/4/2021 21:11,8994834003752,TICTIC,3,2000,0,6000,5100,900
5/4/2021 21:33,8992775110140,GARUDA KACANG KULIT 160G,1,12000,0,12000,10012,1988
5/4/2021 21:39,8999999003067,VASELINE SPF24 100ML,1,19500,0,19500,17600,1900
5/4/2021 21:46,BALON,BALON CABUT,6,1000,0,6000,5400,600
5/4/2021 21:55,8991102384841,WFR TANGO LONG CKLT 130G,1,5000,0,5000,4345,655
5/4/2021 21:55,8992761111540,FANTA STRAWBERY SLIM CAM 250ML,1,5000,0,5000,3750,1250
5/4/2021 21:55,8998989110167,SURYA GUDANG GARAM 16 FILTER,1,24000,0,24000,22100,1900
5/4/2021 22:02,8991001770301,SELAMAT CLACK VANILA,1,13000,0,13000,11800,1200
5/4/2021 22:02,8992775110140,GARUDA KACANG KULIT 160G,1,12000,0,12000,10012,1988
5/5/2021 11:03,8992775000250SCT,CHOCOLATOS MATCHA DRINK SCT,6,2000,0,12000,9516,2484
5/5/2021 11:03,8992775913000GT,CHOCOLATOS CKLT DRINK,1,18000,0,18000,15862,2138
5/5/2021 14:35,KURMA,KURMA,1,60000,0,60000,55000,5000
5/5/2021 14:35,8999999195656,SARI WANGI 50X1.85,1,10000,0,10000,9500,500
5/5/2021 14:35,8992753102204,BKM COKLAT 370G,1,11300,0,11300,9500,1800
5/5/2021 14:35,8992753100101,BKM FULL CREAM GOLD 370,1,15000,0,15000,14000,1000
5/5/2021 14:38,8999999001193,LIFEBUOY BW TOTAL10 LD REFF 450 ML,1,25000,0,25000,22110,2890
5/5/2021 14:40,8998866202930,SEDAAP AYAM JERIT CUP,1,4500,0,4500,3738,762
5/5/2021 14:40,MARS,MARSHMELLOW,2,500,0,1000,866,134
5/5/2021 14:40,089686044249,SUPERMI NUTRIMI STEAK AYAM,1,3500,0,3500,2800,700
5/5/2021 14:40,8994834006128,TICTIC PEDAS,1,2000,0,2000,1700,300
5/5/2021 16:22,089686061024,POP MIE MINI SOTO RL,1,3000,0,3000,2702,298
5/5/2021 16:22,8994834005923,SPIX 1000,1,1000,0,1000,850,150
5/5/2021 16:22,8998009010569,ULTRA CHO 200,1,5000,0,5000,3830,1170
5/5/2021 16:24,8886013257400,TWISTKO,5,1000,0,5000,4500,500
5/5/2021 16:32,8991102230308,BLASTER PINK,1,5000,0,5000,3106,1894
5/5/2021 16:47,8992775913000SCT,CHOCOLATOS CKLT DRINK SCT,2,2000,0,4000,3172,828
5/5/2021 16:47,8999801700030,SUSU FOYU,1,11500,0,11500,10450,1050
5/5/2021 17:50,8992775913000SCT,CHOCOLATOS CKLT DRINK SCT,1,2000,0,2000,1586,414
5/5/2021 17:50,JGR SHN,JOGER SHINY SACHET,6,500,0,3000,2622,378
5/5/2021 17:58,001,PASEO SMART FACIAL SF 250S GT,1,10000,0,10000,9500,500
5/5/2021 17:58,8998989300261,GUDANG GARAM SURYA 12 FILTER,1,18500,0,18500,17200,1300
5/5/2021 17:58,JGR SHN,JOGER SHINY SACHET,3,500,0,1500,1311,189
5/5/2021 17:59,8998989300261,GUDANG GARAM SURYA 12 FILTER,1,18500,0,18500,17200,1300
5/5/2021 18:04,8999801700054,SUSU FOYU 1 KG,1,22000,0,22000,20104,1896
5/5/2021 18:29,8992761166212,FRESTEA APPLE 350ML,1,4500,0,4500,3000,1500
5/5/2021 18:29,BMCC,BIMURA POTATO CINCIN 250G,1,10000,0,10000,9300,700
5/5/2021 18:29,8998866107457,POSH SUMMER LOVE 150ML,1,19500,0,19500,17500,2000
5/5/2021 18:29,MARS,MARSHMELLOW,2,500,0,1000,866,134
5/5/2021 18:30,8994834005923,SPIX 1000,1,1000,0,1000,850,150
5/5/2021 18:30,8886013257400,TWISTKO,2,1000,0,2000,1800,200
5/5/2021 19:19,8991002105409,KOPI KAPAL API,1,20000,0,20000,18888,1112
5/5/2021 19:19,8991004011906,KOPI BORONG,1,10000,0,10000,8333,1667
5/5/2021 19:37,8992761111540,FANTA STRAWBERY SLIM CAM 250ML,1,5000,0,5000,3750,1250
5/5/2021 19:37,BMCC,BIMURA POTATO CINCIN 250G,1,10000,0,10000,9300,700
5/5/2021 19:41,8993072153595,LARISST COTTON 35G,1,5000,0,5000,3300,1700
5/5/2021 19:41,8999999059781,SUNLIGHT LIME NEW POUCH 210ML,1,5000,0,5000,4300,700
5/5/2021 20:12,8998989300230,SIGNATURE BESAR,1,20000,0,20000,18600,1400
5/5/2021 20:29,ABC,BATERAI ABC BIRU,1,8500,0,8500,7500,1000
5/5/2021 20:50,8992775913000SCT,CHOCOLATOS CKLT DRINK SCT,7,2000,0,14000,11102,2898
5/5/2021 20:50,8992775211410,PILUS GARUDA PEDAS,1,5000,0,5000,4886,114
5/5/2021 21:04,6907992823652,JD CHOCOLATE MILKSHAKE,1,6000,0,6000,5200,800
5/5/2021 21:04,HT,HOT-HOT,2,500,0,1000,700,300
5/5/2021 21:04,JGR SHN,JOGER SHINY SACHET,2,500,0,1000,874,126
5/5/2021 22:14,6907992823829,JD MILKY MILK,1,3000,0,3000,2600,400
5/5/2021 22:14,8997231980022,O'JELLY MINI STRAWBERRY,1,3000,0,3000,2250,750
5/5/2021 22:14,8997231980015,O'JELLY MINI APPLE,1,3000,0,3000,2250,750
5/5/2021 22:14,SMC,BIMURA MAKARONI CINCIN 250G,1,10000,0,10000,9300,700
5/6/2021 12:34,8998989300261,GUDANG GARAM SURYA 12 FILTER,1,18500,0,18500,17200,1300
5/6/2021 12:34,8994023000050,MEGKEJU SERBAGUNA 165G,1,12000,0,12000,10339,1661
5/6/2021 12:34,8992696521797SCT,MILO UHT ACT GO 22G,1,2000,0,2000,1412,588
5/6/2021 12:34,8886013257400,TWISTKO,2,1000,0,2000,1800,200
5/6/2021 12:34,8998866202244,EKOMIE BUMBU KALDU AYAM,1,1000,0,1000,798,202
5/6/2021 12:34,TUSTEL,TUSUK TELINGA,1,1000,0,1000,833,167
5/6/2021 12:34,TL,TELUR,15,1500,0,22500,19500,3000
5/6/2021 12:34,8992696520103,DNCO CKLT FORT SCH 39G,2,3000,0,6000,5294,706
5/6/2021 12:35,089686011036,INDOMIE GORENG PEDAS,1,2700,0,2700,2452,248
5/6/2021 12:36,8992993250048,BENDICO COCOA POWDER 90G,1,18000,0,18000,16203,1797
5/6/2021 12:37,8992775001042,PILUS GARUDA MI GORENG,1,5000,0,5000,4810,190
5/6/2021 12:37,8998866609180,SOKLIN SOFTERGENT POUCH 750ML,1,18000,0,18000,16435,1565
5/6/2021 12:43,001,PASEO SMART FACIAL SF 250S GT,1,10000,0,10000,9500,500
5/6/2021 12:49,8998989110167,SURYA GUDANG GARAM 16 FILTER,1,24000,0,24000,22100,1900
5/6/2021 13:20,089686043273,INDOMIE SAMBAL RICA,2,2700,0,5400,4904,496
5/6/2021 13:20,8992761139018,ADES 600ML,1,3500,0,3500,2292,1208
5/6/2021 13:20,MARS,MARSHMELLOW,2,500,0,1000,866,134
5/6/2021 14:27,8998866608756,SOKLIN SOFTENER TWILIGHT BLUE 14SCH,1,5000,0,5000,4560,440
5/6/2021 14:27,8992628010139,BIMOLI 5L,1,75000,0,75000,72100,2900
5/6/2021 15:46,8998866501033,MINYAK GORENG SEDAAP POUCH 2L,1,28000,0,28000,27746,254
5/6/2021 16:19,BDG,BELLAROSA DANTE GOLD,1,95000,0,95000,85000,10000
5/6/2021 16:22,8850507001152,MOTU ATV,1,10000,0,10000,8000,2000
5/6/2021 16:38,8992696521629,DNCO COKLT UHT 180ML,1,5000,0,5000,3533,1467
5/6/2021 16:38,8996001355817,BENG-BENG MAXX,1,27000,0,27000,24500,2500
5/6/2021 16:38,8999999195656,SARI WANGI 50X1.85,1,10000,0,10000,9500,500
5/6/2021 16:43,8993365121539,MADU TJ SUPER 150G,1,16800,0,16800,15220,1580
5/6/2021 16:43,8992696521797GT,MILO ACT GO SCT 22G,1,17500,0,17500,15536,1964
5/6/2021 16:43,ABC SPW,BATERAI ABC SPW,1,4500,0,4500,3893,607
5/6/2021 16:44,8996001302323,MALKIST ABON,1,6500,0,6500,4800,1700
5/6/2021 16:47,8999999195656,SARI WANGI 50X1.85,1,10000,0,10000,9500,500
5/6/2021 16:47,8997018720018,SIRUP DHT,1,23000,0,23000,20958,2042
5/6/2021 16:47,GL,GULA 1 LITER,2,11500,0,23000,21000,2000
5/6/2021 16:47,8998866202930,SEDAAP AYAM JERIT CUP,1,4500,0,4500,3738,762
5/6/2021 17:31,8999999048280,SUNSILK SHP RFR ANTI DDRF 9 ML,1,10500,0,10500,9300,1200
5/6/2021 17:54,8996001600399,LE MINERAL 1500ML,1,5000,0,5000,4042,958
5/6/2021 18:03,8998989300261,GUDANG GARAM SURYA 12 FILTER,1,18500,0,18500,17200,1300
5/6/2021 18:09,6907992824963,JD MILKY CHOCOLATE,4,3000,0,12000,10400,1600
5/6/2021 18:09,8997007780689,JIZZY MINERAL,1,3000,0,3000,1187,1813
5/6/2021 18:22,8991001780140,TWISTER CHOCO,1,5000,0,5000,4600,400
5/6/2021 18:22,8992761145019,COCA COLA PET 250ML,1,3500,0,3500,2417,1083
5/6/2021 19:21,8999909982000,SAMPOERNA 12 FILTER,1,18000,0,18000,16000,2000
5/6/2021 19:21,123124,KOREK BIASA,1,2000,0,2000,1800,200
5/6/2021 19:21,8993058105013,EXTRA JOSS,1,12000,0,12000,9773,2227
5/6/2021 19:41,089686021219,INTER MIE GORENG,5,1000,0,5000,4425,575
5/6/2021 19:41,8999999524722,SUNLIGHT LIME NEW PCH 435ML,1,10000,0,10000,9100,900
5/6/2021 19:41,8999999045623,MOLTO AIO BLUE SCH,6,1000,0,6000,4800,1200
5/6/2021 19:41,089686048704,SARIMIE GORENG AYAM KCP ISI 2,1,3500,0,3500,3120,380
5/6/2021 19:41,8992979130012,TOTAL LEMON SOFTENER,1,13000,0,13000,11532,1468
5/6/2021 19:41,8999999048280,SUNSILK SHP RFR ANTI DDRF 9 ML,1,10500,0,10500,9300,1200
5/6/2021 19:41,8999999706661,PEPSODENT TB DBL CARE SENSITIVE,1,11500,0,11500,10400,1100
5/6/2021 19:41,8999999059781,SUNLIGHT LIME NEW POUCH 210ML,1,5000,0,5000,4300,700
5/6/2021 19:41,8992759120264,LARISST 220,1,10000,0,10000,9200,800
5/6/2021 19:41,8998866501033,MINYAK GORENG SEDAAP POUCH 2L,1,28000,0,28000,27746,254
5/6/2021 19:41,8995333060703,TERIGU KOMPAS 1KG,1,10500,0,10500,9816,684
5/6/2021 19:41,8993379254469,SABUN LERVIA 90G,1,5000,0,5000,3077,1923
5/6/2021 19:41,8998866602549,NUVO FAMILY BIRU 76G,4,2000,0,8000,7280,720
5/6/2021 19:41,8993226365522,GARAM MEJA GYURI 200GR,1,2000,0,2000,1700,300
5/6/2021 19:41,8999999502409,ROYCO FDS BEEF 9G,6,500,0,3000,2250,750
5/6/2021 19:41,TLR,TELUR,1,43000,0,43000,39000,4000
5/6/2021 21:06,8996001355985,BENG-BENG SHARE IT,1,27000,0,27000,25000,2000
5/6/2021 21:06,8992775913000SCT,CHOCOLATOS CKLT DRINK SCT,3,2000,0,6000,4758,1242
5/6/2021 21:06,8994834005923,SPIX 1000,1,1000,0,1000,850,150
5/6/2021 21:06,8991102989534,TANGO VANILA 24G,2,1000,0,2000,1218,782
5/6/2021 21:18,8992775913000SCT,CHOCOLATOS CKLT DRINK SCT,1,2000,0,2000,1586,414
5/6/2021 21:18,6907992823829,JD MILKY MILK,1,3000,0,3000,2600,400
5/6/2021 21:18,8993470672858,SAKU-SAKU RASA BALADO,1,2000,0,2000,1530,470
5/6/2021 21:52,8999909000377,SAMPOERNA AVOLUTION,1,30000,0,30000,28450,1550
5/6/2021 21:57,8998866202770,MIE SEDAAP SALERO PADANG,1,2500,0,2500,2362,138
5/6/2021 21:57,COKLAT,COKLAT COIN,1,500,0,500,400,100
5/6/2021 21:58,8992775001042,PILUS GARUDA MI GORENG,1,5000,0,5000,4810,190
5/6/2021 21:58,8998866202404,NOODLE SEDAAP MIE KOREAN SPICY CHICKEN CUP,1,5000,0,5000,4002,998
5/6/2021 22:17,711844150003,ABC ORANGE,1,12000,0,12000,9900,2100
5/7/2021 11:42,8992775913000SCT,CHOCOLATOS CKLT DRINK SCT,1,2000,0,2000,1586,414
5/7/2021 11:52,8992933211115,NUTRIJELL STRAWBERRY,2,6000,0,12000,10082,1918
5/7/2021 11:52,8992933241112,NUTRIJELL COKLAT,2,7000,0,14000,12832,1168
5/7/2021 11:52,8992933219111,NUTRIJELL CINCAU,2,6000,0,12000,10000,2000
5/7/2021 11:52,8992933214116,NUTRIJELL MELON,2,6000,0,12000,10082,1918
5/7/2021 11:52,8992933218114,NUTRIJELL GRAPE,2,6000,0,12000,9900,2100
5/7/2021 11:52,8992628020152,BIMOLI POUCH 2L,1,30000,0,30000,29000,1000
5/7/2021 11:52,18992628503171,SIMAS 5KG,1,78000,0,78000,76100,1900
5/7/2021 11:52,001,PASEO SMART FACIAL SF 250S GT,1,10000,0,10000,9500,500
5/7/2021 11:52,8999999390198,SUNLIGHT LIME NEW POUCH 755ML,1,17000,0,17000,15400,1600
5/7/2021 11:57,089686043273,INDOMIE SAMBAL RICA,1,2700,0,2700,2452,248
5/7/2021 12:08,089686044249,SUPERMI NUTRIMI STEAK AYAM,1,3500,0,3500,2800,700
5/7/2021 12:08,8992959953198,SWEETY BRONZE  XL2 6+2,1,60000,0,60000,54091,5909
5/7/2021 12:08,8998866610261,DAIA VIOLET GUSSET BAG 290 GR,1,5000,0,5000,4450,550
5/7/2021 12:08,8994023000050,MEGKEJU SERBAGUNA 165G,1,12000,0,12000,10339,1661
5/7/2021 12:08,8993154790021,DELLA CHA,5,2000,0,10000,8570,1430
5/7/2021 12:08,8998866200882,SUKSESMIE GORENG AYAM KRMS 133GR,2,3500,0,7000,6094,906
5/7/2021 12:13,TG,TEH GELAS,2,1000,0,2000,1458,542
5/7/2021 12:13,8994834005923,SPIX 1000,1,1000,0,1000,850,150
5/7/2021 12:13,8993470672827,SAKU-SAKU SAPI PANGGANG,1,2000,0,2000,1530,470
5/7/2021 12:16,001,PASEO SMART FACIAL SF 250S GT,1,10000,0,10000,9500,500
5/7/2021 12:16,711844150003,ABC ORANGE,2,12000,0,24000,19800,4200
5/7/2021 12:16,GL,GULA 1 LITER,1,11500,0,11500,10500,1000
5/7/2021 12:18,GL,GULA 1 LITER,5,11500,0,57500,52500,5000
5/7/2021 16:23,8992959117583,SFX DS REG FLOW WING 20,1,5000,0,5000,4288,712
5/7/2021 16:23,8998866202725,MILKU COKLAT PREMIUM 200ML,1,3000,0,3000,2375,625
5/7/2021 16:23,8992753031900,BKM SCT PUTIH 40G,1,7500,0,7500,6900,600
5/7/2021 16:27,8999999519865,DOVE DEO WMN RO CUCUMBER  40 ML,1,16500,0,16500,15000,1500
5/7/2021 16:27,8996001600597,KOPIKO LUCKY DAY,1,5000,0,5000,4283,717
5/7/2021 16:27,8997213203118,INLITE 12W,1,46000,0,46000,42000,4000
5/7/2021 16:27,8997213203095,INLITE 7W,1,34000,0,34000,31000,3000
5/7/2021 16:44,8999999042592,RINSO MOLTO PERFUME ESSENSE LIQ 4OML,1,5500,0,5500,4817,683
5/7/2021 16:44,8998989110167,SURYA GUDANG GARAM 16 FILTER,1,24000,0,24000,22100,1900
5/7/2021 16:49,GL,GULA 1 LITER,3,11500,0,34500,31500,3000
5/7/2021 16:55,8993083929806,BISKITOP COKLAT,1,30000,0,30000,27000,3000
5/7/2021 17:04,8992775002735,CHOCOLATOS SUSU COKELAT,1,4000,0,4000,3520,480
5/7/2021 17:06,8992959953075,SWEETY BRONZE M9,1,17000,0,17000,15190,1810
5/7/2021 17:13,GL,GULA 1 LITER,5,11500,0,57500,52500,5000
5/7/2021 17:13,8998989110167,SURYA GUDANG GARAM 16 FILTER,1,24000,0,24000,22100,1900
5/8/2021 12:17,8992761136161,COCACOLA 1L,1,10000,0,10000,9000,1000
5/8/2021 12:17,8998866202725,MILKU COKLAT PREMIUM 200ML,1,3000,0,3000,2375,625
5/8/2021 12:17,8992696520103,DNCO CKLT FORT SCH 39G,1,3000,0,3000,2647,353
5/8/2021 12:17,8996001600269,LE MINERAL 600ML,1,3000,0,3000,1688,1312
5/8/2021 12:17,8998866202732,MILKU STROBERI 200ML,1,3000,0,3000,2375,625
5/8/2021 12:17,8992775110157,GARUDA KACANG KULIT,1,5000,0,5000,3925,1075
5/8/2021 12:19,8992993260351,COLATTA COMPOUND DARK 250G,1,18500,0,18500,16714,1786
5/8/2021 12:37,8999999706180,PEPSODENT WHITE 190GR,1,10000,0,10000,9350,650
5/8/2021 12:37,8992222091961,PUCELLE MIST COL SPRAY 75ML,1,13000,0,13000,11650,1350
5/8/2021 12:37,8992979120013,TOTAL BUNGA SOFTENER,1,13000,0,13000,11532,1468
5/8/2021 12:37,001,PASEO SMART FACIAL SF 250S GT,1,10000,0,10000,9500,500
5/8/2021 12:37,8999999552527,ZWITSAL KIDS BB CLN&FRSH BLUE 280 ML,1,21500,0,21500,19855,1645
5/8/2021 12:37,8997002060168,KRP SINGKOG PDS PANDA DUO,1,8000,0,8000,7300,700
5/8/2021 12:37,8992959117583,SFX DS REG FLOW WING 20,1,5000,0,5000,4288,712
5/8/2021 12:37,8999801700030,SUSU FOYU,5,11500,0,57500,52250,5250
5/8/2021 12:37,8991188943543,SASA SANTAN KELAPA 200ML,1,9500,0,9500,8400,1100
5/8/2021 12:37,8991002103764,GOOD DAY CAPPUCINO 10X25G,10,1500,0,15000,13950,1050
5/8/2021 12:37,8714700524002,MAIZENAKU,1,5000,0,5000,4200,800
5/8/2021 12:37,8994023000050,MEGKEJU SERBAGUNA 165G,1,12000,0,12000,10339,1661
5/8/2021 12:37,KT,KUNING TELUR,1,2500,0,2500,2000,500
5/8/2021 12:48,711844150027,ABC NANAS,1,15000,0,15000,12241,2759
5/8/2021 12:51,8994935000049,MINYAK GORENG DAMAI 5L,1,75000,0,75000,73780,1220
5/8/2021 13:04,8886013257400,TWISTKO,1,1000,0,1000,900,100
5/8/2021 13:04,MOBIL,GULA GULA HP,1,2000,0,2000,1700,300
5/8/2021 13:04,KJ,KINDER JOY,1,2000,0,2000,1583,417
5/8/2021 13:06,8998866200561,EKOMIE SUPER 600GR,3,10000,0,30000,25845,4155
5/8/2021 13:06,8995333060703,TERIGU KOMPAS 1KG,1,10500,0,10500,9816,684
5/8/2021 13:19,8999999529703,CLEAR MEN COOL SPORT MTHL 80ML,1,11000,0,11000,10000,1000
5/8/2021 14:12,711844110113,KECAP ABC 135 ML,1,7000,0,7000,6400,600
5/8/2021 14:59,8999999007768,FAIR&LOVELY MULTIVITAMIN  CREAM 9 ML,2,4500,0,9000,6400,2600
5/8/2021 15:02,711844150027,ABC NANAS,2,15000,0,30000,24482,5518
5/8/2021 15:12,8992761145019,COCA COLA PET 250ML,1,3500,0,3500,2417,1083
5/8/2021 15:14,GL,GULA 1 LITER,1,11500,0,11500,10500,1000
5/8/2021 15:44,GL,GULA 1 LITER,4,11500,0,46000,42000,4000
5/8/2021 15:44,8999801700054,SUSU FOYU 1 KG,1,22000,0,22000,20104,1896
5/8/2021 16:02,8994834006128,TICTIC PEDAS,1,2000,0,2000,1700,300
5/8/2021 16:55,8999999048280,SUNSILK SHP RFR ANTI DDRF 9 ML,1,10500,0,10500,9300,1200
5/8/2021 16:58,8998989500166,GUDANG GARAM MERAH BESAR 16KS,1,17000,0,17000,15300,1700
5/8/2021 17:08,8992770084064,SAJIKU TEPUNG BUMBU 240G,1,7000,0,7000,6000,1000
5/8/2021 17:22,8995333000822,TERIGU KOMPAS SOFT 500GR,1,5500,0,5500,4967,533
5/8/2021 17:43,001,PASEO SMART FACIAL SF 250S GT,1,10000,0,10000,9500,500
5/8/2021 17:45,8992753184002,FF MILKY STRW 115G,1,3000,0,3000,2178,822
5/8/2021 17:45,8992753182008,FF MILKY CKLT 115ML,3,3000,0,9000,6537,2463
5/8/2021 19:31,8998989300261,GUDANG GARAM SURYA 12 FILTER,1,18500,0,18500,17200,1300
5/8/2021 19:31,8992775311325,GERY SNACK&SEREAL 100G,1,7000,0,7000,6012,988
5/8/2021 19:31,8997231980022,O'JELLY MINI STRAWBERRY,1,3000,0,3000,2250,750
5/8/2021 19:31,8993470672827,SAKU-SAKU SAPI PANGGANG,1,2000,0,2000,1530,470
5/8/2021 19:31,8993470672858,SAKU-SAKU RASA BALADO,1,2000,0,2000,1530,470
5/8/2021 19:31,8994834005923,SPIX 1000,1,1000,0,1000,850,150
5/8/2021 19:32,GL,GULA 1 LITER,5,11500,0,57500,52500,5000
5/8/2021 19:39,8996001600269,LE MINERAL 600ML,1,3000,0,3000,1688,1312
5/8/2021 19:39,8992761139018,ADES 600ML,1,3500,0,3500,2292,1208
5/8/2021 19:39,8992761166052,FRESTEA MELATI 350ML,1,4500,0,4500,3000,1500
5/8/2021 19:39,8990800004563,MENTOS 40X50 BUAH IND,1,5700,0,5700,5150,550
5/8/2021 19:46,001,PASEO SMART FACIAL SF 250S GT,1,10000,0,10000,9500,500
5/8/2021 19:49,8997231980015,O'JELLY MINI APPLE,1,3000,0,3000,2250,750
5/8/2021 19:49,8997231980022,O'JELLY MINI STRAWBERRY,1,3000,0,3000,2250,750
5/8/2021 19:49,8997028590014,ARGUS 220ML,2,500,0,1000,604,396
5/8/2021 20:10,8996001600399,LE MINERAL 1500ML,1,5000,0,5000,4042,958
5/8/2021 20:21,8992761139018,ADES 600ML,1,3500,0,3500,2292,1208
5/8/2021 20:21,8992761166212,FRESTEA APPLE 350ML,1,4500,0,4500,3000,1500
5/8/2021 20:21,HT,HOT-HOT,2,500,0,1000,700,300
5/8/2021 21:01,8997231980022,O'JELLY MINI STRAWBERRY,2,3000,0,6000,4500,1500
5/8/2021 21:01,8996001318911,BETTER ISI 4,1,2000,0,2000,1700,300
5/8/2021 21:25,MARS,MARSHMELLOW,2,500,0,1000,866,134
5/8/2021 21:45,8997231980022,O'JELLY MINI STRAWBERRY,2,3000,0,6000,4500,1500
5/8/2021 21:45,8998866200325,MIE SEDAAP SOTO,1,2500,0,2500,1952,548
5/8/2021 21:45,6907992823652,JD CHOCOLATE MILKSHAKE,1,6000,0,6000,5200,800
5/8/2021 21:47,6907992823652,JD CHOCOLATE MILKSHAKE,2,6000,0,12000,10400,1600
5/8/2021 21:47,6907992823591,JD STRAW MILKSHAKE,1,5000,0,5000,4300,700
5/8/2021 21:47,JD VM,JD VANILLA MILKSHAKE,1,5000,0,5000,4300,700
5/8/2021 21:47,8992770061034,SAJIKU,2,2000,0,4000,3000,1000
5/8/2021 21:47,8998009040023,TEH KOTAK,1,5000,0,5000,2827,2173
5/8/2021 21:52,PTK,MINI NAIL CLIPPER BESAR THREE SEVEN,1,7000,0,7000,6000,1000
5/8/2021 21:52,089686010107,INDOMIE KALDU AYAM,2,2500,0,5000,4300,700
5/8/2021 21:52,089686011494,INDOMIE SOTO PADANG,1,2600,0,2600,2317,283
5/8/2021 21:52,089686043051,INDOMIE COTO MAKASSAR,1,2800,0,2800,2525,275
5/8/2021 21:52,YOUTOP,YOUTOP,1,1000,0,1000,875,125
5/8/2021 22:09,8992696523067,MILO ACTVGO UHT 180ML,1,4500,0,4500,3515,985
5/8/2021 22:09,8993379200879,SABUN HARMONY MELON 70G,1,2000,0,2000,1652,348
5/8/2021 22:09,8992761164546,NUTRIBOOST STRAWBERRY 300ML,1,6500,0,6500,5300,1200
5/8/2021 22:22,D,TEH PUCUK HARUM 350ML,1,67200,0,67200,55536,11664
5/8/2021 22:25,089686043051,INDOMIE COTO MAKASSAR,1,2800,0,2800,2525,275
5/8/2021 22:25,TL,TELUR,1,1500,0,1500,1300,200
5/8/2021 22:51,089686611878,QTELA TEMPE,1,6000,0,6000,5370,630
5/8/2021 22:51,8996001600146,TEH PUCUK HARUM 350ML,1,3000,0,3000,2314,686
5/8/2021 22:51,8997025914042,ATB MARIE SUSU 185G,1,7000,0,7000,4554,2446
5/8/2021 22:51,8997025410063,BRITISH PROPOLIS,1,250000,0,250000,180000,70000
5/8/2021 22:53,711844610095,LARISSA UDANG 500 GR,2,11000,0,22000,19580,2420
5/8/2021 22:53,8994935000049,MINYAK GORENG DAMAI 5L,1,75000,0,75000,73780,1220
5/9/2021 11:37,8991001780140,TWISTER CHOCO,2,5000,0,10000,9200,800
5/9/2021 11:38,KURMA,KURMA,1,60000,0,60000,55000,5000
5/9/2021 11:38,8998989300261,GUDANG GARAM SURYA 12 FILTER,1,18500,0,18500,17200,1300
5/9/2021 11:38,089686611519,QTELA SINGKONG,1,5000,0,5000,4266,734
5/9/2021 12:40,8996001402023SCT,TB TORA SUSU SCT,3,1500,0,4500,2544,1956
5/9/2021 12:40,8991102230308,BLASTER PINK,1,5000,0,5000,3106,1894
5/9/2021 12:40,8992752112013,MIZONE,1,5000,0,5000,3800,1200
5/9/2021 13:18,8997021870076,FRESH CARE SANDAL WOOD 10ML,1,12000,0,12000,10000,2000
5/9/2021 13:41,8998989300261,GUDANG GARAM SURYA 12 FILTER,1,18500,0,18500,17200,1300
5/9/2021 13:41,8992761145019,COCA COLA PET 250ML,1,3500,0,3500,2417,1083
5/9/2021 14:21,8998866202053,POTABEE AYAM BAKAR PEDAS 68GR,1,8000,0,8000,7200,800
5/9/2021 14:21,8998866201377,KRISBEE FRIES KENTANG GORENG 68 GR,1,5500,0,5500,4620,880
5/9/2021 14:21,8992761139018,ADES 600ML,1,3500,0,3500,2292,1208
5/9/2021 14:21,089686611519,QTELA SINGKONG,1,5000,0,5000,4266,734
5/9/2021 14:21,8886013213208,FRENCH FREIS 2000,1,5000,0,5000,3750,1250
5/9/2021 15:11,8999999390198,SUNLIGHT LIME NEW POUCH 755ML,1,17000,0,17000,15400,1600
5/9/2021 15:11,8998866200646,KOPI TOP MURNI,1,11000,0,11000,9600,1400
5/9/2021 15:17,8999999529284,MOLTO EDP FRENCH LILY SC 10ML,1,5500,0,5500,4800,700
5/9/2021 15:17,8999801700030,SUSU FOYU,1,11500,0,11500,10450,1050
5/9/2021 15:17,ROYCO,ROYCO RASA AYAM,3,500,0,1500,1125,375
5/9/2021 15:17,8999999556341,MOLTO EDP PINK ROSE 20ML,2,1000,0,2000,1600,400
5/9/2021 15:17,8999909096004,SAMPOERNA 16 FILTER,1,24000,0,24000,23000,1000
5/9/2021 15:17,8992761002015,COCA COLA PET 390ML,1,5500,0,5500,4333,1167
5/9/2021 16:06,8991102213189,BLASTER UNGU,1,5000,0,5000,3106,1894
5/9/2021 16:28,8998866611718,EKONOMI PENCUCI PIRING  LIQ 780ML,1,12000,0,12000,10900,1100
5/9/2021 16:28,BTS,BIMURA TARO SEAWEED 250G,1,10000,0,10000,9300,700
5/9/2021 16:44,ARG,ARGUS 220ML,4,14500,0,58000,50000,8000
5/9/2021 17:22,8998989110167,SURYA GUDANG GARAM 16 FILTER,1,24000,0,24000,22100,1900
5/9/2021 17:22,8996001600610,TORA MILKY LATTE 180ML,1,3500,0,3500,2750,750
5/9/2021 17:27,8998866608749,SOFTENER SKL BLS TW VIOLET 14SCT,1,5000,0,5000,4560,440
5/9/2021 17:51,8992628022156,BIMOLI KLASIK TOUCH 1 LT,1,15500,0,15500,14350,1150
5/9/2021 17:51,8998989300261,GUDANG GARAM SURYA 12 FILTER,1,18500,0,18500,17200,1300
5/9/2021 17:51,8998898830125,KKB ENER-G ANGGUR,1,5500,0,5500,4824,676
5/9/2021 17:51,8999801700030,SUSU FOYU,1,11500,0,11500,10450,1050
5/9/2021 17:54,8996001355985,BENG-BENG SHARE IT,1,27000,0,27000,25000,2000
5/9/2021 17:54,8992222050418,GATSBY NORMAL 38GR,1,5000,0,5000,3850,1150
5/9/2021 17:55,8992775913000SCT,CHOCOLATOS CKLT DRINK SCT,2,2000,0,4000,3172,828
5/9/2021 17:55,6907992823867,JD CRUNCHY CHOCOLATE MALT,1,5500,0,5500,4700,800
5/9/2021 17:58,8999999045920,LIFEBUOY TS TOTAL 10 110GR,2,4000,0,8000,7000,1000
5/9/2021 17:58,8999999533717,CITRA TS FRESH WHITE 70G,1,2200,0,2200,1900,300
5/9/2021 18:06,8992761166212,FRESTEA APPLE 350ML,1,4500,0,4500,3000,1500
5/9/2021 18:08,TG,TEH GELAS,1,1000,0,1000,729,271
5/9/2021 18:17,8992761166229,FRESTEA MARKISA 350ML,2,4500,0,9000,6000,3000
5/9/2021 18:17,8992761164546,NUTRIBOOST STRAWBERRY 300ML,1,6500,0,6500,5300,1200
5/9/2021 18:31,8993058105013,EXTRA JOSS,1,12000,0,12000,9773,2227
5/9/2021 18:53,8993176110081,MINYAK KAYU PUTIH 30ML,1,12000,0,12000,9091,2909
5/9/2021 18:53,8992761111540,FANTA STRAWBERY SLIM CAM 250ML,1,5000,0,5000,3750,1250
5/9/2021 18:53,8992761139018,ADES 600ML,1,3500,0,3500,2292,1208
5/9/2021 18:53,MARS,MARSHMELLOW,1,500,0,500,433,67
5/9/2021 19:10,8991102281416,PERMEN MINTZ PPMINT,1,4500,0,4500,4000,500
5/9/2021 19:12,8999909000971,MAGNUM MILD 20,1,24000,0,24000,22750,1250
5/9/2021 19:24,8997231980022,O'JELLY MINI STRAWBERRY,1,3000,0,3000,2250,750
5/9/2021 19:25,8998866501033,MINYAK GORENG SEDAAP POUCH 2L,1,28000,0,28000,27746,254
5/9/2021 19:25,089686021219,INTER MIE GORENG,3,1000,0,3000,2655,345
5/9/2021 19:25,8993226365522,GARAM MEJA GYURI 200GR,1,2000,0,2000,1700,300
5/9/2021 19:36,8992775913000SCT,CHOCOLATOS CKLT DRINK SCT,1,2000,0,2000,1586,414
5/9/2021 19:56,8991004011906,KOPI BORONG,1,10000,0,10000,8333,1667
5/9/2021 19:56,8999999001179,LIFEBUOY BW COOLFRESH LD REFF 450 ML,1,25000,0,25000,22110,2890
5/9/2021 19:56,8998866610261,DAIA VIOLET GUSSET BAG 290 GR,1,5000,0,5000,4450,550
5/9/2021 19:56,6907992823829,JD MILKY MILK,1,3000,0,3000,2600,400
5/9/2021 19:56,8997231980015,O'JELLY MINI APPLE,1,3000,0,3000,2250,750
5/9/2021 19:56,PRG,PARAGO,2,500,0,1000,800,200
5/9/2021 19:58,ARG,ARGUS 220ML,1,14500,0,14500,12500,2000
5/9/2021 19:58,JGR SHN,JOGER SHINY SACHET,1,500,0,500,437,63
5/9/2021 19:58,8998866108102,POSH GREEN BLOSSOM 150,1,19500,0,19500,17500,2000
5/9/2021 20:02,8991102281430,PERMEN MINTZ DUOMINT,2,4500,0,9000,8000,1000
5/9/2021 20:09,8997231980022,O'JELLY MINI STRAWBERRY,1,3000,0,3000,2250,750
5/9/2021 20:15,JGR SHN,JOGER SHINY SACHET,2,500,0,1000,874,126
5/9/2021 20:27,8997231980022,O'JELLY MINI STRAWBERRY,2,3000,0,6000,4500,1500
5/9/2021 20:27,8997231980015,O'JELLY MINI APPLE,1,3000,0,3000,2250,750
5/9/2021 20:30,BG,BERAS GURIH PASAR RAME,1,60000,0,60000,56000,4000
5/9/2021 20:30,8993176110135,MINYAK TELON LANG 30ML,1,10000,0,10000,8167,1833
5/9/2021 20:30,8991102308861,FULLO BLASTO,1,16000,0,16000,14545,1455
5/9/2021 20:36,8850007014546,JB PODER ACTIVE FRESH 300G,1,14000,0,14000,13120,880
5/9/2021 20:37,8992959953082,SWEETY BRONZE L8,1,17000,0,17000,15380,1620
5/9/2021 20:37,8997021870090,FRESH CARE LAVENDER 10ML,1,12000,0,12000,10000,2000
5/9/2021 21:04,089686011036,INDOMIE GORENG PEDAS,1,2700,0,2700,2452,248
5/9/2021 21:04,8998989500128,GUDANG GARAM MERAH KECIL 12KS,3,13000,0,39000,35700,3300
5/9/2021 21:04,8851019210193,POCKY CHOCO BANANA 47G,1,7300,0,7300,5671,1629
5/9/2021 21:04,MARS,MARSHMELLOW,4,500,0,2000,1732,268
5/9/2021 21:06,8998989300261,GUDANG GARAM SURYA 12 FILTER,1,18500,0,18500,17200,1300
5/9/2021 21:06,8993470279651,JOGER CHOCKY BAR,1,1000,0,1000,867,133
5/9/2021 21:06,8997009510055,YOU C1000,1,10000,0,10000,9166,834
5/9/2021 21:07,8998989110167,SURYA GUDANG GARAM 16 FILTER,1,24000,0,24000,22100,1900
5/9/2021 21:07,8997231980015,O'JELLY MINI APPLE,1,3000,0,3000,2250,750
5/9/2021 21:07,8992761166038,MMP ORANGE 300ML,1,5000,0,5000,3750,1250
5/9/2021 21:07,9556001025272,NESCAFE LATTE 240ML,1,8500,0,8500,7834,666
5/9/2021 21:14,8999909096004,SAMPOERNA 16 FILTER,1,24000,0,24000,23000,1000
5/9/2021 21:27,RB,RED BOLD,1,19000,0,19000,17900,1100
5/9/2021 21:27,8996001600597,KOPIKO LUCKY DAY,1,5000,0,5000,4283,717
5/9/2021 21:27,8993470279651,JOGER CHOCKY BAR,1,1000,0,1000,867,133
5/9/2021 22:34,8994834005923,SPIX 1000,1,1000,0,1000,850,150
5/10/2021 11:14,123124,KOREK BIASA,1,2000,0,2000,1800,200
5/10/2021 11:14,8998989300261,GUDANG GARAM SURYA 12 FILTER,1,18500,0,18500,17200,1300
5/10/2021 11:46,711844110083,KECAP ABC 275 ML,1,14500,0,14500,13400,1100
5/10/2021 11:46,8999999528843,CITRA PEARLY WHITE  60ML,1,6200,0,6200,5625,575
5/10/2021 11:46,8999999045616,MOLTO AIO PINK SCH,2,1000,0,2000,1600,400
5/10/2021 11:46,8999999538453,SUNSILK SHP SOFT AND  SMOOTH 55 ML,1,5000,0,5000,3750,1250
5/10/2021 12:13,8998989300261,GUDANG GARAM SURYA 12 FILTER,1,18500,0,18500,17200,1300
5/10/2021 12:13,8991102989428SCT,TANGO CKLT 24G SCT,1,1000,0,1000,609,391
5/10/2021 12:13,HT,HOT-HOT,1,500,0,500,350,150
5/10/2021 12:45,8998989300261,GUDANG GARAM SURYA 12 FILTER,1,18500,0,18500,17200,1300
5/10/2021 12:45,089686041705,INDOMIE GORENG JUMBO,1,3500,0,3500,3143,357
5/10/2021 12:45,8996001600221,KOPIKO 78,1,5000,0,5000,4283,717
5/10/2021 13:29,8998866202244,EKOMIE BUMBU KALDU AYAM,6,1000,0,6000,4788,1212
5/10/2021 13:29,8998866804516,GIV LEMON KOTAK 76G,2,2000,0,4000,3640,360
5/10/2021 13:46,8996001301142,ROMA KELAPA,1,8000,0,8000,6628,1372
5/10/2021 13:46,8998866200301,MIE SEDAAP GORENG,2,2500,0,5000,4046,954
5/10/2021 15:17,8999801700030,SUSU FOYU,1,11500,0,11500,10450,1050
5/10/2021 15:17,8994935000049,MINYAK GORENG DAMAI 5L,1,75000,0,75000,73780,1220
5/10/2021 15:17,8992753102204,BKM COKLAT 370G,1,11300,0,11300,9500,1800
5/10/2021 15:17,8999999504656,SARI MURNI 20X1.8G,1,5000,0,5000,4200,800
5/10/2021 15:17,BAYFLAST,BAYPLAST,4,500,0,2000,1400,600
5/10/2021 15:22,8998866501033,MINYAK GORENG SEDAAP POUCH 2L,1,28000,0,28000,27746,254
5/10/2021 15:22,8992761139018,ADES 600ML,1,3500,0,3500,2292,1208
5/10/2021 15:22,8998866200882,SUKSESMIE GORENG AYAM KRMS 133GR,1,3500,0,3500,3047,453
5/10/2021 15:22,8992775712603,MYTEA POCI OOLONG,1,5000,0,5000,4410,590
5/10/2021 15:22,HT,HOT-HOT,1,500,0,500,350,150
5/10/2021 15:22,6907992825076,JD WATERMELON APPLE,1,2000,0,2000,1700,300
5/10/2021 15:34,8992775211410,PILUS GARUDA PEDAS,1,5000,0,5000,4886,114
5/10/2021 15:37,8996001338056,TAMARIN,1,6000,0,6000,5100,900
5/10/2021 15:37,8992959953044,SWEETY BRONZE XL1,1,2500,0,2500,2250,250
5/10/2021 15:37,8998866200301,MIE SEDAAP GORENG,2,2500,0,5000,4046,954
5/10/2021 15:37,HT,HOT-HOT,1,500,0,500,350,150
5/10/2021 16:16,089686043204,INDOMIE MIE ACEH,1,2700,0,2700,2452,248
5/10/2021 16:16,8998866200301,MIE SEDAAP GORENG,1,2500,0,2500,2023,477
5/10/2021 16:16,6907992824963,JD MILKY CHOCOLATE,1,3000,0,3000,2600,400
5/10/2021 16:43,8998866501033,MINYAK GORENG SEDAAP POUCH 2L,2,28000,0,56000,55492,508
5/10/2021 17:15,9556001004673,MILO NESTLE MALAYSIA ACTIVE GO,1,85000,0,85000,80000,5000
5/10/2021 17:32,8997009510055,YOU C1000,1,10000,0,10000,9166,834
5/10/2021 18:18,8998989300261,GUDANG GARAM SURYA 12 FILTER,1,18500,0,18500,17200,1300
5/10/2021 18:18,8997009510116,LEMON WATER,1,7000,0,7000,5694,1306
5/10/2021 18:18,JGR SHN,JOGER SHINY SACHET,6,500,0,3000,2622,378
5/10/2021 18:18,123124,KOREK BIASA,1,2000,0,2000,1800,200
5/10/2021 18:18,8997231980022,O'JELLY MINI STRAWBERRY,1,3000,0,3000,2250,750
5/10/2021 18:18,bb,BENG-BENG,1,1500,0,1500,1450,50
5/10/2021 18:18,HT,HOT-HOT,1,500,0,500,350,150
5/10/2021 18:27,8992761139018,ADES 600ML,1,3500,0,3500,2292,1208
5/10/2021 18:27,8886013257400,TWISTKO,1,1000,0,1000,900,100
5/10/2021 18:27,8994834005923,SPIX 1000,2,1000,0,2000,1700,300
5/10/2021 19:13,8999999519735,PEPSODENT TB BAMBOO SALT,1,13200,0,13200,11990,1210
5/10/2021 19:13,8993560026103,DETTOL SKINCARE,1,20000,0,20000,18524,1476
5/10/2021 19:13,8998866107099,WET WIPES KODOMO BABY 50SHT CLSSC,1,15000,0,15000,13650,1350
5/10/2021 19:13,8992775001042,PILUS GARUDA MI GORENG,1,5000,0,5000,4810,190
5/10/2021 19:13,8850007090267,JB BATH MILK 400ML (REFILL),1,24500,0,24500,23390,1110
5/10/2021 19:13,8994834005923,SPIX 1000,4,1000,0,4000,3400,600
5/10/2021 19:13,8850507002197,TOK TAK FRUIT CANDY,1,7500,0,7500,6250,1250
5/10/2021 19:18,8850507002197,TOK TAK FRUIT CANDY,1,7500,0,7500,6250,1250
5/10/2021 19:18,8997231980022,O'JELLY MINI STRAWBERRY,1,3000,0,3000,2250,750
5/10/2021 19:35,8996001600146,TEH PUCUK HARUM 350ML,1,3000,0,3000,2314,686
5/10/2021 19:37,8998866201865,KRISBEE PILLOW CHOCOLAVA 120 GR,1,8000,0,8000,7250,750
5/10/2021 19:37,8992775315057,GERY SALUT MALKIST COKLAT,1,6500,0,6500,5516,984
5/10/2021 19:37,8998009010231,ULTRA CHO 250,2,6000,0,12000,9568,2432
5/10/2021 19:37,KJ,KINDER JOY,2,2000,0,4000,3166,834
5/10/2021 19:39,8997231980022,O'JELLY MINI STRAWBERRY,1,3000,0,3000,2250,750
5/10/2021 19:52,8992761166212,FRESTEA APPLE 350ML,1,4500,0,4500,3000,1500
5/10/2021 19:52,8992775211410,PILUS GARUDA PEDAS,1,5000,0,5000,4886,114
5/10/2021 19:52,8886013257400,TWISTKO,2,1000,0,2000,1800,200
5/10/2021 20:27,001,PASEO SMART FACIAL SF 250S GT,1,10000,0,10000,9500,500
5/10/2021 21:16,GL,GULA 1 LITER,4,11500,0,46000,42000,4000
5/10/2021 21:47,8994834005923,SPIX 1000,2,1000,0,2000,1700,300
5/10/2021 22:34,8997009510055,YOU C1000,1,10000,0,10000,9166,834
5/10/2021 22:34,8992696404441,BEAR BRAND 189ML,1,9000,0,9000,7887,1113
5/11/2021 12:00,8992628020152,BIMOLI POUCH 2L,1,30000,0,30000,29000,1000
5/11/2021 12:00,TBR,TEPUNG BERAS,1,8000,0,8000,8000,0
5/11/2021 12:00,TK,TEPUNG KETAN,2,13000,0,26000,26000,0
5/11/2021 12:00,8995333060703,TERIGU KOMPAS 1KG,2,10500,0,21000,19632,1368
5/11/2021 12:00,GL,GULA 1 LITER,2,11500,0,23000,21000,2000
5/11/2021 12:00,711844150003,ABC ORANGE,2,12000,0,24000,19800,4200
5/11/2021 12:12,089686060027,POP MIE AYAM JUMBO,1,4500,0,4500,3833,667
5/11/2021 12:12,8992761145019,COCA COLA PET 250ML,1,3500,0,3500,2417,1083
5/11/2021 12:12,8998866201452,POTABEE REGULER BBQ BEEF 35GR,1,5000,0,5000,4150,850
5/11/2021 12:17,NC,NAURA COKELAT,1,85000,0,85000,75000,10000
5/11/2021 12:17,711844150027,ABC NANAS,3,13000,0,39000,36723,2277
5/11/2021 12:17,711844150003,ABC ORANGE,3,12000,0,36000,29700,6300
5/11/2021 12:17,8991102384841,WFR TANGO LONG CKLT 130G,1,5000,0,5000,4345,655
5/11/2021 12:17,8998989300261,GUDANG GARAM SURYA 12 FILTER,1,18500,0,18500,17200,1300
5/11/2021 12:45,TG,TEH GELAS,1,1000,0,1000,729,271
5/11/2021 12:47,TORT,TORTILA,1,1000,0,1000,1000,0
5/11/2021 12:48,711844610095,LARISSA UDANG 500 GR,3,11000,0,33000,29370,3630
5/11/2021 12:48,8999999195656,SARI WANGI 50X1.85,1,10000,0,10000,9500,500
5/11/2021 12:48,8999999195649,SARI WANGI 25X1.86G,1,6000,0,6000,5050,950
5/11/2021 12:49,TG,TEH GELAS,1,1000,0,1000,729,271
5/11/2021 12:49,TORT,TORTILA,1,1000,0,1000,1000,0
5/11/2021 12:58,8714700524002,MAIZENAKU,1,5000,0,5000,4200,800
5/11/2021 13:06,8994867006997,ROKOK PENA BOLD 20BTG,1,17000,0,17000,15000,2000
5/11/2021 13:20,8999999027261,LIFEBUOY BW LEMONFRESH LD REFF 450 ML,1,25000,0,25000,22110,2890
5/11/2021 13:20,PTK,MINI NAIL CLIPPER BESAR THREE SEVEN,1,7000,0,7000,6000,1000
5/11/2021 13:20,PTKK,MINI NAIL CLIPPER  KECIL THREE SEVEN,1,5000,0,5000,4500,500
5/11/2021 13:20,8718291777199,PHILIPS 8W,1,41000,0,41000,38000,3000
5/11/2021 15:04,8993226112508,GARAM REFINA,1,3000,0,3000,2461,539
5/11/2021 15:04,8993226365522,GARAM MEJA GYURI 200GR,1,2000,0,2000,1700,300
5/11/2021 16:03,6907992825076,JD WATERMELON APPLE,2,2000,0,4000,3400,600
5/11/2021 17:17,MOBIL,GULA GULA HP,1,2000,0,2000,1700,300
5/11/2021 17:30,LT,LIPSTIK HANASUI,1,27000,0,27000,27000,0
5/11/2021 17:30,8999999016128,RINSO MOLTO ROSE FRESH 750ML,1,15000,0,15000,12507,2493
5/11/2021 17:30,8993324850449,BABY LOVE COTTON BUDS,1,5000,0,5000,4500,500
5/11/2021 17:30,8998866106979,CIPTADENT TB CHARCOAL PROTEC,1,6000,0,6000,5250,750
5/11/2021 17:30,8999999557447,PEPSODENT ACTION123 SIWAK 110G,1,9000,0,9000,8000,1000
5/11/2021 17:30,8999999555450,VIXAL PEMB PORS BIRU 190ML,1,5000,0,5000,4200,800
5/11/2021 17:30,8886020001126,SWALLOW KAMP WHITE 150G,1,14000,0,14000,13000,1000
5/11/2021 17:30,8850507002197,TOK TAK FRUIT CANDY,1,7500,0,7500,6250,1250
5/11/2021 18:02,8996001410042SCT,TB TORA MOKA SCT,3,1500,0,4500,2610,1890
5/11/2021 18:05,8992761139018,ADES 600ML,2,3500,0,7000,4584,2416
5/11/2021 18:05,8994834005923,SPIX 1000,1,1000,0,1000,850,150
5/11/2021 18:11,76164217,MARLBORO MERAH,1,30000,0,30000,27700,2300
5/11/2021 18:11,123124,KOREK BIASA,1,2000,0,2000,1800,200
5/11/2021 18:13,123124,KOREK BIASA,1,2000,0,2000,1800,200
5/11/2021 18:13,8993989311279,CLAS MILD 12,1,17000,0,17000,15700,1300
5/11/2021 18:13,HT,HOT-HOT,2,500,0,1000,700,300
5/11/2021 18:32,8996001410042SCT,TB TORA MOKA SCT,2,1500,0,3000,1740,1260
5/11/2021 18:32,8998866501033,MINYAK GORENG SEDAAP POUCH 2L,1,28000,0,28000,27746,254
5/11/2021 18:32,GL,GULA 1 LITER,1,11500,0,11500,10500,1000
5/11/2021 18:32,8998866202695,KOPI MAYOR,1,6000,0,6000,4500,1500
5/11/2021 18:33,JGR SHN,JOGER SHINY SACHET,3,500,0,1500,1311,189
5/11/2021 18:45,8998989300261,GUDANG GARAM SURYA 12 FILTER,1,18500,0,18500,17200,1300
5/11/2021 18:45,KJ,KINDER JOY,1,2000,0,2000,1583,417
5/11/2021 18:46,8998989500128,GUDANG GARAM MERAH KECIL 12KS,1,13000,0,13000,11900,1100
5/11/2021 18:54,8997011700123,BIHUN JAGUNG 300GR,1,6000,0,6000,4979,1021
5/11/2021 18:54,7118441101378,KECAP ABC 520 ML,2,19000,0,38000,35600,2400
5/11/2021 18:54,8993335523363,TOTAL ALMEERA 250G,4,5000,0,20000,16400,3600
5/11/2021 19:09,001,PASEO SMART FACIAL SF 250S GT,1,10000,0,10000,9500,500
5/11/2021 20:14,6907992823829,JD MILKY MILK,3,3000,0,9000,7800,1200
5/11/2021 20:14,6907992823669,JD MILKY STRAW,1,3000,0,3000,2600,400
5/11/2021 20:14,6907992825076,JD WATERMELON APPLE,1,2000,0,2000,1700,300
5/11/2021 20:14,MARS,MARSHMELLOW,2,500,0,1000,866,134
5/11/2021 20:14,8997231980022,O'JELLY MINI STRAWBERRY,2,3000,0,6000,4500,1500
5/11/2021 20:47,8886013257400,TWISTKO,1,1000,0,1000,900,100
5/11/2021 20:47,8992628010139,BIMOLI 5L,1,77000,0,77000,75862,1138
5/11/2021 20:47,8993058105013,EXTRA JOSS,1,12000,0,12000,9773,2227
5/11/2021 21:16,8997231980022,O'JELLY MINI STRAWBERRY,2,3000,0,6000,4500,1500
5/11/2021 21:16,089686049053,SARIMI PUAS,1,3000,0,3000,2400,600
5/11/2021 21:19,8994834005923,SPIX 1000,1,1000,0,1000,850,150
5/11/2021 21:19,8997231980022,O'JELLY MINI STRAWBERRY,1,3000,0,3000,2250,750
5/11/2021 21:20,8998866600521,SOKLIN FLOORCLENER KUNING 400ML,1,6000,0,6000,5025,975
5/11/2021 21:20,8999999538439,CLEAR SHP CSC UNISEX 55ML,1,4200,0,4200,3750,450
5/11/2021 21:20,8994867000179,ROKOK PENA MILD 16,1,14500,0,14500,13000,1500
5/11/2021 21:27,8992761139018,ADES 600ML,2,3500,0,7000,4584,2416
5/11/2021 21:27,089686611878,QTELA TEMPE,1,6000,0,6000,5370,630
5/11/2021 21:27,8996001318430,BETTER 1000,1,1000,0,1000,820,180
5/11/2021 21:27,8992761164539,NUTRIBOOST ORANGE 300ML,1,6500,0,6500,5300,1200
5/11/2021 21:27,8997009510017,YOU C1000 LEMON,1,10000,0,10000,9166,834
5/11/2021 21:27,HT,HOT-HOT,1,500,0,500,350,150
5/11/2021 21:30,8999909010567,234 16 FILTER,1,22000,0,22000,21500,500
5/11/2021 21:35,8993989311279,CLAS MILD 12,1,17000,0,17000,15700,1300
5/11/2021 21:35,8996001440087,ENERGEN KACANG HIJAU,1,1500,0,1500,1150,350
5/11/2021 21:35,8996001440049,ENERGEN,1,1500,0,1500,1200,300
5/11/2021 21:54,6907992823966,JD BLUEBERRY,1,3500,0,3500,3000,500
5/11/2021 21:54,6907992823935,JD SWEETCORN,1,3500,0,3500,3000,500
5/11/2021 22:36,8991102213189,BLASTER UNGU,1,5000,0,5000,3106,1894
5/11/2021 22:37,8991102384841,WFR TANGO LONG CKLT 130G,1,5000,0,5000,4345,655
5/11/2021 22:37,089686611519,QTELA SINGKONG,3,5000,0,15000,12798,2202
5/11/2021 22:43,8998989300261,GUDANG GARAM SURYA 12 FILTER,1,18500,0,18500,17200,1300
5/12/2021 14:14,8992696404441,BEAR BRAND 189ML,1,9000,0,9000,7887,1113
5/12/2021 14:14,8997009510055,YOU C1000,1,10000,0,10000,9166,834
5/12/2021 14:14,8999999045913,LIFEBUOY MILDCARE 110GR,1,15000,0,15000,14245,755
5/12/2021 14:14,8999999045265,RINSO MOLTO ROSE FRESH PWD 770GR,1,21600,0,21600,19338,2262
5/12/2021 14:14,8998866202930,SEDAAP AYAM JERIT CUP,1,4500,0,4500,3738,762
5/12/2021 14:14,ARG,ARGUS 220ML,2,14500,0,29000,25000,4000
5/12/2021 14:14,8998866612173,SOKLIN SOFTERGENT 770G & PIRING,1,18000,0,18000,16055,1945
5/12/2021 14:14,8991102213189,BLASTER UNGU,1,5000,0,5000,3106,1894
5/12/2021 14:14,HT,HOT-HOT,1,500,0,500,350,150
5/12/2021 14:14,8998866200837,NOODLE SEDAAPMIE SOTO CUP 81 GR,1,4500,0,4500,3650,850
5/12/2021 15:03,8996001410042SCT,TB TORA MOKA SCT,3,1500,0,4500,2610,1890
5/12/2021 15:21,11,PASEO SMART FHSTD PERF 6P 12S,1,5000,0,5000,4264,736
5/12/2021 15:24,BB,PASEO SMARTY FACIAL TRAVEL PACK 50S GT,1,3000,0,3000,1980,1020
5/12/2021 15:38,8991102230308,BLASTER PINK,1,5000,0,5000,3106,1894
5/12/2021 15:47,8999999059781,SUNLIGHT LIME NEW POUCH 210ML,1,5000,0,5000,4300,700
5/12/2021 16:18,001,PASEO SMART FACIAL SF 250S GT,1,10000,0,10000,9500,500
5/12/2021 16:18,089686044249,SUPERMI NUTRIMI STEAK AYAM,1,3500,0,3500,2800,700
5/12/2021 16:18,089686011036,INDOMIE GORENG PEDAS,1,2700,0,2700,2452,248
5/12/2021 16:18,8886013213208,FRENCH FREIS 2000,1,5000,0,5000,3750,1250
5/12/2021 16:21,8992628010139,BIMOLI 5L,1,77000,0,77000,75862,1138
5/12/2021 17:24,8998866201377,KRISBEE FRIES KENTANG GORENG 68 GR,1,5500,0,5500,4620,880
5/12/2021 17:58,6907992823874,JD CRUNCHY CHOCO BLUEBERRY,1,5500,0,5500,4700,800
5/12/2021 18:00,8992761139018,ADES 600ML,3,3500,0,10500,6876,3624
5/12/2021 18:00,8886013257400,TWISTKO,1,1000,0,1000,900,100
5/12/2021 18:00,8994834005923,SPIX 1000,1,1000,0,1000,850,150
5/12/2021 18:00,089686021219,INTER MIE GORENG,1,1000,0,1000,885,115
5/12/2021 18:00,JGR SHN,JOGER SHINY SACHET,1,500,0,500,437,63
5/12/2021 18:19,8991102213189,BLASTER UNGU,1,5000,0,5000,3106,1894
5/12/2021 18:20,8992761166212,FRESTEA APPLE 350ML,1,4500,0,4500,3000,1500
5/12/2021 18:27,8992696419742,NESCAFE COFFE CREAM,1,5000,0,5000,4099,901
5/12/2021 18:27,JD VM,JD VANILLA MILKSHAKE,1,5000,0,5000,4300,700
5/12/2021 18:27,8992696521797SCT,MILO UHT ACT GO 22G,5,2000,0,10000,7060,2940
5/12/2021 18:27,8996001600146,TEH PUCUK HARUM 350ML,1,3000,0,3000,2314,686
5/12/2021 18:27,8886020001294,SWALLOW KAMP WARNA 150G,1,14000,0,14000,13200,800
5/12/2021 18:27,8997011700345,MIE KERING LANGIT BIRU,1,23000,0,23000,21000,2000
5/12/2021 18:27,8992993525740,HAAN PUDING MANGGO POUCH 145G,2,8000,0,16000,14370,1630
5/12/2021 18:27,8992957352153,CHOCO CHIPS 45G,1,4500,0,4500,2850,1650
5/12/2021 18:50,089686021219,INTER MIE GORENG,1,1000,0,1000,885,115
5/12/2021 19:01,8992761136161,COCACOLA 1L,1,10000,0,10000,9000,1000
5/12/2021 19:01,8992761136178,SPRITE 1L,1,10000,0,10000,9000,1000
5/12/2021 19:02,8992696523067,MILO ACTVGO UHT 180ML,4,4500,0,18000,14060,3940
5/12/2021 19:12,8999999559854,AXE BLACK POCKET FRAG 17ML,1,10000,0,10000,8000,2000
5/12/2021 19:28,8850507002968,A1 KING TRUCK,1,16500,0,16500,15500,1000
5/12/2021 19:28,6921101219235,YAKUAT JELLY,1,2000,0,2000,1750,250
5/12/2021 19:28,8991102714631,TANGO TETRA CKLT,1,5000,0,5000,4545,455
5/12/2021 19:28,8992761122331,FRESTEA APPEL 500ML,1,6500,0,6500,4708,1792
5/12/2021 19:40,9556001025272,NESCAFE LATTE 240ML,1,8500,0,8500,7834,666
5/12/2021 19:40,8997021870090,FRESH CARE LAVENDER 10ML,1,12000,0,12000,10000,2000
5/12/2021 19:42,8992761136178,SPRITE 1L,2,10000,0,20000,18000,2000
5/12/2021 19:42,8992761136185,FANTA 1L,1,10000,0,10000,9000,1000
5/12/2021 19:47,8997231980022,O'JELLY MINI STRAWBERRY,1,3000,0,3000,2250,750
5/12/2021 19:47,6907992823829,JD MILKY MILK,2,3000,0,6000,5200,800
5/12/2021 19:47,6907992825076,JD WATERMELON APPLE,1,2000,0,2000,1700,300
5/12/2021 19:47,8992775002155,CHOCOLATOS DRINK,1,4000,0,4000,3520,480
5/12/2021 19:47,8996001600146,TEH PUCUK HARUM 350ML,1,3000,0,3000,2314,686
5/12/2021 19:47,PRG,PARAGO,2,500,0,1000,800,200
5/12/2021 19:48,8997231980022,O'JELLY MINI STRAWBERRY,4,3000,0,12000,9000,3000
5/12/2021 19:49,8991102213189,BLASTER UNGU,2,5000,0,10000,6212,3788
5/12/2021 19:49,089686611878,QTELA TEMPE,1,6000,0,6000,5370,630
5/12/2021 19:55,8997009510116,LEMON WATER,1,7000,0,7000,5694,1306
5/12/2021 20:00,089686611878,QTELA TEMPE,3,6000,0,18000,16110,1890
5/12/2021 20:27,8992761139018,ADES 600ML,1,3500,0,3500,2292,1208
5/12/2021 20:27,711844150003,ABC ORANGE,1,12000,0,12000,9900,2100
5/12/2021 20:27,8997226412019,EMINA CHEESE 165G,1,17000,0,17000,15000,2000
5/12/2021 20:34,8998866202732,MILKU STROBERI 200ML,1,3000,0,3000,2375,625
5/12/2021 21:05,8992759120264,LARISST 220,1,10000,0,10000,9200,800
5/12/2021 21:05,089686611878,QTELA TEMPE,1,6000,0,6000,5370,630
5/12/2021 21:05,6907992823652,JD CHOCOLATE MILKSHAKE,1,6000,0,6000,5200,800
5/12/2021 21:05,GL,GULA 1 LITER,1,11500,0,11500,10500,1000
5/12/2021 21:19,ARG,ARGUS 220ML,2,14500,0,29000,25000,4000
5/12/2021 21:57,8992761166212,FRESTEA APPLE 350ML,1,4500,0,4500,3000,1500
5/12/2021 21:57,8992775002735,CHOCOLATOS SUSU COKELAT,1,4000,0,4000,3520,480
5/12/2021 22:02,001,PASEO SMART FACIAL SF 250S GT,2,10000,0,20000,19000,1000
5/16/2021 12:49,8994834003752,TICTIC,2,2000,0,4000,3400,600
5/16/2021 12:49,8998866201377,KRISBEE FRIES KENTANG GORENG 68 GR,2,5500,0,11000,9240,1760
5/16/2021 12:49,8886013213208,FRENCH FREIS 2000,1,5000,0,5000,3750,1250
5/16/2021 12:49,8991001121400,SILVERQUEEN ALMOND 65G,1,15000,0,15000,13200,1800
5/16/2021 12:49,8991001780065,TWISTER BLACK 140G,1,13000,0,13000,11700,1300
5/16/2021 12:49,8991188943062,SASA 250G,1,10000,0,10000,8500,1500
5/16/2021 12:49,ARG,ARGUS 220ML,2,14500,0,29000,25000,4000
5/16/2021 12:49,6921101219235,YAKUAT JELLY,1,2000,0,2000,1750,250
5/16/2021 12:49,8999909010567,234 16 FILTER,1,22000,0,22000,21500,500
5/16/2021 12:49,8998009010590,ULTRA CHO 125,1,3000,0,3000,2428,572
5/16/2021 12:49,6907992823867,JD CRUNCHY CHOCOLATE MALT,1,5500,0,5500,4700,800
5/16/2021 12:49,MARS,MARSHMELLOW,1,500,0,500,433,67
5/16/2021 12:49,8997231980022,O'JELLY MINI STRAWBERRY,1,3000,0,3000,2250,750
5/16/2021 12:49,6907992823966,JD BLUEBERRY,1,3500,0,3500,3000,500
5/16/2021 12:49,8992957220087,COKLAT SINGA,1,2000,0,2000,1700,300
5/16/2021 12:49,8992957220063,COKLAT BANGO,1,2000,0,2000,1700,300
5/16/2021 12:49,8998866202725,MILKU COKLAT PREMIUM 200ML,1,3000,0,3000,2375,625
5/16/2021 12:49,PRG,PARAGO,1,500,0,500,400,100
5/16/2021 12:49,bb,BENG-BENG,1,1500,0,1500,1450,50
5/16/2021 12:49,8994834006128,TICTIC PEDAS,1,2000,0,2000,1700,300
5/16/2021 12:49,SMC,BIMURA MAKARONI CINCIN 250G,1,10000,0,10000,9300,700
5/16/2021 12:49,8991102385060,TANGO WAFFLE CHOX,1,9000,0,9000,8498,502
5/16/2021 12:49,8997025911058,HATARI SHP KELAPA,1,6000,0,6000,4911,1089
5/16/2021 12:49,089686834253,FREISS MELON,1,16000,0,16000,14200,1800
5/16/2021 12:49,8999999023997,CITRA BW FRESH WHITE 220ML,1,12000,0,12000,10700,1300
5/16/2021 12:49,8999999007768,FAIR&LOVELY MULTIVITAMIN  CREAM 9 ML,2,4500,0,9000,6400,2600
5/16/2021 13:26,089686611519,QTELA SINGKONG,2,5000,0,10000,8532,1468
5/16/2021 13:26,8992979130012,TOTAL LEMON SOFTENER,1,13000,0,13000,11532,1468
5/16/2021 13:26,089686043617,INDOMIE MIEGHRTTI,1,2700,0,2700,2452,248
5/16/2021 13:26,8992388133345,NU MILK TEA TEH TARIK 330ML,1,6000,0,6000,5125,875
5/16/2021 13:26,8992775002735,CHOCOLATOS SUSU COKELAT,1,4000,0,4000,3520,480
5/16/2021 13:26,089686049053,SARIMI PUAS,1,3000,0,3000,2400,600
5/16/2021 13:26,8999999524807,SUNLIGHT HABBATUSSAUDA POUCH 755ML,1,17000,0,17000,15400,1600
5/16/2021 13:26,8998989500128,GUDANG GARAM MERAH KECIL 12KS,2,14000,0,28000,26000,2000
5/16/2021 13:26,6907992823843,JD MOCHA CRISPY,3,5000,0,15000,13200,1800
5/16/2021 13:26,8991115012021,BB STRAWBERRY CREAM,1,8500,0,8500,7600,900
5/16/2021 13:26,8999909982000,SAMPOERNA 12 FILTER,1,18000,0,18000,16000,2000
5/16/2021 13:26,8998866201490,POTABEE REGULER GRILLED SEAWED 68 GR,2,8000,0,16000,14400,1600
5/16/2021 13:26,8998866201469,POTABEE REGULER BBQ BEEF 68 GR,1,8000,0,8000,7200,800
5/16/2021 13:26,8998009010569,ULTRA CHO 200,3,5000,0,15000,11490,3510
5/16/2021 13:26,8999909010567,234 16 FILTER,2,22000,0,44000,43000,1000
5/16/2021 13:26,8998666003089SCT,TB GILUX MIX SCT,5,1000,0,5000,4000,1000
5/16/2021 13:26,123124,KOREK BIASA,1,2000,0,2000,1800,200
5/16/2021 13:26,TL,TELUR,8,1500,0,12000,10400,1600
5/16/2021 13:26,089686010107,INDOMIE KALDU AYAM,1,2500,0,2500,2150,350
5/16/2021 13:26,089686021127,INTER MIE KALDU,4,1000,0,4000,3252,748
5/16/2021 13:26,8992628010139,BIMOLI 5L,2,77000,0,154000,151724,2276
5/16/2021 13:26,8993058105013,EXTRA JOSS,1,12000,0,12000,9773,2227
5/16/2021 13:26,8994867007161,ROKOK PENA GOLD 20,1,17000,0,17000,15000,2000
5/16/2021 13:26,8992761164539,NUTRIBOOST ORANGE 300ML,1,6500,0,6500,5300,1200
5/16/2021 13:26,8992761164546,NUTRIBOOST STRAWBERRY 300ML,1,6500,0,6500,5300,1200
5/16/2021 13:26,8992870311091,SALONPAS,1,6000,0,6000,4806,1194
5/16/2021 13:26,8996001350423,ZUPER KEJU,1,9200,0,9200,8360,840
5/16/2021 13:26,8992696521797SCT,MILO UHT ACT GO 22G,3,2000,0,6000,4236,1764
5/16/2021 13:26,089686043051,INDOMIE COTO MAKASSAR,3,2800,0,8400,7575,825
5/16/2021 13:26,8996001600399,LE MINERAL 1500ML,2,5000,0,10000,8084,1916
5/16/2021 13:26,8998866604963,POWDET DAIA LEMON 290GR,1,5000,0,5000,4450,550
5/16/2021 13:26,089686017748,SARIMIE GORENG ISI 2,2,3500,0,7000,6240,760
5/16/2021 13:26,TG,TEH GELAS,1,1000,0,1000,729,271
5/16/2021 13:26,8999999059781,SUNLIGHT LIME NEW POUCH 210ML,1,5000,0,5000,4300,700
5/16/2021 13:26,8991111111995,C&C TONER 100ML,1,14000,0,14000,12900,1100
5/16/2021 13:26,8992806145417,SCOTCH BRITE,1,3500,0,3500,2407,1093
5/16/2021 13:26,8992222091961,PUCELLE MIST COL SPRAY 75ML,1,13000,0,13000,11650,1350
5/16/2021 13:26,8993072153595,LARISST COTTON 35G,1,5000,0,5000,3300,1700
5/16/2021 13:26,8998866202770,MIE SEDAAP SALERO PADANG,10,2500,0,25000,23620,1380
5/16/2021 13:26,8991102994422,TANGO WALUT CHOCOBNN 18G,1,9000,0,9000,8661,339
5/16/2021 13:26,8998866200578,MIE SEDAAP KARI KENTAL,5,2500,0,12500,11315,1185
5/16/2021 13:26,8996001355817,BENG-BENG MAXX,1,27000,0,27000,24500,2500
5/16/2021 13:26,8998866202237,NOODLE SEDAAP TASTY AYAM GEPREK 124 GR,2,5000,0,10000,8334,1666
5/16/2021 13:26,8992775001615,CHOCOLATOS SWEET CHEESE,1,18000,0,18000,15483,2517
5/16/2021 13:26,8997009510055,YOU C1000,1,10000,0,10000,9166,834
5/16/2021 13:26,711844610095,LARISSA UDANG 500 GR,1,11000,0,11000,9790,1210
5/16/2021 13:26,8991188943536,SASA SANTAN KELAPA 65ML,3,3000,0,9000,7311,1689
5/16/2021 13:26,8991111112398,C&C OIL CONTROL FILM FLORAL 15,1,10000,0,10000,8010,1990
5/16/2021 13:26,ARG,ARGUS 220ML,6,14500,0,87000,75000,12000
5/16/2021 13:26,8998866200646,KOPI TOP MURNI,1,11000,0,11000,9600,1400
5/16/2021 13:26,8934868015024,REXONA DEO LOTION FREE SPIRIT 9G,1,4500,0,4500,3900,600
5/16/2021 13:26,8999909096004,SAMPOERNA 16 FILTER,1,24000,0,24000,23000,1000
5/16/2021 13:26,711844150027,ABC NANAS,1,13000,0,13000,12241,759
5/16/2021 13:27,8998989300261,GUDANG GARAM SURYA 12 FILTER,2,18500,0,37000,34400,2600
5/16/2021 14:59,GL,GULA 1 LITER,1,11500,0,11500,10500,1000
5/16/2021 14:59,8992761002022,SPRITE PET 390ML,1,5500,0,5500,4300,1200
5/16/2021 15:33,8995102703534,TERASI DUO 6 GR,1,4000,0,4000,3720,280
5/16/2021 15:47,8992946512223,SHINZUI,1,4000,0,4000,2500,1500
5/16/2021 15:47,8998866611152,CREAM EKONOMI VIOLET 455G,1,5500,0,5500,4750,750
5/16/2021 15:47,6907992823829,JD MILKY MILK,1,3000,0,3000,2600,400
5/16/2021 15:47,8850507000094,POLICE BONCHA,1,2000,0,2000,800,1200
5/16/2021 15:58,8994834003752,TICTIC,3,2000,0,6000,5100,900
5/16/2021 15:58,8994834006128,TICTIC PEDAS,2,2000,0,4000,3400,600
5/16/2021 15:58,8992761122331,FRESTEA APPEL 500ML,1,6500,0,6500,4708,1792
5/16/2021 15:58,6907992823652,JD CHOCOLATE MILKSHAKE,1,6000,0,6000,5200,800
5/16/2021 15:59,HT,HOT-HOT,1,500,0,500,350,150
5/16/2021 16:07,8992696404441,BEAR BRAND 189ML,1,9000,0,9000,7887,1113
5/16/2021 16:21,8992959953020,SWEETY BRONZE M1,2,3000,0,6000,5342,658
5/16/2021 17:05,6907992824963,JD MILKY CHOCOLATE,1,3000,0,3000,2600,400
5/16/2021 17:05,8886013257400,TWISTKO,1,1000,0,1000,900,100
5/16/2021 17:05,6907992823966,JD BLUEBERRY,1,3500,0,3500,3000,500
5/16/2021 17:05,6907992823829,JD MILKY MILK,1,3000,0,3000,2600,400
5/16/2021 17:05,8994834005923,SPIX 1000,3,1000,0,3000,2550,450
5/16/2021 17:05,8991001503114,CHACHA MILK CHOCOLATE 35G,1,5500,0,5500,4900,600
5/16/2021 17:40,8997025911058,HATARI SHP KELAPA,1,6000,0,6000,4911,1089
5/16/2021 17:40,8992696404441,BEAR BRAND 189ML,2,9000,0,18000,15774,2226
5/16/2021 17:53,6907992823904,JD CRUNCHY CHOCOLATE VAN,1,8000,0,8000,6800,1200
5/16/2021 18:28,6921101219235,YAKUAT JELLY,1,2000,0,2000,1750,250
5/16/2021 18:28,8997025911058,HATARI SHP KELAPA,1,6000,0,6000,4911,1089
5/16/2021 18:28,8998866500708,FLORIDINA ORANGE,1,3000,0,3000,2500,500
5/16/2021 18:28,8999908389008,HEMAVITON C1000,1,8000,0,8000,6000,2000
5/16/2021 18:28,8991102384841,WFR TANGO LONG CKLT 130G,1,5000,0,5000,4345,655
5/16/2021 18:28,8991102987639,WFR TANGO LONG VNL 130G,1,5000,0,5000,3773,1227
5/16/2021 18:31,8994834005923,SPIX 1000,1,1000,0,1000,850,150
5/16/2021 18:31,VTM,VITAMIN,2,500,0,1000,850,150
5/16/2021 18:47,8998866202404,NOODLE SEDAAP MIE KOREAN SPICY CHICKEN CUP,1,5000,0,5000,4002,998
5/16/2021 18:55,8998866202930,SEDAAP AYAM JERIT CUP,1,4500,0,4500,3738,762
5/16/2021 18:59,TL,TELUR,3,1500,0,4500,3900,600
5/16/2021 18:59,HT,HOT-HOT,1,500,0,500,350,150
5/16/2021 19:26,8993989311279,CLAS MILD 12,1,17000,0,17000,15700,1300
5/16/2021 19:32,8997231980022,O'JELLY MINI STRAWBERRY,2,3000,0,6000,4500,1500
5/16/2021 19:32,VTM,VITAMIN,2,500,0,1000,850,150
5/16/2021 20:00,8999099920691,SGM 1+ MADU 1000G,1,85000,0,85000,78510,6490
5/16/2021 20:29,089686060126,POP MIE BASO JUMBO,1,4500,0,4500,3833,667
5/16/2021 20:31,GL,GULA 1 LITER,4,11500,0,46000,42000,4000
5/16/2021 20:31,6921101219235,YAKUAT JELLY,1,2000,0,2000,1750,250
5/16/2021 20:31,8886013213208,FRENCH FREIS 2000,1,5000,0,5000,3750,1250
5/16/2021 21:36,8999999042646,RINSO MOLTO ROSE FRESH LIQ 40ML,1,5000,0,5000,4817,183
5/16/2021 21:36,8998866608756,SOKLIN SOFTENER TWILIGHT BLUE 14SCH,1,5000,0,5000,4560,440
5/16/2021 21:37,8998866201827,JAVANA GULA BATU 350ML,1,3000,0,3000,2150,850
5/16/2021 21:40,8991102989428SCT,TANGO CKLT 24G SCT,1,1000,0,1000,609,391
5/16/2021 22:17,089686044249,SUPERMI NUTRIMI STEAK AYAM,1,3500,0,3500,2800,700
5/16/2021 22:17,089686010343,INDOMIE SOTO MIE,1,2600,0,2600,2367,233
5/16/2021 22:17,089686010824,INDOMIE GORENG SPESIAL,1,2700,0,2700,2452,248
5/16/2021 22:27,8998009020186,BUAVITA GUAVA 250ML,1,7000,0,7000,6083,917
5/16/2021 22:27,089686611519,QTELA SINGKONG,1,5000,0,5000,4266,734
5/16/2021 22:27,8996001600146,TEH PUCUK HARUM 350ML,1,3000,0,3000,2314,686
5/16/2021 22:28,8991102989428SCT,TANGO CKLT 24G SCT,2,1000,0,2000,1218,782
5/16/2021 22:45,8991689668006,SWALLOW,1,3500,0,3500,3500,0
5/16/2021 22:45,8992933241112,NUTRIJELL COKLAT,2,7000,0,14000,12832,1168
5/16/2021 22:45,8992993525740,HAAN PUDING MANGGO POUCH 145G,1,8000,0,8000,7185,815
5/16/2021 22:45,8992992102423,WIPPY CREAM 200G,2,28000,0,56000,51980,4020
5/16/2021 22:45,8998866200882,SUKSESMIE GORENG AYAM KRMS 133GR,2,3500,0,7000,6094,906
5/16/2021 22:47,8992870311091,SALONPAS,1,6000,0,6000,4806,1194
5/16/2021 22:47,HT,HOT-HOT,1,500,0,500,350,150
5/16/2021 22:58,8998866200578,MIE SEDAAP KARI KENTAL,2,2500,0,5000,4526,474
5/16/2021 22:58,8998866202619,MIE SEDAAP KOREAN SPICY SOUP,1,2500,0,2500,2273,227
5/17/2021 17:24,8991102230308,BLASTER PINK,1,5000,0,5000,3106,1894
5/17/2021 19:02,8999999034061,ZWITSAL BAT NAT HAIR&BODY  300ML,1,28700,0,28700,26125,2575
5/17/2021 19:02,8999908284907,MY BABY MINYAK TELON 90ML,1,25000,0,25000,22700,2300
5/17/2021 19:02,8998989110167,SURYA GUDANG GARAM 16 FILTER,1,25000,0,25000,23200,1800
5/17/2021 19:02,8998866200882,SUKSESMIE GORENG AYAM KRMS 133GR,1,3500,0,3500,3047,453
5/17/2021 19:08,8999999059781,SUNLIGHT LIME NEW POUCH 210ML,1,5000,0,5000,4300,700
5/17/2021 19:08,8992628605151,AMANDA MARGARINE,1,5000,0,5000,3806,1194
5/17/2021 19:08,8992957352153,CHOCO CHIPS 45G,1,4500,0,4500,2850,1650
5/17/2021 19:08,8992761166038,MMP ORANGE 300ML,1,5000,0,5000,3750,1250
5/17/2021 19:08,HT,HOT-HOT,4,500,0,2000,1400,600
5/17/2021 19:08,6907992823843,JD MOCHA CRISPY,1,5000,0,5000,4400,600
5/17/2021 19:08,6907992823669,JD MILKY STRAW,1,3000,0,3000,2600,400
5/17/2021 19:08,8998866202343,MIE SEDAAP KOREAN SPICY,1,2500,0,2500,2023,477
5/17/2021 19:08,8992775311615,CHOCOLATOS,1,12000,0,12000,9983,2017
5/17/2021 19:08,BTS,BIMURA TARO SEAWEED 250G,2,10000,0,20000,18600,1400
5/17/2021 19:09,8992959953105,SWEETY BRONZE XXL6,1,16000,0,16000,15230,770
5/17/2021 19:13,8998866200882,SUKSESMIE GORENG AYAM KRMS 133GR,2,3500,0,7000,6094,906
5/17/2021 19:13,VTM,VITAMIN,1,500,0,500,425,75
5/17/2021 19:13,8991102281430,PERMEN MINTZ DUOMINT,1,4500,0,4500,4000,500
5/17/2021 19:13,8991102281416,PERMEN MINTZ PPMINT,1,4500,0,4500,4000,500
5/17/2021 19:13,8991102989381,TANGO LONG BUBBLEGUM 130G,1,5000,0,5000,4345,655
5/17/2021 19:13,8992775913000SCT,CHOCOLATOS CKLT DRINK SCT,1,2000,0,2000,1586,414
5/17/2021 19:13,8999999534097,PEPSODENT PGB FCM 75G,1,5000,0,5000,3850,1150
5/17/2021 19:13,8998989500128,GUDANG GARAM MERAH KECIL 12KS,1,14000,0,14000,13000,1000
5/17/2021 19:13,RB,RED BOLD,1,19000,0,19000,17900,1100
5/17/2021 19:13,8998866200844,NOODLE SEDAAP MIE KARI SPESIAL CUP 81 GR,1,4500,0,4500,3650,850
5/17/2021 19:13,8998866200837,NOODLE SEDAAPMIE SOTO CUP 81 GR,1,4500,0,4500,3650,850
5/17/2021 19:13,8992959953082,SWEETY BRONZE L8,1,17000,0,17000,15380,1620
5/17/2021 19:32,8992761166212,FRESTEA APPLE 350ML,1,4500,0,4500,3000,1500
5/17/2021 19:32,JGR SHN,JOGER SHINY SACHET,1,500,0,500,437,63
5/17/2021 19:33,8998866200882,SUKSESMIE GORENG AYAM KRMS 133GR,2,3500,0,7000,6094,906
5/17/2021 19:37,8997231980022,O'JELLY MINI STRAWBERRY,1,3000,0,3000,2250,750
5/17/2021 19:37,8992775001653,GERY SALUT CHOCOLATE COCONUT,1,2000,0,2000,1476,524
5/17/2021 19:37,VTM,VITAMIN,5,500,0,2500,2125,375
5/17/2021 19:37,bb,BENG-BENG,1,1500,0,1500,1450,50
5/17/2021 19:37,HT,HOT-HOT,1,500,0,500,350,150
5/17/2021 20:19,089686043617,INDOMIE MIEGHRTTI,3,2700,0,8100,7356,744
5/17/2021 20:28,ARG,ARGUS 220ML,6,14500,0,87000,75000,12000
5/17/2021 20:42,PUDING,VITA PUDDING,1,5000,0,5000,3750,1250
5/17/2021 20:54,8991102303309,WFR TANGO SBJ 176G,1,10000,0,10000,8694,1306
5/17/2021 21:10,089686611519,QTELA SINGKONG,1,5000,0,5000,4266,734
5/17/2021 21:45,8999999502003,"SARIMURNI RL RB 1,8G",1,1500,0,1500,1207,293
5/17/2021 21:45,089686011494,INDOMIE SOTO PADANG,1,2600,0,2600,2317,283
5/17/2021 21:45,BAYFLAST,BAYPLAST,2,500,0,1000,700,300
5/17/2021 21:45,TL,TELUR,1,1500,0,1500,1300,200
5/17/2021 21:52,089686011494,INDOMIE SOTO PADANG,1,2600,0,2600,2317,283
5/17/2021 21:57,8998866202732,MILKU STROBERI 200ML,1,3000,0,3000,2375,625
5/17/2021 21:57,8998866202725,MILKU COKLAT PREMIUM 200ML,1,3000,0,3000,2375,625
5/17/2021 21:57,8998866201452,POTABEE REGULER BBQ BEEF 35GR,1,5000,0,5000,4150,850
5/17/2021 21:57,PRG,PARAGO,11,500,0,5500,4400,1100
5/18/2021 12:25,8998866608718,DAIA SOFTENER PINK,1,5000,0,5000,4450,550
5/18/2021 12:25,MOLTO PINK,MOLTO ALL IN ONE 11 ML,2,500,0,1000,800,200
5/18/2021 12:25,MOBIL,GULA GULA HP,1,2000,0,2000,1700,300
5/18/2021 12:28,8991188943536,SASA SANTAN KELAPA 65ML,2,3000,0,6000,4874,1126
5/18/2021 12:28,BTS,BIMURA TARO SEAWEED 250G,1,10000,0,10000,9300,700
5/18/2021 12:28,8992775913000SCT,CHOCOLATOS CKLT DRINK SCT,2,2000,0,4000,3172,828
5/18/2021 12:28,8994834005923,SPIX 1000,1,1000,0,1000,850,150
5/18/2021 12:28,8992761139018,ADES 600ML,1,3500,0,3500,2292,1208
5/18/2021 12:28,8997028590014,ARGUS 220ML,4,500,0,2000,1208,792
5/18/2021 12:31,8998989300261,GUDANG GARAM SURYA 12 FILTER,1,18500,0,18500,17200,1300
5/18/2021 12:36,8993989311699,CLAS MILD 16 FILTER,1,23000,0,23000,21700,1300
5/18/2021 13:24,8999909010567,234 16 FILTER,1,22000,0,22000,21500,500
5/18/2021 14:06,GL,GULA 1 LITER,3,11500,0,34500,31500,3000
5/18/2021 14:06,8993058105013,EXTRA JOSS,1,12000,0,12000,9773,2227
5/18/2021 14:40,089686010107,INDOMIE KALDU AYAM,1,2500,0,2500,2150,350
5/18/2021 16:36,9556001025272,NESCAFE LATTE 240ML,1,8500,0,8500,7834,666
5/18/2021 16:36,8992761166212,FRESTEA APPLE 350ML,1,4500,0,4500,3000,1500
5/18/2021 16:36,VCL,VITAMIN C500 LEMON,1,1000,0,1000,575,425
5/18/2021 16:36,8997009510055,YOU C1000,1,10000,0,10000,9166,834
5/18/2021 16:36,8998898280401,TOLAK ANGIN FLU,3,3500,0,10500,8124,2376
5/18/2021 16:51,8998866202732,MILKU STROBERI 200ML,1,3000,0,3000,2375,625
5/18/2021 17:20,8994935000049,MINYAK GORENG DAMAI 5L,1,75000,0,75000,73780,1220
5/18/2021 17:31,GL,GULA 1 LITER,1,11500,0,11500,10500,1000
5/18/2021 17:49,8996001600375,LE MINERAL 330ML,1,2000,0,2000,1417,583
5/18/2021 18:21,8999909003439,MARLBORO CRAFTED 12,1,8000,0,8000,7250,750
5/18/2021 19:32,8998866501033,MINYAK GORENG SEDAAP POUCH 2L,1,28000,0,28000,27746,254
5/18/2021 19:59,8997231980022,O'JELLY MINI STRAWBERRY,1,3000,0,3000,2250,750
5/18/2021 19:59,8992696521797SCT,MILO UHT ACT GO 22G,2,2000,0,4000,2824,1176
5/18/2021 19:59,8998866202923,FLORIDINA COCO,1,3000,0,3000,2500,500
5/18/2021 19:59,8997231980015,O'JELLY MINI APPLE,1,3000,0,3000,2250,750
5/18/2021 20:20,8999909096004,SAMPOERNA 16 FILTER,1,24000,0,24000,23000,1000
5/18/2021 20:54,8992761139018,ADES 600ML,1,3500,0,3500,2292,1208
5/18/2021 21:07,089686043617,INDOMIE MIEGHRTTI,1,2700,0,2700,2452,248
5/18/2021 21:07,8998866200325,MIE SEDAAP SOTO,1,2500,0,2500,1952,548
5/18/2021 21:07,COKLAT,COKLAT COIN,1,500,0,500,400,100
5/18/2021 21:31,8998866202725,MILKU COKLAT PREMIUM 200ML,1,3000,0,3000,2375,625
5/18/2021 21:31,8998898337440,TOLAK ANGIN CARE 10ML,1,10000,0,10000,7893,2107
5/18/2021 21:31,089686611878,QTELA TEMPE,1,6000,0,6000,5370,630
5/18/2021 21:31,089686611519,QTELA SINGKONG,1,5000,0,5000,4266,734
5/18/2021 21:31,6907992823935,JD SWEETCORN,1,3500,0,3500,3000,500
5/18/2021 21:31,8996001600146,TEH PUCUK HARUM 350ML,1,3000,0,3000,2314,686
5/18/2021 21:31,089686021219,INTER MIE GORENG,3,1000,0,3000,2655,345
5/18/2021 21:32,8992959953044,SWEETY BRONZE XL1,2,2500,0,5000,4500,500
5/18/2021 21:48,089686010824,INDOMIE GORENG SPESIAL,4,2700,0,10800,9808,992
5/18/2021 21:48,089686010343,INDOMIE SOTO MIE,4,2600,0,10400,9468,932
5/18/2021 21:49,8998866202732,MILKU STROBERI 200ML,1,3000,0,3000,2375,625
5/18/2021 22:29,9556001025272,NESCAFE LATTE 240ML,1,8500,0,8500,7834,666
5/18/2021 22:29,8991102384841,WFR TANGO LONG CKLT 130G,1,5000,0,5000,4345,655
5/18/2021 22:29,6907992823935,JD SWEETCORN,1,3500,0,3500,3000,500
5/19/2021 11:04,123124,KOREK BIASA,1,2000,0,2000,1800,200
5/19/2021 11:29,AMPLOP,AMPLOP,4,250,0,1000,560,440
5/19/2021 11:43,8993989311699,CLAS MILD 16 FILTER,1,23000,0,23000,21700,1300
5/19/2021 11:53,8993083929837,BISKITOP BLACK COOKIES,1,27000,0,27000,23700,3300
5/19/2021 11:53,8991102989312,WFR TANGO SBJ 7G,1,8300,0,8300,7455,845
5/19/2021 12:06,8998989300261,GUDANG GARAM SURYA 12 FILTER,1,18500,0,18500,17200,1300
5/19/2021 12:06,8992959953082,SWEETY BRONZE L8,1,17000,0,17000,15380,1620
5/19/2021 12:17,8998989300261,GUDANG GARAM SURYA 12 FILTER,2,18500,0,37000,34400,2600
5/19/2021 12:36,TL,TELUR,3,1500,0,4500,3900,600
5/19/2021 14:02,ff,FULLO BLASTO,1,1000,0,1000,995,5
5/19/2021 14:02,ABC SPW,BATERAI ABC SPW,1,4500,0,4500,3893,607
5/19/2021 14:02,8992775002735,CHOCOLATOS SUSU COKELAT,1,4000,0,4000,3520,480
5/19/2021 14:02,8992946512223,SHINZUI,1,4000,0,4000,2500,1500
5/19/2021 14:02,TUSTEL,TUSUK TELINGA,1,1000,0,1000,833,167
5/19/2021 14:10,8992761166212,FRESTEA APPLE 350ML,1,4500,0,4500,3000,1500
5/19/2021 14:10,8998009020186,BUAVITA GUAVA 250ML,1,7000,0,7000,6083,917
5/19/2021 14:10,8998989500128,GUDANG GARAM MERAH KECIL 12KS,1,14000,0,14000,13000,1000
5/19/2021 14:10,8999999390198,SUNLIGHT LIME NEW POUCH 755ML,1,17000,0,17000,15400,1600
5/19/2021 14:10,001,PASEO SMART FACIAL SF 250S GT,1,10000,0,10000,9500,500
5/19/2021 14:10,8998866609036,DAIA BUNGA GUSSET 565G,1,10000,0,10000,8700,1300
5/19/2021 14:10,8999801700030,SUSU FOYU,1,11500,0,11500,10450,1050
5/19/2021 14:10,9311931024036,COFFEEMIX SCT,1,1500,0,1500,1200,300
5/19/2021 14:22,8992761136185,FANTA 1L,4,10000,0,40000,36000,4000
5/19/2021 14:22,8992761136161,COCACOLA 1L,1,10000,0,10000,9000,1000
5/19/2021 14:24,8999909010567,234 16 FILTER,2,22000,0,44000,43000,1000
5/19/2021 14:44,8999999516208,ROYCO FDS CHICKEN NEW 230G,1,10000,0,10000,9000,1000
5/19/2021 14:44,8997009510055,YOU C1000,1,10000,0,10000,9166,834
5/19/2021 14:44,BK,BUMBU KACANG,1,5000,0,5000,5000,0
5/19/2021 14:44,GL,GULA 1 LITER,1,11500,0,11500,10500,1000
5/19/2021 14:44,8999999524722,SUNLIGHT LIME NEW PCH 435ML,1,10000,0,10000,9100,900
5/19/2021 14:44,8998866803694,SOKLIN SOFTERGENT PURPLE BAG 770 & PIRING,1,18000,0,18000,16680,1320
5/19/2021 14:44,001,PASEO SMART FACIAL SF 250S GT,1,10000,0,10000,9500,500
5/19/2021 14:44,8993053641042,PASEO BABY WIPES GAZETTE 50S,1,17000,0,17000,15400,1600
5/19/2021 14:44,8995333032113,TERIGU GATOT KACA 1 KG,1,8500,0,8500,8012,488
5/19/2021 14:44,8998866200561,EKOMIE SUPER 600GR,1,10000,0,10000,8615,1385
5/19/2021 14:44,8998866202664,POTABEE WAGYU BEEF STEAK 68 GR,1,8000,0,8000,7200,800
5/19/2021 14:44,8998866201827,JAVANA GULA BATU 350ML,1,3000,0,3000,2150,850
5/19/2021 17:00,6907992823591,JD STRAW MILKSHAKE,1,5000,0,5000,4300,700
5/19/2021 17:00,6907992823652,JD CHOCOLATE MILKSHAKE,1,6000,0,6000,5200,800
5/19/2021 18:05,8999909096004,SAMPOERNA 16 FILTER,1,24000,0,24000,23000,1000
5/19/2021 18:08,8992696430860,KOKO KRUNCH 80G,1,9000,0,9000,8063,937
5/19/2021 18:08,8992957220025,GOLDEN CITY MINI,1,3000,0,3000,2500,500
5/19/2021 18:08,8991102281416,PERMEN MINTZ PPMINT,1,4500,0,4500,4000,500
5/19/2021 18:08,8992761002039,FANTA STRAWBERRY PET 390 ML,1,5500,0,5500,4300,1200
5/19/2021 19:31,8992725910400,LISTERINE COOLMINT 100ML,1,7500,0,7500,6800,700
5/19/2021 19:31,8998866108119,POSH HIJAB PURPLE WISH 150ML,1,19500,0,19500,17500,2000
5/19/2021 19:31,8992761166038,MMP ORANGE 300ML,1,5000,0,5000,3750,1250
5/19/2021 19:31,8992761002022,SPRITE PET 390ML,1,5500,0,5500,4300,1200
5/19/2021 19:32,8998866108119,POSH HIJAB PURPLE WISH 150ML,1,19500,0,19500,17500,2000
5/19/2021 19:32,8992725910400,LISTERINE COOLMINT 100ML,1,7500,0,7500,6800,700
5/19/2021 19:32,8998866202930,SEDAAP AYAM JERIT CUP,2,4500,0,9000,7476,1524
5/19/2021 19:32,8992957220087,COKLAT SINGA,1,2000,0,2000,1700,300
5/19/2021 19:40,8993989311699,CLAS MILD 16 FILTER,1,23000,0,23000,21700,1300
5/19/2021 20:19,8997231980015,O'JELLY MINI APPLE,1,3000,0,3000,2250,750
5/19/2021 20:19,TL,TELUR,3,1500,0,4500,3900,600
5/19/2021 20:19,089686010107,INDOMIE KALDU AYAM,1,2500,0,2500,2150,350
5/19/2021 20:24,8992959508312,SWEETY SILVER PANTS XL RTG,1,15500,0,15500,13944,1556
5/19/2021 20:30,8997009510055,YOU C1000,1,10000,0,10000,9166,834
5/19/2021 20:30,8992696404441,BEAR BRAND 189ML,1,9000,0,9000,7887,1113
5/19/2021 20:34,8997231980022,O'JELLY MINI STRAWBERRY,1,3000,0,3000,2250,750
5/19/2021 20:49,8992761002039,FANTA STRAWBERRY PET 390 ML,1,5500,0,5500,4300,1200
5/19/2021 20:49,bb,BENG-BENG,3,1500,0,4500,4350,150
5/19/2021 20:49,8996001318911,BETTER ISI 4,1,2000,0,2000,1700,300
5/19/2021 21:36,8991102281416,PERMEN MINTZ PPMINT,1,4500,0,4500,4000,500
5/19/2021 21:36,8996001600269,LE MINERAL 600ML,1,3000,0,3000,1688,1312
5/19/2021 21:36,8992761166229,FRESTEA MARKISA 350ML,1,4500,0,4500,3000,1500
5/19/2021 21:48,8998866200561,EKOMIE SUPER 600GR,1,10000,0,10000,8615,1385
5/19/2021 22:02,6907992823669,JD MILKY STRAW,1,3000,0,3000,2600,400
5/19/2021 22:27,8998866202664,POTABEE WAGYU BEEF STEAK 68 GR,1,8000,0,8000,7200,800
5/19/2021 22:27,8886013257400,TWISTKO,2,1000,0,2000,1800,200
5/19/2021 22:30,8998989300261,GUDANG GARAM SURYA 12 FILTER,1,18500,0,18500,17200,1300
5/19/2021 22:30,8998866200882,SUKSESMIE GORENG AYAM KRMS 133GR,1,3500,0,3500,3047,453
5/20/2021 12:52,9556001004673,MILO NESTLE MALAYSIA ACTIVE GO,1,85000,0,85000,80000,5000
5/20/2021 12:53,8998898337440,TOLAK ANGIN CARE 10ML,2,10000,0,20000,15786,4214
5/20/2021 13:51,8999999042646,RINSO MOLTO ROSE FRESH LIQ 40ML,1,6000,0,6000,4817,1183
5/20/2021 13:51,8998866611718,EKONOMI PENCUCI PIRING  LIQ 780ML,1,12000,0,12000,10900,1100
5/20/2021 13:51,8992388133017,NU MILK TEA ORI 330ML,1,6000,0,6000,5125,875
5/20/2021 13:52,8991001502933,CHACHA TUBE,2,7500,0,15000,12800,2200
5/20/2021 13:55,8991001005694,SELAMAT 20X15G,1,18000,0,18000,16000,2000
5/20/2021 13:55,8992959953334,SWEETY BRONZE XL42,1,80000,0,80000,75455,4545
5/20/2021 14:50,8998866202671,NOODLE SEDAAP MIE KOREAN SPICY SOUP CUP,2,5000,0,10000,8004,1996
5/20/2021 14:50,8992761166212,FRESTEA APPLE 350ML,2,4500,0,9000,6000,3000
5/20/2021 14:50,8991001502933,CHACHA TUBE,1,7500,0,7500,6400,1100
5/20/2021 14:50,123124,KOREK BIASA,1,2000,0,2000,1800,200
5/20/2021 16:16,8996001600269,LE MINERAL 600ML,1,3000,0,3000,1688,1312
5/20/2021 16:18,GL,GULA 1 LITER,1,11500,0,11500,10500,1000
5/20/2021 16:18,8991004011906,KOPI BORONG,1,10000,0,10000,8333,1667
5/20/2021 16:18,8998989500128,GUDANG GARAM MERAH KECIL 12KS,2,14000,0,28000,26000,2000
5/20/2021 17:07,8992959850046,CONFI PANTS M10,1,80000,0,80000,75120,4880
5/20/2021 17:07,8993176110081,MINYAK KAYU PUTIH 30ML,1,12000,0,12000,9091,2909
5/20/2021 17:07,001,PASEO SMART FACIAL SF 250S GT,1,10000,0,10000,9500,500
5/20/2021 17:48,8992761122430,FRESTEA GREEN HONEY 500ML,1,6500,0,6500,4708,1792
5/20/2021 17:48,8998866500135,HERSPROTEX SOFTCARE WINGS,1,5500,0,5500,4820,680
5/20/2021 17:48,8991001780140,TWISTER CHOCO,1,5000,0,5000,4600,400
5/20/2021 17:48,8991001503107,CHACHA PEANUT 35GR,1,5500,0,5500,4900,600
5/20/2021 17:48,8991001780126,SELAMAT CKLAT 60G,1,5000,0,5000,4300,700
5/20/2021 17:48,8992761111533,SPRITE SLIM CAM250ML,1,5000,0,5000,3750,1250
5/20/2021 17:48,8992775001653,GERY SALUT CHOCOLATE COCONUT,2,2000,0,4000,2952,1048
5/20/2021 17:52,8997009510055,YOU C1000,1,10000,0,10000,9166,834
5/20/2021 18:17,8998009010590,ULTRA CHO 125,1,3000,0,3000,2428,572
5/20/2021 18:17,8998009010569,ULTRA CHO 200,1,5000,0,5000,3830,1170
5/20/2021 18:26,089686010107,INDOMIE KALDU AYAM,2,2500,0,5000,4300,700
5/20/2021 18:39,TG APEL,TEH GELAS APEL,1,2000,0,2000,1178,822
5/20/2021 18:39,8999999502003,"SARIMURNI RL RB 1,8G",1,1500,0,1500,1207,293
5/20/2021 18:39,6907992825069,JD FRUITY,1,5000,0,5000,4400,600
5/20/2021 18:39,8991001503107,CHACHA PEANUT 35GR,1,5500,0,5500,4900,600
5/20/2021 18:39,8992761002039,FANTA STRAWBERRY PET 390 ML,1,5500,0,5500,4300,1200
5/20/2021 18:39,8991001502933,CHACHA TUBE,1,7500,0,7500,6400,1100
5/20/2021 18:39,8996001600146,TEH PUCUK HARUM 350ML,1,3000,0,3000,2314,686
5/20/2021 18:39,089686044249,SUPERMI NUTRIMI STEAK AYAM,1,3500,0,3500,2800,700
5/20/2021 18:50,8998009010590,ULTRA CHO 125,1,3000,0,3000,2428,572
5/20/2021 18:50,8998009010569,ULTRA CHO 200,1,5000,0,5000,3830,1170
5/20/2021 18:50,8992761164539,NUTRIBOOST ORANGE 300ML,1,6500,0,6500,5300,1200
5/20/2021 18:50,8991102387286SCT,TANGO LONG CKLT 47G,4,2000,0,8000,6204,1796
5/20/2021 18:50,8991102714631,TANGO TETRA CKLT,1,5000,0,5000,4545,455
5/20/2021 18:52,8998989300261,GUDANG GARAM SURYA 12 FILTER,1,18500,0,18500,17200,1300
5/20/2021 20:26,8994935000285,MINYAK GORENG DUNIA 4500ML,1,70000,0,70000,66433,3567
5/20/2021 20:26,711844610095,LARISSA UDANG 500 GR,2,11000,0,22000,19580,2420
5/20/2021 20:39,8999999390198,SUNLIGHT LIME NEW POUCH 755ML,1,17000,0,17000,15400,1600
5/20/2021 20:40,8994867007161,ROKOK PENA GOLD 20,1,17000,0,17000,15000,2000
5/20/2021 20:40,HT,HOT-HOT,1,500,0,500,350,150
5/20/2021 21:03,8992959850053,CONFIDENCE ADULT PANTS L10,1,100000,0,100000,92960,7040
5/20/2021 21:03,KJ,KINDER JOY,1,2000,0,2000,1583,417
5/20/2021 21:09,8992959953044,SWEETY BRONZE XL1,2,2500,0,5000,4500,500
5/20/2021 21:14,bb,BENG-BENG,4,1500,0,6000,5800,200
5/20/2021 22:10,8994834005923,SPIX 1000,1,1000,0,1000,850,150
5/20/2021 22:10,8998866202923,FLORIDINA COCO,1,3000,0,3000,2500,500
5/20/2021 22:12,8992775110157,GARUDA KACANG KULIT,1,5000,0,5000,3925,1075
5/20/2021 22:12,8992761139018,ADES 600ML,1,3500,0,3500,2292,1208
5/20/2021 22:12,TG APEL,TEH GELAS APEL,1,2000,0,2000,1178,822
5/20/2021 22:12,8999908389008,HEMAVITON C1000,1,8000,0,8000,6000,2000
5/20/2021 22:12,8992761164539,NUTRIBOOST ORANGE 300ML,1,6500,0,6500,5300,1200
5/20/2021 22:12,8997025915124,HATARI PEANUT 125G,1,7000,0,7000,6037,963
5/20/2021 22:12,6291100212866,KURMA KHALAS,1,85000,0,85000,80000,5000
5/20/2021 22:12,8996001600375,LE MINERAL 330ML,1,2000,0,2000,1417,583
5/20/2021 22:12,8996001600269,LE MINERAL 600ML,1,3000,0,3000,1688,1312
5/20/2021 22:12,8996001600399,LE MINERAL 1500ML,1,5000,0,5000,4042,958
5/20/2021 22:18,TL,TELUR,16,1500,0,24000,20800,3200
5/20/2021 22:29,8997231980022,O'JELLY MINI STRAWBERRY,1,3000,0,3000,2250,750
5/21/2021 11:53,8991102230308,BLASTER PINK,1,5000,0,5000,3106,1894
5/21/2021 11:53,8991102213189,BLASTER UNGU,1,5000,0,5000,3106,1894
5/21/2021 12:11,089686611519,QTELA SINGKONG,1,5000,0,5000,4266,734
5/21/2021 12:11,8999999502409,ROYCO FDS BEEF 9G,2,500,0,1000,750,250
5/21/2021 12:11,8991188943536,SASA SANTAN KELAPA 65ML,2,3000,0,6000,4874,1126
5/21/2021 12:19,8992761111533,SPRITE SLIM CAM250ML,1,5000,0,5000,3750,1250
5/21/2021 12:23,8998866202671,NOODLE SEDAAP MIE KOREAN SPICY SOUP CUP,1,5000,0,5000,4002,998
5/21/2021 13:11,8998009010590,ULTRA CHO 125,1,3000,0,3000,2428,572
5/21/2021 13:11,HT,HOT-HOT,2,500,0,1000,700,300
5/21/2021 13:11,COKLAT,COKLAT COIN,2,500,0,1000,800,200
5/21/2021 13:24,8999999526856,MOLTO ALL IN ONE BLUE 11ML,2,5500,0,11000,9600,1400
5/21/2021 14:19,GL,GULA 1 LITER,1,11500,0,11500,10500,1000
5/21/2021 14:43,8886057883665,KRATING DAENG,1,6000,0,6000,4286,1714
5/21/2021 14:43,8992761164546,NUTRIBOOST STRAWBERRY 300ML,1,6500,0,6500,5300,1200
5/21/2021 14:43,8992761002022,SPRITE PET 390ML,1,5500,0,5500,4300,1200
5/21/2021 14:51,8994867000179,ROKOK PENA MILD 16,1,14500,0,14500,13000,1500
5/21/2021 14:51,123124,KOREK BIASA,1,2000,0,2000,1800,200
5/21/2021 14:51,8992775110157,GARUDA KACANG KULIT,1,5000,0,5000,3925,1075
5/21/2021 14:57,8999999042646,RINSO MOLTO ROSE FRESH LIQ 40ML,1,6000,0,6000,4817,1183
5/21/2021 15:30,8999999059781,SUNLIGHT LIME NEW POUCH 210ML,1,5000,0,5000,4300,700
5/21/2021 16:04,8996001355985,BENG-BENG SHARE IT,1,27000,0,27000,25000,2000
5/21/2021 16:34,8998989300261,GUDANG GARAM SURYA 12 FILTER,1,18500,0,18500,17200,1300
5/21/2021 17:15,089686043051,INDOMIE COTO MAKASSAR,2,2800,0,5600,5050,550
5/21/2021 17:15,8991004011906,KOPI BORONG,1,10000,0,10000,8333,1667
5/21/2021 17:15,089686010107,INDOMIE KALDU AYAM,2,2500,0,5000,4300,700
5/21/2021 17:15,8999999502393,ROYCO FDS CHICKEN 8G,1,5000,0,5000,4500,500
5/21/2021 17:15,GL,GULA 1 LITER,2,11500,0,23000,21000,2000
5/21/2021 17:15,8998866501033,MINYAK GORENG SEDAAP POUCH 2L,1,28000,0,28000,27746,254
5/21/2021 17:16,TK,TEPUNG KETAN,1,13000,0,13000,13000,0
5/21/2021 17:23,8998866605106,CLING BIRU BTL 440ML,1,8500,0,8500,7600,900
5/21/2021 17:24,8992761122430,FRESTEA GREEN HONEY 500ML,1,6500,0,6500,4708,1792
5/21/2021 17:24,8992761166052,FRESTEA MELATI 350ML,1,4500,0,4500,3000,1500
5/21/2021 17:27,8992761145019,COCA COLA PET 250ML,1,3500,0,3500,2417,1083
5/21/2021 17:28,8992933214116,NUTRIJELL MELON,2,6000,0,12000,10082,1918
5/21/2021 17:28,8990800020013,MENTOS MINT HALAL IND,1,5700,0,5700,5150,550
5/21/2021 17:28,8999801700030,SUSU FOYU,1,11500,0,11500,10450,1050
5/21/2021 17:44,8992959954058,SWEETY BRONZE NB 44,1,48000,0,48000,45682,2318
5/21/2021 17:55,8992761164539,NUTRIBOOST ORANGE 300ML,1,6500,0,6500,5300,1200
5/21/2021 17:55,8998866200882,SUKSESMIE GORENG AYAM KRMS 133GR,1,3500,0,3500,3047,453
5/21/2021 18:31,8993470411433,JOGER CLASSIC,1,1000,0,1000,850,150
5/21/2021 18:31,089686043273,INDOMIE SAMBAL RICA,1,2700,0,2700,2452,248
5/21/2021 18:35,COKLAT,COKLAT COIN,3,500,0,1500,1200,300
5/21/2021 18:35,bb,BENG-BENG,1,1500,0,1500,1450,50
5/21/2021 18:35,8994834003752,TICTIC,1,2000,0,2000,1700,300
5/21/2021 18:36,COKLAT,COKLAT COIN,2,500,0,1000,800,200
5/21/2021 18:36,8993470411433,JOGER CLASSIC,1,1000,0,1000,850,150
5/21/2021 18:45,8999999537180,CLEAR SHP LEMON FRESH 9 ML,1,10500,0,10500,9300,1200
5/21/2021 18:45,8999999571887,MOLTO EDP PURPLE 10ML,1,5000,0,5000,4800,200
5/21/2021 18:45,8999999390198,SUNLIGHT LIME NEW POUCH 755ML,1,17000,0,17000,15400,1600
5/21/2021 18:57,8994834003752,TICTIC,1,2000,0,2000,1700,300
5/21/2021 18:57,8992957220087,COKLAT SINGA,1,2000,0,2000,1700,300
5/21/2021 19:02,8886013257400,TWISTKO,2,1000,0,2000,1800,200
5/21/2021 20:01,8997231980022,O'JELLY MINI STRAWBERRY,1,3000,0,3000,2250,750
5/21/2021 20:01,COKLAT,COKLAT COIN,2,500,0,1000,800,200
5/21/2021 20:01,6907992823829,JD MILKY MILK,1,3000,0,3000,2600,400
5/21/2021 20:01,8993470671752,JOGER STICK DUO KACANG,1,1000,0,1000,850,150
5/21/2021 20:40,8998866603683,FRES&NATURAL SOAP MERAH 65G,1,1800,0,1800,1425,375
5/21/2021 20:42,8997231980022,O'JELLY MINI STRAWBERRY,1,3000,0,3000,2250,750
5/21/2021 20:42,kp,KALPA,1,2000,0,2000,1666,334
5/21/2021 20:42,bb,BENG-BENG,1,1500,0,1500,1450,50
5/21/2021 20:42,JGR SHN,JOGER SHINY SACHET,1,500,0,500,437,63
5/21/2021 21:14,8994867007161,ROKOK PENA GOLD 20,1,17000,0,17000,15000,2000
5/21/2021 21:37,8992761002039,FANTA STRAWBERRY PET 390 ML,1,5500,0,5500,4300,1200
5/21/2021 21:45,8992761136161,COCACOLA 1L,2,10000,0,20000,18000,2000
5/21/2021 22:29,8996001600146,TEH PUCUK HARUM 350ML,1,3000,0,3000,2314,686
5/21/2021 22:29,8997218380135,ICHITAN GREEN TEA,1,8000,0,8000,6583,1417
5/21/2021 22:29,8999908204202,MY BABY MINYAK TELON 60ML,1,18000,0,18000,16900,1100
5/21/2021 22:29,8998989300261,GUDANG GARAM SURYA 12 FILTER,1,18500,0,18500,17200,1300
5/22/2021 12:14,8991001502933,CHACHA TUBE,3,7500,0,22500,19200,3300
5/22/2021 13:06,8999999059316,LIFEBUOY TS MILDCARE 75G,2,3000,0,6000,5280,720
5/22/2021 13:06,8993379210854,SABUN HARMONY APPLE 70G,1,2000,0,2000,1652,348
5/22/2021 13:51,8999999027049,LIFEBUOY PRWTN RMBT RNTK 9ML,1,5000,0,5000,4500,500
5/22/2021 16:22,8998866609487,SOKLIN SOFTERGEN 280G,1,5000,0,5000,4425,575
5/22/2021 16:22,8992761166038,MMP ORANGE 300ML,1,5000,0,5000,3750,1250
5/22/2021 16:28,8993083140058,BISKITOP COCONUT,1,27000,0,27000,25200,1800
5/22/2021 18:03,8998866610377,ISOPLUS,1,3000,0,3000,2350,650
5/22/2021 18:05,MOBIL,GULA GULA HP,1,2000,0,2000,1700,300
5/22/2021 18:05,8991001502933,CHACHA TUBE,1,7500,0,7500,6400,1100
5/22/2021 18:05,8991001111883,SILVERQUEEN CHUNKYBAR 33G,1,8000,0,8000,7150,850
5/22/2021 18:44,8998989300261,GUDANG GARAM SURYA 12 FILTER,1,18500,0,18500,17200,1300
5/22/2021 18:44,8999999195656,SARI WANGI 50X1.85,1,10000,0,10000,9500,500
5/22/2021 18:59,8998989300261,GUDANG GARAM SURYA 12 FILTER,1,18500,0,18500,17200,1300
5/22/2021 18:59,8998009010569,ULTRA CHO 200,1,5000,0,5000,3830,1170
5/22/2021 18:59,8998009040023,TEH KOTAK,1,5000,0,5000,2827,2173
5/22/2021 19:02,COKLAT,COKLAT COIN,6,500,0,3000,2400,600
5/22/2021 19:12,11222,LEM KOREA,1,10000,0,10000,8000,2000
5/22/2021 19:31,8992761002039,FANTA STRAWBERRY PET 390 ML,1,5500,0,5500,4300,1200
5/22/2021 19:31,8992959953044,SWEETY BRONZE XL1,2,2500,0,5000,4500,500
5/22/2021 19:57,6907992823652,JD CHOCOLATE MILKSHAKE,1,6000,0,6000,5200,800
5/22/2021 19:57,8998866201483,POTABEE REGULER GRILLED SEAWEED 35GR,1,5000,0,5000,4150,850
5/22/2021 19:57,8997231980022,O'JELLY MINI STRAWBERRY,1,3000,0,3000,2250,750
5/22/2021 20:03,8997231980022,O'JELLY MINI STRAWBERRY,1,3000,0,3000,2250,750
5/22/2021 20:03,8993470671752,JOGER STICK DUO KACANG,1,1000,0,1000,850,150
5/22/2021 20:03,bb,BENG-BENG,1,1500,0,1500,1450,50
5/22/2021 20:03,COKLAT,COKLAT COIN,6,500,0,3000,2400,600
5/22/2021 20:03,6907992823829,JD MILKY MILK,1,3000,0,3000,2600,400
5/22/2021 20:03,JGR SHN,JOGER SHINY SACHET,1,500,0,500,437,63
5/22/2021 20:13,8992933215113,NUTRIJELL TANPA RASA,1,6000,0,6000,4950,1050
5/22/2021 20:13,8992933213119,NUTRIJELL LECI,1,6000,0,6000,5041,959
5/22/2021 20:13,GL,GULA 1 LITER,2,11500,0,23000,21000,2000
5/22/2021 20:13,8999999059781,SUNLIGHT LIME NEW POUCH 210ML,1,5000,0,5000,4300,700
5/22/2021 20:13,8991004011906,KOPI BORONG,1,10000,0,10000,8333,1667
5/22/2021 20:13,8993470671752,JOGER STICK DUO KACANG,1,1000,0,1000,850,150
5/22/2021 20:13,8998989500128,GUDANG GARAM MERAH KECIL 12KS,2,14000,0,28000,26000,2000
5/22/2021 20:13,8998866610261,DAIA VIOLET GUSSET BAG 290 GR,1,5000,0,5000,4450,550
5/22/2021 20:13,8991102281430,PERMEN MINTZ DUOMINT,1,4500,0,4500,4000,500
5/22/2021 20:13,8990800020013,MENTOS MINT HALAL IND,1,5700,0,5700,5150,550
5/22/2021 20:13,8998866610438,SOKLIN SOFTERGENT RED BAG 770G & PIRING,1,18000,0,18000,16680,1320
5/22/2021 20:13,089686017748,SARIMIE GORENG ISI 2,2,3500,0,7000,6240,760
5/22/2021 20:13,8997231980022,O'JELLY MINI STRAWBERRY,2,3000,0,6000,4500,1500
5/22/2021 20:13,089686043051,INDOMIE COTO MAKASSAR,2,2800,0,5600,5050,550
5/22/2021 20:13,089686044249,SUPERMI NUTRIMI STEAK AYAM,2,3500,0,7000,5600,1400
5/22/2021 20:13,8999999502003,"SARIMURNI RL RB 1,8G",1,1500,0,1500,1207,293
5/22/2021 20:13,8992775002735,CHOCOLATOS SUSU COKELAT,1,4000,0,4000,3520,480
5/22/2021 20:13,8998866202725,MILKU COKLAT PREMIUM 200ML,1,3000,0,3000,2375,625
5/22/2021 20:13,8998866202732,MILKU STROBERI 200ML,1,3000,0,3000,2375,625
5/22/2021 20:13,8992761166212,FRESTEA APPLE 350ML,1,4500,0,4500,3000,1500
5/22/2021 20:13,8994834003752,TICTIC,1,2000,0,2000,1700,300
5/22/2021 20:13,8993365121539,MADU TJ SUPER 150G,1,16800,0,16800,15220,1580
5/22/2021 20:36,8992959508992,SWEETY SILVER PANTS L 28,1,56800,0,56800,51819,4981
5/22/2021 20:36,8998866200646,KOPI TOP MURNI,1,11000,0,11000,9600,1400
5/22/2021 21:02,8998866202732,MILKU STROBERI 200ML,1,3000,0,3000,2375,625
5/22/2021 21:13,BB,PASEO SMARTY FACIAL TRAVEL PACK 50S GT,1,3000,0,3000,1980,1020
5/22/2021 22:07,8998866202244,EKOMIE BUMBU KALDU AYAM,5,1000,0,5000,3990,1010
5/22/2021 22:07,089686021219,INTER MIE GORENG,1,1000,0,1000,885,115
5/22/2021 22:12,8999909096004,SAMPOERNA 16 FILTER,1,24000,0,24000,23000,1000
5/22/2021 22:13,GL,GULA 1 LITER,1,11500,0,11500,10500,1000
5/22/2021 22:21,COKLAT,COKLAT COIN,10,500,0,5000,4000,1000
5/22/2021 22:23,6907992823867,JD CRUNCHY CHOCOLATE MALT,1,5500,0,5500,4700,800
5/22/2021 22:29,8992761136161,COCACOLA 1L,1,10000,0,10000,9000,1000
5/22/2021 22:29,8992761136178,SPRITE 1L,1,10000,0,10000,9000,1000
5/22/2021 22:40,089686011036,INDOMIE GORENG PEDAS,1,2700,0,2700,2452,248
5/22/2021 22:49,8993379200855,SABUN HARMONY STRAWBERRY 70G,2,2000,0,4000,3304,696
5/22/2021 22:49,8993379152017,SABUN CUCI SURYA 200G,1,3000,0,3000,2281,719
5/22/2021 22:49,8999999035532,VASELINE NIGHT REPAIR 200ML,1,33800,0,33800,30855,2945
5/22/2021 22:49,8991001111883,SILVERQUEEN CHUNKYBAR 33G,1,8000,0,8000,7150,850
5/22/2021 22:49,8996001600146,TEH PUCUK HARUM 350ML,1,3000,0,3000,2314,686
5/22/2021 22:49,8992761139018,ADES 600ML,1,3500,0,3500,2292,1208
5/22/2021 22:49,8998009020186,BUAVITA GUAVA 250ML,1,7000,0,7000,6083,917
5/22/2021 22:49,8992775110157,GARUDA KACANG KULIT,1,5000,0,5000,3925,1075
5/23/2021 11:54,8996001600269,LE MINERAL 600ML,1,3000,0,3000,1688,1312
5/23/2021 14:09,6907992823843,JD MOCHA CRISPY,1,5000,0,5000,4400,600
5/23/2021 14:09,6907992823867,JD CRUNCHY CHOCOLATE MALT,1,5500,0,5500,4700,800
5/23/2021 14:10,8991111101316,JB OIL 50ML,1,9500,0,9500,8700,800
5/23/2021 14:38,6907992823850,JD CHOCO CIRLE,1,5500,0,5500,4700,800
5/23/2021 14:38,6907992823591,JD STRAW MILKSHAKE,1,5000,0,5000,4300,700
5/23/2021 14:38,8992761145019,COCA COLA PET 250ML,1,3500,0,3500,2417,1083
5/23/2021 14:38,8992761164546,NUTRIBOOST STRAWBERRY 300ML,1,6500,0,6500,5300,1200
5/23/2021 14:40,8886020033431,KAPUR AJAIB ANTI KECOA DAN NYAMUK,1,3000,0,3000,2700,300
5/23/2021 15:15,6907992823669,JD MILKY STRAW,1,3000,0,3000,2600,400
5/23/2021 15:15,6907992824963,JD MILKY CHOCOLATE,1,3000,0,3000,2600,400
5/23/2021 15:15,COKLAT,COKLAT COIN,2,500,0,1000,800,200
5/23/2021 15:58,8992761164539,NUTRIBOOST ORANGE 300ML,1,6500,0,6500,5300,1200
5/23/2021 15:58,8992761002022,SPRITE PET 390ML,1,5500,0,5500,4300,1200
5/23/2021 15:58,8992761166205,FRESTEA GREEN HONEY 350ML,1,4500,0,4500,3000,1500
5/23/2021 16:03,8992761139018,ADES 600ML,1,3500,0,3500,2292,1208
5/23/2021 16:03,8886013257400,TWISTKO,1,1000,0,1000,900,100
5/23/2021 16:03,YP,YUPI,2,250,0,500,416,84
5/23/2021 18:39,089686044249,SUPERMI NUTRIMI STEAK AYAM,1,3500,0,3500,2800,700
5/23/2021 18:41,8992696419742,NESCAFE COFFE CREAM,1,5000,0,5000,4099,901
5/23/2021 19:22,8992959953044,SWEETY BRONZE XL1,2,2500,0,5000,4500,500
5/23/2021 19:24,089686044249,SUPERMI NUTRIMI STEAK AYAM,1,3500,0,3500,2800,700
5/23/2021 19:24,8999999016128,RINSO MOLTO ROSE FRESH 750ML,1,15000,0,15000,12507,2493
5/23/2021 19:24,8993560026011,DETTOL FRESH,1,20000,0,20000,18524,1476
5/23/2021 19:24,8999999059781,SUNLIGHT LIME NEW POUCH 210ML,1,5000,0,5000,4300,700
5/23/2021 19:24,8999999557447,PEPSODENT ACTION123 SIWAK 110G,1,9000,0,9000,8000,1000
5/23/2021 19:24,8998866106351,ZINC MEN ACTIVE COOL 70ML,1,8500,0,8500,7550,950
5/23/2021 19:24,8999999519735,PEPSODENT TB BAMBOO SALT,1,13200,0,13200,11990,1210
5/23/2021 19:24,8992946512223,SHINZUI,1,4000,0,4000,2500,1500
5/23/2021 19:24,8992222054973,GATSBY STYLING POMADE 30GR,1,15000,0,15000,13000,2000
5/23/2021 20:02,8994834006128,TICTIC PEDAS,1,2000,0,2000,1700,300
5/23/2021 20:02,8997231980022,O'JELLY MINI STRAWBERRY,1,3000,0,3000,2250,750
5/23/2021 20:02,PRG,PARAGO,2,500,0,1000,800,200
5/23/2021 20:02,8993470411433,JOGER CLASSIC,1,1000,0,1000,850,150
5/23/2021 20:02,YP,YUPI,2,250,0,500,416,84
5/23/2021 20:02,JGR SHN,JOGER SHINY SACHET,1,500,0,500,437,63
5/23/2021 20:02,HT,HOT-HOT,1,500,0,500,350,150
5/23/2021 20:02,COKLAT,COKLAT COIN,1,500,0,500,400,100
5/23/2021 21:05,8991102381024,FULLO VNL PCK,1,10000,0,10000,9000,1000
5/23/2021 21:06,8992696404441,BEAR BRAND 189ML,2,9000,0,18000,15774,2226
5/23/2021 21:12,089686043051,INDOMIE COTO MAKASSAR,1,2800,0,2800,2525,275
5/23/2021 21:12,089686043273,INDOMIE SAMBAL RICA,1,2700,0,2700,2452,248
5/23/2021 21:12,8998989300261,GUDANG GARAM SURYA 12 FILTER,1,18500,0,18500,17200,1300
5/23/2021 21:12,8993176110081,MINYAK KAYU PUTIH 30ML,1,12000,0,12000,9091,2909
5/23/2021 21:36,711844150027,ABC NANAS,1,13000,0,13000,12241,759
5/23/2021 21:40,8996001600375,LE MINERAL 330ML,1,2000,0,2000,1417,583
5/23/2021 22:30,8992761164546,NUTRIBOOST STRAWBERRY 300ML,2,6500,0,13000,10600,2400
5/23/2021 22:30,8992761166205,FRESTEA GREEN HONEY 350ML,1,4500,0,4500,3000,1500
5/23/2021 22:30,8991102300421,WFR TANGO COKLAT 176GR,1,10000,0,10000,8694,1306
5/23/2021 22:30,8850507000094,POLICE BONCHA,2,2000,0,4000,1600,2400
5/24/2021 13:18,8994867007161,ROKOK PENA GOLD 20,1,17000,0,17000,15000,2000
5/24/2021 13:44,8998866501033,MINYAK GORENG SEDAAP POUCH 2L,6,28000,0,168000,166476,1524
5/24/2021 14:54,089686010343,INDOMIE SOTO MIE,1,2600,0,2600,2367,233
5/24/2021 14:54,089686010824,INDOMIE GORENG SPESIAL,2,2700,0,5400,4904,496
5/24/2021 15:00,8998866201377,KRISBEE FRIES KENTANG GORENG 68 GR,1,5500,0,5500,4620,880
5/24/2021 15:00,8998989500166,GUDANG GARAM MERAH BESAR 16KS,1,18000,0,18000,17000,1000
5/24/2021 15:14,8998866200851,NOODLE SEDAAP MIE BAKSO SPESIAL CUP 77 GR,2,4500,0,9000,7300,1700
5/24/2021 15:14,8998866202671,NOODLE SEDAAP MIE KOREAN SPICY SOUP CUP,1,5000,0,5000,4002,998
5/24/2021 15:14,8998866202404,NOODLE SEDAAP MIE KOREAN SPICY CHICKEN CUP,1,5000,0,5000,4002,998
5/24/2021 15:16,8999999528850,CITRA NAT GLOW WHITE 60ML,1,6200,0,6200,5625,575
5/24/2021 15:16,8998866105484,EMERON LOVELY MOISTURE&BRIGHT,1,4300,0,4300,3800,500
5/24/2021 15:16,VTM,VITAMIN,1,500,0,500,425,75
5/24/2021 15:22,YP,YUPI,8,250,0,2000,1664,336
5/24/2021 15:22,YP,YUPI,16,250,0,4000,3328,672
5/24/2021 15:22,PRG,PARAGO,2,500,0,1000,800,200
5/24/2021 15:47,VCL,VITAMIN C500 LEMON,1,1000,0,1000,575,425
5/24/2021 15:47,VCO,VITAMIN C500 ORANGE,1,1000,0,1000,575,425
5/24/2021 16:14,8999999534097,PEPSODENT PGB FCM 75G,1,5000,0,5000,3850,1150
5/24/2021 16:44,089686010343,INDOMIE SOTO MIE,2,2600,0,5200,4734,466
5/24/2021 16:44,8996001410042GT,TB TORA MOKA,1,13000,0,13000,8700,4300
5/24/2021 16:46,8998866200561,EKOMIE SUPER 600GR,1,10000,0,10000,8615,1385
5/24/2021 16:46,8997011700123,BIHUN JAGUNG 300GR,1,6000,0,6000,4979,1021
5/24/2021 16:46,8999999533731,CITRA TS NATURE WHITE 70G,2,2200,0,4400,3800,600
5/24/2021 16:46,8992979190986,TOTAL PUTIH SOFTENER,1,13000,0,13000,11532,1468
5/24/2021 17:11,8994834006128,TICTIC PEDAS,1,2000,0,2000,1700,300
5/24/2021 17:11,8998866202725,MILKU COKLAT PREMIUM 200ML,1,3000,0,3000,2375,625
5/24/2021 17:32,8998989300261,GUDANG GARAM SURYA 12 FILTER,1,18500,0,18500,17200,1300
5/24/2021 17:32,VTM,VITAMIN,1,500,0,500,425,75
5/24/2021 17:48,8998866202732,MILKU STROBERI 200ML,1,3000,0,3000,2375,625
5/24/2021 17:48,8992628020152,BIMOLI POUCH 2L,1,31000,0,31000,29800,1200
5/24/2021 17:55,8996001600399,LE MINERAL 1500ML,1,5000,0,5000,4042,958
5/24/2021 17:55,001,PASEO SMART FACIAL SF 250S GT,1,10000,0,10000,9500,500
5/24/2021 17:55,8998009020186,BUAVITA GUAVA 250ML,2,7000,0,14000,12166,1834
5/24/2021 17:55,8991102989428SCT,TANGO CKLT 24G SCT,1,1000,0,1000,609,391
5/24/2021 18:23,8994834006128,TICTIC PEDAS,1,2000,0,2000,1700,300
5/24/2021 18:23,8886013257400,TWISTKO,2,1000,0,2000,1800,200
5/24/2021 18:23,8994834005923,SPIX 1000,1,1000,0,1000,850,150
5/24/2021 18:38,TG,TEH GELAS,1,1000,0,1000,729,271
5/24/2021 18:38,8992696404441,BEAR BRAND 189ML,1,9000,0,9000,7887,1113
5/24/2021 18:50,8997231980022,O'JELLY MINI STRAWBERRY,1,3000,0,3000,2250,750
5/24/2021 18:50,8997231980015,O'JELLY MINI APPLE,1,3000,0,3000,2250,750
5/24/2021 18:59,GL,GULA 1 LITER,4,11500,0,46000,42000,4000
5/24/2021 19:12,8886013213208,FRENCH FREIS 2000,3,5000,0,15000,11250,3750
5/24/2021 19:18,8992725910417,LISTERINE FRESH BURST 100ML,1,7500,0,7500,6800,700
5/24/2021 19:18,VCO,VITAMIN C500 ORANGE,1,1000,0,1000,575,425
5/24/2021 19:34,711844610095,LARISSA UDANG 500 GR,3,11000,0,33000,29370,3630
5/24/2021 19:52,8997231980022,O'JELLY MINI STRAWBERRY,1,3000,0,3000,2250,750
5/24/2021 19:52,MOBIL,GULA GULA HP,1,2000,0,2000,1700,300
5/24/2021 19:53,8993072153595,LARISST COTTON 35G,1,5000,0,5000,3300,1700
5/24/2021 20:00,8995333060703,TERIGU KOMPAS 1KG,2,10500,0,21000,19632,1368
5/24/2021 20:00,8998866201865,KRISBEE PILLOW CHOCOLAVA 120 GR,1,8000,0,8000,7250,750
5/24/2021 20:00,8998866600521,SOKLIN FLOORCLENER KUNING 400ML,1,6000,0,6000,5025,975
5/24/2021 20:00,8997226412019,EMINA CHEESE 165G,1,17000,0,17000,15000,2000
5/24/2021 20:15,8998866202725,MILKU COKLAT PREMIUM 200ML,1,3000,0,3000,2375,625
5/24/2021 20:15,8994834006128,TICTIC PEDAS,1,2000,0,2000,1700,300
5/24/2021 21:05,ARG,ARGUS 220ML,2,14500,0,29000,25000,4000
5/24/2021 21:06,VCO,VITAMIN C500 ORANGE,1,1000,0,1000,575,425
5/24/2021 21:32,8992959072202,HN PANTS L 20,1,35000,0,35000,32576,2424
5/24/2021 21:52,8998989300261,GUDANG GARAM SURYA 12 FILTER,1,18500,0,18500,17200,1300
5/24/2021 21:52,PRG,PARAGO,2,500,0,1000,800,200
5/24/2021 21:52,COKLAT,COKLAT COIN,1,500,0,500,400,100
5/24/2021 21:52,YP,YUPI,2,250,0,500,416,84
5/24/2021 22:06,ff,FULLO BLASTO,1,1000,0,1000,995,5
5/24/2021 22:24,8992775110157,GARUDA KACANG KULIT,1,5000,0,5000,3925,1075
5/24/2021 22:24,8992775211410,PILUS GARUDA PEDAS,1,5000,0,5000,4886,114
5/25/2021 12:25,8997027490018,LADAMAS MERICA BUBUK,1,9500,0,9500,8898,602
5/25/2021 12:25,8992753102204,BKM COKLAT 370G,1,11300,0,11300,9500,1800
5/25/2021 12:25,BK,BUMBU KACANG,1,5000,0,5000,5000,0
5/25/2021 12:25,8992959117569,SFX DS REG FLOW NW 8,1,4000,0,4000,3530,470
5/25/2021 12:25,8992959117583,SFX DS REG FLOW WING 20,1,5000,0,5000,4288,712
5/25/2021 12:25,8991102380805,FULLO  CKL PCK 8G,1,10000,0,10000,9000,1000
5/25/2021 12:25,8999908204202,MY BABY MINYAK TELON 60ML,1,18000,0,18000,16900,1100
5/25/2021 12:25,8997231980022,O'JELLY MINI STRAWBERRY,1,3000,0,3000,2250,750
5/25/2021 12:25,8999999524722,SUNLIGHT LIME NEW PCH 435ML,1,10000,0,10000,9100,900
5/25/2021 12:25,8998866202060,POTABEE AYAM BAKAR PEDAS 35 GR,2,5000,0,10000,8300,1700
5/25/2021 12:25,8992959509005,SWEETY SILVER PANTS XL26,1,61500,0,61500,55910,5590
5/25/2021 12:25,8992959953198,SWEETY BRONZE  XL2 6+2,1,60000,0,60000,54091,5909
5/25/2021 12:52,8998989500166,GUDANG GARAM MERAH BESAR 16KS,1,18000,0,18000,17000,1000
5/25/2021 12:52,bb,BENG-BENG,1,1500,0,1500,1450,50
5/25/2021 12:52,BTS,BIMURA TARO SEAWEED 250G,1,10000,0,10000,9300,700
5/25/2021 12:52,8992761002039,FANTA STRAWBERRY PET 390 ML,1,5500,0,5500,4300,1200
5/25/2021 13:31,bb,BENG-BENG,2,1500,0,3000,2900,100
5/25/2021 13:58,8992933241112,NUTRIJELL COKLAT,2,7000,0,14000,12832,1168
5/25/2021 13:58,8999801700030,SUSU FOYU,1,11500,0,11500,10450,1050
5/25/2021 13:58,8991188943536,SASA SANTAN KELAPA 65ML,2,3000,0,6000,4874,1126
5/25/2021 13:58,8997018720018,SIRUP DHT,1,23000,0,23000,20958,2042
5/25/2021 13:58,8997028900837,SABUN PAPAYA,1,10000,0,10000,9375,625
5/25/2021 13:58,8993379200855,SABUN HARMONY STRAWBERRY 70G,1,2000,0,2000,1652,348
5/25/2021 14:44,8998989300261,GUDANG GARAM SURYA 12 FILTER,1,18500,0,18500,17200,1300
5/25/2021 14:56,GL,GULA 1 LITER,2,11500,0,23000,21000,2000
5/25/2021 14:56,8998989300261,GUDANG GARAM SURYA 12 FILTER,3,18500,0,55500,51600,3900
5/25/2021 14:56,8991102303309,WFR TANGO SBJ 176G,2,10000,0,20000,17388,2612
5/25/2021 14:56,8993470279651,JOGER CHOCKY BAR,2,1000,0,2000,1734,266
5/25/2021 14:56,8998009020186,BUAVITA GUAVA 250ML,1,7000,0,7000,6083,917
5/25/2021 14:56,8993470671752,JOGER STICK DUO KACANG,1,1000,0,1000,850,150
5/25/2021 14:56,8993571004732,SALAS SALEP CAP19 6G,1,7000,0,7000,6000,1000
5/25/2021 14:56,8992761002022,SPRITE PET 390ML,1,5500,0,5500,4300,1200
5/25/2021 14:56,8999909096004,SAMPOERNA 16 FILTER,1,24000,0,24000,23000,1000
5/25/2021 14:56,8998898810721,KKB ENER-G C1000,1,8000,0,8000,6690,1310
5/25/2021 14:56,JGR SHN,JOGER SHINY SACHET,4,500,0,2000,1748,252
5/25/2021 14:56,8886013257400,TWISTKO,1,1000,0,1000,900,100
5/25/2021 14:56,8999999195656,SARI WANGI 50X1.85,1,10000,0,10000,9500,500
5/25/2021 14:56,8998989500128,GUDANG GARAM MERAH KECIL 12KS,1,14000,0,14000,13000,1000
5/25/2021 14:56,8994935000285,MINYAK GORENG DUNIA 4500ML,2,70000,0,140000,132866,7134
5/25/2021 14:56,8998866200646,KOPI TOP MURNI,1,11000,0,11000,9600,1400
5/25/2021 14:56,8992222052979,GATSBY WATER GLOSS MERAH,1,5000,0,5000,3700,1300
5/25/2021 14:56,8998866501033,MINYAK GORENG SEDAAP POUCH 2L,1,28000,0,28000,27746,254
5/25/2021 14:56,8992959953181,SWEETY BRONZE L30+2,1,55000,0,55000,53410,1590
5/25/2021 14:56,8992761164539,NUTRIBOOST ORANGE 300ML,1,6500,0,6500,5300,1200
5/25/2021 14:56,6907992823843,JD MOCHA CRISPY,1,5000,0,5000,4400,600
5/25/2021 14:58,8993989311699,CLAS MILD 16 FILTER,1,23000,0,23000,21700,1300
5/25/2021 16:06,8992761166212,FRESTEA APPLE 350ML,1,4500,0,4500,3000,1500
5/25/2021 16:06,089686611519,QTELA SINGKONG,1,5000,0,5000,4266,734
5/25/2021 16:06,HT,HOT-HOT,1,500,0,500,350,150
5/25/2021 16:32,8997231980015,O'JELLY MINI APPLE,1,3000,0,3000,2250,750
5/25/2021 16:32,8886013257400,TWISTKO,1,1000,0,1000,900,100
5/25/2021 16:32,8998866202732,MILKU STROBERI 200ML,1,3000,0,3000,2375,625
5/25/2021 16:45,001,PASEO SMART FACIAL SF 250S GT,1,10000,0,10000,9500,500
5/25/2021 16:47,089686611878,QTELA TEMPE,1,6000,0,6000,5370,630
5/25/2021 16:47,8998866600521,SOKLIN FLOORCLENER KUNING 400ML,1,6000,0,6000,5025,975
5/25/2021 16:47,TG,TEH GELAS,1,1000,0,1000,729,271
5/25/2021 17:07,8991111109107,JB POWDER BEDTIME 75+25g,1,6000,0,6000,5440,560
5/25/2021 17:07,BB,PASEO SMARTY FACIAL TRAVEL PACK 50S GT,1,3000,0,3000,1980,1020
5/25/2021 17:35,089686611519,QTELA SINGKONG,1,5000,0,5000,4266,734
5/25/2021 17:48,8993053641042,PASEO BABY WIPES GAZETTE 50S,1,17000,0,17000,15400,1600
5/25/2021 17:48,001,PASEO SMART FACIAL SF 250S GT,1,10000,0,10000,9500,500
5/25/2021 17:49,8993053641042,PASEO BABY WIPES GAZETTE 50S,1,17000,0,17000,15400,1600
5/25/2021 18:35,8997231980022,O'JELLY MINI STRAWBERRY,1,3000,0,3000,2250,750
5/25/2021 18:35,8997231980015,O'JELLY MINI APPLE,1,3000,0,3000,2250,750
5/25/2021 18:35,8998866202770,MIE SEDAAP SALERO PADANG,1,2500,0,2500,2362,138
5/25/2021 18:41,8998866201827,JAVANA GULA BATU 350ML,1,3000,0,3000,2150,850
5/25/2021 18:51,8997231980015,O'JELLY MINI APPLE,1,3000,0,3000,2250,750
5/25/2021 19:42,8999999534097,PEPSODENT PGB FCM 75G,1,5000,0,5000,3850,1150
5/25/2021 19:42,8998866608305,GIV BENGKOANG KOTAK 76G,1,2000,0,2000,1820,180
5/25/2021 19:42,8998866888615,GIV BIRU KOTAK 76G,1,2000,0,2000,1820,180
5/25/2021 19:42,8998866602389,GIV UNGU KOTAK 76G,1,2000,0,2000,1820,180
5/25/2021 19:42,8998866888639,GIV HIJAU KOTAK 76G,1,2000,0,2000,1820,180
5/25/2021 19:42,8998866609142,GIV MULBERRY SILK KOTAK 76G,1,2000,0,2000,1820,180
5/25/2021 19:42,8991111152073,LISTERINE GREEN TEA 100ML,1,8000,0,8000,7600,400
5/25/2021 19:46,8997231980015,O'JELLY MINI APPLE,1,3000,0,3000,2250,750
5/25/2021 19:46,PRG,PARAGO,4,500,0,2000,1600,400
5/25/2021 19:56,6907992823843,JD MOCHA CRISPY,1,5000,0,5000,4400,600
5/25/2021 19:56,8996001600146,TEH PUCUK HARUM 350ML,1,3000,0,3000,2314,686
5/25/2021 20:31,8999909002821,MALBORO BLACK 16,1,22000,0,22000,20850,1150
5/25/2021 20:45,8998866601429,POWDET DAIA BUNGA BAG 290GR,2,5000,0,10000,8900,1100
5/25/2021 20:45,8997231980015,O'JELLY MINI APPLE,2,3000,0,6000,4500,1500
5/25/2021 20:45,YP,YUPI,4,250,0,1000,832,168
5/25/2021 20:53,8998989500166,GUDANG GARAM MERAH BESAR 16KS,2,18000,0,36000,34000,2000
5/25/2021 20:55,COKLAT,COKLAT COIN,2,500,0,1000,800,200
5/25/2021 20:55,PRG,PARAGO,2,500,0,1000,800,200
5/25/2021 21:02,089686021219,INTER MIE GORENG,2,1000,0,2000,1770,230
5/25/2021 21:02,8998866200301,MIE SEDAAP GORENG,1,2500,0,2500,2023,477
5/25/2021 21:02,8996001301142,ROMA KELAPA,1,8000,0,8000,6628,1372
5/25/2021 21:02,089686043204,INDOMIE MIE ACEH,2,2700,0,5400,4904,496
5/25/2021 21:02,8996001318911,BETTER ISI 4,1,18000,0,18000,17000,1000
5/25/2021 21:03,ARG,ARGUS 220ML,6,14500,0,87000,75000,12000
5/25/2021 21:07,8998989300261,GUDANG GARAM SURYA 12 FILTER,1,18500,0,18500,17200,1300
5/25/2021 21:07,VCO,VITAMIN C500 ORANGE,1,1000,0,1000,575,425
5/25/2021 21:09,8993989311279,CLAS MILD 12,1,17000,0,17000,15700,1300
5/25/2021 21:09,VCO,VITAMIN C500 ORANGE,1,1000,0,1000,575,425
5/25/2021 21:50,089686010107,INDOMIE KALDU AYAM,4,2500,0,10000,8600,1400
5/25/2021 22:06,8992870311091,SALONPAS,1,6000,0,6000,4806,1194
5/25/2021 22:06,8997025914042,ATB MARIE SUSU 185G,1,7000,0,7000,4554,2446
5/25/2021 22:06,6907992825076,JD WATERMELON APPLE,1,2000,0,2000,1700,300
5/25/2021 22:06,8992696404441,BEAR BRAND 189ML,1,9000,0,9000,7887,1113
5/25/2021 22:06,8997009510055,YOU C1000,1,10000,0,10000,9166,834
5/25/2021 22:06,089686611878,QTELA TEMPE,1,6000,0,6000,5370,630
5/26/2021 12:09,6907992823935,JD SWEETCORN,1,3500,0,3500,3000,500
5/26/2021 12:09,8997231980015,O'JELLY MINI APPLE,1,3000,0,3000,2250,750
5/26/2021 12:13,8998866608718,DAIA SOFTENER PINK,1,5000,0,5000,4450,550
5/26/2021 12:13,MLTO PINK,MOLTO ALL IN ONE,1,1000,0,1000,800,200
5/26/2021 12:13,8997231980022,O'JELLY MINI STRAWBERRY,2,3000,0,6000,4500,1500
5/26/2021 12:13,8998989300261,GUDANG GARAM SURYA 12 FILTER,1,18500,0,18500,17200,1300
5/26/2021 12:13,8993470671752,JOGER STICK DUO KACANG,1,1000,0,1000,850,150
5/26/2021 12:13,8999999502003,"SARIMURNI RL RB 1,8G",1,1500,0,1500,1207,293
5/26/2021 12:13,8991102303309,WFR TANGO SBJ 176G,1,10000,0,10000,8694,1306
5/26/2021 12:13,8996001305041,ROMA SANDWICH CKLT,1,7000,0,7000,5000,2000
5/26/2021 12:13,8991004011906,KOPI BORONG,1,10000,0,10000,8333,1667
5/26/2021 12:13,ARG,ARGUS 220ML,1,14500,0,14500,12500,2000
5/26/2021 12:13,089686611519,QTELA SINGKONG,1,5000,0,5000,4266,734
5/26/2021 12:14,8999999514518,RINSO MOLTO PERF ESSENCE 215ML,1,5000,0,5000,4250,750
5/26/2021 12:40,8998866200301,MIE SEDAAP GORENG,1,2500,0,2500,2023,477
5/26/2021 12:40,089686043204,INDOMIE MIE ACEH,1,2700,0,2700,2452,248
5/26/2021 12:40,089686011036,INDOMIE GORENG PEDAS,1,2700,0,2700,2452,248
5/26/2021 12:40,HT,HOT-HOT,4,500,0,2000,1400,600
5/26/2021 12:53,KURMA,KURMA,1,60000,0,60000,55000,5000
5/26/2021 12:53,8998989110167,SURYA GUDANG GARAM 16 FILTER,1,25000,0,25000,23200,1800
5/26/2021 12:54,COKLAT,COKLAT COIN,8,500,0,4000,3200,800
5/26/2021 12:54,8997231980022,O'JELLY MINI STRAWBERRY,1,3000,0,3000,2250,750
5/26/2021 12:54,8997231980015,O'JELLY MINI APPLE,1,3000,0,3000,2250,750
5/26/2021 13:00,8997231980022,O'JELLY MINI STRAWBERRY,1,3000,0,3000,2250,750
5/26/2021 13:24,8991001111883,SILVERQUEEN CHUNKYBAR 33G,1,8000,0,8000,7150,850
5/26/2021 13:24,HT,HOT-HOT,4,500,0,2000,1400,600
5/26/2021 13:36,8994935000285,MINYAK GORENG DUNIA 4500ML,1,70000,0,70000,66433,3567
5/26/2021 13:36,8992696404441,BEAR BRAND 189ML,1,9000,0,9000,7887,1113
5/26/2021 14:36,8992959107515,SFX NON WING 23CM 8,1,4000,0,4000,3288,712
5/26/2021 14:36,VCL,VITAMIN C500 LEMON,1,1000,0,1000,575,425
5/26/2021 15:06,8992759120264,LARISST 220,1,10000,0,10000,9200,800
5/26/2021 15:06,8996001600269,LE MINERAL 600ML,1,3000,0,3000,1688,1312
5/26/2021 15:06,6907992823829,JD MILKY MILK,1,3000,0,3000,2600,400
5/26/2021 15:06,COKLAT,COKLAT COIN,2,500,0,1000,800,200
5/26/2021 17:18,8992761164546,NUTRIBOOST STRAWBERRY 300ML,1,6500,0,6500,5300,1200
5/26/2021 17:18,089686611519,QTELA SINGKONG,1,5000,0,5000,4266,734
5/26/2021 17:18,8998866201452,POTABEE REGULER BBQ BEEF 35GR,1,5000,0,5000,4150,850
5/26/2021 17:18,HT,HOT-HOT,1,500,0,500,350,150
5/26/2021 17:28,8992959974018,SFX SIRIH 36CM 12+1,1,17000,0,17000,15958,1042
5/26/2021 17:28,8991102387286SCT,TANGO LONG CKLT 47G,1,2000,0,2000,1551,449
5/26/2021 17:28,8991102989428SCT,TANGO CKLT 24G SCT,1,1000,0,1000,609,391
5/26/2021 17:29,8999999037765,PEPSODENT WHITE 225G,1,12000,0,12000,10750,1250
5/26/2021 17:31,8994834006128,TICTIC PEDAS,1,2000,0,2000,1700,300
5/26/2021 17:31,ff,FULLO BLASTO,2,1000,0,2000,1990,10
5/26/2021 17:31,8993470671752,JOGER STICK DUO KACANG,1,1000,0,1000,850,150
5/26/2021 17:47,8999999195656,SARI WANGI 50X1.85,1,10000,0,10000,9500,500
5/26/2021 18:24,089686611878,QTELA TEMPE,1,6000,0,6000,5370,630
5/26/2021 18:24,8993470279651,JOGER CHOCKY BAR,1,1000,0,1000,867,133
5/26/2021 18:24,001,PASEO SMART FACIAL SF 250S GT,1,10000,0,10000,9500,500
5/26/2021 18:33,PTK,MINI NAIL CLIPPER BESAR THREE SEVEN,1,7000,0,7000,6000,1000
5/26/2021 18:33,8997025911058,HATARI SHP KELAPA,1,6000,0,6000,4911,1089
5/26/2021 18:53,COKLAT,COKLAT COIN,1,500,0,500,400,100
5/26/2021 18:53,HT,HOT-HOT,1,500,0,500,350,150
5/26/2021 18:53,PRG,PARAGO,2,500,0,1000,800,200
5/26/2021 21:00,8998866202770,MIE SEDAAP SALERO PADANG,1,2500,0,2500,2362,138
5/26/2021 21:00,8999999559540,LIFEBUOY BW LEMONFRESH 90ML,2,5000,0,10000,8000,2000
5/26/2021 22:19,8998989110167,SURYA GUDANG GARAM 16 FILTER,1,25000,0,25000,23200,1800
5/26/2021 22:19,6907992825076,JD WATERMELON APPLE,1,2000,0,2000,1700,300
5/26/2021 22:19,8999908389008,HEMAVITON C1000,1,8000,0,8000,6000,2000
5/26/2021 22:19,YP,YUPI,8,250,0,2000,1664,336
5/26/2021 22:19,TL,TELUR,10,1500,0,15000,13000,2000
5/26/2021 22:20,8997231980022,O'JELLY MINI STRAWBERRY,1,3000,0,3000,2250,750
5/26/2021 22:20,8994834005923,SPIX 1000,1,1000,0,1000,850,150
5/27/2021 13:41,8999909002821,MARLBORO BLACK 16,1,22000,0,22000,20850,1150
5/27/2021 14:07,8999909096004,SAMPOERNA 16 FILTER,1,24000,0,24000,23000,1000
5/27/2021 14:07,8998989110167,SURYA GUDANG GARAM 16 FILTER,1,25000,0,25000,23200,1800
5/27/2021 14:38,8998866501033,MINYAK GORENG SEDAAP POUCH 2L,1,28000,0,28000,27746,254
5/27/2021 15:00,8992959953129,SWEETY BRONZE M20,1,35000,0,35000,33020,1980
5/27/2021 15:00,8993053641042,PASEO BABY WIPES GAZETTE 50S,1,17000,0,17000,15400,1600
5/27/2021 15:00,BB,PASEO SMARTY FACIAL TRAVEL PACK 50S GT,1,3000,0,3000,1980,1020
5/27/2021 15:00,001,PASEO SMART FACIAL SF 250S GT,1,10000,0,10000,9500,500
5/27/2021 15:00,8999999706111,PEPSODENT WHITE 25G,1,2000,0,2000,1450,550
5/27/2021 15:00,8999999031930,PEPSODENT TB TRIPLE CLEAN,1,3500,0,3500,2850,650
5/27/2021 15:00,8999999036492,LUX BW PINK SOFT BTL 100ML,1,10000,0,10000,8690,1310
5/27/2021 15:01,089686043051,INDOMIE COTO MAKASSAR,1,2800,0,2800,2525,275
5/27/2021 15:01,089686043617,INDOMIE MIEGHRTTI,1,2700,0,2700,2452,248
5/27/2021 15:46,8999999031930,PEPSODENT TB TRIPLE CLEAN,1,3500,0,3500,2850,650
5/27/2021 15:46,76164217,MARLBORO MERAH,1,30000,0,30000,27700,2300
5/27/2021 16:19,8992957220087,COKLAT SINGA,1,2000,0,2000,1700,300
5/27/2021 16:24,8990800016757,BB TUTI FRUITTY COSMO,1,8500,0,8500,7600,900
5/27/2021 16:24,8998009020186,BUAVITA GUAVA 250ML,1,7000,0,7000,6083,917
5/27/2021 16:24,8992696523067,MILO ACTVGO UHT 180ML,2,4500,0,9000,7030,1970
5/27/2021 16:24,8998009040023,TEH KOTAK,1,5000,0,5000,2827,2173
5/27/2021 16:24,8992696523081,MILO UHT 110ML,1,2500,0,2500,1962,538
5/27/2021 16:39,8991001111883,SILVERQUEEN CHUNKYBAR 33G,1,8000,0,8000,7150,850
5/27/2021 16:39,8997231980022,O'JELLY MINI STRAWBERRY,2,3000,0,6000,4500,1500
5/27/2021 16:39,8994834006128,TICTIC PEDAS,3,2000,0,6000,5100,900
5/27/2021 16:39,8994834003752,TICTIC,1,2000,0,2000,1700,300
5/27/2021 16:51,8998989500166,GUDANG GARAM MERAH BESAR 16KS,1,18000,0,18000,17000,1000
5/27/2021 16:58,8999999059316,LIFEBUOY TS MILDCARE 75G,2,3000,0,6000,5280,720
5/27/2021 16:58,8998989300261,GUDANG GARAM SURYA 12 FILTER,1,18500,0,18500,17200,1300
5/27/2021 17:07,VCO,VITAMIN C500 ORANGE,1,1000,0,1000,575,425
5/27/2021 17:27,8992775002155,CHOCOLATOS DRINK,1,4000,0,4000,3520,480
5/27/2021 17:27,001,PASEO SMART FACIAL SF 250S GT,1,10000,0,10000,9500,500
5/27/2021 17:27,8998866609487,SOKLIN SOFTERGEN 280G,1,5000,0,5000,4425,575
5/27/2021 17:51,8998009020186,BUAVITA GUAVA 250ML,3,7000,0,21000,18249,2751
5/27/2021 17:52,8991111102962,JB STARTERKIT BB GIFT SET,1,87000,0,87000,82880,4120
5/27/2021 18:36,711844610095,LARISSA UDANG 500 GR,2,11000,0,22000,19580,2420
5/27/2021 18:42,8997231980022,O'JELLY MINI STRAWBERRY,1,3000,0,3000,2250,750
5/27/2021 18:42,COKLAT,COKLAT COIN,4,500,0,2000,1600,400
5/27/2021 18:51,8993989311279,CLAS MILD 12,1,17000,0,17000,15700,1300
5/27/2021 21:30,8997009510055,YOU C1000,1,10000,0,10000,9166,834
5/27/2021 21:37,8992761002039,FANTA STRAWBERRY PET 390 ML,1,5500,0,5500,4300,1200
5/27/2021 21:37,8992959953044,SWEETY BRONZE XL1,2,2500,0,5000,4500,500
5/27/2021 21:37,bb,BENG-BENG,3,1500,0,4500,4350,150
5/27/2021 22:23,ARG,ARGUS 220ML,6,14500,0,87000,75000,12000
5/27/2021 22:23,8993058105013,EXTRA JOSS,1,12000,0,12000,9773,2227
5/28/2021 9:14,RB,RED BOLD,1,19000,0,19000,17900,1100
5/28/2021 9:14,8993989311699,CLAS MILD 16 FILTER,1,23000,0,23000,21700,1300
5/28/2021 9:14,9556001025272,NESCAFE LATTE 240ML,1,8500,0,8500,7834,666
5/28/2021 9:14,VCO,VITAMIN C500 ORANGE,2,1000,0,2000,1150,850
5/28/2021 10:16,8992696407053,DNCO 3+ MADU 800G,1,84500,0,84500,82333,2167
5/28/2021 11:10,8992761002022,SPRITE PET 390ML,1,5500,0,5500,4300,1200
5/28/2021 11:11,8997231980022,O'JELLY MINI STRAWBERRY,1,3000,0,3000,2250,750
5/28/2021 11:11,8997231980015,O'JELLY MINI APPLE,1,3000,0,3000,2250,750
5/28/2021 11:11,PRG,PARAGO,2,500,0,1000,800,200
5/28/2021 12:48,8992761166212,FRESTEA APPLE 350ML,2,4500,0,9000,6000,3000
5/28/2021 12:48,8886013257400,TWISTKO,1,1000,0,1000,900,100
5/28/2021 13:07,6907992823676,JD PEACH,2,2000,0,4000,3400,600
5/28/2021 13:07,8997231980022,O'JELLY MINI STRAWBERRY,1,3000,0,3000,2250,750
5/28/2021 13:09,8997231980022,O'JELLY MINI STRAWBERRY,1,3000,0,3000,2250,750
5/28/2021 13:09,8997231980015,O'JELLY MINI APPLE,1,3000,0,3000,2250,750
5/28/2021 13:09,PRG,PARAGO,2,500,0,1000,800,200
5/28/2021 13:13,8997231980022,O'JELLY MINI STRAWBERRY,1,3000,0,3000,2250,750
5/28/2021 13:13,ff,FULLO BLASTO,1,1000,0,1000,995,5
5/28/2021 13:14,089686010107,INDOMIE KALDU AYAM,6,2500,0,15000,12900,2100
5/28/2021 13:21,8998989500166,GUDANG GARAM MERAH BESAR 16KS,1,18000,0,18000,17000,1000
5/28/2021 14:09,8993083929905,BISKITOP WAFER,1,30000,0,30000,27000,3000
5/28/2021 14:09,8996001600641,TORA CAPPUCINO,1,3500,0,3500,2750,750
5/28/2021 14:15,8992775110157,GARUDA KACANG KULIT,1,5000,0,5000,3925,1075
5/28/2021 14:15,8994834003752,TICTIC,1,2000,0,2000,1700,300
5/28/2021 14:15,8992761002022,SPRITE PET 390ML,1,5500,0,5500,4300,1200
5/28/2021 14:15,6907992823676,JD PEACH,1,2000,0,2000,1700,300
5/28/2021 14:15,8992761139018,ADES 600ML,1,3500,0,3500,2292,1208
5/28/2021 14:58,8997231980022,O'JELLY MINI STRAWBERRY,1,3000,0,3000,2250,750
5/28/2021 14:58,8997231980015,O'JELLY MINI APPLE,1,3000,0,3000,2250,750
5/28/2021 15:38,8996001600399,LE MINERAL 1500ML,2,5000,0,10000,8084,1916
5/28/2021 15:38,8997028590014,ARGUS 220ML,2,500,0,1000,604,396
5/28/2021 16:39,VCL,VITAMIN C500 LEMON,1,1000,0,1000,575,425
5/28/2021 16:39,089686043051,INDOMIE COTO MAKASSAR,1,2800,0,2800,2525,275
5/28/2021 16:39,8991102989534,TANGO VANILA 24G,1,1000,0,1000,609,391
5/28/2021 16:49,8999999195649,SARI WANGI 25X1.86G,1,6000,0,6000,5050,950
5/28/2021 16:49,8999999059781,SUNLIGHT LIME NEW POUCH 210ML,1,5000,0,5000,4300,700
5/28/2021 16:49,089686010107,INDOMIE KALDU AYAM,5,2500,0,12500,10750,1750
5/28/2021 17:10,8998009020186,BUAVITA GUAVA 250ML,1,7000,0,7000,6083,917
5/28/2021 17:18,8992775110157,GARUDA KACANG KULIT,1,5000,0,5000,3925,1075
5/28/2021 17:18,8994834005923,SPIX 1000,1,1000,0,1000,850,150
5/28/2021 18:36,8997028590014,ARGUS 220ML,4,500,0,2000,1208,792
5/28/2021 18:36,VCO,VITAMIN C500 ORANGE,1,1000,0,1000,575,425
5/28/2021 18:45,8998866200325,MIE SEDAAP SOTO,1,2500,0,2500,1952,548
5/28/2021 18:45,8998866200578,MIE SEDAAP KARI KENTAL,1,2500,0,2500,2263,237
5/28/2021 18:45,8998866202770,MIE SEDAAP SALERO PADANG,1,2500,0,2500,2362,138
5/28/2021 18:45,001,PASEO SMART FACIAL SF 250S GT,1,10000,0,10000,9500,500
5/28/2021 18:46,8998009010590,ULTRA CHO 125,3,3000,0,9000,7284,1716
5/28/2021 18:46,8998009010569,ULTRA CHO 200,2,5000,0,10000,7660,2340
5/28/2021 18:48,VTM,VITAMIN,1,500,0,500,425,75
5/28/2021 19:07,8998009040023,TEH KOTAK,1,5000,0,5000,2827,2173
5/28/2021 19:07,089686611519,QTELA SINGKONG,1,5000,0,5000,4266,734
5/28/2021 19:07,8992775311325,GERY SNACK&SEREAL 100G,1,7000,0,7000,6012,988
5/28/2021 19:08,VCO,VITAMIN C500 ORANGE,1,1000,0,1000,575,425
5/28/2021 19:34,8999999031930,PEPSODENT TB TRIPLE CLEAN,1,3500,0,3500,2850,650
5/28/2021 19:34,6901997923072,SILET SEAGULL,1,6000,0,6000,5500,500
5/28/2021 19:34,8991111109114,JB BEDTIME 150+50G,1,10000,0,10000,9210,790
5/28/2021 19:34,YP,YUPI,2,250,0,500,416,84
5/28/2021 22:07,8997009510055,YOU C1000,1,10000,0,10000,9166,834
5/28/2021 22:24,8994867007161,ROKOK PENA GOLD 20,1,17000,0,17000,15000,2000
5/29/2021 11:42,8998989300261,GUDANG GARAM SURYA 12 FILTER,1,18500,0,18500,17200,1300
5/29/2021 11:45,8991102989428SCT,TANGO CKLT 24G SCT,1,1000,0,1000,609,391
5/29/2021 11:45,8993470671752,JOGER STICK DUO KACANG,1,1000,0,1000,850,150
5/29/2021 11:45,kp,KALPA,1,2000,0,2000,1666,334
5/29/2021 11:45,8998989500166,GUDANG GARAM MERAH BESAR 16KS,1,18000,0,18000,17000,1000
5/29/2021 11:56,8999999706111,PEPSODENT WHITE 25G,1,2000,0,2000,1450,550
5/29/2021 11:56,8999999059316,LIFEBUOY TS MILDCARE 75G,1,3000,0,3000,2640,360
5/29/2021 11:56,8998009020186,BUAVITA GUAVA 250ML,1,7000,0,7000,6083,917
5/29/2021 12:26,ARG,ARGUS 220ML,1,14500,0,14500,12500,2000
5/29/2021 12:26,8994907000428,KECAP SACHET ABC,4,500,0,2000,1416,584
5/29/2021 14:16,8998866200578,MIE SEDAAP KARI KENTAL,1,2500,0,2500,2263,237
5/29/2021 14:17,8993989311279,CLAS MILD 12,1,17000,0,17000,15700,1300
5/29/2021 14:40,8999999526863,MOLTO ALL IN ONE PINK 11ML,1,5500,0,5500,4800,700
5/29/2021 14:40,8999999042639,RINSO ANTI NODA CLS LIQ 40ML,5,1000,0,5000,4025,975
5/29/2021 14:42,8992761111533,SPRITE SLIM CAM250ML,2,5000,0,10000,7500,2500
5/29/2021 14:42,8992775001042,PILUS GARUDA MI GORENG,1,5000,0,5000,4810,190
5/29/2021 14:46,8991102987875,WFR TANGO POUCH CKL 115G,1,8000,0,8000,6786,1214
5/29/2021 14:46,8992775211410,PILUS GARUDA PEDAS,1,5000,0,5000,4886,114
5/29/2021 14:46,8998866613699,EMERON LOVELY COOLBRIGHT 100ML,1,4300,0,4300,3800,500
5/29/2021 14:46,JGR SHN,JOGER SHINY SACHET,5,500,0,2500,2185,315
5/29/2021 15:57,8999999037765,PEPSODENT WHITE 225G,2,12000,0,24000,21500,2500
5/29/2021 15:57,8999999055769,FAIR&LOVELY MVIT FC FOAM 50 G,1,12500,0,12500,11180,1320
5/29/2021 15:58,8998989110167,SURYA GUDANG GARAM 16 FILTER,1,25000,0,25000,23200,1800
5/29/2021 15:58,BMO,BERAS MERAH ORGANIK,1,25000,0,25000,23500,1500
5/29/2021 15:59,ABC,BATERAI ABC BIRU,1,8500,0,8500,7500,1000
5/29/2021 15:59,8996001600146,TEH PUCUK HARUM 350ML,2,3000,0,6000,4628,1372
5/29/2021 16:01,6907992823676,JD PEACH,1,2000,0,2000,1700,300
5/29/2021 16:01,6907992823621,JD CREAMY YOGURT,1,3000,0,3000,2600,400
5/29/2021 16:02,8999999007768,FAIR&LOVELY MULTIVITAMIN  CREAM 9 ML,2,4500,0,9000,6400,2600
5/29/2021 16:47,8998989300261,GUDANG GARAM SURYA 12 FILTER,1,18500,0,18500,17200,1300
5/29/2021 16:47,VCO,VITAMIN C500 ORANGE,2,1000,0,2000,1150,850
5/29/2021 17:52,8991102380805,FULLO  CKL PCK 8G,1,10000,0,10000,9000,1000
5/29/2021 17:52,8998866202725,MILKU COKLAT PREMIUM 200ML,1,3000,0,3000,2375,625
5/29/2021 17:52,VCO,VITAMIN C500 ORANGE,1,1000,0,1000,575,425
5/29/2021 17:52,6907992823843,JD MOCHA CRISPY,1,5000,0,5000,4400,600
5/29/2021 17:55,8997218380074,ICHITAN MILK TEA,1,8000,0,8000,6583,1417
5/29/2021 17:55,8998866201865,KRISBEE PILLOW CHOCOLAVA 120 GR,1,8000,0,8000,7250,750
5/29/2021 17:56,8999999023997,CITRA BW FRESH WHITE 220ML,1,12000,0,12000,10700,1300
5/29/2021 17:56,8998866610278,DAIA VIOLET GUSSET 565G,1,10000,0,10000,8700,1300
5/29/2021 18:00,089686611878,QTELA TEMPE,1,6000,0,6000,5370,630
5/29/2021 18:00,089686611519,QTELA SINGKONG,1,5000,0,5000,4266,734
5/29/2021 18:00,8997210107877,VORTEX SMART 3,1,10000,0,10000,9500,500
5/29/2021 18:00,8992761122331,FRESTEA APPEL 500ML,1,6500,0,6500,4708,1792
5/29/2021 18:52,8998989500166,GUDANG GARAM MERAH BESAR 16KS,1,18000,0,18000,17000,1000
5/29/2021 19:03,8994834003752,TICTIC,1,2000,0,2000,1700,300
5/29/2021 19:03,VTM,VITAMIN,2,500,0,1000,850,150
5/29/2021 19:03,YP,YUPI,4,250,0,1000,832,168
5/29/2021 19:03,ff,FULLO BLASTO,2,1000,0,2000,1990,10
5/29/2021 19:03,8992775002735,CHOCOLATOS SUSU COKELAT,1,4000,0,4000,3520,480
5/29/2021 19:04,8992775002155,CHOCOLATOS DRINK,1,4000,0,4000,3520,480
5/29/2021 19:04,ff,FULLO BLASTO,1,1000,0,1000,995,5
5/29/2021 19:16,8998989500166,GUDANG GARAM MERAH BESAR 16KS,1,18000,0,18000,17000,1000
5/29/2021 19:33,8991102303309,WFR TANGO SBJ 176G,1,10000,0,10000,8694,1306
5/29/2021 19:54,8998666003089GT,TB GILUX MIX,1,9000,0,9000,8000,1000
5/29/2021 20:05,8994834003752,TICTIC,1,2000,0,2000,1700,300
5/29/2021 20:05,8998009010590,ULTRA CHO 125,1,3000,0,3000,2428,572
5/29/2021 20:05,AMPLOP,AMPLOP,4,250,0,1000,560,440
5/29/2021 20:05,8997009510055,YOU C1000,1,10000,0,10000,9166,834
5/29/2021 20:05,8992696404441,BEAR BRAND 189ML,1,9000,0,9000,7887,1113
5/29/2021 20:05,089686021127,INTER MIE KALDU,1,1000,0,1000,813,187
5/29/2021 20:05,8991188943536,SASA SANTAN KELAPA 65ML,1,3000,0,3000,2437,563
5/29/2021 20:05,8993274532105,BOLU,1,1000,0,1000,833,167
5/29/2021 20:05,TUSTEL,TUSUK TELINGA,1,1000,0,1000,833,167
5/29/2021 20:05,8998866200882,SUKSESMIE GORENG AYAM KRMS 133GR,1,3500,0,3500,3047,453
5/29/2021 20:05,8998989300261,GUDANG GARAM SURYA 12 FILTER,1,18500,0,18500,17200,1300
5/29/2021 20:05,089686010343,INDOMIE SOTO MIE,4,2600,0,10400,9468,932
5/29/2021 20:05,8992761139018,ADES 600ML,3,3500,0,10500,6876,3624
5/29/2021 20:05,JGR,JOGER CHOCKY PASTA,1,20000,0,20000,18190,1810
5/29/2021 20:05,YP,YUPI,2,250,0,500,416,84
5/29/2021 20:05,JGR SHN,JOGER SHINY SACHET,1,500,0,500,437,63
5/29/2021 20:05,PRG,PARAGO,1,500,0,500,400,100
5/29/2021 20:05,8992984920110,CUKA DAPUR DUA BELIBIS,1,4500,0,4500,3250,1250
5/29/2021 20:07,8993989311699,CLAS MILD 16 FILTER,1,23000,0,23000,21700,1300
5/29/2021 20:07,9556001025272,NESCAFE LATTE 240ML,1,8500,0,8500,7834,666
5/29/2021 20:07,8992696404441,BEAR BRAND 189ML,1,9000,0,9000,7887,1113
5/29/2021 20:07,HT,HOT-HOT,1,500,0,500,350,150
5/29/2021 20:07,8998989300261,GUDANG GARAM SURYA 12 FILTER,1,18500,0,18500,17200,1300
5/29/2021 20:07,8992761139018,ADES 600ML,1,3500,0,3500,2292,1208
5/29/2021 20:07,8886013257400,TWISTKO,1,1000,0,1000,900,100
5/29/2021 20:07,8992957220186,COKLAT RUSA,2,2000,0,4000,3400,600
5/29/2021 20:07,VTM,VITAMIN,1,500,0,500,425,75
5/29/2021 20:07,8993989311279,CLAS MILD 12,1,17000,0,17000,15700,1300
5/29/2021 20:07,8994935000285,MINYAK GORENG DUNIA 4500ML,1,70000,0,70000,66433,3567
5/29/2021 20:08,8886013257400,TWISTKO,5,1000,0,5000,4500,500
5/29/2021 20:08,8992696422735,DNCO CKLT UHT 110ML,3,2500,0,7500,6123,1377
5/29/2021 20:09,HT,HOT-HOT,1,500,0,500,350,150
5/29/2021 20:11,BTS,BIMURA TARO SEAWEED 250G,1,10000,0,10000,9300,700
5/29/2021 20:11,8997231980022,O'JELLY MINI STRAWBERRY,1,3000,0,3000,2250,750
5/29/2021 20:11,8992696523081,MILO UHT 110ML,1,2500,0,2500,1962,538
5/29/2021 20:11,8998898830125,KKB ENER-G ANGGUR,1,5500,0,5500,4824,676
5/29/2021 20:34,8992696430860,KOKO KRUNCH 80G,1,9000,0,9000,8063,937
5/29/2021 20:34,8992696523081,MILO UHT 110ML,1,2500,0,2500,1962,538
5/29/2021 20:39,8999909010567,234 16 FILTER,1,22000,0,22000,21500,500
5/29/2021 20:39,8998989121163,SURYA PRO MERAH,1,20000,0,20000,18600,1400
5/29/2021 20:39,8998898101409,TOLAK ANGIN SIDOMUNCUL,5,3500,0,17500,13540,3960
5/29/2021 21:20,8997211230147,KERUPUK BAWANG VITARASA,1,10000,0,10000,8580,1420
5/29/2021 21:50,8997027300089,NOMOS,1,4000,0,4000,2963,1037
5/29/2021 21:50,8996001600399,LE MINERAL 1500ML,1,5000,0,5000,4042,958
5/30/2021 13:04,8996001600665,COOL TIME,1,3500,0,3500,2750,750
5/30/2021 13:04,HT,HOT-HOT,1,500,0,500,350,150
5/30/2021 13:15,8994907000428,KECAP SACHET ABC,2,500,0,1000,708,292
5/30/2021 13:41,BTS,BIMURA TARO SEAWEED 250G,1,10000,0,10000,9300,700
5/30/2021 14:47,BTS,BIMURA TARO SEAWEED 250G,1,10000,0,10000,9300,700
5/30/2021 15:03,8992959304235,SFX COMFORT SLIM 29CM 8S,1,8000,0,8000,7387,613
5/30/2021 15:03,8992696404441,BEAR BRAND 189ML,2,9000,0,18000,15774,2226
5/30/2021 15:03,001,PASEO SMART FACIAL SF 250S GT,1,10000,0,10000,9500,500
5/30/2021 15:57,GL,GULA 1 LITER,1,11500,0,11500,10500,1000
5/30/2021 15:57,VTM,VITAMIN,1,500,0,500,425,75
5/30/2021 16:24,089686010190,INDOMIE KARI AYAM,2,2800,0,5600,5044,556
5/30/2021 17:04,8994867000179,ROKOK PENA MILD 16,2,14500,0,29000,26000,3000
5/30/2021 17:19,8992696404441,BEAR BRAND 189ML,1,9000,0,9000,7887,1113
5/30/2021 17:19,6907992823669,JD MILKY STRAW,3,3000,0,9000,7800,1200
5/30/2021 17:19,6907992824963,JD MILKY CHOCOLATE,2,3000,0,6000,5200,800
5/30/2021 17:19,8998866202695,KOPI MAYOR,1,6000,0,6000,4500,1500
5/30/2021 17:19,8992222050418,GATSBY NORMAL 38GR,1,5000,0,5000,3850,1150
5/30/2021 17:19,8998866106474,POSH BLAZE PINK 150ML,1,19500,0,19500,17500,2000
5/30/2021 17:19,8991111101507,JB POWDER BLOSSOM 50G,1,3500,0,3500,3000,500
5/30/2021 17:19,8996001302316,MALKIST ABON SCT,1,1000,0,1000,840,160
5/30/2021 17:19,HT,HOT-HOT,2,500,0,1000,700,300
5/30/2021 17:19,PRG,PARAGO,1,500,0,500,400,100
5/30/2021 17:19,8999909982000,SAMPOERNA 12 FILTER,1,18000,0,18000,16000,2000
5/30/2021 17:19,8999999008475,SUNLIGHT LIME NEW REF 1600ML,1,33000,0,33000,29800,3200
5/30/2021 17:19,8992959953327,SWEETY BRONZE L52,1,85000,0,85000,80304,4696
5/30/2021 17:19,8998866501033,MINYAK GORENG SEDAAP POUCH 2L,1,28000,0,28000,27746,254
5/30/2021 17:19,8999999524722,SUNLIGHT LIME NEW PCH 435ML,1,10000,0,10000,9100,900
5/30/2021 17:19,711844150027,ABC NANAS,1,13000,0,13000,12241,759
5/30/2021 17:19,8993470671752,JOGER STICK DUO KACANG,1,1000,0,1000,850,150
5/30/2021 17:19,8998866202732,MILKU STROBERI 200ML,2,3000,0,6000,4750,1250
5/30/2021 17:19,GL,GULA 1 LITER,1,11500,0,11500,10500,1000
5/30/2021 17:19,8998989500166,GUDANG GARAM MERAH BESAR 16KS,1,18000,0,18000,17000,1000
5/30/2021 17:39,089686611519,QTELA SINGKONG,1,5000,0,5000,4266,734
5/30/2021 17:47,8997028590014,ARGUS 220ML,2,500,0,1000,604,396
5/30/2021 18:15,GL,GULA 1 LITER,10,11500,0,115000,105000,10000
5/30/2021 18:15,8992959508855,SWEETY SILVER PANTS XL 18,1,47800,0,47800,43353,4447
5/30/2021 18:15,8850507002968,A1 KING TRUCK,1,16500,0,16500,15500,1000
5/30/2021 20:39,8999999195649,SARI WANGI 25X1.86G,1,6000,0,6000,5050,950
5/30/2021 20:39,VCO,VITAMIN C500 ORANGE,1,1000,0,1000,575,425
5/30/2021 21:38,8998866202770,MIE SEDAAP SALERO PADANG,1,2500,0,2500,2362,138
5/30/2021 21:38,8998866200301,MIE SEDAAP GORENG,1,2500,0,2500,2023,477
5/30/2021 21:38,8998866200325,MIE SEDAAP SOTO,2,2500,0,5000,3904,1096
5/30/2021 21:39,8999999049423,REXONA MEN RO SPORT DEFENSE 45 ML,1,15000,0,15000,13550,1450
5/30/2021 21:39,8999999706449,CLOSEUP ICY WHITE 65G,1,9000,0,9000,7865,1135
5/30/2021 21:39,8999999048167,SUNSILK SHP BLACK SHINE 9ML,1,10500,0,10500,9300,1200
5/30/2021 21:39,8996001600221,KOPIKO 78,1,5000,0,5000,4283,717
5/30/2021 21:40,JGR SHN,JOGER SHINY SACHET,1,500,0,500,437,63
5/30/2021 21:58,8992628022156,BIMOLI KLASIK TOUCH 1 LT,1,15500,0,15500,14350,1150
5/30/2021 21:59,ARD,SENDAL ARDILES,1,15000,0,15000,13500,1500
5/31/2021 12:29,ARG,ARGUS 220ML,3,14500,0,43500,37500,6000
5/31/2021 12:30,ARG,ARGUS 220ML,1,14500,0,14500,12500,2000
5/31/2021 12:38,8998989300261,GUDANG GARAM SURYA 12 FILTER,1,18500,0,18500,17200,1300
5/31/2021 12:38,VCO,VITAMIN C500 ORANGE,2,1000,0,2000,1150,850
5/31/2021 12:51,HT,HOT-HOT,2,500,0,1000,700,300
5/31/2021 12:51,8999909002821,MARLBORO BLACK 16,1,22000,0,22000,20850,1150
5/31/2021 13:05,8991002307209,COFFE CANDY,2,5000,0,10000,9000,1000
5/31/2021 13:33,8992959508930,SWEETY SILVER PANTS L 54,1,108000,0,108000,99697,8303
5/31/2021 15:13,8998866200325,MIE SEDAAP SOTO,5,2500,0,12500,9760,2740
5/31/2021 15:13,8998866202619,MIE SEDAAP KOREAN SPICY SOUP,5,2500,0,12500,11365,1135
5/31/2021 15:13,089686041705,INDOMIE GORENG JUMBO,4,3500,0,14000,12572,1428
5/31/2021 15:13,8991102994422,TANGO WALUT CHOCOBNN 18G,1,9000,0,9000,8661,339
5/31/2021 15:13,8996001355008,BENG-BENG SP20G,1,29000,0,29000,26500,2500
5/31/2021 15:13,8991102387286GT,TANGO LONG CKLT 47G,1,17000,0,17000,15517,1483
5/31/2021 15:13,8999999195649,SARI WANGI 25X1.86G,2,6000,0,12000,10100,1900
5/31/2021 15:13,8995333060772,TERIGU GATOT KACA 500GR,2,4500,0,9000,8130,870
5/31/2021 15:43,8998989300261,GUDANG GARAM SURYA 12 FILTER,1,18500,0,18500,17200,1300
5/31/2021 16:11,8998866601535,BLEACHING SOKLIN PEMUTIH 500ML,1,7000,0,7000,4880,2120
5/31/2021 16:38,GL,GULA 1 LITER,1,11500,0,11500,10500,1000
5/31/2021 16:38,VCO,VITAMIN C500 ORANGE,2,1000,0,2000,1150,850
5/31/2021 17:08,8992696521797SCT,MILO UHT ACT GO 22G,1,2000,0,2000,1412,588
5/31/2021 17:09,8996001305041,ROMA SANDWICH CKLT,1,7000,0,7000,5000,2000
5/31/2021 17:09,8992957220087,COKLAT SINGA,1,2000,0,2000,1700,300
5/31/2021 17:09,JGR SHN,JOGER SHINY SACHET,1,500,0,500,437,63
5/31/2021 17:09,YP,YUPI,1,250,0,250,208,42
5/31/2021 17:09,YP,YUPI,1,250,0,250,208,42
5/31/2021 17:18,8998866501033,MINYAK GORENG SEDAAP POUCH 2L,1,28000,0,28000,27746,254
5/31/2021 17:45,8992770034151,MASAKO 250GR,1,10000,0,10000,8000,2000
5/31/2021 17:49,9556001025272,NESCAFE LATTE 240ML,1,8500,0,8500,7834,666
5/31/2021 17:49,8997231980022,O'JELLY MINI STRAWBERRY,1,3000,0,3000,2250,750
5/31/2021 17:49,8991001503114,CHACHA MILK CHOCOLATE 35G,1,5500,0,5500,4900,600
5/31/2021 17:49,ff,FULLO BLASTO,1,1000,0,1000,995,5
5/31/2021 18:18,8998866202930,SEDAAP AYAM JERIT CUP,1,4500,0,4500,3738,762
5/31/2021 18:18,HT,HOT-HOT,1,500,0,500,350,150
5/31/2021 18:29,VTM,VITAMIN,2,500,0,1000,850,150
5/31/2021 18:30,8999999195656,SARI WANGI 50X1.85,1,10000,0,10000,9500,500
5/31/2021 18:38,8998866202930,SEDAAP AYAM JERIT CUP,1,4500,0,4500,3738,762
5/31/2021 18:38,8998866202671,NOODLE SEDAAP MIE KOREAN SPICY SOUP CUP,1,5000,0,5000,4002,998
5/31/2021 18:38,HT,HOT-HOT,1,500,0,500,350,150
5/31/2021 18:51,6907992823669,JD MILKY STRAW,1,3000,0,3000,2600,400
5/31/2021 18:51,6907992824963,JD MILKY CHOCOLATE,2,3000,0,6000,5200,800
5/31/2021 19:00,6907992824963,JD MILKY CHOCOLATE,1,3000,0,3000,2600,400
5/31/2021 19:00,VTM,VITAMIN,2,500,0,1000,850,150
5/31/2021 19:13,089686049053,SARIMI PUAS,1,3000,0,3000,2400,600
5/31/2021 19:25,8991102022347,SIKAT GIGI FORMULA RIPPLE,1,5000,0,5000,4583,417
5/31/2021 19:25,8999999534097,PEPSODENT PGB FCM 75G,1,5000,0,5000,3850,1150
5/31/2021 19:25,BB,PASEO SMARTY FACIAL TRAVEL PACK 50S GT,1,3000,0,3000,1980,1020
5/31/2021 19:25,8999999558086,RINSO MOLTO FERFUME ESSENSE PWD 44G,5,1000,0,5000,4025,975
5/31/2021 19:25,8993324850449,BABY LOVE COTTON BUDS,1,5000,0,5000,4500,500
5/31/2021 19:25,8996001350423,ZUPER KEJU,1,9200,0,9200,8360,840
5/31/2021 19:27,8997021870090,FRESH CARE LAVENDER 10ML,1,12000,0,12000,10000,2000
5/31/2021 19:28,8996001600146,TEH PUCUK HARUM 350ML,1,3000,0,3000,2314,686
5/31/2021 19:28,8992761145019,COCA COLA PET 250ML,1,3500,0,3500,2417,1083
5/31/2021 19:30,8992761145019,COCA COLA PET 250ML,1,3500,0,3500,2417,1083
5/31/2021 19:48,8998866610438,SOKLIN SOFTERGENT RED BAG 770G & PIRING,1,18000,0,18000,16680,1320
5/31/2021 19:58,6291100212866,KURMA KHALAS,1,85000,0,85000,80000,5000
5/31/2021 20:25,8992959509005,SWEETY SILVER PANTS XL26,1,61500,0,61500,55910,5590
5/31/2021 20:25,HT,HOT-HOT,1,500,0,500,350,150
5/31/2021 21:03,8992696422735,DNCO CKLT UHT 110ML,1,2500,0,2500,2041,459
5/31/2021 21:03,089686010190,INDOMIE KARI AYAM,1,2800,0,2800,2522,278
5/31/2021 21:03,8991102989428SCT,TANGO CKLT 24G SCT,1,1000,0,1000,609,391
5/31/2021 21:03,8992957220087,COKLAT SINGA,1,2000,0,2000,1700,300
5/31/2021 21:03,HT,HOT-HOT,2,500,0,1000,700,300
5/31/2021 21:03,bb,BENG-BENG,1,1500,0,1500,1450,50
5/31/2021 21:12,8997025914059,HATARI SEE HONG,1,6000,0,6000,4911,1089
5/31/2021 21:13,089686611878,QTELA TEMPE,1,6000,0,6000,5370,630
5/31/2021 21:13,8996001600221,KOPIKO 78,1,5000,0,5000,4283,717
5/31/2021 21:13,PRG,PARAGO,2,500,0,1000,800,200
5/31/2021 21:45,8998989300261,GUDANG GARAM SURYA 12 FILTER,1,18500,0,18500,17200,1300
5/31/2021 22:10,8999909096004,SAMPOERNA 16 FILTER,1,24000,0,24000,23000,1000
5/31/2021 22:10,8998989300261,GUDANG GARAM SURYA 12 FILTER,1,18500,0,18500,17200,1300
5/31/2021 22:11,8999999552800,LUX YUZU BLOSSOM 75G,1,3500,0,3500,2800,700
5/31/2021 22:11,8998866608718,DAIA SOFTENER PINK,1,5000,0,5000,4450,550
5/31/2021 22:11,8998866202770,MIE SEDAAP SALERO PADANG,1,2500,0,2500,2362,138
5/31/2021 22:12,8993072153595,LARISST COTTON 35G,1,5000,0,5000,3300,1700
5/31/2021 22:22,8991111109107,JB POWDER BEDTIME 75+25g,1,6000,0,6000,5440,560
5/31/2021 22:34,8998866201865,KRISBEE PILLOW CHOCOLAVA 120 GR,1,8000,0,8000,7250,750
5/31/2021 22:34,8996001600146,TEH PUCUK HARUM 350ML,2,3000,0,6000,4628,1372
5/31/2021 22:34,VCL,VITAMIN C500 LEMON,1,1000,0,1000,575,425
6/1/2021 11:46,VCO,VITAMIN C500 ORANGE,1,1000,0,1000,575,425
6/1/2021 12:49,8998989110167,SURYA GUDANG GARAM 16 FILTER,1,25000,0,25000,23200,1800
6/1/2021 12:49,8992753100101,BKM FULL CREAM GOLD 370,1,15000,0,15000,14000,1000
6/1/2021 13:48,8999999524722,SUNLIGHT LIME NEW PCH 435ML,1,10000,0,10000,9100,900
6/1/2021 14:36,8991102213189,BLASTER UNGU,1,5000,0,5000,3106,1894
6/1/2021 16:13,8994834006128,TICTIC PEDAS,1,2000,0,2000,1700,300
6/1/2021 16:13,8997231980015,O'JELLY MINI APPLE,1,3000,0,3000,2250,750
6/1/2021 16:13,PRG,PARAGO,1,500,0,500,400,100
6/1/2021 16:13,JGR SHN,JOGER SHINY SACHET,1,500,0,500,437,63
6/1/2021 16:14,8992957220087,COKLAT SINGA,2,2000,0,4000,3400,600
6/1/2021 16:14,8992761166212,FRESTEA APPLE 350ML,1,4500,0,4500,3000,1500
6/1/2021 16:14,JGR SHN,JOGER SHINY SACHET,1,500,0,500,437,63
6/1/2021 16:14,8886013257400,TWISTKO,1,1000,0,1000,900,100
6/1/2021 16:45,8991004011906,KOPI BORONG,1,10000,0,10000,8333,1667
6/1/2021 18:18,8998866202619,MIE SEDAAP KOREAN SPICY SOUP,2,2500,0,5000,4546,454
6/1/2021 18:31,8992775315057,GERY SALUT MALKIST COKLAT,1,6500,0,6500,5516,984
6/1/2021 18:31,8992959304235,SFX COMFORT SLIM 29CM 8S,1,8000,0,8000,7387,613
6/1/2021 18:36,8993007000680,INDOMILK 1L,1,16500,0,16500,14792,1708
6/1/2021 18:36,8992761166205,FRESTEA GREEN HONEY 350ML,1,4500,0,4500,3000,1500
6/1/2021 19:46,VCO,VITAMIN C500 ORANGE,2,1000,0,2000,1150,850
6/1/2021 19:48,8992761164546,NUTRIBOOST STRAWBERRY 300ML,1,6500,0,6500,5300,1200
6/1/2021 19:49,089686021127,INTER MIE KALDU,2,1000,0,2000,1626,374
6/1/2021 20:06,8999909010567,234 16 FILTER,1,22000,0,22000,21500,500
6/1/2021 20:07,8991001780065,TWISTER BLACK 140G,1,13000,0,13000,11700,1300
6/1/2021 20:47,ARG,ARGUS 220ML,6,14500,0,87000,75000,12000
6/1/2021 21:03,8997009510055,YOU C1000,1,10000,0,10000,9166,834
6/1/2021 21:03,8992696404441,BEAR BRAND 189ML,1,9000,0,9000,7887,1113
6/1/2021 21:05,8992959953082,SWEETY BRONZE L8,1,17000,0,17000,15380,1620
6/1/2021 21:06,8997025915124,HATARI PEANUT 125G,1,7000,0,7000,6037,963
6/1/2021 21:14,GL,GULA 1 LITER,1,11500,0,11500,10500,1000
6/1/2021 21:34,8993176110081,MINYAK KAYU PUTIH 30ML,1,12000,0,12000,9091,2909
6/1/2021 21:34,8999908042408,MY BABY POWDER BIRU,1,5000,0,5000,3275,1725
6/1/2021 21:51,8996001600375,LE MINERAL 330ML,1,2000,0,2000,1417,583
6/1/2021 21:51,8996001318980,BETTER 120G,1,6000,0,6000,5100,900
6/1/2021 21:57,089686060027,POP MIE AYAM JUMBO,1,4500,0,4500,3833,667
6/1/2021 21:57,8997231980022,O'JELLY MINI STRAWBERRY,2,3000,0,6000,4500,1500
6/1/2021 22:05,8998989300261,GUDANG GARAM SURYA 12 FILTER,1,18500,0,18500,17200,1300
6/1/2021 22:05,089686010107,INDOMIE KALDU AYAM,1,2500,0,2500,2150,350
6/1/2021 22:05,089686010343,INDOMIE SOTO MIE,1,2600,0,2600,2367,233
6/1/2021 22:05,089686011036,INDOMIE GORENG PEDAS,1,2700,0,2700,2452,248
6/1/2021 22:25,8997025914059,HATARI SEE HONG,1,6000,0,6000,4911,1089
6/1/2021 22:25,8998866202244,EKOMIE BUMBU KALDU AYAM,1,1000,0,1000,798,202
6/1/2021 22:25,8997027300089,NOMOS,1,4000,0,4000,2963,1037
6/1/2021 22:25,8998866105507,EMERON LOVELY NOURIST&BRIGHT 100ML,1,4300,0,4300,3800,500
6/1/2021 22:25,8997009510055,YOU C1000,1,10000,0,10000,9166,834
6/1/2021 22:25,8992696404441,BEAR BRAND 189ML,1,9000,0,9000,7887,1113
6/1/2021 22:25,8998866202770,MIE SEDAAP SALERO PADANG,2,2500,0,5000,4724,276
6/1/2021 22:25,8998866501033,MINYAK GORENG SEDAAP POUCH 2L,3,29000,0,87000,83238,3762
6/1/2021 22:25,8995333060703,TERIGU KOMPAS 1KG,1,10500,0,10500,9816,684
6/1/2021 22:25,8998989300261,GUDANG GARAM SURYA 12 FILTER,1,18500,0,18500,17200,1300
6/1/2021 22:25,8997231980015,O'JELLY MINI APPLE,1,3000,0,3000,2250,750
6/1/2021 22:25,8993007003063,ENAAK 500G,1,11000,0,11000,9625,1375
6/2/2021 10:54,8991102714495,TANGO DRINK COKLAT,1,5000,0,5000,3818,1182
6/2/2021 10:54,8992775211434,PILUS GARUDA SAPI PANGGANG,1,5000,0,5000,4810,190
6/2/2021 11:03,8992761139018,ADES 600ML,1,3500,0,3500,2292,1208
6/2/2021 11:17,8999909010567,234 16 FILTER,1,22000,0,22000,21500,500
6/2/2021 11:17,8996001302316,MALKIST ABON SCT,1,1000,0,1000,840,160
6/2/2021 11:32,8998866607315,SOKLIN SOFTERGENT SAKURA 770G & PIRING,1,18000,0,18000,16680,1320
6/2/2021 11:34,711844150027,ABC NANAS,1,13000,0,13000,12241,759
6/2/2021 11:39,8996001302323,MALKIST ABON,1,6500,0,6500,4800,1700
6/2/2021 11:39,8997028590014,ARGUS 220ML,2,500,0,1000,604,396
6/2/2021 12:06,8992761122331,FRESTEA APPEL 500ML,1,6500,0,6500,4708,1792
6/2/2021 12:06,8992761166038,MMP ORANGE 300ML,1,5000,0,5000,3750,1250
6/2/2021 12:06,8994834006128,TICTIC PEDAS,5,2000,0,10000,8500,1500
6/2/2021 12:06,8994834003752,TICTIC,2,2000,0,4000,3400,600
6/2/2021 12:10,8992761139018,ADES 600ML,2,3500,0,7000,4584,2416
6/2/2021 12:10,8992761166212,FRESTEA APPLE 350ML,1,4500,0,4500,3000,1500
6/2/2021 12:10,PRG,PARAGO,7,500,0,3500,2800,700
6/2/2021 12:12,8997028590014,ARGUS 220ML,4,500,0,2000,1208,792
6/2/2021 12:33,8994867000162,ROKOK PUNDIMAS KRETEK16,1,10000,0,10000,8600,1400
6/2/2021 13:53,8998866501033,MINYAK GORENG SEDAAP POUCH 2L,2,29000,0,58000,55492,2508
6/2/2021 14:36,VCO,VITAMIN C500 ORANGE,1,1000,0,1000,575,425
6/2/2021 15:07,8992761111519,COCA COLA SLIM CAM 250ML,1,5000,0,5000,3750,1250
6/2/2021 15:08,8999909010567,234 16 FILTER,1,22000,0,22000,21500,500
6/2/2021 15:08,6907992823973,JD PINEAPPLE,1,5000,0,5000,4300,700
6/2/2021 15:08,HT,HOT-HOT,2,500,0,1000,700,300
6/2/2021 15:29,8998866608756,SOKLIN SOFTENER TWILIGHT BLUE 14SCH,1,5000,0,5000,4560,440
6/2/2021 15:29,8999999042646,RINSO MOLTO ROSE FRESH LIQ 40ML,1,6000,0,6000,4817,1183
6/2/2021 15:29,HT,HOT-HOT,2,500,0,1000,700,300
6/2/2021 15:34,6907992823966,JD BLUEBERRY,1,3500,0,3500,3000,500
6/2/2021 15:34,VCO,VITAMIN C500 ORANGE,2,1000,0,2000,1150,850
6/2/2021 15:45,8998866202053,POTABEE AYAM BAKAR PEDAS 68GR,1,8000,0,8000,7200,800
6/2/2021 15:45,089686611519,QTELA SINGKONG,1,5000,0,5000,4266,734
6/2/2021 15:45,089686834055,FREISS JERUK,1,11000,0,11000,8750,2250
6/2/2021 15:45,8997009510116,LEMON WATER,1,7000,0,7000,5694,1306
6/2/2021 15:45,bb,BENG-BENG,2,1500,0,3000,2900,100
6/2/2021 15:45,ARG,ARGUS 220ML,1,14500,0,14500,12500,2000
6/2/2021 15:45,JGR SHN,JOGER SHINY SACHET,3,500,0,1500,1311,189
6/2/2021 16:28,8998866108317,EMERON HJB ANTDNDF 10ML,1,5000,0,5000,4185,815
6/2/2021 16:41,8998866202732,MILKU STROBERI 200ML,1,3000,0,3000,2375,625
6/2/2021 16:41,8991102387286SCT,TANGO LONG CKLT 47G,1,2000,0,2000,1551,449
6/2/2021 16:46,8995333060772,TERIGU GATOT KACA 500GR,1,4500,0,4500,4065,435
6/2/2021 16:46,HT,HOT-HOT,1,500,0,500,350,150
6/2/2021 17:23,VCO,VITAMIN C500 ORANGE,1,1000,0,1000,575,425
6/2/2021 17:23,8994867007161,ROKOK PENA GOLD 20,1,17000,0,17000,15000,2000
6/2/2021 17:32,8993989311279,CLAS MILD 12,1,17000,0,17000,15700,1300
6/2/2021 17:51,8998989300261,GUDANG GARAM SURYA 12 FILTER,2,18500,0,37000,34400,2600
6/2/2021 17:53,089686021127,INTER MIE KALDU,2,1000,0,2000,1626,374
6/2/2021 17:53,RB,RED BOLD,1,19000,0,19000,17900,1100
6/2/2021 17:53,8997009510055,YOU C1000,1,10000,0,10000,9166,834
6/2/2021 17:53,8993470671752,JOGER STICK DUO KACANG,1,1000,0,1000,850,150
6/2/2021 17:53,8996001305041,ROMA SANDWICH CKLT,1,7000,0,7000,5000,2000
6/2/2021 17:53,8998866200882,SUKSESMIE GORENG AYAM KRMS 133GR,1,3500,0,3500,3047,453
6/2/2021 17:53,8998866202732,MILKU STROBERI 200ML,1,3000,0,3000,2375,625
6/2/2021 17:53,VCO,VITAMIN C500 ORANGE,1,1000,0,1000,575,425
6/2/2021 17:55,8998009020186,BUAVITA GUAVA 250ML,1,7000,0,7000,6083,917
6/2/2021 17:55,6907992823850,JD CHOCO CIRLE,1,5500,0,5500,4700,800
6/2/2021 17:55,8991102987875,WFR TANGO POUCH CKL 115G,1,8000,0,8000,6786,1214
6/2/2021 17:55,8992761139018,ADES 600ML,1,3500,0,3500,2292,1208
6/2/2021 17:55,8998866202930,SEDAAP AYAM JERIT CUP,1,4500,0,4500,3738,762
6/2/2021 17:55,YP,YUPI,6,250,0,1500,1248,252
6/2/2021 18:29,089686043617,INDOMIE MIEGHETTI,2,2700,0,5400,4904,496
6/2/2021 18:29,8997013790108,BIMURA KACANG TELUR 25G,1,1000,0,1000,875,125
6/2/2021 18:29,8991102989428SCT,TANGO CKLT 24G SCT,1,1000,0,1000,609,391
6/2/2021 18:29,8994834005923,SPIX 1000,1,1000,0,1000,850,150
6/2/2021 18:29,JGR SHN,JOGER SHINY SACHET,1,500,0,500,437,63
6/2/2021 18:29,8998866202930,SEDAAP AYAM JERIT CUP,1,4500,0,4500,3738,762
6/2/2021 18:59,8998866202930,SEDAAP AYAM JERIT CUP,2,4500,0,9000,7476,1524
6/2/2021 19:31,7118441101378,KECAP ABC 520 ML,1,19000,0,19000,17800,1200
6/2/2021 19:39,YP,YUPI,12,250,0,3000,2496,504
6/2/2021 20:27,BRS5,BERAS BUMN 5KG,2,64000,0,128000,101000,27000
6/2/2021 20:27,BMO,BERAS MERAH ORGANIK,2,25000,0,50000,47000,3000
6/2/2021 20:28,8997021870595,HOT IN CREAM AROMA THERAPY 60G,1,12500,0,12500,11360,1140
6/2/2021 20:29,8992696405424,DNCO INST FORTIGO 200G,1,21000,0,21000,19297,1703
6/2/2021 20:29,8996001600375,LE MINERAL 330ML,1,2000,0,2000,1417,583
6/2/2021 20:29,8996001600399,LE MINERAL 1500ML,2,5000,0,10000,8084,1916
6/2/2021 20:49,6907992823874,JD CRUNCHY CHOCO BLUEBERRY,1,5500,0,5500,4700,800
6/2/2021 21:02,8994834005923,SPIX 1000,2,1000,0,2000,1700,300
6/2/2021 21:02,089686041705,INDOMIE GORENG JUMBO,1,3500,0,3500,3143,357
6/2/2021 21:02,YP,YUPI,2,250,0,500,416,84
6/2/2021 22:28,8991002304413,RELAXA GRAPE MINT,1,5000,0,5000,4500,500
6/2/2021 22:28,001,PASEO SMART FACIAL SF 250S GT,1,10000,0,10000,9500,500
6/2/2021 22:28,VCO,VITAMIN C500 ORANGE,1,1000,0,1000,575,425
6/9/2021 9:49,8999999516208,ROYCO FDS CHICKEN NEW 230G,1,10000,0,10000,9000,1000
6/9/2021 10:29,8999999540159,VASELINE REPAIRING JELLY ALOE 50ML,1,23000,0,23000,21333,1667
6/9/2021 10:41,ARG,ARGUS 220ML,3,14500,0,43500,37500,6000
6/9/2021 12:56,8999909002821,MARLBORO BLACK 16,1,22000,0,22000,20850,1150
6/9/2021 14:32,8999999049492,REXONA WMN RO POWDER DRY 45 ML,1,15000,0,15000,13500,1500
6/9/2021 14:32,8992959509005,SWEETY SILVER PANTS XL26,1,61500,0,61500,55910,5590
6/9/2021 14:32,HT,HOT-HOT,1,500,0,500,350,150
6/9/2021 14:34,8996001600269,LE MINERAL 600ML,1,3000,0,3000,1688,1312
6/9/2021 14:34,8991102213189,BLASTER UNGU,1,5000,0,5000,3106,1894
6/9/2021 15:09,8992775001691,GARUDA ROSTA WAGYU BEEF,1,8000,0,8000,7322,678
6/9/2021 15:09,8991102994422,TANGO WALUT CHOCOBNN 18G,1,9000,0,9000,8661,339
6/9/2021 15:09,8992761136161,COCACOLA 1L,1,10000,0,10000,9000,1000
6/9/2021 15:09,8993470279651,JOGER CHOCKY BAR,1,1000,0,1000,867,133
6/9/2021 15:56,6907992825076,JD WATERMELON APPLE,1,2000,0,2000,1700,300
6/9/2021 16:13,8992959850046,CONFI PANTS M10,1,80000,0,80000,75120,4880
6/9/2021 16:13,8992761002022,SPRITE PET 390ML,1,5500,0,5500,4300,1200
6/9/2021 16:13,089686611519,QTELA SINGKONG,1,5000,0,5000,4266,734
6/9/2021 16:38,8995333060703,TERIGU KOMPAS 1KG,1,10500,0,10500,9816,684
6/9/2021 16:39,8999999007768,FAIR&LOVELY MULTIVITAMIN  CREAM 9 ML,2,4500,0,9000,6400,2600
6/9/2021 17:26,8998866202930,SEDAAP AYAM JERIT CUP,1,4500,0,4500,3738,762
6/9/2021 17:27,ARG,ARGUS 220ML,1,14500,0,14500,12500,2000
6/9/2021 17:28,HT,HOT-HOT,1,500,0,500,350,150
6/9/2021 17:39,8998866201711,KRISBEE KRUNCHY JAGUNG BAKAR MENTEGA 75 GR,1,5500,0,5500,4400,1100
6/9/2021 17:39,8993470672827,SAKU-SAKU SAPI PANGGANG,1,2000,0,2000,1530,470
6/9/2021 17:39,8996001305003,SARI GANDUM SANDWICH,1,6000,0,6000,5100,900
6/9/2021 17:39,8993470672858,SAKU-SAKU RASA BALADO,1,2000,0,2000,1530,470
6/9/2021 17:39,8998866202343,MIE SEDAAP KOREAN SPICY,2,2500,0,5000,4046,954
6/9/2021 17:39,HT,HOT-HOT,1,500,0,500,350,150
6/9/2021 18:16,8999999529703,CLEAR MEN COOL SPORT MTHL 80ML,1,11000,0,11000,10000,1000
6/9/2021 18:50,8998989500166,GUDANG GARAM MERAH BESAR 16KS,2,18000,0,36000,34000,2000
6/9/2021 18:59,089686021219,INTER MIE GORENG,3,1000,0,3000,2655,345
6/9/2021 19:37,8998866610278,DAIA VIOLET GUSSET 565G,1,10000,0,10000,8700,1300
6/9/2021 19:59,8992761164546,NUTRIBOOST STRAWBERRY 300ML,1,6500,0,6500,5300,1200
6/9/2021 19:59,8998666001306GT,TB CREAMY LATTE,1,13000,0,13000,9900,3100
6/9/2021 19:59,HT,HOT-HOT,1,500,0,500,350,150
6/9/2021 20:01,8993007003063,ENAAK 500G,1,11000,0,11000,9625,1375
6/9/2021 20:01,8850507000094,POLICE BONCHA,2,2000,0,4000,1600,2400
6/9/2021 20:01,KJ,KINDER JOY,2,2000,0,4000,3166,834
6/9/2021 20:04,089686021127,INTER MIE KALDU,2,1000,0,2000,1626,374
6/9/2021 20:04,RB,RED BOLD,1,19000,0,19000,17900,1100
6/9/2021 20:04,8997009510055,YOU C1000,1,10000,0,10000,9166,834
6/9/2021 20:04,8993470671752,JOGER STICK DUO KACANG,1,1000,0,1000,850,150
6/9/2021 20:04,8998989300261,GUDANG GARAM SURYA 12 FILTER,1,18500,0,18500,17200,1300
6/9/2021 20:04,8996001305041,ROMA SANDWICH CKLT,1,7000,0,7000,5000,2000
6/9/2021 20:04,VCO,VITAMIN C500 ORANGE,1,1000,0,1000,575,425
6/9/2021 20:04,8998866200882,SUKSESMIE GORENG AYAM KRMS 133GR,1,3500,0,3500,3047,453
6/9/2021 20:04,8998866202732,MILKU STROBERI 200ML,1,3000,0,3000,2375,625
6/9/2021 20:04,GL,GULA 1 LITER,3,11500,0,34500,31500,3000
6/9/2021 20:04,8996001302323,MALKIST ABON,1,6500,0,6500,4800,1700
6/9/2021 20:04,8998866201964,MINYAK GORENG SABRINA 2L POUCH,1,27500,0,27500,26753,747
6/9/2021 20:04,8996001312278,MALKIST KEJU MANIS,2,6500,0,13000,10800,2200
6/9/2021 20:04,8999999059781,SUNLIGHT LIME NEW POUCH 210ML,1,5000,0,5000,4300,700
6/9/2021 20:04,089686021219,INTER MIE GORENG,2,1000,0,2000,1770,230
6/9/2021 20:09,8991102300421,WFR TANGO COKLAT 176GR,1,10000,0,10000,8694,1306
6/9/2021 20:09,8999909096004,SAMPOERNA 16 FILTER,1,24000,0,24000,23000,1000
6/9/2021 20:09,8996001600221,KOPIKO 78,1,5000,0,5000,4283,717
6/9/2021 20:40,089686043204,INDOMIE MIE ACEH,1,2700,0,2700,2452,248
6/9/2021 20:40,YP,YUPI,1,250,0,250,208,42
6/9/2021 21:08,8999909002821,MARLBORO BLACK 16,1,22000,0,22000,20850,1150
6/9/2021 21:27,8999909000377,SAMPOERNA AVOLUTION,1,30000,0,30000,28450,1550
6/9/2021 21:27,8991001005694,SELAMAT 20X15G,1,18000,0,18000,16000,2000
6/9/2021 21:27,BRS5,BERAS BUMN 5KG,1,64000,0,64000,50500,13500
6/9/2021 21:27,8998866611718,EKONOMI PENCUCI PIRING  LIQ 780ML,1,12000,0,12000,10900,1100
6/9/2021 21:27,8998866102605,KODOMO TB REG 2IN1,1,7500,0,7500,6600,900
6/9/2021 21:27,8998866200882,SUKSESMIE GORENG AYAM KRMS 133GR,1,3500,0,3500,3047,453
6/9/2021 21:27,089686010107,INDOMIE KALDU AYAM,1,2500,0,2500,2150,350
6/9/2021 21:27,8999908284907,MY BABY MINYAK TELON 90ML,1,25000,0,25000,22700,2300
6/9/2021 21:27,8998989300261,GUDANG GARAM SURYA 12 FILTER,1,18500,0,18500,17200,1300
6/9/2021 21:41,8997013790108,BIMURA KACANG TELUR 25G,3,1000,0,3000,2625,375
6/9/2021 21:41,8994834005923,SPIX 1000,2,1000,0,2000,1700,300
6/9/2021 21:41,8998866202619,MIE SEDAAP KOREAN SPICY SOUP,1,2500,0,2500,2273,227
6/9/2021 21:41,JGR SHN,JOGER SHINY SACHET,1,500,0,500,437,63
6/9/2021 21:58,8992959953129,SWEETY BRONZE M20,1,35000,0,35000,33020,1980
6/9/2021 21:58,089686010343,INDOMIE SOTO MIE,2,2600,0,5200,4734,466
6/9/2021 21:58,089686010824,INDOMIE GORENG SPESIAL,1,2700,0,2700,2452,248
6/9/2021 21:58,089686043204,INDOMIE MIE ACEH,1,2700,0,2700,2452,248
6/9/2021 21:58,089686011036,INDOMIE GORENG PEDAS,1,2700,0,2700,2452,248
6/9/2021 21:59,8992761139018,ADES 600ML,1,3500,0,3500,2292,1208
6/9/2021 22:17,8998898336405,TOLAK ANGIN FREE SUGAR,3,3500,0,10500,8598,1902
6/10/2021 10:46,8996001600375,LE MINERAL 330ML,1,2000,0,2000,1417,583
6/10/2021 10:46,8996001600146,TEH PUCUK HARUM 350ML,1,3000,0,3000,2314,686
6/10/2021 11:10,8998866202466,JAPOTA HAPPY HONEY BUTTER,2,5000,0,10000,8300,1700
6/10/2021 11:10,089686041705,INDOMIE GORENG JUMBO,3,3500,0,10500,9429,1071
6/10/2021 11:10,089686043204,INDOMIE MIE ACEH,3,2700,0,8100,7356,744
6/10/2021 11:10,HT,HOT-HOT,3,500,0,1500,1050,450
6/10/2021 12:33,8998866501033,MINYAK GORENG SEDAAP POUCH 2L,3,29000,0,87000,83238,3762
6/10/2021 13:31,8998866602563,NUVO FAMILY HIJAU 76G,3,2000,0,6000,5460,540
6/10/2021 13:31,8998866602570,NUVO FAMILY KUNING 76G,1,2000,0,2000,1820,180
6/10/2021 13:31,8999999059781,SUNLIGHT LIME NEW POUCH 210ML,1,5000,0,5000,4300,700
6/10/2021 13:31,8999999033149,LIFEBUOY SHP PERAWATAN RMBT RONTOK 340ML,1,29500,0,29500,26850,2650
6/10/2021 14:33,8999909096004,SAMPOERNA 16 FILTER,1,24000,0,24000,23000,1000
6/10/2021 14:34,8996001600269,LE MINERAL 600ML,2,3000,0,6000,3376,2624
6/10/2021 14:40,123124,KOREK BIASA,1,2000,0,2000,1800,200
6/10/2021 15:29,8992696422735,DNCO CKLT UHT 110ML,1,2500,0,2500,2041,459
6/10/2021 15:29,8996001600146,TEH PUCUK HARUM 350ML,1,3000,0,3000,2314,686
6/10/2021 15:29,HT,HOT-HOT,1,500,0,500,350,150
6/10/2021 17:11,SMC,BIMURA MAKARONI CINCIN 250G,1,10000,0,10000,9300,700
6/10/2021 17:11,8997231980022,O'JELLY MINI STRAWBERRY,2,3000,0,6000,4500,1500
6/10/2021 17:11,8997013790108,BIMURA KACANG TELUR 25G,1,1000,0,1000,875,125
6/10/2021 17:18,6907992825076,JD WATERMELON APPLE,1,2000,0,2000,1700,300
6/10/2021 17:22,8998989300261,GUDANG GARAM SURYA 12 FILTER,1,18500,0,18500,17200,1300
6/10/2021 17:22,089686043051,INDOMIE COTO MAKASSAR,2,2800,0,5600,5050,550
6/10/2021 18:13,8991001780065,TWISTER BLACK 140G,2,13000,0,26000,23400,2600
6/10/2021 18:13,34678,SENDAL JEPIT,1,15000,0,15000,13500,1500
6/10/2021 18:15,8996001600269,LE MINERAL 600ML,2,3000,0,6000,3376,2624
6/10/2021 18:52,ARG,ARGUS 220ML,3,14500,0,43500,37500,6000
6/10/2021 19:02,AMPLOP,AMPLOP,4,250,0,1000,560,440
6/10/2021 19:21,8993989311279,CLAS MILD 12,1,17000,0,17000,15700,1300
6/10/2021 19:40,8991102989428GT,TANGO CKLT 24G GT,2,7500,0,15000,12184,2816
6/10/2021 19:40,8996001355985,BENG-BENG SHARE IT,1,27000,0,27000,25000,2000
6/10/2021 19:43,8992696404441,BEAR BRAND 189ML,1,9000,0,9000,7887,1113
6/10/2021 19:43,8998989110167,SURYA GUDANG GARAM 16 FILTER,1,25000,0,25000,23200,1800
6/10/2021 19:45,8994834006128,TICTIC PEDAS,1,2000,0,2000,1700,300
6/10/2021 19:45,8997231980022,O'JELLY MINI STRAWBERRY,1,3000,0,3000,2250,750
6/10/2021 19:45,PRG,PARAGO,1,500,0,500,400,100
6/10/2021 19:45,JGR SHN,JOGER SHINY SACHET,1,500,0,500,437,63
6/10/2021 19:56,1223456,LEM CASTOL,1,10000,0,10000,8750,1250
6/10/2021 19:58,8999999528843,CITRA PEARLY WHITE  60ML,1,6200,0,6200,5625,575
6/10/2021 19:58,8999999706173,PEPSODENT WHITE 120G,1,6700,0,6700,5940,760
6/10/2021 19:58,8998866602570,NUVO FAMILY KUNING 76G,1,2000,0,2000,1820,180
6/10/2021 19:58,8991102385060,TANGO WAFFLE CHOX,1,9000,0,9000,8498,502
6/10/2021 20:14,711844330108,ABC SARDEN CABAI,1,10000,0,10000,8000,2000
6/10/2021 20:14,711844330009,ABC SARDEN TOMAT,1,10000,0,10000,8000,2000
6/10/2021 20:34,GL,GULA 1 LITER,1,11500,0,11500,10500,1000
6/10/2021 20:34,089686010824,INDOMIE GORENG SPESIAL,2,2700,0,5400,4904,496
6/10/2021 20:39,8992775211434,PILUS GARUDA SAPI PANGGANG,1,5000,0,5000,4810,190
6/10/2021 20:39,8997013790108,BIMURA KACANG TELUR 25G,1,1000,0,1000,875,125
6/10/2021 20:39,8994834005923,SPIX 1000,1,1000,0,1000,850,150
6/10/2021 20:39,JGR SHN,JOGER SHINY SACHET,6,500,0,3000,2622,378
6/10/2021 20:52,8995333032113,TERIGU GATOT KACA 1 KG,1,8500,0,8500,8012,488
6/10/2021 20:52,8995333060772,TERIGU GATOT KACA 500GR,1,4500,0,4500,4065,435
6/10/2021 20:52,8997025915124,HATARI PEANUT 125G,1,7000,0,7000,6037,963
6/10/2021 20:55,GL,GULA 1 LITER,1,11500,0,11500,10500,1000
6/10/2021 21:46,8991002105409,KOPI KAPAL API,1,20000,0,20000,18888,1112
6/10/2021 21:46,8994867000162,ROKOK PUNDIMAS KRETEK16,1,10000,0,10000,8600,1400
6/10/2021 21:46,8998989110167,SURYA GUDANG GARAM 16 FILTER,1,25000,0,25000,23200,1800
6/10/2021 22:10,8999099920486,SGM 0-6 1000G,1,87000,0,87000,83707,3293
6/10/2021 22:10,711844330146,ABC SARDEN EXTRA PEDAS,1,10000,0,10000,8000,2000
6/10/2021 22:10,YP,YUPI,4,250,0,1000,832,168
6/10/2021 22:32,8993379152017,SABUN CUCI SURYA 200G,1,3000,0,3000,2281,719
6/10/2021 22:32,8999999549565,PONDS ROSE MICELLAR WTR 100ML,1,25000,0,25000,22800,2200
6/10/2021 22:32,8998866608312,GIV PAPAYA KOTAK 76GR,3,2000,0,6000,5460,540
6/10/2021 22:32,8992696404441,BEAR BRAND 189ML,2,9000,0,18000,15774,2226
6/10/2021 22:32,8992761139018,ADES 600ML,1,3500,0,3500,2292,1208
6/11/2021 10:12,8998866501033,MINYAK GORENG SEDAAP POUCH 2L,3,29000,0,87000,83238,3762
6/11/2021 11:10,089686010343,INDOMIE SOTO MIE,1,2600,0,2600,2367,233
6/11/2021 11:10,8998866202619,MIE SEDAAP KOREAN SPICY SOUP,1,2500,0,2500,2273,227
6/11/2021 11:10,8886013213208,FRENCH FREIS 2000,1,5000,0,5000,3750,1250
6/11/2021 11:10,089686611878,QTELA TEMPE,1,6000,0,6000,5370,630
6/11/2021 11:10,8997231980022,O'JELLY MINI STRAWBERRY,1,3000,0,3000,2250,750
6/11/2021 11:54,8992761122331,FRESTEA APPEL 500ML,1,6500,0,6500,4708,1792
6/11/2021 11:55,6907992823959,JD HAWTHORN BERRY,1,2000,0,2000,1700,300
6/11/2021 12:57,SLAIM,SLAIM WARNA,1,2000,0,2000,1743,257
6/11/2021 12:57,8998866202732,MILKU STROBERI 200ML,1,3000,0,3000,2375,625
6/11/2021 13:41,8996001600399,LE MINERAL 1500ML,1,5000,0,5000,4042,958
6/11/2021 13:41,8992761136161,COCACOLA 1L,1,10000,0,10000,9000,1000
6/11/2021 13:41,8992759120264,LARISST 220,1,10000,0,10000,9200,800
6/11/2021 13:41,8991102989534,TANGO VANILA 24G,1,1000,0,1000,609,391
6/11/2021 13:41,8999999192150,ROYCO FDS CHICKEN 100GR,1,5000,0,5000,4300,700
6/11/2021 14:05,WC,WAFER COKELAT MADE,2,1000,0,2000,1600,400
6/11/2021 14:48,8998866200301,MIE SEDAAP GORENG,1,2500,0,2500,2023,477
6/11/2021 14:48,COKLAT,COKLAT COIN,3,500,0,1500,1275,225
6/11/2021 15:01,8998866202770,MIE SEDAAP SALERO PADANG,2,2500,0,5000,4724,276
6/11/2021 16:22,GL,GULA 1 LITER,1,11500,0,11500,10500,1000
6/11/2021 16:23,089686611519,QTELA SINGKONG,1,5000,0,5000,4266,734
6/11/2021 16:24,8993072254056,MELROSE COTTON BUDS KCL,1,3000,0,3000,2450,550
6/11/2021 16:24,8998866202770,MIE SEDAAP SALERO PADANG,4,2500,0,10000,9448,552
6/11/2021 16:58,6907992823966,JD BLUEBERRY,1,3500,0,3500,3000,500
6/11/2021 16:58,6907992823959,JD HAWTHORN BERRY,1,2000,0,2000,1700,300
6/11/2021 16:58,8998866202732,MILKU STROBERI 200ML,1,3000,0,3000,2375,625
6/11/2021 16:58,bb,BENG-BENG,1,1500,0,1500,1450,50
6/11/2021 16:59,6907992823935,JD SWEETCORN,1,3500,0,3500,3000,500
6/11/2021 17:19,8999999516208,ROYCO FDS CHICKEN NEW 230G,5,10000,0,50000,45000,5000
6/11/2021 17:21,8934868015024,REXONA DEO LOTION FREE SPIRIT 9G,2,4500,0,9000,7800,1200
6/11/2021 17:29,8999999030186,PEPSODENT ACTION 123 COMPLETE 190G,1,14000,0,14000,13200,800
6/11/2021 17:29,8991102381024,FULLO VNL PCK,2,10000,0,20000,18000,2000
6/11/2021 17:49,8996001600146,TEH PUCUK HARUM 350ML,1,3000,0,3000,2314,686
6/11/2021 17:49,MARS,MARSHMELLOW,2,500,0,1000,866,134
6/11/2021 17:53,8996001318980,BETTER 120G,1,6000,0,6000,5100,900
6/11/2021 17:53,8996001600221,KOPIKO 78,1,5000,0,5000,4283,717
6/11/2021 17:54,8997007780689,JIZZY MINERAL,3,3000,0,9000,3561,5439
6/11/2021 17:54,6907992823850,JD CHOCO CIRLE,1,5500,0,5500,4700,800
6/11/2021 17:54,8998866202244,EKOMIE BUMBU KALDU AYAM,1,1000,0,1000,798,202
6/11/2021 17:54,WC,WAFER COKELAT MADE,1,1000,0,1000,800,200
6/11/2021 17:54,YP,YUPI,2,250,0,500,416,84
6/11/2021 18:23,8996001600399,LE MINERAL 1500ML,1,5000,0,5000,4042,958
6/11/2021 18:24,8996001600399,LE MINERAL 1500ML,1,5000,0,5000,4042,958
6/11/2021 19:08,8998989500166,GUDANG GARAM MERAH BESAR 16KS,1,18000,0,18000,17000,1000
6/11/2021 19:08,123124,KOREK BIASA,1,2000,0,2000,1800,200
6/11/2021 19:53,8998009020186,BUAVITA GUAVA 250ML,2,7000,0,14000,12166,1834
6/11/2021 20:06,8993989311279,CLAS MILD 12,1,17000,0,17000,15700,1300
6/11/2021 20:07,8992775913000SCT,CHOCOLATOS CKLT DRINK SCT,3,2000,0,6000,4758,1242
6/11/2021 20:13,8999999528843,CITRA PEARLY WHITE  60ML,1,6200,0,6200,5625,575
6/11/2021 20:13,8993335523363,TOTAL ALMEERA 250G,1,5000,0,5000,4100,900
6/11/2021 20:13,8996001600399,LE MINERAL 1500ML,1,5000,0,5000,4042,958
6/11/2021 20:13,8991102989428SCT,TANGO CKLT 24G SCT,2,1000,0,2000,1218,782
6/11/2021 20:13,8998866202923,FLORIDINA COCO,1,3000,0,3000,2500,500
6/11/2021 20:13,8992959117613,SFX DAUN SIRIH WING 1,2,5000,0,10000,8260,1740
6/11/2021 20:16,SFX,SOFTEX DAUN SIRIH 1,2,500,0,1000,826,174
6/11/2021 21:43,8998009020186,BUAVITA GUAVA 250ML,1,7000,0,7000,6083,917
6/11/2021 21:43,8998866201827,JAVANA GULA BATU 350ML,1,3000,0,3000,2150,850
6/11/2021 21:44,ARG,ARGUS 220ML,3,14500,0,43500,37500,6000
6/11/2021 21:53,GL,GULA 1 LITER,1,11500,0,11500,10500,1000
6/11/2021 21:53,bb,BENG-BENG,1,1500,0,1500,1450,50
6/12/2021 10:41,8850507001152,MOTU ATV,1,10000,0,10000,8000,2000
6/12/2021 10:41,SMC,BIMURA MAKARONI CINCIN 250G,1,10000,0,10000,9300,700
6/12/2021 10:46,8998989500128,GUDANG GARAM MERAH KECIL 12KS,1,14000,0,14000,13000,1000
6/12/2021 10:46,8992696404441,BEAR BRAND 189ML,1,9000,0,9000,7887,1113
6/12/2021 11:44,8991001121615,SILVERQUEEN NUT,1,15000,0,15000,13200,1800
6/12/2021 11:44,8999999528928,CITRA NOURISH WHT 230ML,1,20000,0,20000,18040,1960
6/12/2021 11:44,8999999030179,PEPSODENT ACTION 123 COMPLETE 75G,1,6700,0,6700,5170,1530
6/12/2021 11:44,8991002105409,KOPI KAPAL API,1,20000,0,20000,18888,1112
6/12/2021 11:44,8992775913000SCT,CHOCOLATOS CKLT DRINK SCT,7,2000,0,14000,11102,2898
6/12/2021 12:14,8992628605151,AMANDA MARGARINE,1,5000,0,5000,3806,1194
6/12/2021 12:14,SS,SUPER SNAPS,1,1500,0,1500,1333,167
6/12/2021 12:29,8997231980022,O'JELLY MINI STRAWBERRY,1,3000,0,3000,2250,750
6/12/2021 12:29,8998866501033,MINYAK GORENG SEDAAP POUCH 2L,2,29000,0,58000,55492,2508
6/12/2021 12:29,GL,GULA 1 LITER,1,11500,0,11500,10500,1000
6/12/2021 12:48,8998989500166,GUDANG GARAM MERAH BESAR 16KS,2,18000,0,36000,34000,2000
6/12/2021 12:48,8998866106979,CIPTADENT TB CHARCOAL PROTEC,1,6000,0,6000,5250,750
6/12/2021 12:53,BTS,BIMURA TARO SEAWEED 250G,1,10000,0,10000,9300,700
6/12/2021 12:53,8998866608756,SOKLIN SOFTENER TWILIGHT BLUE 14SCH,1,5000,0,5000,4560,440
6/12/2021 13:25,8991001111883,SILVERQUEEN CHUNKYBAR 33G,1,8000,0,8000,7150,850
6/12/2021 13:36,8998009020186,BUAVITA GUAVA 250ML,2,7000,0,14000,12166,1834
6/12/2021 13:53,8996001302620,MALKIST COKLAT SCT,2,1000,0,2000,1680,320
6/12/2021 14:24,8992222052979,GATSBY WATER GLOSS MERAH,1,5000,0,5000,3700,1300
6/12/2021 14:24,8997210107877,VORTEX SMART 3,1,10000,0,10000,9500,500
6/12/2021 14:36,8996001302620,MALKIST COKLAT SCT,1,1000,0,1000,840,160
6/12/2021 14:55,8992628020152,BIMOLI POUCH 2L,1,31000,0,31000,29800,1200
6/12/2021 14:55,8999999036355,SUNLIGHT LIME BTL 750ML,1,25000,0,25000,23050,1950
6/12/2021 15:38,8998866501026,MINYAK GORENG SEDAAP POUCH 1 L,1,15000,0,15000,14110,890
6/12/2021 15:38,8999999519735,PEPSODENT TB BAMBOO SALT,1,13200,0,13200,11990,1210
6/12/2021 15:38,8996001600375,LE MINERAL 330ML,1,2000,0,2000,1417,583
6/12/2021 15:38,8996001600269,LE MINERAL 600ML,1,3000,0,3000,1688,1312
6/12/2021 15:38,8998866611718,EKONOMI PENCUCI PIRING  LIQ 780ML,1,12000,0,12000,10900,1100
6/12/2021 15:45,8992759120264,LARISST 220,1,10000,0,10000,9200,800
6/12/2021 15:45,8997226852006,TEH CAP KAMPUNG MANIS,1,12000,0,12000,10000,2000
6/12/2021 16:49,8998866501033,MINYAK GORENG SEDAAP POUCH 2L,1,29000,0,29000,27746,1254
6/12/2021 17:28,8998866200561,EKOMIE SUPER 600GR,2,10000,0,20000,17230,2770
6/12/2021 17:53,8992761111533,SPRITE SLIM CAM250ML,1,5000,0,5000,3750,1250
6/12/2021 18:44,8997002060168,KRP SINGKOG PDS PANDA DUO,1,8000,0,8000,7300,700
6/12/2021 18:47,ARG,ARGUS 220ML,1,14500,0,14500,12500,2000
6/12/2021 18:47,8998866200325,MIE SEDAAP SOTO,4,2500,0,10000,7808,2192
6/12/2021 18:47,8994867007161,ROKOK PENA GOLD 20,1,17000,0,17000,15500,1500
6/12/2021 18:52,089686043273,INDOMIE SAMBAL RICA,2,2700,0,5400,4904,496
6/12/2021 18:53,8998866202244,EKOMIE BUMBU KALDU AYAM,1,1000,0,1000,798,202
6/12/2021 19:11,8993379254469,SABUN LERVIA 90G,2,5000,0,10000,6154,3846
6/12/2021 19:11,8999999558079,RINSO MOLTO ROSE FRESH PWD 44G,1,1000,0,1000,805,195
6/12/2021 19:11,8886013213208,FRENCH FREIS 2000,2,5000,0,10000,7500,2500
6/12/2021 19:11,8992959117514,SFX NON WING 20,1,10000,0,10000,9091,909
6/12/2021 19:11,8992957220025,GOLDEN CITY MINI,1,3000,0,3000,2500,500
6/12/2021 19:16,8994834005923,SPIX 1000,1,1000,0,1000,850,150
6/12/2021 19:16,8991102989534,TANGO VANILA 24G,2,1000,0,2000,1218,782
6/12/2021 19:16,JGR SHN,JOGER SHINY SACHET,1,500,0,500,437,63
6/12/2021 19:46,8997025914059,HATARI SEE HONG,1,6000,0,6000,4911,1089
6/12/2021 19:52,8998866501026,MINYAK GORENG SEDAAP POUCH 1 L,1,15000,0,15000,14110,890
6/12/2021 19:52,089686044249,SUPERMI NUTRIMI STEAK AYAM,1,3500,0,3500,2800,700
6/12/2021 19:52,VTM,VITAMIN,3,500,0,1500,1275,225
6/12/2021 20:06,8996001355985,BENG-BENG SHARE IT,1,27000,0,27000,25000,2000
6/12/2021 20:06,8991102989428GT,TANGO CKLT 24G GT,2,7500,0,15000,12184,2816
6/12/2021 20:22,8992761139018,ADES 600ML,1,3500,0,3500,2292,1208
6/12/2021 20:22,8996001600269,LE MINERAL 600ML,3,3000,0,9000,5064,3936
6/12/2021 20:22,8996001600597,KOPIKO LUCKY DAY,1,5000,0,5000,4283,717
6/12/2021 20:22,8991102989428GT,TANGO CKLT 24G GT,2,7500,0,15000,12184,2816
6/12/2021 20:22,8996001318980,BETTER 120G,1,6000,0,6000,5100,900
6/12/2021 20:22,6907992823904,JD CRUNCHY CHOCOLATE VAN,1,8000,0,8000,6800,1200
6/12/2021 22:00,8992959953044,SWEETY BRONZE XL1,2,2500,0,5000,4500,500
6/12/2021 22:00,WC,WAFER COKELAT MADE,1,1000,0,1000,800,200
6/12/2021 22:00,SLAIM,SLAIM WARNA,2,2000,0,4000,3486,514
6/12/2021 22:12,8993058304201,BEJO JAHE MERAH,1,3000,0,3000,1893,1107
6/13/2021 10:36,8998866501033,MINYAK GORENG SEDAAP POUCH 2L,2,29000,0,58000,55492,2508
6/13/2021 10:52,8999908284907,MY BABY MINYAK TELON 90ML,1,25000,0,25000,22700,2300
6/13/2021 10:52,8998989300261,GUDANG GARAM SURYA 12 FILTER,1,18500,0,18500,17200,1300
6/13/2021 11:04,8992775913000GT,CHOCOLATOS CKLT DRINK,2,18000,0,36000,31724,4276
6/13/2021 11:04,8997009510017,YOU C1000 LEMON,1,10000,0,10000,9166,834
6/13/2021 11:04,8999999042608,RINSO MOLTO PARFUME ESSENCE 750ML,1,15000,0,15000,12507,2493
6/13/2021 11:04,8992775110157,GARUDA KACANG KULIT,1,5000,0,5000,3925,1075
6/13/2021 11:04,8996001600610,TORA MILKY LATTE 180ML,1,3500,0,3500,2750,750
6/13/2021 11:04,8991002103764,GOOD DAY CAPPUCINO 10X25G,1,1500,0,1500,1395,105
6/13/2021 11:04,8997007780689,JIZZY MINERAL,1,3000,0,3000,1187,1813
6/13/2021 11:13,MOLTO PINK,MOLTO ALL IN ONE 11 ML,2,500,0,1000,800,200
6/13/2021 11:13,8993335523363,TOTAL ALMEERA 250G,1,5000,0,5000,4100,900
6/13/2021 11:58,9999,ISOLASI LAKBAN,1,8000,0,8000,6500,1500
6/13/2021 12:09,8886020033431,KAPUR AJAIB ANTI KECOA DAN NYAMUK,1,3000,0,3000,2700,300
6/13/2021 13:07,8997021870076,FRESH CARE SANDAL WOOD 10ML,1,12000,0,12000,10000,2000
6/13/2021 13:47,6907992825076,JD WATERMELON APPLE,1,2000,0,2000,1700,300
6/13/2021 13:47,6907992823959,JD HAWTHORN BERRY,1,2000,0,2000,1700,300
6/13/2021 13:47,HT,HOT-HOT,1,500,0,500,350,150
6/13/2021 14:06,8998989500128,GUDANG GARAM MERAH KECIL 12KS,2,14000,0,28000,26000,2000
6/13/2021 14:06,8999909096004,SAMPOERNA 16 FILTER,1,24000,0,24000,23000,1000
6/13/2021 14:57,SLAIM,SLAIM WARNA,1,2000,0,2000,1743,257
6/13/2021 14:57,COKLAT,COKLAT COIN,2,500,0,1000,850,150
6/13/2021 14:57,PRG,PARAGO,2,500,0,1000,800,200
6/13/2021 14:57,MARS,MARSHMELLOW,2,500,0,1000,866,134
6/13/2021 15:57,8993053641042,PASEO BABY WIPES GAZETTE 50S,1,17000,0,17000,15400,1600
6/13/2021 15:57,8992775311325,GERY SNACK&SEREAL 100G,2,7000,0,14000,12024,1976
6/13/2021 15:57,8992959508312,SWEETY SILVER PANTS XL RTG,1,15500,0,15500,13944,1556
6/13/2021 16:50,TBR,TEPUNG BERAS,1,8000,0,8000,8000,0
6/13/2021 16:50,8992628020152,BIMOLI POUCH 2L,1,31000,0,31000,29800,1200
6/13/2021 17:30,8996001600375,LE MINERAL 330ML,4,2000,0,8000,5668,2332
6/13/2021 18:13,8996001600269,LE MINERAL 600ML,2,3000,0,6000,3376,2624
6/13/2021 18:18,8992761166038,MMP ORANGE 300ML,1,5000,0,5000,3750,1250
6/13/2021 18:21,8996001305041,ROMA SANDWICH CKLT,2,7000,0,14000,10000,4000
6/13/2021 18:21,8992761002039,FANTA STRAWBERRY PET 390 ML,1,5500,0,5500,4300,1200
6/13/2021 18:55,8998866501033,MINYAK GORENG SEDAAP POUCH 2L,1,29000,0,29000,27746,1254
6/13/2021 18:55,8991188943062,SASA 250G,1,10000,0,10000,8500,1500
6/13/2021 19:05,8998989500166,GUDANG GARAM MERAH BESAR 16KS,1,18000,0,18000,17000,1000
6/13/2021 19:42,8997027300089,NOMOS,2,4000,0,8000,5926,2074
6/13/2021 19:42,8991102989428SCT,TANGO CKLT 24G SCT,4,1000,0,4000,2436,1564
6/13/2021 20:13,8992959953136,SWEETY BRONZE L20,1,40000,0,40000,36770,3230
6/13/2021 20:13,8998898337440,TOLAK ANGIN CARE 10ML,1,10000,0,10000,7893,2107
6/13/2021 20:33,8998866202930,SEDAAP AYAM JERIT CUP,1,4500,0,4500,3738,762
6/13/2021 20:44,8994867000162,ROKOK PUNDIMAS KRETEK16,1,10000,0,10000,8600,1400
6/13/2021 20:44,8998866202930,SEDAAP AYAM JERIT CUP,1,4500,0,4500,3738,762
6/13/2021 21:03,8992761002039,FANTA STRAWBERRY PET 390 ML,2,5500,0,11000,8600,2400
6/13/2021 21:04,8992761166212,FRESTEA APPLE 350ML,1,4500,0,4500,3000,1500
6/13/2021 21:04,JGR SHN,JOGER SHINY SACHET,1,500,0,500,437,63
6/13/2021 21:07,PRG,PARAGO,2,500,0,1000,800,200
6/13/2021 21:07,bb,BENG-BENG,2,1500,0,3000,2900,100
6/13/2021 21:07,8996001318430,BETTER 1000,1,1000,0,1000,820,180
6/13/2021 21:07,8992959953044,SWEETY BRONZE XL1,2,2500,0,5000,4500,500
6/13/2021 21:14,8991002105409,KOPI KAPAL API,1,20000,0,20000,18888,1112
6/13/2021 21:25,8994867007161,ROKOK PENA GOLD 20,1,17000,0,17000,15500,1500
6/13/2021 22:15,8998866200325,MIE SEDAAP SOTO,2,2500,0,5000,3904,1096
6/13/2021 22:15,8992959953099,SWEETY BRONZE XL7,1,16000,0,16000,15190,810
6/13/2021 22:15,089686021127,INTER MIE KALDU,1,1000,0,1000,813,187
6/13/2021 22:51,8998866201827,JAVANA GULA BATU 350ML,1,3000,0,3000,2150,850
6/13/2021 22:51,8998989300261,GUDANG GARAM SURYA 12 FILTER,1,18500,0,18500,17200,1300
6/13/2021 22:54,8992775002155,CHOCOLATOS DRINK,1,4000,0,4000,3520,480
6/13/2021 22:54,8992761164539,NUTRIBOOST ORANGE 300ML,1,6500,0,6500,5300,1200
6/13/2021 22:54,YP,YUPI,2,250,0,500,416,84
6/13/2021 22:54,COKLAT,COKLAT COIN,2,500,0,1000,850,150
6/13/2021 22:54,8993470279651,JOGER CHOCKY BAR,1,1000,0,1000,867,133
6/13/2021 22:54,8998866202619,MIE SEDAAP KOREAN SPICY SOUP,1,2500,0,2500,2273,227
6/13/2021 22:54,8997007780689,JIZZY MINERAL,1,3000,0,3000,1187,1813
6/13/2021 22:54,8992730002992,HAI CANDY,1,7000,0,7000,6000,1000
6/13/2021 22:54,8991002103764,GOOD DAY CAPPUCINO 10X25G,1,1500,0,1500,1395,105
6/13/2021 22:54,8996001600221,KOPIKO 78,1,5000,0,5000,4283,717
6/14/2021 10:55,SLAIM,SLAIM WARNA,2,2000,0,4000,3486,514
6/14/2021 11:09,8992761002022,SPRITE PET 390ML,1,5500,0,5500,4300,1200
6/14/2021 11:33,8992761002022,SPRITE PET 390ML,1,5500,0,5500,4300,1200
6/14/2021 11:33,8993274532105,BOLU,4,1000,0,4000,3332,668
6/14/2021 11:33,JGR SHN,JOGER SHINY SACHET,1,500,0,500,437,63
6/14/2021 11:51,6907992823973,JD PINEAPPLE,1,5000,0,5000,4300,700
6/14/2021 11:51,6907992824963,JD MILKY CHOCOLATE,1,3000,0,3000,2600,400
6/14/2021 12:57,6907992825076,JD WATERMELON APPLE,1,2000,0,2000,1700,300
6/14/2021 12:57,8996001600269,LE MINERAL 600ML,1,3000,0,3000,1688,1312
6/14/2021 13:10,SLAIM,SLAIM WARNA,1,2000,0,2000,1743,257
6/14/2021 13:14,8999909000711,MAGNUM MILD 16,1,21000,0,21000,19350,1650
6/14/2021 15:16,8992775211434,PILUS GARUDA SAPI PANGGANG,1,5000,0,5000,4810,190
6/14/2021 15:16,8992775001042,PILUS GARUDA MI GORENG,1,5000,0,5000,4810,190
6/14/2021 15:16,8996001600269,LE MINERAL 600ML,1,3000,0,3000,1688,1312
6/14/2021 15:16,SWAL,SENDAL SWALLOW,1,18000,0,18000,16500,1500
6/14/2021 16:48,8994834005923,SPIX 1000,1,1000,0,1000,850,150
6/14/2021 16:48,SLAIM,SLAIM WARNA,1,2000,0,2000,1743,257
6/14/2021 16:48,089686021127,INTER MIE KALDU,4,1000,0,4000,3252,748
6/14/2021 16:48,089686021141,INTER MIE SOTO,3,1000,0,3000,2562,438
6/14/2021 16:48,089686021219,INTER MIE GORENG,3,1000,0,3000,2655,345
6/14/2021 16:50,8994867000179,ROKOK PENA MILD 16,1,14500,0,14500,13500,1000
6/14/2021 17:07,8998989300261,GUDANG GARAM SURYA 12 FILTER,1,18500,0,18500,17200,1300
6/14/2021 17:15,MARS,MARSHMELLOW,2,500,0,1000,866,134
6/14/2021 17:17,8997231980015,O'JELLY MINI APPLE,1,3000,0,3000,2250,750
6/14/2021 17:25,6907992823935,JD SWEETCORN,1,3500,0,3500,3000,500
6/14/2021 17:25,MARS,MARSHMELLOW,1,500,0,500,433,67
6/14/2021 17:29,8993083929806,BISKITOP COKLAT,1,30000,0,30000,27000,3000
6/14/2021 17:31,8992696521797GT,MILO ACT GO SCT 22G,1,17500,0,17500,15536,1964
6/14/2021 17:31,8996001305249,ROMA KELAPA CREAM,1,6800,0,6800,5514,1286
6/14/2021 17:54,8993989311699,CLAS MILD 16 FILTER,1,23000,0,23000,21700,1300
6/14/2021 17:54,8991102384841,WFR TANGO LONG CKLT 130G,1,5000,0,5000,4345,655
6/14/2021 17:59,711844110021,KECAP ABC 600 ML,1,22000,0,22000,20700,1300
6/14/2021 17:59,711844120037,SAMBAL ABC 135 ML,1,7000,0,7000,5600,1400
6/14/2021 18:21,ARG,ARGUS 220ML,3,14500,0,43500,37500,6000
6/14/2021 19:35,8992694247255,ZWITSAL BATH NAT HAIR&BODY 200ML,1,20500,0,20500,18810,1690
6/14/2021 19:35,8999999005580,DOVE DEO WMN RONOURISH & SMOOTH 40 ML,1,17800,0,17800,16050,1750
6/14/2021 19:35,8999999557355,ZWITSAL BABY BOTTLE CLEANER 135 ML,1,5000,0,5000,4000,1000
6/14/2021 19:35,089686010107,INDOMIE KALDU AYAM,1,2500,0,2500,2150,350
6/14/2021 19:46,76239878,MARLBORO GOLD,1,30000,0,30000,27700,2300
6/14/2021 19:46,8998989300261,GUDANG GARAM SURYA 12 FILTER,1,18500,0,18500,17200,1300
6/14/2021 19:52,8998866200301,MIE SEDAAP GORENG,2,2500,0,5000,4046,954
6/14/2021 19:52,8994834005923,SPIX 1000,2,1000,0,2000,1700,300
6/14/2021 19:52,8997013790108,BIMURA KACANG TELUR 25G,1,1000,0,1000,875,125
6/14/2021 19:56,089686010107,INDOMIE KALDU AYAM,1,2500,0,2500,2150,350
6/14/2021 19:56,089686010824,INDOMIE GORENG SPESIAL,1,2700,0,2700,2452,248
6/14/2021 19:56,089686010343,INDOMIE SOTO MIE,1,2600,0,2600,2367,233
6/14/2021 19:57,8999909982000,SAMPOERNA 12 FILTER,1,18000,0,18000,16000,2000
6/14/2021 19:57,8998989300261,GUDANG GARAM SURYA 12 FILTER,1,18500,0,18500,17200,1300
6/14/2021 20:00,8996001302316,MALKIST ABON SCT,5,1000,0,5000,4200,800
6/14/2021 20:00,8997028590014,ARGUS 220ML,10,500,0,5000,3020,1980
6/14/2021 20:19,8999909010567,234 DJI SAM SOE 16,1,22000,0,22000,21500,500
6/14/2021 20:38,8999999031930,PEPSODENT TB TRIPLE CLEAN,2,3500,0,7000,5700,1300
6/14/2021 20:43,8998866202770,MIE SEDAAP SALERO PADANG,1,2500,0,2500,2362,138
6/14/2021 20:43,089686010107,INDOMIE KALDU AYAM,1,2500,0,2500,2150,350
6/14/2021 20:43,8998866200301,MIE SEDAAP GORENG,1,2500,0,2500,2023,477
6/14/2021 20:43,089686043204,INDOMIE MIE ACEH,1,2700,0,2700,2452,248
6/14/2021 21:12,8998866200882,SUKSESMIE GORENG AYAM KRMS 133GR,1,3500,0,3500,3047,453
6/14/2021 21:12,JGR SHN,JOGER SHINY SACHET,3,500,0,1500,1311,189
6/14/2021 21:17,089686010107,INDOMIE KALDU AYAM,2,2500,0,5000,4300,700
6/14/2021 21:17,089686010343,INDOMIE SOTO MIE,2,2600,0,5200,4734,466
6/14/2021 21:17,089686043051,INDOMIE COTO MAKASSAR,2,2800,0,5600,5050,550
6/14/2021 21:17,8996001301142,ROMA KELAPA,1,8000,0,8000,6628,1372
6/14/2021 21:29,JGR SH,JOGER SHINY CHOCO,1,17500,0,17500,16235,1265
6/14/2021 21:29,8992957220025,GOLDEN CITY MINI,1,3000,0,3000,2500,500
6/14/2021 21:29,BALON,BALON CABUT,1,1000,0,1000,900,100
6/14/2021 21:29,6907992823959,JD HAWTHORN BERRY,1,2000,0,2000,1700,300
6/14/2021 21:29,VTM,VITAMIN,1,500,0,500,425,75
6/14/2021 21:32,8998866105507,EMERON LOVELY NOURIST&BRIGHT 100ML,1,4300,0,4300,3800,500
6/14/2021 21:32,6907992823935,JD SWEETCORN,1,3500,0,3500,3000,500
6/14/2021 21:32,8996001600269,LE MINERAL 600ML,1,3000,0,3000,1688,1312
6/14/2021 21:32,8991102384841,WFR TANGO LONG CKLT 130G,1,5000,0,5000,4345,655
6/14/2021 21:56,BALON,BALON CABUT,2,1000,0,2000,1800,200
6/14/2021 21:56,8886020033431,KAPUR AJAIB ANTI KECOA DAN NYAMUK,1,3000,0,3000,2700,300
6/15/2021 10:20,6907992823843,JD MOCHA CRISPY,1,5000,0,5000,4400,600
6/15/2021 10:21,8992959508848,SWEETY SILVER PANTS L 18,1,41500,0,41500,37728,3772
6/15/2021 10:25,8999909002821,MARLBORO BLACK 16,1,22000,0,22000,20850,1150
6/15/2021 10:47,8994834006128,TICTIC PEDAS,1,2000,0,2000,1700,300
6/15/2021 12:55,BALON,BALON CABUT,7,1000,0,7000,6300,700
6/15/2021 13:15,8998866201452,POTABEE REGULER BBQ BEEF 35GR,1,5000,0,5000,4150,850
6/15/2021 13:15,8997231980022,O'JELLY MINI STRAWBERRY,1,3000,0,3000,2250,750
6/15/2021 13:15,8996001600375,LE MINERAL 330ML,1,2000,0,2000,1417,583
6/15/2021 13:15,8992759120264,LARISST 220,2,10000,0,20000,18400,1600
6/15/2021 13:15,SLAIM,SLAIM WARNA,1,2000,0,2000,1743,257
6/15/2021 13:16,8996001600269,LE MINERAL 600ML,1,3000,0,3000,1688,1312
6/15/2021 14:17,bb,BENG-BENG,1,1500,0,1500,1450,50
6/15/2021 14:17,8998866501033,MINYAK GORENG SEDAAP POUCH 2L,1,29000,0,29000,27746,1254
6/15/2021 15:03,8996001600375,LE MINERAL 330ML,1,2000,0,2000,1417,583
6/15/2021 15:34,8999999524722,SUNLIGHT LIME NEW PCH 435ML,1,10000,0,10000,9100,900
6/15/2021 15:37,8992696521797SCT,MILO UHT ACT GO 22G,1,2000,0,2000,1412,588
6/15/2021 15:37,8999999502003,"SARIMURNI RL RB 1,8G",1,1500,0,1500,1207,293
6/15/2021 15:37,BALON,BALON CABUT,6,1000,0,6000,5400,600
6/15/2021 17:07,8999909028234,234 DJI SAM SOE 12,1,17000,0,17000,15850,1150
6/15/2021 17:13,SLAIM,SLAIM WARNA,1,2000,0,2000,1743,257
6/15/2021 17:29,8995333032113,TERIGU GATOT KACA 1 KG,2,8500,0,17000,16024,976
6/15/2021 18:07,BALON,BALON CABUT,1,1000,0,1000,900,100
6/15/2021 18:32,GL,GULA 1 LITER,1,11500,0,11500,10500,1000
6/15/2021 18:32,8998989500166,GUDANG GARAM MERAH BESAR 16KS,2,18000,0,36000,34000,2000
6/15/2021 18:47,089686043273,INDOMIE SAMBAL RICA,1,2700,0,2700,2452,248
6/15/2021 19:08,8998866609043,DAIA SOFTENER GUSSET 565G,1,10000,0,10000,8700,1300
6/15/2021 19:08,711844120037,SAMBAL ABC 135 ML,1,7000,0,7000,5600,1400
6/15/2021 19:08,8998866200325,MIE SEDAAP SOTO,3,2500,0,7500,5856,1644
6/15/2021 19:08,8999999525088,MOLTO AIO BLUE SPK 250ML,1,9800,0,9800,8910,890
6/15/2021 19:10,8998866202930,SEDAAP AYAM JERIT CUP,1,4500,0,4500,3738,762
6/15/2021 20:29,8998866201964,MINYAK GORENG SABRINA 2L POUCH,1,28000,0,28000,26753,1247
6/15/2021 21:11,8999909010567,234 DJI SAM SOE 16,1,22000,0,22000,21500,500
6/15/2021 21:11,8993989311699,CLAS MILD 16 FILTER,1,23000,0,23000,21700,1300
6/15/2021 21:34,8992959953129,SWEETY BRONZE M20,1,35000,0,35000,33020,1980
6/15/2021 21:34,8996001600399,LE MINERAL 1500ML,1,5000,0,5000,4042,958
6/15/2021 21:40,8992775000014,CHOCOLATOS HAZELNUT,1,18000,0,18000,15483,2517
6/15/2021 21:40,8999999195649,SARI WANGI 25X1.86G,1,6000,0,6000,5050,950
6/15/2021 21:40,8992736025162,SASA TEPUNG PISANG GORENG,1,5000,0,5000,4455,545
6/15/2021 21:40,711844120419,SAMBAL ABC 275 ML,1,12000,0,12000,10800,1200
6/15/2021 21:40,9556040040038,SUSU F&N,1,33000,0,33000,30000,3000
6/15/2021 21:40,4801010531234,JB BATH BLUE 200 (REFILL),1,14000,0,14000,13530,470
6/15/2021 21:40,8992745320326,STELLA ORG 200ML,1,15000,0,15000,13300,1700
6/15/2021 21:40,8999999059323,LIFEBUOY TS LEMONFRESH 75G,1,3000,0,3000,2640,360
6/15/2021 21:40,8998866603683,FRES&NATURAL SOAP MERAH 65G,3,1800,0,5400,4275,1125
6/15/2021 21:40,8999999520885,WIPOL 500 ML,1,10000,0,10000,8600,1400
6/15/2021 22:04,8998866106504,EMERON LOVELY NAT PINK,1,3500,0,3500,2900,600
6/15/2021 22:04,8999999706111,PEPSODENT WHITE 25G,1,2000,0,2000,1450,550
6/16/2021 10:38,8997231980015,O'JELLY MINI APPLE,1,3000,0,3000,2250,750
6/16/2021 10:38,089686044249,SUPERMI NUTRIMI STEAK AYAM,2,3500,0,7000,5600,1400
6/16/2021 10:47,8992222091961,PUCELLE MIST COL SPRAY 75ML,1,13000,0,13000,11650,1350
6/16/2021 10:47,8992759120264,LARISST 220,1,10000,0,10000,9200,800
6/16/2021 11:05,8998866610261,DAIA VIOLET GUSSET BAG 290 GR,1,5000,0,5000,4450,550
6/16/2021 11:05,8992959953143,SWEEETY BRONZE XL20,1,45000,0,45000,42620,2380
6/16/2021 11:05,8998866201483,POTABEE REGULER GRILLED SEAWEED 35GR,3,5000,0,15000,12450,2550
6/16/2021 11:05,8998866201452,POTABEE REGULER BBQ BEEF 35GR,1,5000,0,5000,4150,850
6/16/2021 11:05,8992696422735,DNCO CKLT UHT 110ML,3,2500,0,7500,6123,1377
6/16/2021 11:07,8994867007161,ROKOK PENA GOLD 20,1,17000,0,17000,15500,1500
6/16/2021 12:05,BALON,BALON CABUT,2,1000,0,2000,1800,200
6/16/2021 12:05,YP,YUPI,2,250,0,500,416,84
6/16/2021 12:05,MARS,MARSHMELLOW,1,500,0,500,433,67
6/16/2021 13:37,8998866200646,KOPI TOP MURNI,1,11000,0,11000,9600,1400
6/16/2021 13:37,GL,GULA 1 LITER,2,11500,0,23000,21000,2000
6/16/2021 13:37,8992979120013,TOTAL BUNGA SOFTENER,1,13000,0,13000,11532,1468
6/16/2021 13:40,YP,YUPI,2,250,0,500,416,84
6/16/2021 13:40,MARS,MARSHMELLOW,3,500,0,1500,1299,201
6/16/2021 13:40,COKLAT,COKLAT COIN,2,500,0,1000,850,150
6/16/2021 13:42,8998866501033,MINYAK GORENG SEDAAP POUCH 2L,3,29000,0,87000,83238,3762
6/16/2021 13:42,HT,HOT-HOT,2,500,0,1000,700,300
6/16/2021 14:16,ARG,ARGUS 220ML,6,14500,0,87000,75000,12000
6/16/2021 15:02,089686010343,INDOMIE SOTO MIE,5,2600,0,13000,11835,1165
6/16/2021 15:02,089686010824,INDOMIE GORENG SPESIAL,5,2700,0,13500,12260,1240
6/16/2021 15:02,8999999195649,SARI WANGI 25X1.86G,1,6000,0,6000,5050,950
6/16/2021 15:02,8995333060703,TERIGU KOMPAS 1KG,1,10500,0,10500,9816,684
6/16/2021 15:02,711844150027,ABC NANAS,1,13000,0,13000,12241,759
6/16/2021 15:49,8991102989428GT,TANGO CKLT 24G GT,1,7500,0,7500,6092,1408
6/16/2021 16:26,RB,RED BOLD,1,19000,0,19000,17900,1100
6/16/2021 17:22,8998009010569,ULTRA CHO 200,1,5000,0,5000,3830,1170
6/16/2021 18:26,8995333060772,TERIGU GATOT KACA 500GR,2,4500,0,9000,8130,870
6/16/2021 18:26,8995333032113,TERIGU GATOT KACA 1 KG,1,8500,0,8500,8012,488
6/16/2021 19:45,8998866202619,MIE SEDAAP KOREAN SPICY SOUP,1,2500,0,2500,2273,227
6/16/2021 19:45,8998866202930,SEDAAP AYAM JERIT CUP,1,4500,0,4500,3738,762
6/16/2021 19:46,8998989300261,GUDANG GARAM SURYA 12 FILTER,1,18500,0,18500,17200,1300
6/16/2021 19:46,8993176110081,MINYAK KAYU PUTIH 30ML,1,12000,0,12000,9091,2909
6/16/2021 19:52,8992222050418,GATSBY NORMAL 38GR,1,5000,0,5000,3850,1150
6/16/2021 19:52,8998866105507,EMERON LOVELY NOURIST&BRIGHT 100ML,1,4300,0,4300,3800,500
6/16/2021 19:57,8999999033170,LIFEBUOY SHP  KUAT&BERKILAU 170ML,1,16500,0,16500,14950,1550
6/16/2021 19:57,9556040040038,SUSU F&N,1,33000,0,33000,30000,3000
6/16/2021 19:57,8991002307209,COFFE CANDY,1,5000,0,5000,4500,500
6/16/2021 19:57,8992759120264,LARISST 220,1,10000,0,10000,9200,800
6/16/2021 19:57,JGR SHN,JOGER SHINY SACHET,1,500,0,500,437,63
6/16/2021 19:57,8998866202923,FLORIDINA COCO,1,3000,0,3000,2500,500
6/16/2021 20:03,8994867007161,ROKOK PENA GOLD 20,1,17000,0,17000,15500,1500
6/16/2021 20:30,COKLAT,COKLAT COIN,1,500,0,500,425,75
6/16/2021 20:30,MARS,MARSHMELLOW,1,500,0,500,433,67
6/16/2021 20:30,VTM,VITAMIN,2,500,0,1000,850,150
6/16/2021 20:38,8998866200325,MIE SEDAAP SOTO,2,2500,0,5000,3904,1096
6/16/2021 20:38,089686043051,INDOMIE COTO MAKASSAR,2,2800,0,5600,5050,550
6/16/2021 20:40,8992775211434,PILUS GARUDA SAPI PANGGANG,1,5000,0,5000,4810,190
6/16/2021 20:40,8993176110081,MINYAK KAYU PUTIH 30ML,1,12000,0,12000,9091,2909
6/16/2021 20:40,bb,BENG-BENG,2,1500,0,3000,2900,100
6/16/2021 20:40,8996001600269,LE MINERAL 600ML,1,3000,0,3000,1688,1312
6/16/2021 20:41,8996001600269,LE MINERAL 600ML,1,3000,0,3000,1688,1312
6/16/2021 20:41,MARS,MARSHMELLOW,4,500,0,2000,1732,268
6/16/2021 20:41,8993470279651,JOGER CHOCKY BAR,2,1000,0,2000,1734,266
6/16/2021 20:41,8850507002197,TOK TAK FRUIT CANDY,1,7500,0,7500,6250,1250
6/16/2021 20:42,6907992823935,JD SWEETCORN,1,3500,0,3500,3000,500
6/16/2021 20:42,8996001600269,LE MINERAL 600ML,1,3000,0,3000,1688,1312
6/16/2021 20:42,bb,BENG-BENG,1,1500,0,1500,1450,50
6/16/2021 20:43,BALON,BALON CABUT,1,1000,0,1000,900,100
6/16/2021 20:43,COKLAT,COKLAT COIN,1,500,0,500,425,75
6/16/2021 20:44,COKLAT,COKLAT COIN,3,500,0,1500,1275,225
6/16/2021 20:51,8999909010567,234 DJI SAM SOE 16,1,22000,0,22000,21500,500
6/16/2021 21:03,6907992823966,JD BLUEBERRY,1,3500,0,3500,3000,500
6/16/2021 21:03,8990800016757,BB TUTI FRUITTY COSMO,1,8500,0,8500,7600,900
6/16/2021 21:03,8996001440087,ENERGEN KACANG HIJAU,2,1500,0,3000,2300,700
6/16/2021 21:03,8996001440049,ENERGEN,2,1500,0,3000,2400,600
6/16/2021 21:03,8999999558086,RINSO MOLTO FERFUME ESSENSE PWD 44G,3,1000,0,3000,2415,585
6/16/2021 21:03,8992770034175,MASAKO,5,500,0,2500,2500,0
6/16/2021 21:56,8996001600399,LE MINERAL 1500ML,1,5000,0,5000,4042,958
6/16/2021 21:56,8996001600269,LE MINERAL 600ML,1,3000,0,3000,1688,1312
6/16/2021 21:58,8998866202770,MIE SEDAAP SALERO PADANG,3,2500,0,7500,7086,414
6/16/2021 21:58,8998866200301,MIE SEDAAP GORENG,4,2500,0,10000,8092,1908
6/16/2021 21:58,089686043051,INDOMIE COTO MAKASSAR,1,2800,0,2800,2525,275
6/16/2021 22:09,PRG,PARAGO,7,500,0,3500,2800,700
6/16/2021 22:09,bb,BENG-BENG,1,1500,0,1500,1450,50
6/16/2021 22:09,8996001318911,BETTER ISI 4,1,2000,0,2000,1700,300
6/17/2021 10:40,8997007780689,JIZZY MINERAL,2,3000,0,6000,2374,3626
6/17/2021 10:40,8996001600221,KOPIKO 78,1,5000,0,5000,4283,717
6/17/2021 10:40,9556001025272,NESCAFE LATTE 240ML,1,8500,0,8500,7834,666
6/17/2021 10:40,8996001301579,MALKIST CKLT KELAPA PACK,1,6500,0,6500,5400,1100
6/17/2021 10:40,089686060027,POP MIE AYAM JUMBO,1,4500,0,4500,3833,667
6/17/2021 10:43,MOLTO PINK,MOLTO ALL IN ONE 11 ML,2,500,0,1000,800,200
6/17/2021 10:43,8998866608718,DAIA SOFTENER PINK,1,5000,0,5000,4450,550
6/17/2021 11:01,8997009510017,YOU C1000 LEMON,1,10000,0,10000,9166,834
6/17/2021 11:01,8998989500128,GUDANG GARAM MERAH KECIL 12KS,1,14000,0,14000,13000,1000
6/17/2021 11:01,8998989500166,GUDANG GARAM MERAH BESAR 16KS,1,18000,0,18000,17000,1000
6/17/2021 11:42,BALON,BALON CABUT,1,1000,0,1000,900,100
6/17/2021 12:03,8998866200301,MIE SEDAAP GORENG,2,2500,0,5000,4046,954
6/17/2021 12:03,8998866202770,MIE SEDAAP SALERO PADANG,2,2500,0,5000,4724,276
6/17/2021 12:03,8998866200578,MIE SEDAAP KARI KENTAL,4,2500,0,10000,9052,948
6/17/2021 12:03,8998866202343,MIE SEDAAP KOREAN SPICY,4,2500,0,10000,8092,1908
6/17/2021 12:03,089686043617,INDOMIE MIEGHETTI,4,2700,0,10800,9808,992
6/17/2021 12:03,089686400816,SAMBAL EXTRA PEDAS 135ML,1,5500,0,5500,4950,550
6/17/2021 12:03,711844140059,ABC SAUS TIRAM 135 ML,1,8500,0,8500,7750,750
6/17/2021 12:04,8998866202923,FLORIDINA COCO,1,3000,0,3000,2500,500
6/17/2021 14:39,8998866501033,MINYAK GORENG SEDAAP POUCH 2L,3,29000,0,87000,83238,3762
6/17/2021 15:32,8994834006128,TICTIC PEDAS,1,2000,0,2000,1700,300
6/17/2021 15:32,8993470672827,SAKU-SAKU SAPI PANGGANG,1,2000,0,2000,1530,470
6/17/2021 15:32,8996001318911,BETTER ISI 4,1,2000,0,2000,1700,300
6/17/2021 15:32,8992696422735,DNCO CKLT UHT 110ML,1,2500,0,2500,2041,459
6/17/2021 15:32,8998866201452,POTABEE REGULER BBQ BEEF 35GR,1,5000,0,5000,4150,850
6/17/2021 15:32,8991102714631,TANGO TETRA CKLT,1,5000,0,5000,4545,455
6/17/2021 15:32,SST,SUPERSTAR,2,1000,0,2000,1832,168
6/17/2021 15:32,8991102989428SCT,TANGO CKLT 24G SCT,2,1000,0,2000,1218,782
6/17/2021 15:32,8994834003752,TICTIC,1,2000,0,2000,1700,300
6/17/2021 15:35,TG APEL,TEH GELAS APEL,1,2000,0,2000,1178,822
6/17/2021 15:41,BALON,BALON CABUT,1,1000,0,1000,900,100
6/17/2021 15:41,8998989300261,GUDANG GARAM SURYA 12 FILTER,1,18500,0,18500,17200,1300
6/17/2021 16:45,8998989300261,GUDANG GARAM SURYA 12 FILTER,1,18500,0,18500,17200,1300
6/17/2021 16:45,8998866611718,EKONOMI PENCUCI PIRING  LIQ 780ML,1,12000,0,12000,10900,1100
6/17/2021 16:52,8991002105409,KOPI KAPAL API,1,20000,0,20000,18888,1112
6/17/2021 16:52,8997021870595,HOT IN CREAM AROMA THERAPY 60G,1,12500,0,12500,11360,1140
6/17/2021 17:35,8999999037765,PEPSODENT WHITE 225G,1,12000,0,12000,10750,1250
6/17/2021 17:35,8992959117583,SFX DS REG FLOW WING 20,1,5000,0,5000,4288,712
6/17/2021 17:35,8991102230308,BLASTER PINK,1,5000,0,5000,3106,1894
6/17/2021 17:35,8998866105644,EMERON LOVELY SMOTH&BRIGHT 200ML,1,7500,0,7500,6475,1025
6/17/2021 17:35,8991111109107,JB POWDER BEDTIME 75+25g,1,6000,0,6000,5440,560
6/17/2021 18:21,8998989300261,GUDANG GARAM SURYA 12 FILTER,1,18500,0,18500,17200,1300
6/17/2021 18:23,8997213203095,INLITE 7W,1,34000,0,34000,31000,3000
6/17/2021 18:25,8994834005923,SPIX 1000,1,1000,0,1000,850,150
6/17/2021 18:25,8997013790108,BIMURA KACANG TELUR 25G,1,1000,0,1000,875,125
6/17/2021 18:25,8991102989428SCT,TANGO CKLT 24G SCT,1,1000,0,1000,609,391
6/17/2021 18:25,089686021219,INTER MIE GORENG,3,1000,0,3000,2655,345
6/17/2021 18:47,8998866202930,SEDAAP AYAM JERIT CUP,1,4500,0,4500,3738,762
6/17/2021 19:01,8993989311699,CLAS MILD 16 FILTER,1,23000,0,23000,21700,1300
6/17/2021 19:08,8998866201469,POTABEE REGULER BBQ BEEF 68 GR,1,8000,0,8000,7200,800
6/17/2021 19:08,8998866201377,KRISBEE FRIES KENTANG GORENG 68 GR,1,5500,0,5500,4620,880
6/17/2021 19:08,8998866202435,JAPOTA UMAMI JAPANESE SEAWEED 35GR,1,5000,0,5000,4150,850
6/17/2021 19:32,8992761139018,ADES 600ML,2,3500,0,7000,4584,2416
6/17/2021 21:23,8998989300261,GUDANG GARAM SURYA 12 FILTER,1,18500,0,18500,17200,1300
6/17/2021 21:25,8999999571924,MOLTO PURE 1OML,1,5000,0,5000,4800,200
6/17/2021 22:01,8999909002821,MARLBORO BLACK 16,1,22000,0,22000,20850,1150
6/18/2021 11:06,8991002330504,RELAXA MANGO MINT,1,5000,0,5000,4500,500
6/18/2021 11:06,8992696404441,BEAR BRAND 189ML,1,9000,0,9000,7887,1113
6/18/2021 11:06,8994834006128,TICTIC PEDAS,1,2000,0,2000,1700,300
6/18/2021 11:06,BKM,BKM COKLAT SACHET,1,1500,0,1500,1150,350
6/18/2021 11:06,8996001414002SCT,TB CAPPUCINO SCT,1,1500,0,1500,1350,150
6/18/2021 11:08,SLAIM,SLAIM WARNA,1,2000,0,2000,1743,257
6/18/2021 11:08,8991909101016,URBAN MILD 16,1,17000,0,17000,15800,1200
6/18/2021 11:13,8996001600375,LE MINERAL 330ML,2,2000,0,4000,2834,1166
6/18/2021 11:13,8998989110167,SURYA GUDANG GARAM 16 FILTER,1,25000,0,25000,23200,1800
6/18/2021 11:13,GL,GULA 1 LITER,1,11500,0,11500,10500,1000
6/18/2021 11:13,PRG,PARAGO,1,500,0,500,400,100
6/18/2021 11:13,8996001600399,LE MINERAL 1500ML,2,5000,0,10000,8084,1916
6/18/2021 11:13,8998866200325,MIE SEDAAP SOTO,1,2500,0,2500,1952,548
6/18/2021 11:13,8998866200578,MIE SEDAAP KARI KENTAL,1,2500,0,2500,2263,237
6/18/2021 11:13,8991002105409,KOPI KAPAL API,1,20000,0,20000,18888,1112
6/18/2021 11:13,089686011036,INDOMIE GORENG PEDAS,1,2700,0,2700,2452,248
6/18/2021 11:13,089686010343,INDOMIE SOTO MIE,1,2600,0,2600,2367,233
6/18/2021 11:13,089686010107,INDOMIE KALDU AYAM,1,2500,0,2500,2150,350
6/18/2021 11:13,MARS,MARSHMELLOW,4,500,0,2000,1732,268
6/18/2021 11:13,COKLAT,COKLAT COIN,3,500,0,1500,1275,225
6/18/2021 11:13,YP,YUPI,3,250,0,750,624,126
6/18/2021 11:13,8998866202619,MIE SEDAAP KOREAN SPICY SOUP,1,2500,0,2500,2273,227
6/18/2021 11:40,TG,TEH GELAS,1,1000,0,1000,729,271
6/18/2021 12:12,8993226365522,GARAM MEJA GYURI 200GR,2,2000,0,4000,3400,600
6/18/2021 12:12,8995333060703,TERIGU KOMPAS 1KG,1,10500,0,10500,9816,684
6/18/2021 12:23,8998866607315,SOKLIN SOFTERGENT SAKURA 770G & PIRING,1,18000,0,18000,16680,1320
6/18/2021 12:23,8992702000063,INDOMILK COKLAT 370G,1,10000,0,10000,9020,980
6/18/2021 12:23,TBR,TEPUNG BERAS ROSE BRAND,1,8000,0,8000,5800,2200
6/18/2021 12:25,8998866200561,EKOMIE SUPER 600GR,1,10000,0,10000,8615,1385
6/18/2021 12:47,8994935000070,MINYAK DUNIA 450 ML,1,7500,0,7500,6779,721
6/18/2021 12:48,VCO,VITAMIN C500 ORANGE,3,1000,0,3000,1725,1275
6/18/2021 13:17,8997011700123,BIHUN JAGUNG 300GR,2,6000,0,12000,9958,2042
6/18/2021 13:17,8993058105013,EXTRA JOSS,1,12000,0,12000,9773,2227
6/18/2021 13:25,8997002060168,KRP SINGKOG PDS PANDA DUO,1,8000,0,8000,7300,700
6/18/2021 13:25,8997025914059,HATARI SEE HONG,1,6000,0,6000,4911,1089
6/18/2021 13:25,8992761136178,SPRITE 1L,1,10000,0,10000,9000,1000
6/18/2021 13:25,8995333060703,TERIGU KOMPAS 1KG,2,10500,0,21000,19632,1368
6/18/2021 13:25,8999999049478,REXONA WMN RO NATURALS BIO 45 ML,1,16500,0,16500,14900,1600
6/18/2021 13:25,8999999528966,CITRA FRESH WHITE 120ML,1,13200,0,13200,11875,1325
6/18/2021 13:48,TG,TEH GELAS,2,1000,0,2000,1458,542
6/18/2021 13:48,8997028590014,ARGUS 220ML,3,500,0,1500,906,594
6/18/2021 13:48,8998866200882,SUKSESMIE GORENG AYAM KRMS 133GR,1,3500,0,3500,3047,453
6/18/2021 14:04,8992761139018,ADES 600ML,1,3500,0,3500,2292,1208
6/18/2021 14:10,8997028590014,ARGUS 220ML,4,500,0,2000,1208,792
6/18/2021 14:10,JGR SHN,JOGER SHINY SACHET,6,500,0,3000,2622,378
6/18/2021 14:21,8993083929837,BISKITOP BLACK COOKIES,1,27000,0,27000,23700,3300
6/18/2021 14:21,8996001318911,BETTER ISI 4,1,2000,0,2000,1700,300
6/18/2021 14:21,8996001302316,MALKIST ABON SCT,1,1000,0,1000,840,160
6/18/2021 15:05,089686611519,QTELA SINGKONG,1,5000,0,5000,4266,734
6/18/2021 15:05,8886013213208,FRENCH FREIS 2000,2,5000,0,10000,7500,2500
6/18/2021 15:05,8998866201865,KRISBEE PILLOW CHOCOLAVA 120 GR,1,8000,0,8000,7250,750
6/18/2021 15:28,8996001600146,TEH PUCUK HARUM 350ML,1,3000,0,3000,2314,686
6/18/2021 15:28,8886013213208,FRENCH FREIS 2000,2,5000,0,10000,7500,2500
6/18/2021 15:28,6907992823874,JD CRUNCHY CHOCO BLUEBERRY,1,5500,0,5500,4700,800
6/18/2021 15:28,YP,YUPI,6,250,0,1500,1248,252
6/18/2021 16:01,SFX,SOFTEX DAUN SIRIH 1,10,500,0,5000,4130,870
6/18/2021 16:01,8997021300092,LARISSA BAWANG 250GR,1,5500,0,5500,5125,375
6/18/2021 16:01,8997028900837,SABUN PAPAYA,1,10000,0,10000,9375,625
6/18/2021 16:01,8998866603683,FRES&NATURAL SOAP MERAH 65G,1,1800,0,1800,1425,375
6/18/2021 16:01,8998866610742,NOVO FAMILY PINK 76G,1,2000,0,2000,1820,180
6/18/2021 16:01,8998866604512,FRES&NATURAL SOAP VIOLET 65G,1,1800,0,1800,1425,375
6/18/2021 16:03,8999999031602,SARI MURNI 20X1.6G,1,6000,0,6000,5400,600
6/18/2021 16:03,SMC,BIMURA MAKARONI CINCIN 250G,1,10000,0,10000,9300,700
6/18/2021 16:15,8998866608312,GIV PAPAYA KOTAK 76GR,1,2000,0,2000,1820,180
6/18/2021 16:15,8999999516208,ROYCO FDS CHICKEN NEW 230G,3,10000,0,30000,27000,3000
6/18/2021 16:22,BALON,BALON CABUT,6,1000,0,6000,5400,600
6/18/2021 16:22,8991102989428SCT,TANGO CKLT 24G SCT,1,1000,0,1000,609,391
6/18/2021 16:34,089686021219,INTER MIE GORENG,1,1000,0,1000,885,115
6/18/2021 16:34,8998866501033,MINYAK GORENG SEDAAP POUCH 2L,1,29000,0,29000,27746,1254
6/18/2021 17:44,BRS,BERAS BUMN 10KG,1,128000,0,128000,100000,28000
6/18/2021 17:44,BRS5,BERAS BUMN 5KG,1,64000,0,64000,50500,13500
6/18/2021 17:44,8998866201964,MINYAK GORENG SABRINA 2L POUCH,1,28000,0,28000,26753,1247
6/18/2021 17:44,8992736925134,SASA TEPUNG BUMBU SERBAGUNA,1,5500,0,5500,4700,800
6/18/2021 17:44,8997025911058,HATARI SHP KELAPA,1,6000,0,6000,4911,1089
6/18/2021 17:59,8999999195656,SARI WANGI 50X1.85,1,10000,0,10000,9500,500
6/18/2021 17:59,8999999502003,"SARIMURNI RL RB 1,8G",2,1500,0,3000,2414,586
6/18/2021 17:59,8997025911058,HATARI SHP KELAPA,1,6000,0,6000,4911,1089
6/18/2021 18:00,6907992823874,JD CRUNCHY CHOCO BLUEBERRY,1,5500,0,5500,4700,800
6/18/2021 18:00,8992959117583,SFX DS REG FLOW WING 20,1,5000,0,5000,4288,712
6/18/2021 18:00,8997218380074,ICHITAN MILK TEA,1,8000,0,8000,6583,1417
6/18/2021 18:00,8996001600269,LE MINERAL 600ML,3,3000,0,9000,5064,3936
6/18/2021 18:36,8992761164539,NUTRIBOOST ORANGE 300ML,1,6500,0,6500,5300,1200
6/18/2021 18:36,8992761164546,NUTRIBOOST STRAWBERRY 300ML,1,6500,0,6500,5300,1200
6/18/2021 19:41,8999999524722,SUNLIGHT LIME NEW PCH 435ML,2,10000,0,20000,18200,1800
6/18/2021 19:43,8999908389008,HEMAVITON C1000,1,8000,0,8000,6000,2000
6/18/2021 19:43,8992696404441,BEAR BRAND 189ML,1,9000,0,9000,7887,1113
6/18/2021 19:44,8999909096004,SAMPOERNA 16 FILTER,1,24000,0,24000,23000,1000
6/18/2021 20:06,8999909002821,MARLBORO BLACK 16,1,22000,0,22000,20850,1150
6/18/2021 20:23,8992761166229,FRESTEA MARKISA 350ML,1,4500,0,4500,3000,1500
6/18/2021 20:49,ARG,ARGUS 220ML,3,14500,0,43500,37500,6000
6/18/2021 21:02,8992775211434,PILUS GARUDA SAPI PANGGANG,1,5000,0,5000,4810,190
6/18/2021 21:07,711844120433,SAMBAL ABC 600 ML,1,22000,0,22000,20300,1700
6/18/2021 21:48,123,BETREI JAM,1,5500,0,5500,5000,500
6/18/2021 21:48,BALON,BALON CABUT,1,1000,0,1000,900,100
6/18/2021 21:52,8998989300261,GUDANG GARAM SURYA 12 FILTER,1,18500,0,18500,17200,1300
6/18/2021 21:52,8998989500166,GUDANG GARAM MERAH BESAR 16KS,1,18000,0,18000,17000,1000
6/18/2021 21:52,YP,YUPI,2,250,0,500,416,84
6/18/2021 22:11,8993989311279,CLAS MILD 12,1,17000,0,17000,15700,1300
6/18/2021 22:22,8999999549138,CLEAR HIJAB AD SHP HF TMT 160ML,1,25000,0,25000,23870,1130
6/18/2021 22:22,TK,TEPUNG KETAN,1,13000,0,13000,13000,0
6/19/2021 10:48,8999999031930,PEPSODENT TB TRIPLE CLEAN,1,3500,0,3500,2850,650
6/19/2021 10:48,BB,PASEO SMARTY FACIAL TRAVEL PACK 50S GT,1,3000,0,3000,1980,1020
6/19/2021 10:48,8998866500135,HERSPROTEX SOFTCARE WINGS,1,5500,0,5500,4820,680
6/19/2021 10:48,8993560026103,DETTOL SKINCARE,1,20000,0,20000,18524,1476
6/19/2021 10:48,8996001440049,ENERGEN,3,1500,0,4500,3600,900
6/19/2021 11:03,ff,FULLO BLASTO,1,1000,0,1000,995,5
6/19/2021 11:03,BALON,BALON CABUT,4,1000,0,4000,3600,400
6/19/2021 11:19,8992628022156,BIMOLI KLASIK TOUCH 1 LT,1,16000,0,16000,14350,1650
6/19/2021 11:19,8999999559045,SUNLIGHT LIME CREAM 110G,1,2000,0,2000,1800,200
6/19/2021 11:19,8994834003752,TICTIC,1,2000,0,2000,1700,300
6/19/2021 12:10,8998866201377,KRISBEE FRIES KENTANG GORENG 68 GR,1,5500,0,5500,4620,880
6/19/2021 12:10,8994834005923,SPIX 1000,1,1000,0,1000,850,150
6/19/2021 12:10,8991001503114,CHACHA MILK CHOCOLATE 35G,3,5500,0,16500,14700,1800
6/19/2021 12:10,8992696422735,DNCO CKLT UHT 110ML,1,2500,0,2500,2041,459
6/19/2021 12:10,8991001780065,TWISTER BLACK 140G,1,13000,0,13000,11700,1300
6/19/2021 12:10,8992696523067,MILO ACTVGO UHT 180ML,1,4500,0,4500,3515,985
6/19/2021 12:10,8992753184200,FF MILKY STRY 180ML,1,4500,0,4500,3250,1250
6/19/2021 12:59,8998866501033,MINYAK GORENG SEDAAP POUCH 2L,2,29000,0,58000,55492,2508
6/19/2021 12:59,8998866200882,SUKSESMIE GORENG AYAM KRMS 133GR,1,3500,0,3500,3047,453
6/19/2021 13:00,8992696425316,NESCAFE BLACK,1,5000,0,5000,4099,901
6/19/2021 13:00,8998989300261,GUDANG GARAM SURYA 12 FILTER,1,18500,0,18500,17200,1300
6/19/2021 13:39,VTM,VITAMIN,1,500,0,500,425,75
6/19/2021 13:41,089686043617,INDOMIE MIEGHETTI,2,2700,0,5400,4904,496
6/19/2021 14:01,8999999195649,SARI WANGI 25X1.86G,1,6000,0,6000,5050,950
6/19/2021 14:01,8992753102204,BKM COKLAT 370G,1,11300,0,11300,9500,1800
6/19/2021 14:01,SFX,SOFTEX DAUN SIRIH 1,10,500,0,5000,4130,870
6/19/2021 14:03,8996001302620,MALKIST COKLAT SCT,2,1000,0,2000,1680,320
6/19/2021 14:16,8993176110135,MINYAK TELON LANG 30ML,1,10000,0,10000,8167,1833
6/19/2021 14:16,8992946512223,SHINZUI,1,4000,0,4000,2500,1500
6/19/2021 14:16,8993335523363,TOTAL ALMEERA 250G,1,5000,0,5000,4100,900
6/19/2021 14:48,8999909010567,234 DJI SAM SOE 16,1,22000,0,22000,21500,500
6/19/2021 15:16,8999909002821,MARLBORO BLACK 16,1,22000,0,22000,20850,1150
6/19/2021 15:31,RB,RED BOLD,1,19000,0,19000,17900,1100
6/19/2021 15:31,PRG,PARAGO,2,500,0,1000,800,200
6/19/2021 15:58,089686010107,INDOMIE KALDU AYAM,2,2500,0,5000,4300,700
6/19/2021 15:58,089686010824,INDOMIE GORENG SPESIAL,4,2700,0,10800,9808,992
6/19/2021 15:58,8992753100101,BKM FULL CREAM GOLD 370,2,15000,0,30000,28000,2000
6/19/2021 16:39,8996001305058,ROMA SANDWICH KACANG,1,7000,0,7000,5000,2000
6/19/2021 16:39,8996001600146,TEH PUCUK HARUM 350ML,1,3000,0,3000,2314,686
6/19/2021 16:39,8997231980022,O'JELLY MINI STRAWBERRY,1,3000,0,3000,2250,750
6/19/2021 16:39,ff,FULLO BLASTO,2,1000,0,2000,1990,10
6/19/2021 16:39,COKLAT,COKLAT COIN,4,500,0,2000,1700,300
6/19/2021 16:39,HT,HOT-HOT,2,500,0,1000,700,300
6/19/2021 16:40,8999999053000,PONDS OIL CONTROL FACIAL FOAM 50G,1,18400,0,18400,16300,2100
6/19/2021 16:40,8996001600221,KOPIKO 78,1,5000,0,5000,4283,717
6/19/2021 16:40,8991001111883,SILVERQUEEN CHUNKYBAR 33G,1,8000,0,8000,7150,850
6/19/2021 17:16,089686611519,QTELA SINGKONG,2,5000,0,10000,8532,1468
6/19/2021 17:16,8999999036607,LUX TS SOFT ROSE 75G,1,3500,0,3500,2800,700
6/19/2021 17:16,SFX,SOFTEX DAUN SIRIH 1,2,500,0,1000,826,174
6/19/2021 17:16,MOLTO PINK,MOLTO ALL IN ONE 11 ML,7,500,0,3500,2800,700
6/19/2021 17:17,8998666001306SCT,TB CREAMY LATTE SCT,2,1500,0,3000,1980,1020
6/19/2021 17:23,8996001414002SCT,TB CAPPUCINO SCT,2,1500,0,3000,2700,300
6/19/2021 17:34,SLAIM,SLAIM WARNA,1,2000,0,2000,1743,257
6/19/2021 17:34,8991001503114,CHACHA MILK CHOCOLATE 35G,1,5500,0,5500,4900,600
6/19/2021 17:34,8999999528850,CITRA NAT GLOW WHITE 60ML,1,6200,0,6200,5625,575
6/19/2021 17:34,8996001414002SCT,TB CAPPUCINO SCT,2,1500,0,3000,2700,300
6/19/2021 17:34,6907992823850,JD CHOCO CIRLE,1,5500,0,5500,4700,800
6/19/2021 17:35,SLAIM,SLAIM WARNA,1,2000,0,2000,1743,257
6/19/2021 17:58,089686010107,INDOMIE KALDU AYAM,1,2500,0,2500,2150,350
6/19/2021 17:58,089686010343,INDOMIE SOTO MIE,1,2600,0,2600,2367,233
6/19/2021 17:58,089686043617,INDOMIE MIEGHETTI,1,2700,0,2700,2452,248
6/19/2021 17:58,BALON,BALON CABUT,6,1000,0,6000,5400,600
6/19/2021 18:06,8992730002992,HAI CANDY,1,7000,0,7000,6000,1000
6/19/2021 18:09,8994867000179,ROKOK PENA MILD 16,1,14500,0,14500,13500,1000
6/19/2021 18:09,8999999559861,AXE DARK POCKET FRAG 17ML,1,10000,0,10000,8000,2000
6/19/2021 18:09,VTM,VITAMIN,1,500,0,500,425,75
6/19/2021 18:47,8992696404441,BEAR BRAND 189ML,2,9000,0,18000,15774,2226
6/19/2021 18:47,8991001780492,SELAMAT COKLAT,1,13000,0,13000,11800,1200
6/19/2021 19:04,8994867000162,ROKOK PUNDIMAS KRETEK16,1,10000,0,10000,8600,1400
6/19/2021 19:04,8993083929806,BISKITOP COKLAT,1,30000,0,30000,27000,3000
6/19/2021 19:04,GL,GULA 1 LITER,4,11500,0,46000,42000,4000
6/19/2021 19:04,8999999195656,SARI WANGI 50X1.85,1,10000,0,10000,9500,500
6/19/2021 19:09,8998009020186,BUAVITA GUAVA 250ML,1,7000,0,7000,6083,917
6/19/2021 19:09,6907992823829,JD MILKY MILK,1,3000,0,3000,2600,400
6/19/2021 19:27,8994867007161,ROKOK PENA GOLD 20,1,17000,0,17000,15500,1500
6/19/2021 19:35,8998866200301,MIE SEDAAP GORENG,1,2500,0,2500,2023,477
6/19/2021 19:35,MARS,MARSHMELLOW,1,500,0,500,433,67
6/19/2021 19:38,MARS,MARSHMELLOW,2,500,0,1000,866,134
6/19/2021 19:45,8998989110167,SURYA GUDANG GARAM 16 FILTER,1,25000,0,25000,23200,1800
6/19/2021 19:45,6921101219235,YAKUAT JELLY,1,2000,0,2000,1750,250
6/19/2021 19:54,8996001302620,MALKIST COKLAT SCT,1,1000,0,1000,840,160
6/19/2021 19:54,MARS,MARSHMELLOW,1,500,0,500,433,67
6/19/2021 19:56,089686021141,INTER MIE SOTO,5,1000,0,5000,4270,730
6/19/2021 19:57,8992759120264,LARISST 220,1,10000,0,10000,9200,800
6/19/2021 19:57,8992222054973,GATSBY STYLING POMADE 30GR,1,15000,0,15000,13000,2000
6/19/2021 19:57,8999999048488,SUNSILK SHP REFRESH ANTI DDRF 70+21ML,1,10000,0,10000,9075,925
6/19/2021 20:23,6907992823904,JD CRUNCHY CHOCOLATE VAN,2,8000,0,16000,13600,2400
6/19/2021 20:25,8998866200325,MIE SEDAAP SOTO,4,2500,0,10000,7808,2192
6/19/2021 20:25,089686041705,INDOMIE GORENG JUMBO,1,3500,0,3500,3143,357
6/19/2021 20:25,089686010824,INDOMIE GORENG SPESIAL,1,2700,0,2700,2452,248
6/19/2021 20:25,8991004011906,KOPI BORONG,1,10000,0,10000,8333,1667
6/19/2021 21:05,8998989500166,GUDANG GARAM MERAH BESAR 16KS,1,18000,0,18000,17000,1000
6/19/2021 21:58,8999099920714,SGM 1+ VANILA 1000G,1,85000,0,85000,78510,6490
6/19/2021 21:58,8999999048303,SUNSILK HJV RFR HF SOL 170ML,1,22000,0,22000,20020,1980
6/19/2021 22:01,8994867000179,ROKOK PENA MILD 16,1,14500,0,14500,13500,1000
6/19/2021 22:02,8992775211434,PILUS GARUDA SAPI PANGGANG,1,5000,0,5000,4810,190
6/19/2021 22:11,089686010824,INDOMIE GORENG SPESIAL,2,2700,0,5400,4904,496
6/19/2021 22:11,089686010343,INDOMIE SOTO MIE,2,2600,0,5200,4734,466
6/19/2021 22:11,8992388112401,MIE ABC SELERA PEDAS- GORENG AYAM PEDAS LIMAU,1,2600,0,2600,2368,232
6/19/2021 22:11,8998866202435,JAPOTA UMAMI JAPANESE SEAWEED 35GR,1,5000,0,5000,4150,850
6/19/2021 22:11,8992696521797G,MILO 22G GT,1,20000,0,20000,17090,2910
6/19/2021 22:11,711844110113,KECAP ABC 135 ML,1,7000,0,7000,6400,600
6/19/2021 22:11,8999801700030,SUSU FOYU,1,11500,0,11500,10450,1050
6/19/2021 22:11,8998866500135,HERSPROTEX SOFTCARE WINGS,1,5500,0,5500,4820,680
6/19/2021 22:11,8992959107539,SFX WING 23CM,1,5000,0,5000,4091,909
6/19/2021 22:11,8999999024468,CITRA FRESH EHITE 400ML,1,20800,0,20800,18950,1850
6/19/2021 22:11,8998866618298,DAIA CLEAN&FRESH HJB 320GR,1,5000,0,5000,4450,550
6/19/2021 22:11,8999999059781,SUNLIGHT LIME NEW POUCH 210ML,1,5000,0,5000,4300,700
6/19/2021 22:11,8992806145417,SCOTCH BRITE,1,3500,0,3500,2407,1093
6/19/2021 22:11,8999999007768,FAIR&LOVELY MULTIVITAMIN  CREAM 9 ML,1,4500,0,4500,3200,1300
6/19/2021 22:11,6907992823904,JD CRUNCHY CHOCOLATE VAN,1,8000,0,8000,6800,1200
6/19/2021 22:12,8992775315057,GERY SALUT MALKIST COKLAT,1,6500,0,6500,5516,984
6/19/2021 22:28,ARG,ARGUS 220ML,3,14500,0,43500,37500,6000
6/20/2021 10:58,8999909096004,SAMPOERNA 16 FILTER,1,24000,0,24000,23000,1000
6/20/2021 10:58,8996001305041,ROMA SANDWICH CKLT,1,7000,0,7000,5000,2000
6/20/2021 10:58,8999999516208,ROYCO FDS CHICKEN NEW 230G,1,10000,0,10000,9000,1000
6/20/2021 10:58,8999909010567,234 DJI SAM SOE 16,1,22000,0,22000,21500,500
6/20/2021 10:58,8998866202053,POTABEE AYAM BAKAR PEDAS 68GR,1,8000,0,8000,7200,800
6/20/2021 10:58,8998866500708,FLORIDINA ORANGE,1,3000,0,3000,2500,500
6/20/2021 10:58,8997231980015,O'JELLY MINI APPLE,1,3000,0,3000,2250,750
6/20/2021 10:58,6907992825069,JD FRUITY,1,5000,0,5000,4400,600
6/20/2021 10:58,8994867007161,ROKOK PENA GOLD 20,1,17000,0,17000,15500,1500
6/20/2021 11:07,8991002105409,KOPI KAPAL API,1,20000,0,20000,18888,1112
6/20/2021 11:07,GL,GULA 1 LITER,2,11500,0,23000,21000,2000
6/20/2021 11:07,KP,KERIPIK PISANG,2,5000,0,10000,10000,0
6/20/2021 11:07,8992725910424,LISTERINE FRESH BURST 250ML,1,19000,0,19000,17550,1450
6/20/2021 11:07,8999999030179,PEPSODENT ACTION 123 COMPLETE 75G,1,6700,0,6700,5170,1530
6/20/2021 11:07,BTS,BIMURA TARO SEAWEED 250G,1,10000,0,10000,9300,700
6/20/2021 11:07,8998866105491,EMERON LOVELY SMOTH&BRIGHT 100ML,1,4300,0,4300,3800,500
6/20/2021 11:07,8998866610261,DAIA VIOLET GUSSET BAG 290 GR,1,5000,0,5000,4450,550
6/20/2021 11:07,8997011700123,BIHUN JAGUNG 300GR,1,6000,0,6000,4979,1021
6/20/2021 11:07,8998866200882,SUKSESMIE GORENG AYAM KRMS 133GR,2,3500,0,7000,6094,906
6/20/2021 11:07,8997231980022,O'JELLY MINI STRAWBERRY,1,3000,0,3000,2250,750
6/20/2021 11:07,8991102228053,TEH GELAS BOTOL,1,3000,0,3000,1695,1305
6/20/2021 11:09,KRTS,KERTAS NASI,1,10000,0,10000,7200,2800
6/20/2021 11:26,8998866201827,JAVANA GULA BATU 350ML,1,3000,0,3000,2150,850
6/20/2021 12:40,GL,GULA 1 LITER,4,11500,0,46000,42000,4000
6/20/2021 12:41,8991102022347,SIKAT GIGI FORMULA RIPPLE,1,5000,0,5000,4583,417
6/20/2021 12:49,8998866202343,MIE SEDAAP KOREAN SPICY,5,2500,0,12500,10115,2385
6/20/2021 12:50,8994834006128,TICTIC PEDAS,2,2000,0,4000,3400,600
6/20/2021 13:11,8996001318911,BETTER ISI 4,1,2000,0,2000,1700,300
6/20/2021 13:11,8994834006128,TICTIC PEDAS,1,2000,0,2000,1700,300
6/20/2021 13:11,8991102989534,TANGO VANILA 24G,1,1000,0,1000,609,391
6/20/2021 13:14,8998898830125,KKB ENER-G ANGGUR,1,5500,0,5500,4824,676
6/20/2021 13:14,YP,YUPI,2,250,0,500,416,84
6/20/2021 13:32,8997231980022,O'JELLY MINI STRAWBERRY,2,3000,0,6000,4500,1500
6/20/2021 13:32,JGR SHN,JOGER SHINY SACHET,2,500,0,1000,874,126
6/20/2021 13:32,MARS,MARSHMELLOW,6,500,0,3000,2598,402
6/20/2021 16:55,8998898830125,KKB ENER-G ANGGUR,2,5500,0,11000,9648,1352
6/20/2021 16:58,8992959002032,SWEETY SILVER PANTS L 36,1,72000,0,72000,68182,3818
6/20/2021 16:59,8999999559854,AXE BLACK POCKET FRAG 17ML,1,10000,0,10000,8000,2000
6/20/2021 17:00,GL,GULA 1 LITER,2,11500,0,23000,21000,2000
6/20/2021 17:07,8991102387286SCT,TANGO LONG CKLT 47G,1,2000,0,2000,1551,449
6/20/2021 17:07,8994834005923,SPIX 1000,1,1000,0,1000,850,150
6/20/2021 17:07,8999999059316,LIFEBUOY TS MILDCARE 75G,1,3000,0,3000,2640,360
6/20/2021 17:16,8996001302620,MALKIST COKLAT SCT,2,1000,0,2000,1680,320
6/20/2021 17:17,JD VM,JD VANILLA MILKSHAKE,1,5000,0,5000,4300,700
6/20/2021 17:35,8992761166229,FRESTEA MARKISA 350ML,1,4500,0,4500,3000,1500
6/20/2021 17:35,YP,YUPI,2,250,0,500,416,84
6/20/2021 18:33,8998989110129,SURYA KECIL MERAH 12KS,1,18000,0,18000,16450,1550
6/20/2021 18:33,8998989110167,SURYA GUDANG GARAM 16 FILTER,1,25000,0,25000,23200,1800
6/20/2021 18:34,089686043273,INDOMIE SAMBAL RICA,2,2700,0,5400,4904,496
6/20/2021 19:46,8993176110081,MINYAK KAYU PUTIH 30ML,1,12000,0,12000,9091,2909
6/20/2021 19:46,8993470671752,JOGER STICK DUO KACANG,1,1000,0,1000,850,150
6/20/2021 20:01,8991102987639,WFR TANGO LONG VNL 130G,1,5000,0,5000,3773,1227
6/20/2021 20:01,8992959953044,SWEETY BRONZE XL1,1,2500,0,2500,2250,250
6/20/2021 20:05,ff,FULLO BLASTO,2,1000,0,2000,1990,10
6/20/2021 20:38,8991102384841,WFR TANGO LONG CKLT 130G,1,5000,0,5000,4345,655
6/20/2021 21:13,GL,GULA 1 LITER,1,11500,0,11500,10500,1000
6/20/2021 21:13,8998989300261,GUDANG GARAM SURYA 12 FILTER,1,18500,0,18500,17200,1300
6/20/2021 21:13,8995333060772,TERIGU GATOT KACA 500GR,1,4500,0,4500,4065,435
6/20/2021 21:30,8998898337440,TOLAK ANGIN CARE 10ML,1,10000,0,10000,7893,2107
6/20/2021 22:07,8999909000377,SAMPOERNA AVOLUTION,1,30000,0,30000,28450,1550
6/21/2021 10:49,SMC,BIMURA MAKARONI CINCIN 250G,1,10000,0,10000,9300,700
6/21/2021 10:49,MARS,MARSHMELLOW,7,500,0,3500,3031,469
6/21/2021 10:49,8998866108126,POSH HIJAB WINTER MAGIC 150ML,1,19500,0,19500,17500,2000
6/21/2021 11:13,8999909028234,234 DJI SAM SOE 12,1,17000,0,17000,15850,1150
6/21/2021 11:16,8992775312414,GERY CHOCO HEZELNUT,1,11000,0,11000,9983,1017
6/21/2021 11:16,8992222091961,PUCELLE MIST COL SPRAY 75ML,1,13000,0,13000,11650,1350
6/21/2021 12:13,8992761002039,FANTA STRAWBERRY PET 390 ML,1,5500,0,5500,4300,1200
6/21/2021 12:26,8992761002039,FANTA STRAWBERRY PET 390 ML,1,5500,0,5500,4300,1200
6/21/2021 12:54,8999909010567,234 DJI SAM SOE 16,1,22000,0,22000,21500,500
6/21/2021 13:21,8999909096004,SAMPOERNA 16 FILTER,1,24000,0,24000,23000,1000
6/21/2021 13:33,8998989300261,GUDANG GARAM SURYA 12 FILTER,1,18500,0,18500,17200,1300
6/21/2021 13:33,YP,YUPI,2,250,0,500,416,84
6/21/2021 13:47,9556040040038,SUSU F&N,1,33000,0,33000,30000,3000
6/21/2021 13:50,TG,TEH GELAS,1,1000,0,1000,729,271
6/21/2021 14:22,8999801700030,SUSU FOYU,1,11500,0,11500,10450,1050
6/21/2021 14:22,COKLAT,COKLAT COIN,1,500,0,500,425,75
6/21/2021 14:29,8999999192150,ROYCO FDS CHICKEN 100GR,4,5000,0,20000,17200,2800
6/21/2021 14:29,8999999516208,ROYCO FDS CHICKEN NEW 230G,1,10000,0,10000,9000,1000
6/21/2021 15:43,8991102300421,WFR TANGO COKLAT 176GR,1,10000,0,10000,8694,1306
6/21/2021 15:43,8998866202060,POTABEE AYAM BAKAR PEDAS 35 GR,1,5000,0,5000,4150,850
6/21/2021 15:43,8992696422735,DNCO CKLT UHT 110ML,1,2500,0,2500,2041,459
6/21/2021 15:43,COKLAT,COKLAT COIN,5,500,0,2500,2125,375
6/21/2021 15:47,8993989311699,CLAS MILD 16 FILTER,1,23000,0,23000,21700,1300
6/21/2021 16:20,8998866201964,MINYAK GORENG SABRINA 2L POUCH,1,28000,0,28000,26753,1247
6/21/2021 16:20,COKLAT,COKLAT COIN,4,500,0,2000,1700,300
6/21/2021 16:45,8996001600221,KOPIKO 78,1,5000,0,5000,4283,717
6/21/2021 16:45,8998866618298,DAIA CLEAN&FRESH HJB 320GR,1,5000,0,5000,4450,550
6/21/2021 16:45,KP,KERIPIK PISANG,1,5000,0,5000,5000,0
6/21/2021 16:45,8992759120264,LARISST 220,1,10000,0,10000,9200,800
6/21/2021 16:45,8992388111206,MIE ABC SELERA PEDAS-GULAI AYAM PEDAS,1,2500,0,2500,2022,478
6/21/2021 16:45,8992388112401,MIE ABC SELERA PEDAS- GORENG AYAM PEDAS LIMAU,1,2600,0,2600,2368,232
6/21/2021 16:55,8994867000179,ROKOK PENA MILD 16,1,14500,0,14500,13500,1000
6/21/2021 16:59,8996001440520,ENERGEN JAGUNG,1,1500,0,1500,1150,350
6/21/2021 17:04,8997218380135,ICHITAN GREEN TEA,1,8000,0,8000,6583,1417
6/21/2021 17:04,8991001121400,SILVERQUEEN ALMOND 65G,1,15000,0,15000,13200,1800
6/21/2021 17:15,8999999710880,PEPSODENT ACTION123 HERBAL 75G,1,7500,0,7500,6650,850
6/21/2021 17:54,8992628020152,BIMOLI POUCH 2L,1,31000,0,31000,29800,1200
6/21/2021 17:54,6907992823591,JD STRAW MILKSHAKE,2,5000,0,10000,8600,1400
6/21/2021 17:54,6907992823904,JD CRUNCHY CHOCOLATE VAN,4,8000,0,32000,27200,4800
6/21/2021 17:54,JD VM,JD VANILLA MILKSHAKE,1,5000,0,5000,4300,700
6/21/2021 17:54,6907992824963,JD MILKY CHOCOLATE,1,3000,0,3000,2600,400
6/21/2021 18:02,8996001600375,LE MINERAL 330ML,1,42000,0,42000,34008,7992
6/21/2021 18:10,6907992825076,JD WATERMELON APPLE,1,2000,0,2000,1700,300
6/21/2021 18:10,8997028590014,ARGUS 220ML,2,500,0,1000,604,396
6/21/2021 18:47,8994867000162,ROKOK PUNDIMAS KRETEK16,1,10000,0,10000,8600,1400
6/21/2021 20:32,MARS,MARSHMELLOW,6,500,0,3000,2598,402
6/21/2021 20:48,8999999042646,RINSO MOLTO ROSE FRESH LIQ 40ML,1,6000,0,6000,4817,1183
6/21/2021 20:52,8997231980022,O'JELLY MINI STRAWBERRY,1,3000,0,3000,2250,750
6/21/2021 21:30,8992775913000GT,CHOCOLATOS CKLT DRINK,1,18000,0,18000,15862,2138
6/21/2021 21:30,8992753100101,BKM FULL CREAM GOLD 370,1,15000,0,15000,14000,1000
6/21/2021 21:31,8996001600221,KOPIKO 78,2,5000,0,10000,8566,1434
6/21/2021 21:31,8996001600146,TEH PUCUK HARUM 350ML,1,3000,0,3000,2314,686
6/21/2021 21:31,SMC,BIMURA MAKARONI CINCIN 250G,1,10000,0,10000,9300,700
6/21/2021 22:11,MARS,MARSHMELLOW,2,500,0,1000,866,134
6/22/2021 14:15,8992959953327,SWEETY BRONZE L52,1,85000,0,85000,80304,4696
6/22/2021 14:42,8997025914059,HATARI SEE HONG,1,6000,0,6000,4911,1089
6/22/2021 14:42,8999999195649,SARI WANGI 25X1.86G,1,6000,0,6000,5050,950
6/22/2021 16:18,089686010343,INDOMIE SOTO MIE,5,2600,0,13000,11835,1165
6/22/2021 16:18,089686010190,INDOMIE KARI AYAM,5,2800,0,14000,12610,1390
6/22/2021 16:19,8999909096004,SAMPOERNA 16 FILTER,1,24000,0,24000,23000,1000
6/22/2021 16:28,8998866108003,EMERON HJB CLEANFRESH 10ML,1,5000,0,5000,4185,815
6/22/2021 18:05,8998866200578,MIE SEDAAP KARI KENTAL,2,2500,0,5000,4526,474
6/22/2021 18:05,8997012321174,CHILLI-QU,1,1000,0,1000,800,200
6/22/2021 19:02,8994834006128,TICTIC PEDAS,1,2000,0,2000,1700,300
6/22/2021 19:38,089686021127,INTER MIE KALDU,1,1000,0,1000,813,187
6/22/2021 19:38,8998866202343,MIE SEDAAP KOREAN SPICY,2,2500,0,5000,4046,954
6/22/2021 19:44,8992959610114,HN PANTS XL 44,1,78000,0,78000,72273,5727
6/22/2021 19:44,8999908389008,HEMAVITON C1000,1,8000,0,8000,6000,2000
6/22/2021 19:44,8992696523081,MILO UHT 110ML,1,2500,0,2500,1962,538
6/22/2021 19:44,8997210107877,VORTEX SMART 3,1,5000,0,5000,4750,250
6/22/2021 19:52,8994867000179,ROKOK PENA MILD 16,1,14500,0,14500,13500,1000
6/22/2021 21:47,LT,LIPSTIK HANASUI,1,27000,0,27000,27000,0
6/22/2021 21:47,8999999007768,FAIR&LOVELY MULTIVITAMIN  CREAM 9 ML,1,4500,0,4500,3200,1300
6/22/2021 21:47,MOBIL,GULA GULA HP,1,2000,0,2000,1700,300
6/22/2021 21:47,8991001503114,CHACHA MILK CHOCOLATE 35G,1,5500,0,5500,4900,600
6/22/2021 21:47,VTM,VITAMIN,2,500,0,1000,850,150
6/22/2021 21:47,8996001600399,LE MINERAL 1500ML,1,5000,0,5000,4042,958
6/22/2021 21:47,8992775211410,PILUS GARUDA PEDAS,1,5000,0,5000,4886,114
6/22/2021 21:51,GL,GULA 1 LITER,4,11500,0,46000,42000,4000
6/22/2021 22:31,8998989300261,GUDANG GARAM SURYA 12 FILTER,1,18500,0,18500,17200,1300
6/22/2021 22:31,089686011036,INDOMIE GORENG PEDAS,1,2700,0,2700,2452,248
6/22/2021 22:43,8996001440124,ENERGEN VANILA,2,1500,0,3000,2300,700
6/22/2021 22:43,8998866202060,POTABEE AYAM BAKAR PEDAS 35 GR,1,5000,0,5000,4150,850
6/22/2021 22:43,8996001600375,LE MINERAL 330ML,2,2000,0,4000,2834,1166
6/22/2021 22:43,8994834003752,TICTIC,1,2000,0,2000,1700,300
6/22/2021 22:43,8996001305041,ROMA SANDWICH CKLT,1,7000,0,7000,5000,2000
6/22/2021 22:43,089686010824,INDOMIE GORENG SPESIAL,1,2700,0,2700,2452,248
6/22/2021 22:43,8999999059781,SUNLIGHT LIME NEW POUCH 210ML,1,5000,0,5000,4300,700
6/22/2021 22:43,8998866200882,SUKSESMIE GORENG AYAM KRMS 133GR,1,3500,0,3500,3047,453
6/22/2021 22:43,8998866613262,SUKSESMIE SOTO 111 GR,1,3500,0,3500,2770,730
6/23/2021 11:43,GL,GULA 1 LITER,1,11500,0,11500,10500,1000
6/23/2021 12:27,8992628022156,BIMOLI KLASIK TOUCH 1 LT,1,16000,0,16000,14350,1650
6/23/2021 12:43,089686043617,INDOMIE MIEGHETTI,1,2700,0,2700,2452,248
6/23/2021 12:43,8998866200561,EKOMIE SUPER 600GR,1,10000,0,10000,8615,1385
6/23/2021 12:43,8998866608305,GIV BENGKOANG KOTAK 76G,2,2000,0,4000,3640,360
6/23/2021 12:43,8999999534097,PEPSODENT PGB FCM 75G,1,5000,0,5000,3850,1150
6/23/2021 12:49,ASTOR,ASTOR SCT,13,1000,0,13000,10725,2275
6/23/2021 12:50,9556001025272,NESCAFE LATTE 240ML,1,8500,0,8500,7834,666
6/23/2021 12:50,ASTOR,ASTOR SCT,3,1000,0,3000,2475,525
6/23/2021 12:50,YP,YUPI,2,250,0,500,416,84
6/23/2021 13:55,8992775002155,CHOCOLATOS DRINK,1,4000,0,4000,3520,480
6/23/2021 14:05,8993989311699,CLAS MILD 16 FILTER,1,23000,0,23000,21700,1300
6/23/2021 14:27,8999999502003,"SARIMURNI RL RB 1,8G",12,1500,0,18000,14484,3516
6/23/2021 15:35,8999999502003,"SARIMURNI RL RB 1,8G",2,1500,0,3000,2414,586
6/23/2021 16:41,6907992825045,JD CRUNCHY MATCHA CHEESE,1,8000,0,8000,7000,1000
6/23/2021 17:51,8991004011906,KOPI BORONG,1,10000,0,10000,8333,1667
6/23/2021 17:51,8998898847109,KOPI JAHE,2,1500,0,3000,2360,640
6/23/2021 17:51,711844110083,KECAP ABC 275 ML,1,14500,0,14500,13400,1100
6/23/2021 17:51,8992979120013,TOTAL BUNGA SOFTENER,1,13000,0,13000,11532,1468
6/23/2021 18:00,8998866202619,MIE SEDAAP KOREAN SPICY SOUP,1,2500,0,2500,2273,227
6/23/2021 18:29,8994834005923,SPIX 1000,2,1000,0,2000,1700,300
6/23/2021 18:33,8992696404441,BEAR BRAND 189ML,1,9000,0,9000,7887,1113
6/23/2021 18:33,6907992824963,JD MILKY CHOCOLATE,2,3000,0,6000,5200,800
6/23/2021 18:36,8998989500166,GUDANG GARAM MERAH BESAR 16KS,2,18000,0,36000,34000,2000
6/23/2021 18:50,8997018460150,MARLBORO ICE BURST 20,1,30000,0,30000,27750,2250
6/23/2021 18:55,8992775211434,PILUS GARUDA SAPI PANGGANG,1,5000,0,5000,4810,190
6/23/2021 19:11,MARS,MARSHMELLOW,2,500,0,1000,866,134
6/23/2021 19:15,8999909002821,MARLBORO BLACK 16,1,22000,0,22000,20850,1150
6/23/2021 19:36,8992959508879,SWEETY SILVER PANTS L 7,1,16800,0,16800,15228,1572
6/23/2021 19:59,8998989300261,GUDANG GARAM SURYA 12 FILTER,1,18500,0,18500,17200,1300
6/23/2021 20:01,8991111109121,JB POWDER BLOSSOM 75+25G,1,6000,0,6000,5430,570
6/23/2021 21:29,8994867000162,ROKOK PUNDIMAS KRETEK16,1,10000,0,10000,8600,1400
6/23/2021 21:34,6907992824963,JD MILKY CHOCOLATE,1,3000,0,3000,2600,400
6/23/2021 21:46,8998866200646,KOPI TOP MURNI,1,11000,0,11000,9600,1400
6/23/2021 21:48,8998866200646,KOPI TOP MURNI,1,11000,0,11000,9600,1400
6/23/2021 21:48,8998866619288,SOKLIN ANTISEP,1,5000,0,5000,4159,841
6/23/2021 21:48,8999999037765,PEPSODENT WHITE 225G,1,12000,0,12000,10750,1250
6/23/2021 22:14,8992761002039,FANTA STRAWBERRY PET 390 ML,1,5500,0,5500,4300,1200
6/23/2021 22:14,8992696523067,MILO ACTVGO UHT 180ML,1,4500,0,4500,3515,985
6/23/2021 22:16,8998989300261,GUDANG GARAM SURYA 12 FILTER,1,18500,0,18500,17200,1300
6/23/2021 22:34,089686010343,INDOMIE SOTO MIE,1,2600,0,2600,2367,233
6/23/2021 22:34,089686010824,INDOMIE GORENG SPESIAL,1,2700,0,2700,2452,248
6/23/2021 22:34,089686010107,INDOMIE KALDU AYAM,1,2500,0,2500,2150,350
6/23/2021 22:34,089686043204,INDOMIE MIE ACEH,1,2700,0,2700,2452,248
6/23/2021 22:34,ASTOR,ASTOR SCT,1,1000,0,1000,825,175
6/23/2021 22:36,ASTOR,ASTOR SCT,1,1000,0,1000,825,175
6/23/2021 22:36,MARS,MARSHMELLOW,1,500,0,500,433,67
6/23/2021 22:36,VTM,VITAMIN,1,500,0,500,425,75
6/24/2021 11:26,8996001600269,LE MINERAL 600ML,1,3000,0,3000,1688,1312
6/24/2021 11:26,8993989311699,CLAS MILD 16 FILTER,1,23000,0,23000,21700,1300
6/24/2021 11:26,8997012321204,MAXX BUMBU BALADO,1,5000,0,5000,4100,900
6/24/2021 11:30,8996001355978,BENG-BENG SHARE IT 9.5G,1,10000,0,10000,8700,1300
6/24/2021 11:30,8992761164478,FRESTEA MILK TEA,1,8000,0,8000,6575,1425
6/24/2021 11:30,6907992825076,JD WATERMELON APPLE,1,2000,0,2000,1700,300
6/24/2021 11:36,9556001004673,MILO NESTLE MALAYSIA ACTIVE GO,1,85000,0,85000,80000,5000
6/24/2021 11:36,711844130128,ABC SAUS TOMAT 275 ML,1,10000,0,10000,8800,1200
6/24/2021 11:36,089686010343,INDOMIE SOTO MIE,4,2600,0,10400,9468,932
6/24/2021 11:36,8999999049454,REXONA WMN RO FREE SPIRIT 45 ML,1,15000,0,15000,13550,1450
6/24/2021 11:37,8998866200325,MIE SEDAAP SOTO,2,2500,0,5000,3904,1096
6/24/2021 11:46,GL,GULA 1 LITER,2,11500,0,23000,21000,2000
6/24/2021 11:49,8992984820410,BAKING POWDER,1,6500,0,6500,5500,1000
6/24/2021 11:49,8998866501026,MINYAK GORENG SEDAAP POUCH 1 L,1,15000,0,15000,14110,890
6/24/2021 12:18,COKLAT,COKLAT COIN,2,500,0,1000,850,150
6/24/2021 12:18,VTM,VITAMIN,2,500,0,1000,850,150
6/24/2021 12:21,BAYFLAST,BAYPLAST,4,500,0,2000,1400,600
6/24/2021 14:02,8998666003089SCT,TB GILUX MIX SCT,1,1000,0,1000,800,200
6/24/2021 14:02,9311931024036,COFFEEMIX SCT,1,1500,0,1500,1200,300
6/24/2021 14:02,8992959971093,SFX COMFORT SLIME 6,1,8500,0,8500,7798,702
6/24/2021 14:02,8998866202770,MIE SEDAAP SALERO PADANG,2,2500,0,5000,4724,276
6/24/2021 14:02,8998866200325,MIE SEDAAP SOTO,2,2500,0,5000,3904,1096
6/24/2021 14:03,8998866106535,EMERON LOVELY NAT GREEN 200ML,1,6000,0,6000,5075,925
6/24/2021 14:05,8998866501033,MINYAK GORENG SEDAAP POUCH 2L,1,29000,0,29000,27746,1254
6/24/2021 14:16,8997028590014,ARGUS 220ML,2,500,0,1000,604,396
6/24/2021 14:34,8997011700123,BIHUN JAGUNG 300GR,1,6000,0,6000,4979,1021
6/24/2021 14:34,ff,FULLO BLASTO,1,1000,0,1000,995,5
6/24/2021 15:01,8998989110167,SURYA GUDANG GARAM 16 FILTER,1,25000,0,25000,23200,1800
6/24/2021 15:11,GL,GULA 1 LITER,3,11500,0,34500,31500,3000
6/24/2021 15:11,8998866201964,MINYAK GORENG SABRINA 2L POUCH,1,28000,0,28000,26753,1247
6/24/2021 15:11,8992759120264,LARISST 220,1,10000,0,10000,9200,800
6/24/2021 15:11,089686043204,INDOMIE MIE ACEH,3,2700,0,8100,7356,744
6/24/2021 15:11,8992775310212,GERY PASTA COKELAT,1,18000,0,18000,16029,1971
6/24/2021 16:58,8999999706173,PEPSODENT WHITE 120G,1,6700,0,6700,5940,760
6/24/2021 16:58,6907992823591,JD STRAW MILKSHAKE,1,5000,0,5000,4300,700
6/24/2021 16:59,8994867000179,ROKOK PENA MILD 16,2,14500,0,29000,27000,2000
6/24/2021 17:22,8999999195656,SARI WANGI 50X1.85,1,10000,0,10000,9500,500
6/24/2021 17:22,8999999046989,LIFEBUOY MILD CARE 60G,1,10000,0,10000,7645,2355
6/24/2021 17:25,8996001600269,LE MINERAL 600ML,1,3000,0,3000,1688,1312
6/24/2021 17:25,8992761164546,NUTRIBOOST STRAWBERRY 300ML,1,6500,0,6500,5300,1200
6/24/2021 17:25,8992761164539,NUTRIBOOST ORANGE 300ML,1,6500,0,6500,5300,1200
6/24/2021 17:25,089686834307,FREISS LECI,5,11000,0,55000,43750,11250
6/24/2021 17:25,711844150027,ABC NANAS,1,13000,0,13000,12241,759
6/24/2021 17:25,089686834055,FREISS JERUK,4,11000,0,44000,35000,9000
6/24/2021 17:26,8991102303309,WFR TANGO SBJ 176G,1,10000,0,10000,8694,1306
6/24/2021 17:42,8992959954058,SWEETY BRONZE NB 44,1,48000,0,48000,45682,2318
6/24/2021 17:42,8996001600375,LE MINERAL 330ML,1,2000,0,2000,1417,583
6/24/2021 18:06,LT,LIPSTIK HANASUI,1,27000,0,27000,27000,0
6/24/2021 18:06,8998866107464,POSH FRESH SPIRIT 150ML,1,19500,0,19500,17500,2000
6/24/2021 20:07,8992761139018,ADES 600ML,1,3500,0,3500,2292,1208
6/24/2021 20:07,8886013213208,FRENCH FREIS 2000,2,5000,0,10000,7500,2500
6/24/2021 20:07,8998009010569,ULTRA CHO 200,2,5000,0,10000,7660,2340
6/24/2021 20:07,COKLAT,COKLAT COIN,10,500,0,5000,4250,750
6/24/2021 20:07,JGR SHN,JOGER SHINY SACHET,3,500,0,1500,1311,189
6/24/2021 21:08,8999999706111,PEPSODENT WHITE 25G,1,2000,0,2000,1450,550
6/24/2021 21:08,8992959117583,SFX DS REG FLOW WING 20,1,5000,0,5000,4288,712
6/24/2021 21:41,8996001440049,ENERGEN,2,1500,0,3000,2400,600
6/24/2021 21:42,8998866202244,EKOMIE BUMBU KALDU AYAM,3,1000,0,3000,2394,606
6/24/2021 21:42,8992696520103SCT,DNCO CKLT 39G SCT,2,3500,0,7000,5914,1086
6/24/2021 21:43,8994867000179,ROKOK PENA MILD 16,1,14500,0,14500,13500,1000
6/24/2021 21:43,8998989300261,GUDANG GARAM SURYA 12 FILTER,1,18500,0,18500,17200,1300
6/24/2021 21:43,8993989311279,CLAS MILD 12,1,17000,0,17000,15700,1300
6/24/2021 21:43,8992696521797SCT,MILO ACT GO 22G SCT,1,2000,0,2000,1553,447
6/24/2021 22:01,PRG,PARAGO,6,500,0,3000,2400,600
6/25/2021 10:57,8998866618298,DAIA CLEAN&FRESH HJB 320GR,1,5000,0,5000,4450,550
6/25/2021 10:57,8998666001924SCT,TB TORA CAFE CHOCO LATTE SCT,1,1000,0,1000,780,220
6/25/2021 11:05,MOLTO PINK,MOLTO ALL IN ONE 11 ML,4,500,0,2000,1600,400
6/25/2021 11:05,MARS,MARSHMELLOW,13,500,0,6500,5629,871
6/25/2021 11:05,8992761145026,SPRITE PET 250ML,3,3500,0,10500,7251,3249
6/25/2021 11:05,ASTOR,ASTOR SCT,1,1000,0,1000,825,175
6/25/2021 11:05,bb,BENG-BENG,1,1500,0,1500,1450,50
6/25/2021 11:05,8998989300261,GUDANG GARAM SURYA 12 FILTER,1,18500,0,18500,17200,1300
6/25/2021 11:05,8992702000018,INDOMILK 370G,1,10000,0,10000,9020,980
6/25/2021 11:05,8998866202244,EKOMIE BUMBU KALDU AYAM,5,1000,0,5000,3990,1010
6/25/2021 11:34,ROTI,ROTI 2000,2,2000,0,4000,3600,400
6/25/2021 12:55,8999909010567,234 DJI SAM SOE 16,1,22000,0,22000,21500,500
6/25/2021 14:22,8994935000070,MINYAK DUNIA 450 ML,1,7500,0,7500,6779,721
6/25/2021 14:22,ROTI,ROTI 2000,1,2000,0,2000,1800,200
6/25/2021 14:23,8993989311699,CLAS MILD 16 FILTER,1,23000,0,23000,21700,1300
6/25/2021 14:23,8996001600269,LE MINERAL 600ML,1,3000,0,3000,1688,1312
6/25/2021 14:23,VTM,VITAMIN,2,500,0,1000,850,150
6/25/2021 14:42,8999999719760,PONDS CLEAR SOL SHAKE&CLEAN 100ML,1,20000,0,20000,18000,2000
6/25/2021 14:42,8998989500166,GUDANG GARAM MERAH BESAR 16KS,2,18000,0,36000,34000,2000
6/25/2021 15:42,GL,GULA 1 LITER,1,11500,0,11500,10500,1000
6/25/2021 16:18,8886013213208,FRENCH FREIS 2000,7,5000,0,35000,26250,8750
6/25/2021 16:18,8994834003752,TICTIC,1,2000,0,2000,1700,300
6/25/2021 16:18,8994834003752,TICTIC,1,2000,0,2000,1700,300
6/25/2021 16:55,MARS,MARSHMELLOW,4,500,0,2000,1732,268
6/25/2021 17:46,711844610095,LARISSA UDANG 500 GR,2,11000,0,22000,19580,2420
6/25/2021 18:07,8998866610438,SOKLIN SOFTERGENT RED BAG 770G & PIRING,1,18000,0,18000,16680,1320
6/25/2021 18:07,8994834005923,SPIX 1000,3,1000,0,3000,2550,450
6/25/2021 18:07,ROTI,ROTI 2000,2,2000,0,4000,3600,400
6/25/2021 18:17,8992959117583,SFX DS REG FLOW WING 20,1,5000,0,5000,4288,712
6/25/2021 18:17,8999999035495,VASELINE INSTA FAIR 190ML,1,33100,0,33100,30855,2245
6/25/2021 18:17,8999999549305,VASELINE SUPERFOOD CRANBERRY 200ML,1,26000,0,26000,23940,2060
6/26/2021 21:16,8991102989381,TANGO LONG BUBBLEGUM 130G,1,5000,0,5000,4345,655
6/26/2021 21:36,8991102989381,TANGO LONG BUBBLEGUM 130G,1,5000,0,5000,4345,655
6/26/2021 21:36,8998866202343,MIE SEDAAP KOREAN SPICY,1,2500,0,2500,2023,477
6/26/2021 21:45,8998989110167,SURYA GUDANG GARAM 16 FILTER,1,25000,0,25000,23200,1800
6/26/2021 21:59,8998009040023,TEH KOTAK,1,5000,0,5000,2827,2173
6/26/2021 22:02,8991102989381,TANGO LONG BUBBLEGUM 130G,1,5000,0,5000,4345,655
6/26/2021 22:02,8996001355978,BENG-BENG SHARE IT 9.5G,2,10000,0,20000,17400,2600
6/27/2021 20:38,gula,GULA,1,11500,0,11500,10000,1500
6/27/2021 20:44,8998989110167,SURYA GUDANG GARAM 16 FILTER,1,25000,0,25000,23200,1800
6/27/2021 20:59,8992959974018,SFX SIRIH 36CM 12+1,1,17000,0,17000,15958,1042
6/27/2021 20:59,8992959508954,SWEETY SILVER PANTS S 66,1,92000,0,92000,88788,3212
6/27/2021 20:59,8991909101016,URBAN MILD 16,1,17000,0,17000,15800,1200
6/27/2021 21:25,8998989300261,GUDANG GARAM SURYA 12 FILTER,1,18500,0,18500,17200,1300
6/27/2021 21:30,8998989300261,GUDANG GARAM SURYA 12 FILTER,1,18500,0,18500,17200,1300
6/27/2021 21:42,8998989300261,GUDANG GARAM SURYA 12 FILTER,1,18500,0,18500,17200,1300
6/27/2021 21:50,8998989110167,SURYA GUDANG GARAM 16 FILTER,1,25000,0,25000,23200,1800
6/27/2021 22:01,8998866618298,DAIA CLEAN&FRESH HJB 320GR,1,5000,0,5000,4450,550
6/27/2021 22:24,8998989500166,GUDANG GARAM MERAH BESAR 16KS,2,18000,0,36000,34000,2000
6/27/2021 22:37,8999099922985,SGM 0-6 600G,2,55000,0,110000,103902,6098
6/28/2021 20:06,8998989110167,SURYA GUDANG GARAM 16 FILTER,2,25000,0,50000,46400,3600
6/28/2021 20:07,8994867007161,ROKOK PENA GOLD 20,1,17000,0,17000,15500,1500
6/28/2021 20:10,8992696404441,BEAR BRAND 189ML,1,9000,0,9000,7887,1113
6/28/2021 20:14,8999909096004,SAMPOERNA 16 FILTER,1,24000,0,24000,23000,1000
6/28/2021 20:19,8992696523081,MILO UHT 110ML,2,2500,0,5000,3924,1076
6/28/2021 20:22,8992775000076,GERY SNACK RING CKLT,1,2000,0,2000,1712,288
6/28/2021 20:30,8999999059309,LIFEBUOY TS TOTAL 10 DG 75G,1,3000,0,3000,2640,360
6/28/2021 20:35,8996001355237,SUPER STAR,1,11000,0,11000,9900,1100
6/28/2021 20:36,8996001355237,SUPER STAR,3,11000,0,33000,29700,3300
6/28/2021 20:41,089686011494,INDOMIE SOTO PADANG,1,2600,0,2600,2317,283
6/28/2021 20:53,8999999707835,CLOSEUP GREEN 65G,2,7000,0,14000,12000,2000
6/28/2021 20:54,8999999031930,PEPSODENT TB TRIPLE CLEAN,2,3500,0,7000,5700,1300
6/28/2021 21:16,8992696404441,BEAR BRAND 189ML,2,9000,0,18000,15774,2226
6/28/2021 21:28,8996001600399,LE MINERAL 1500ML,1,5000,0,5000,4042,958
6/28/2021 22:29,089686010824,INDOMIE GORENG SPESIAL,2,2700,0,5400,4904,496
6/28/2021 22:32,8998989110167,SURYA GUDANG GARAM 16 FILTER,1,25000,0,25000,23200,1800
6/28/2021 22:37,8999999001209,LIFEBUOY BW MILDCARE LD REFF 450 ML,2,25000,0,50000,44220,5780
6/29/2021 20:11,8998989110167,SURYA GUDANG GARAM 16 FILTER,1,25000,0,25000,23200,1800
6/29/2021 20:12,8993989311279,CLAS MILD 12,1,17000,0,17000,15700,1300
6/29/2021 20:15,8999999706180,PEPSODENT WHITE 190GR,1,10000,0,10000,9350,650
6/29/2021 20:18,8992696404441,BEAR BRAND 189ML,1,9000,0,9000,7887,1113
6/29/2021 20:21,089686010190,INDOMIE KARI AYAM,2,2800,0,5600,5044,556
6/29/2021 20:24,8998989500128,GUDANG GARAM MERAH KECIL 12KS,1,14000,0,14000,13000,1000
6/29/2021 20:29,8999999031602,SARI MURNI 20X1.6G,1,6000,0,6000,5400,600
6/29/2021 21:28,8998989500128,GUDANG GARAM MERAH KECIL 12KS,1,14000,0,14000,13000,1000
6/29/2021 21:30,8999999001179,LIFEBUOY BW COOLFRESH LD REFF 450 ML,1,25000,0,25000,22110,2890
6/29/2021 21:30,8999999048181,SUNSILK BLK SHINE 170ML,1,20000,0,20000,18150,1850
6/29/2021 21:30,8992694247255,ZWITSAL BATH NAT HAIR&BODY 200ML,1,20500,0,20500,18810,1690
6/29/2021 21:37,8999999059309,LIFEBUOY TS TOTAL 10 DG 75G,1,3000,0,3000,2640,360
6/29/2021 22:11,8999999004248,CITRA NATURAL WHITE SCRUB 200ML,1,16200,0,16200,14550,1650
6/29/2021 22:11,8999999528942,CITRA HBL PEARLY WHITE UV 120ML,1,12000,0,12000,10082,1918
6/29/2021 22:11,089686010824,INDOMIE GORENG SPESIAL,1,2700,0,2700,2452,248
6/29/2021 22:11,711844110113,KECAP ABC 135 ML,1,7000,0,7000,6400,600
6/29/2021 22:11,8994834003752,TICTIC,1,2000,0,2000,1700,300
6/29/2021 22:11,8991111101316,JB OIL 50ML,1,9500,0,9500,8700,800
6/29/2021 22:14,8998989500128,GUDANG GARAM MERAH KECIL 12KS,2,14000,0,28000,26000,2000
6/29/2021 22:19,8991102022347,SIKAT GIGI FORMULA RIPPLE,1,5000,0,5000,4583,417
6/29/2021 22:19,8999999559861,AXE DARK POCKET FRAG 17ML,1,10000,0,10000,8000,2000
6/29/2021 22:19,8993072254056,MELROSE COTTON BUDS KCL,1,3000,0,3000,2450,550
6/30/2021 11:56,8992753102204,BKM COKLAT 370G,1,11300,0,11300,9500,1800
6/30/2021 12:07,8994867007161,ROKOK PENA GOLD 20,1,17000,0,17000,15500,1500
6/30/2021 12:07,8999909002821,MARLBORO BLACK 16,1,22000,0,22000,20850,1150
6/30/2021 12:40,8997028590014,ARGUS 220ML,1,500,0,500,302,198
6/30/2021 14:38,6907992823591,JD STRAW MILKSHAKE,1,5000,0,5000,4300,700
6/30/2021 16:04,8999999571924,MOLTO PURE 1OML,1,5000,0,5000,4800,200
6/30/2021 16:04,8999999195656,SARI WANGI 50X1.85,1,10000,0,10000,9500,500
6/30/2021 16:04,COKLAT,COKLAT COIN,2,500,0,1000,850,150
6/30/2021 16:22,8997009510017,YOU C1000 LEMON,2,10000,0,20000,18332,1668
6/30/2021 16:28,8993989311279,CLAS MILD 12,1,17000,0,17000,15700,1300
6/30/2021 16:30,8998866501033,MINYAK GORENG SEDAAP POUCH 2L,1,29000,0,29000,27746,1254
6/30/2021 16:35,8999909010567,234 DJI SAM SOE 16,1,22000,0,22000,21500,500
6/30/2021 16:48,8991102281430,PERMEN MINTZ DUOMINT,1,4500,0,4500,4000,500
6/30/2021 16:51,6907992823843,JD MOCHA CRISPY,2,5000,0,10000,8800,1200
6/30/2021 16:51,8992775318201,GERY SNACK BANTAL COKLAT,2,2000,0,4000,3424,576
6/30/2021 16:51,8996001305003,SARI GANDUM SANDWICH,1,6000,0,6000,5100,900
6/30/2021 17:01,8994867000094,ROKOK PUNDIMAS FIL16,1,15000,0,15000,13500,1500
6/30/2021 17:47,8992696521797SCT,MILO ACT GO 22G SCT,2,2000,0,4000,3106,894
6/30/2021 18:04,8850007090267,JB BATH MILK 400ML (REFILL),1,24500,0,24500,23390,1110
6/30/2021 18:34,8998866607315,SOKLIN SOFTERGENT SAKURA 770G & PIRING,1,18000,0,18000,16680,1320
6/30/2021 19:12,GL,GULA 1 LITER,4,11500,0,46000,42000,4000
6/30/2021 19:15,8998989110167,SURYA GUDANG GARAM 16 FILTER,1,25000,0,25000,23200,1800
6/30/2021 19:16,8992696404441,BEAR BRAND 189ML,1,9000,0,9000,7887,1113
6/30/2021 19:41,8992959953181,SWEETY BRONZE L30+2,1,55000,0,55000,53410,1590
6/30/2021 21:06,8998866202466,JAPOTA HAPPY HONEY BUTTER,1,5000,0,5000,4150,850
6/30/2021 21:06,8998866202435,JAPOTA UMAMI JAPANESE SEAWEED 35GR,1,5000,0,5000,4150,850
6/30/2021 21:06,8991909101016,URBAN MILD 16,1,17000,0,17000,15800,1200
6/30/2021 21:50,8999909010567,234 DJI SAM SOE 16,1,22000,0,22000,21500,500
6/30/2021 22:09,8996001600375,LE MINERAL 330ML,1,43200,0,43200,34008,9192
6/30/2021 22:44,8998866202244,EKOMIE BUMBU KALDU AYAM,1,1000,0,1000,798,202
6/30/2021 22:44,8997007780689,JIZZY MINERAL,1,3000,0,3000,1187,1813
6/30/2021 22:44,6907992825076,JD WATERMELON APPLE,1,2000,0,2000,1700,300
6/30/2021 22:44,SS,SUPER SNAPS,1,1500,0,1500,1333,167
6/30/2021 22:44,8992761145033,FANTA STRAW PET 250ML,1,3500,0,3500,2417,1083
6/30/2021 22:44,8992775318201,GERY SNACK BANTAL COKLAT,1,2000,0,2000,1712,288
7/1/2021 11:19,8997231980015,O'JELLY MINI APPLE,1,3000,0,3000,2250,750
7/1/2021 11:34,8998866501033,MINYAK GORENG SEDAAP POUCH 2L,2,29000,0,58000,55492,2508
7/1/2021 11:34,bb,BENG-BENG,2,1500,0,3000,2900,100
7/1/2021 12:32,9556001004673,MILO NESTLE MALAYSIA ACTIVE GO,1,85000,0,85000,80000,5000
7/1/2021 12:32,KP,KERIPIK PISANG,2,5000,0,10000,10000,0
7/1/2021 12:32,089686611519,QTELA SINGKONG,1,5000,0,5000,4266,734
7/1/2021 12:32,8996001600269,LE MINERAL 600ML,2,3000,0,6000,3376,2624
7/1/2021 13:25,8999999195649,SARI WANGI 25X1.86G,1,6000,0,6000,5050,950
7/1/2021 13:50,8999908284907,MY BABY MINYAK TELON 90ML,1,25000,0,25000,22700,2300
7/1/2021 13:50,8998989300261,GUDANG GARAM SURYA 12 FILTER,1,18500,0,18500,17200,1300
7/1/2021 13:50,SF TAWAR ORI,SAFFANAH TAWAR ORI,1,9000,0,9000,8000,1000
7/1/2021 14:33,8996001600269,LE MINERAL 600ML,3,3000,0,9000,5064,3936
7/1/2021 14:52,089686010824,INDOMIE GORENG SPESIAL,2,2700,0,5400,4904,496
7/1/2021 15:23,8991002103764GT,GOOD DAY CAPPUCINO,1,13000,0,13000,11000,2000
7/1/2021 15:23,8992957220025,GOLDEN CITY MINI,1,3000,0,3000,2500,500
7/1/2021 15:23,8993072254056,MELROSE COTTON BUDS KCL,1,3000,0,3000,2450,550
7/1/2021 15:23,8991102213189,BLASTER UNGU,1,5000,0,5000,3106,1894
7/1/2021 15:23,8999999195649,SARI WANGI 25X1.86G,1,6000,0,6000,5050,950
7/1/2021 15:23,kp,KALPA,2,2000,0,4000,3332,668
7/1/2021 15:23,8995333032113,TERIGU GATOT KACA 1 KG,1,8500,0,8500,8012,488
7/1/2021 15:23,8992730002992,HAI CANDY,1,7000,0,7000,6000,1000
7/1/2021 15:23,COKLAT,COKLAT COIN,1,500,0,500,425,75
7/1/2021 16:16,8998989500128,GUDANG GARAM MERAH KECIL 12KS,1,14000,0,14000,13000,1000
7/1/2021 16:16,8998989500166,GUDANG GARAM MERAH BESAR 16KS,2,18000,0,36000,34000,2000
7/1/2021 16:47,6907992823843,JD MOCHA CRISPY,1,5000,0,5000,4400,600
7/1/2021 16:47,8992761166038,MMP ORANGE 300ML,1,5000,0,5000,3750,1250
7/1/2021 16:47,8999999195656,SARI WANGI 50X1.85,1,10000,0,10000,9500,500
7/1/2021 16:47,8992628022156,BIMOLI KLASIK TOUCH 1 LT,1,16000,0,16000,14350,1650
7/1/2021 16:47,8992761166052,FRESTEA MELATI 350ML,1,4500,0,4500,3000,1500
7/1/2021 18:10,8998866202060,POTABEE AYAM BAKAR PEDAS 35 GR,1,5000,0,5000,4150,850
7/1/2021 18:10,8998866501026,MINYAK GORENG SEDAAP POUCH 1 L,1,15000,0,15000,14110,890
7/1/2021 18:10,8997011700123,BIHUN JAGUNG 300GR,1,6000,0,6000,4979,1021
7/1/2021 18:29,8991002105409,KOPI KAPAL API,1,20000,0,20000,18888,1112
7/1/2021 18:29,8991909101016,URBAN MILD 16,1,17000,0,17000,15800,1200
7/1/2021 18:29,123124,KOREK BIASA,1,2000,0,2000,1800,200
7/1/2021 19:15,8998866200325,MIE SEDAAP SOTO,2,2500,0,5000,3904,1096
7/1/2021 19:21,8999909010567,234 DJI SAM SOE 16,1,22000,0,22000,21500,500
7/1/2021 19:45,8993058304201,BEJO JAHE MERAH,1,3000,0,3000,1893,1107
7/1/2021 19:45,8996001301142,ROMA KELAPA,1,8000,0,8000,6628,1372
7/1/2021 20:33,8992959953037,SWEETY BRONZE L1,1,3000,0,3000,2671,329
7/1/2021 20:33,8992870311091,SALONPAS,1,6000,0,6000,4806,1194
7/1/2021 20:42,8992959953181,SWEETY BRONZE L30+2,1,55000,0,55000,53410,1590
7/1/2021 20:47,8992959953044,SWEETY BRONZE XL1,1,2500,0,2500,2250,250
7/1/2021 20:47,8992775001653,GERY SALUT CHOCOLATE COCONUT,1,2000,0,2000,1476,524
7/1/2021 20:47,HT,HOT-HOT,1,500,0,500,350,150
7/1/2021 20:51,8999909002821,MARLBORO BLACK 16,1,22000,0,22000,20850,1150
7/1/2021 20:57,8993989311279,CLAS MILD 12,1,17000,0,17000,15700,1300
7/1/2021 20:57,VTM,VITAMIN,2,500,0,1000,850,150
7/1/2021 21:16,8993176110074,MINYAK KAYU PUTIH 60ML,1,20000,0,20000,17333,2667
7/1/2021 21:21,8998009010569,ULTRA CHO 200,1,5000,0,5000,3830,1170
7/1/2021 21:32,8998866200301,MIE SEDAAP GORENG,2,2500,0,5000,4046,954
7/1/2021 21:32,8999999531508,MOLTO HYGIENE SC 10ML,10,500,0,5000,4800,200
7/1/2021 21:32,6907992823911,JD CRUNCHY HONEYDEW MELON,1,8000,0,8000,6800,1200
7/1/2021 21:32,6907992823621,JD CREAMY YOGURT,1,3000,0,3000,2600,400
7/1/2021 21:32,8992957220087,COKLAT SINGA,2,2000,0,4000,3400,600
7/1/2021 21:40,8997013790108,BIMURA KACANG TELUR 25G,2,1000,0,2000,1750,250
7/1/2021 21:40,6907992823911,JD CRUNCHY HONEYDEW MELON,1,8000,0,8000,6800,1200
7/1/2021 21:40,COKLAT,COKLAT COIN,2,500,0,1000,850,150
7/1/2021 22:36,089686017748,SARIMIE GORENG ISI 2,2,3500,0,7000,6240,760
7/1/2021 22:36,8999999031602,SARI MURNI 20X1.6G,1,6000,0,6000,5400,600
7/1/2021 22:36,8996001440087,ENERGEN KACANG HIJAU,7,1500,0,10500,8050,2450
7/1/2021 22:36,8993083929806,BISKITOP COKLAT,1,30000,0,30000,27000,3000
7/1/2021 22:37,8993470671752,JOGER STICK DUO KACANG,1,1000,0,1000,850,150
7/1/2021 22:37,HT,HOT-HOT,1,500,0,500,350,150
7/1/2021 22:56,8998866200325,MIE SEDAAP SOTO,1,2500,0,2500,1952,548
7/1/2021 22:56,CC,NICE FACIAL KILOAN 900 GR DUO,1,34500,0,34500,31325,3175
7/1/2021 22:56,8997007780689,JIZZY MINERAL,2,3000,0,6000,2374,3626
7/1/2021 22:56,8886013213208,FRENCH FREIS 2000,1,5000,0,5000,3750,1250
7/1/2021 22:56,8992775000663,GERY SNACK KEJU,1,2000,0,2000,1712,288
7/2/2021 11:18,123,BETREI JAM,1,5500,0,5500,5000,500
7/2/2021 11:28,GL,GULA 1 LITER,1,11500,0,11500,10500,1000
7/2/2021 11:28,8998866501033,MINYAK GORENG SEDAAP POUCH 2L,1,29000,0,29000,27746,1254
7/2/2021 11:28,8999999516208,ROYCO FDS CHICKEN NEW 230G,1,10000,0,10000,9000,1000
7/2/2021 11:28,8998008151065,MIWON 100 GR,1,3300,0,3300,2996,304
7/2/2021 11:33,8999909004221,SAMPOERNA ULTRAMILD 16,1,22000,0,22000,20350,1650
7/2/2021 11:42,SF TAWAR ORI,SAFFANAH TAWAR ORI,1,9000,0,9000,8000,1000
7/2/2021 11:42,8998898830125,KKB ENER-G ANGGUR,1,5500,0,5500,4824,676
7/2/2021 11:42,8992761139018,ADES 600ML,1,3500,0,3500,2292,1208
7/2/2021 11:42,8998866501033,MINYAK GORENG SEDAAP POUCH 2L,1,29000,0,29000,27746,1254
7/2/2021 11:42,ff,FULLO BLASTO,1,1000,0,1000,995,5
7/2/2021 11:42,bb,BENG-BENG,6,1500,0,9000,8700,300
7/2/2021 11:42,8992775210215,GARUDA ATOM PEDAS,1,17000,0,17000,15363,1637
7/2/2021 11:42,8992775610008,TING-TING GARUDA 2.5G,1,7500,0,7500,6296,1204
7/2/2021 11:42,8997025914059,HATARI SEE HONG,1,6000,0,6000,4911,1089
7/2/2021 11:42,8991102230308,BLASTER PINK,1,5000,0,5000,3106,1894
7/2/2021 11:42,VTM,VITAMIN,4,500,0,2000,1700,300
7/2/2021 11:42,ROTI,ROTI 2000,2,2000,0,4000,3600,400
7/2/2021 11:42,8998666001306SCT,TB CREAMY LATTE SCT,2,1500,0,3000,1980,1020
7/2/2021 11:42,8996001414002SCT,TB CAPPUCINO SCT,2,1500,0,3000,2700,300
7/2/2021 11:53,HT,HOT-HOT,1,500,0,500,350,150
7/2/2021 11:53,TUSTEL,TUSUK TELINGA,1,1000,0,1000,833,167
7/2/2021 11:53,8998866501033,MINYAK GORENG SEDAAP POUCH 2L,2,29000,0,58000,55492,2508
7/2/2021 11:53,bb,BENG-BENG,1,1500,0,1500,1450,50
7/2/2021 11:53,COKLAT,COKLAT COIN,1,500,0,500,425,75
7/2/2021 11:53,ROTI,ROTI 2000,2,2000,0,4000,3600,400
7/2/2021 12:21,8990800016757,BB TUTI FRUITTY COSMO,1,8500,0,8500,7600,900
7/2/2021 12:21,COKLAT,COKLAT COIN,1,500,0,500,425,75
7/2/2021 12:21,8997231980022,O'JELLY MINI STRAWBERRY,3,3000,0,9000,6750,2250
7/2/2021 12:21,8996001304549,SLAI OLAI 1000,2,1000,0,2000,1650,350
7/2/2021 12:21,ASTOR,ASTOR SCT,5,1000,0,5000,4125,875
7/2/2021 12:21,YP,YUPI,4,250,0,1000,832,168
7/2/2021 12:21,8992761145033,FANTA STRAW PET 250ML,1,3500,0,3500,2417,1083
7/2/2021 12:21,MARS,MARSHMELLOW,14,500,0,7000,6062,938
7/2/2021 12:21,8993154790021,DELLA CHA,1,2000,0,2000,1714,286
7/2/2021 12:21,8998866610261,DAIA VIOLET GUSSET BAG 290 GR,1,5000,0,5000,4450,550
7/2/2021 12:21,JD VM,JD VANILLA MILKSHAKE,1,5000,0,5000,4300,700
7/2/2021 12:21,8999909002821,MARLBORO BLACK 16,1,22000,0,22000,20850,1150
7/2/2021 12:21,8992752112013,MIZONE,1,5000,0,5000,3800,1200
7/2/2021 12:21,8991102384841,WFR TANGO LONG CKLT 130G,1,5000,0,5000,4345,655
7/2/2021 12:21,8996001414002SCT,TB CAPPUCINO SCT,2,1500,0,3000,2700,300
7/2/2021 12:21,8998866202343,MIE SEDAAP KOREAN SPICY,1,2500,0,2500,2023,477
7/2/2021 12:21,ARG,ARGUS 220ML,1,14500,0,14500,12500,2000
7/2/2021 12:21,8992696404441,BEAR BRAND 189ML,1,9000,0,9000,7887,1113
7/2/2021 12:21,8997009510017,YOU C1000 LEMON,1,10000,0,10000,9166,834
7/2/2021 12:21,8999909085114,SAMPOERNA KRETEK HIJAU 12,1,13000,0,13000,11650,1350
7/2/2021 12:21,8998009010590,ULTRA CHO 125,1,3000,0,3000,2428,572
7/2/2021 12:21,MOBIL,GULA GULA HP,1,2000,0,2000,1700,300
7/2/2021 12:21,6907992823843,JD MOCHA CRISPY,1,5000,0,5000,4400,600
7/2/2021 12:21,711844610095,LARISSA UDANG 500 GR,1,11000,0,11000,9790,1210
7/2/2021 12:21,8998866202244,EKOMIE BUMBU KALDU AYAM,5,1000,0,5000,3990,1010
7/2/2021 12:21,8993335523363,TOTAL ALMEERA 250G,1,5000,0,5000,4100,900
7/2/2021 12:21,8999999059781,SUNLIGHT LIME NEW POUCH 210ML,1,5000,0,5000,4300,700
7/2/2021 12:21,MOLTO PINK,MOLTO ALL IN ONE 11 ML,4,500,0,2000,1600,400
7/2/2021 12:21,8993989311699,CLAS MILD 16 FILTER,2,23000,0,46000,43400,2600
7/2/2021 12:21,8998866202619,MIE SEDAAP KOREAN SPICY SOUP,2,2500,0,5000,4546,454
7/2/2021 12:21,8999999707781,PEPSODENT ACTION 123 PLUS WHITENING 190G,1,17200,0,17200,15785,1415
7/2/2021 12:21,8991102994422,TANGO WALUT CHOCOBNN 18G,1,9000,0,9000,8661,339
7/2/2021 12:21,8994834003752,TICTIC,4,2000,0,8000,6800,1200
7/2/2021 12:21,8994834006128,TICTIC PEDAS,2,2000,0,4000,3400,600
7/2/2021 12:21,8998866500708,FLORIDINA ORANGE,1,3000,0,3000,2500,500
7/2/2021 12:21,8995333032113,TERIGU GATOT KACA 1 KG,3,8500,0,25500,24036,1464
7/2/2021 12:21,8992761111533,SPRITE SLIM CAM250ML,1,5000,0,5000,3750,1250
7/2/2021 12:21,8996001600269,LE MINERAL 600ML,2,3000,0,6000,3376,2624
7/2/2021 12:21,8992759120264,LARISST 220,2,10000,0,20000,18400,1600
7/2/2021 12:21,8992628020152,BIMOLI POUCH 2L,2,31000,0,62000,59600,2400
7/2/2021 12:21,8998009020186,BUAVITA GUAVA 250ML,1,7000,0,7000,6083,917
7/2/2021 12:21,8997002060168,KRP SINGKOG PDS PANDA DUO,1,8000,0,8000,7300,700
7/2/2021 12:21,8997011700123,BIHUN JAGUNG 300GR,2,6000,0,12000,9958,2042
7/2/2021 12:21,8999999524807,SUNLIGHT HABBATUSSAUDA POUCH 755ML,1,17000,0,17000,15400,1600
7/2/2021 12:21,8996001440049,ENERGEN,9,1500,0,13500,10800,2700
7/2/2021 12:21,8999999707859,CLOSEUP GREEN 160G,1,15000,0,15000,13600,1400
7/2/2021 12:21,8999999548698,LUXTS VALVET JASMINE 4X60G,1,8500,0,8500,7650,850
7/2/2021 12:21,8992702000063,INDOMILK COKLAT 370G,1,10000,0,10000,9020,980
7/2/2021 12:21,8992979190986,TOTAL PUTIH SOFTENER,1,13000,0,13000,11532,1468
7/2/2021 12:21,8992979130012,TOTAL LEMON SOFTENER,1,13000,0,13000,11532,1468
7/2/2021 12:38,8996001301142,ROMA KELAPA,1,8000,0,8000,6628,1372
7/2/2021 12:38,8999999531478,MOLTO BLACK PURPLE,1,5500,0,5500,4800,700
7/2/2021 12:38,8999999048167,SUNSILK SHP BLACK SHINE 9ML,1,10500,0,10500,9300,1200
7/2/2021 12:38,8998989300261,GUDANG GARAM SURYA 12 FILTER,2,18500,0,37000,34400,2600
7/2/2021 12:38,8994834005923,SPIX 1000,1,1000,0,1000,850,150
7/2/2021 12:38,8992775002735,CHOCOLATOS SUSU COKELAT,1,4000,0,4000,3520,480
7/2/2021 12:38,YP,YUPI,3,250,0,750,624,126
7/2/2021 12:38,8996001600399,LE MINERAL 1500ML,1,5000,0,5000,4042,958
7/2/2021 12:38,8992694247255,ZWITSAL BATH NAT HAIR&BODY 200ML,1,20500,0,20500,18810,1690
7/2/2021 12:38,8992959610114,HN PANTS XL 44,1,78000,0,78000,72273,5727
7/2/2021 12:38,8997231980015,O'JELLY MINI APPLE,2,3000,0,6000,4500,1500
7/2/2021 12:38,6907992823973,JD PINEAPPLE,2,5000,0,10000,8600,1400
7/2/2021 12:38,8998009020186,BUAVITA GUAVA 250ML,1,7000,0,7000,6083,917
7/2/2021 12:38,711844120419,SAMBAL ABC 275 ML,1,12000,0,12000,10800,1200
7/2/2021 12:38,8999909010567,234 DJI SAM SOE 16,1,22000,0,22000,21500,500
7/2/2021 12:38,8996001600269,LE MINERAL 600ML,1,3000,0,3000,1688,1312
7/2/2021 12:38,8998866500708,FLORIDINA ORANGE,1,3000,0,3000,2500,500
7/2/2021 12:38,MARS,MARSHMELLOW,22,500,0,11000,9526,1474
7/2/2021 12:38,8991102989534,TANGO VANILA 24G,2,1000,0,2000,1218,782
7/2/2021 12:38,8998666002525GT,TB TORA CAFE CAPPUCINO,1,9000,0,9000,7800,1200
7/2/2021 12:38,8998866200578,MIE SEDAAP KARI KENTAL,2,2500,0,5000,4526,474
7/2/2021 12:38,8998989500166,GUDANG GARAM MERAH BESAR 16KS,1,18000,0,18000,17000,1000
7/2/2021 12:38,123124,KOREK BIASA,1,2000,0,2000,1800,200
7/2/2021 12:38,089686010343,INDOMIE SOTO MIE,1,2600,0,2600,2367,233
7/2/2021 12:38,089686010824,INDOMIE GORENG SPESIAL,1,2700,0,2700,2452,248
7/2/2021 12:38,8991001503114,CHACHA MILK CHOCOLATE 35G,1,5500,0,5500,4900,600
7/2/2021 12:38,8993176110074,MINYAK KAYU PUTIH 60ML,1,20000,0,20000,17333,2667
7/2/2021 12:38,8992761166038,MMP ORANGE 300ML,2,5000,0,10000,7500,2500
7/2/2021 12:38,8998866202619,MIE SEDAAP KOREAN SPICY SOUP,1,2500,0,2500,2273,227
7/2/2021 12:38,8992959117514,SFX NON WING 20,1,10000,0,10000,9091,909
7/2/2021 12:38,8992775001783,GERY SALUT MALKIST,1,6500,0,6500,5516,984
7/2/2021 12:38,8999909001909,MAGNUM REVAMP BLACK 12,1,18000,0,18000,16300,1700
7/2/2021 12:38,6907992823669,JD MILKY STRAW,4,3000,0,12000,10400,1600
7/2/2021 12:38,089686043204,INDOMIE MIE ACEH,1,2700,0,2700,2452,248
7/2/2021 12:38,8992775000250SCT,CHOCOLATOS MATCHA DRINK SCT,1,2000,0,2000,1586,414
7/2/2021 12:38,ff,FULLO BLASTO,1,1000,0,1000,995,5
7/2/2021 12:38,8992696404441,BEAR BRAND 189ML,1,9000,0,9000,7887,1113
7/2/2021 12:38,8997009510017,YOU C1000 LEMON,1,10000,0,10000,9166,834
7/2/2021 12:38,8992759120264,LARISST 220,1,10000,0,10000,9200,800
7/2/2021 12:38,8992696405417SCT,DNCO INSTANT 27G SCT,3,3500,0,10500,8871,1629
7/2/2021 12:38,8992696521797SCT,MILO ACT GO 22G SCT,1,2000,0,2000,1553,447
7/2/2021 12:39,8999099923005,SGM 6-12 600G,1,53000,0,53000,51951,1049
7/2/2021 12:50,8999999008475,SUNLIGHT LIME NEW REF 1600ML,1,33000,0,33000,29800,3200
7/2/2021 12:50,8998866610070,SOKLIN SOFTERGEN 280G PURPLE,1,5000,0,5000,4425,575
7/2/2021 12:50,8999999046989,LIFEBUOY MILD CARE 60G,1,10000,0,10000,7645,2355
7/2/2021 12:50,8999999030186,PEPSODENT ACTION 123 COMPLETE 190G,1,14000,0,14000,13200,800
7/2/2021 12:50,8992759218046,JOLLY KLNR FCL CR LUNAK EMBOSS 10 ROLL,1,9000,0,9000,8075,925
7/2/2021 12:50,8998009020186,BUAVITA GUAVA 250ML,1,7000,0,7000,6083,917
7/2/2021 12:50,SF SOSIS,SAFFANAH ROTI SOSIS,2,6000,0,12000,11000,1000
7/2/2021 12:50,8996001600399,LE MINERAL 1500ML,1,5000,0,5000,4042,958
7/2/2021 12:50,8992761122331,FRESTEA APPEL 500ML,1,6500,0,6500,4708,1792
7/2/2021 12:50,089686011036,INDOMIE GORENG PEDAS,1,2700,0,2700,2452,248
7/2/2021 12:50,089686043273,INDOMIE SAMBAL RICA,1,2700,0,2700,2452,248
7/2/2021 12:50,8998866200882,SUKSESMIE GORENG AYAM KRMS 133GR,1,3500,0,3500,3047,453
7/2/2021 12:50,089686011494,INDOMIE SOTO PADANG,1,2600,0,2600,2317,283
7/2/2021 12:50,8992959974018,SFX SIRIH 36CM 12+1,1,17000,0,17000,15958,1042
7/2/2021 12:50,JGR,JOGER CHOCKY PASTA,1,20000,0,20000,18190,1810
7/2/2021 12:50,SF TAWAR ORI,SAFFANAH TAWAR ORI,1,9000,0,9000,8000,1000
7/2/2021 12:50,8886013213208,FRENCH FREIS 2000,1,5000,0,5000,3750,1250
7/2/2021 12:50,089686041705,INDOMIE GORENG JUMBO,1,3500,0,3500,3143,357
7/2/2021 12:50,089686010190,INDOMIE KARI AYAM,2,2800,0,5600,5044,556
7/2/2021 12:50,8999999555191,SAHAJA PENCUCI PRG JRUK NIPIS  BTL 650ML,1,19000,0,19000,17250,1750
7/2/2021 12:50,ARG,ARGUS 220ML,1,14500,0,14500,12500,2000
7/2/2021 12:50,8992753102204,BKM COKLAT 370G,1,11300,0,11300,9500,1800
7/2/2021 12:50,8991909101016,URBAN MILD 16,1,17000,0,17000,15800,1200
7/2/2021 12:50,8997231980022,O'JELLY MINI STRAWBERRY,1,3000,0,3000,2250,750
7/2/2021 12:50,8996001414002SCT,TB CAPPUCINO SCT,1,1500,0,1500,1350,150
7/2/2021 12:50,8992775001653,GERY SALUT CHOCOLATE COCONUT,1,2000,0,2000,1476,524
7/2/2021 12:50,GL,GULA 1 LITER,1,11500,0,11500,10500,1000
7/2/2021 12:50,8994935000070,MINYAK DUNIA 450 ML,2,7500,0,15000,13558,1442
7/2/2021 12:50,8995333032113,TERIGU GATOT KACA 1 KG,1,8500,0,8500,8012,488
7/2/2021 12:50,8998898830125,KKB ENER-G ANGGUR,1,5500,0,5500,4824,676
7/2/2021 12:50,8991102300421,WFR TANGO COKLAT 176GR,1,10000,0,10000,8694,1306
7/2/2021 12:50,8997027490018,LADAMAS MERICA BUBUK,1,9500,0,9500,8898,602
7/2/2021 12:50,8992770034175,MASAKO,6,500,0,3000,3000,0
7/2/2021 13:00,8992959953327,SWEETY BRONZE L52,1,85000,0,85000,80304,4696
7/2/2021 13:00,8993176110074,MINYAK KAYU PUTIH 60ML,2,20000,0,40000,34666,5334
7/2/2021 13:00,8992761145033,FANTA STRAW PET 250ML,2,3500,0,7000,4834,2166
7/2/2021 13:00,8997011700123,BIHUN JAGUNG 300GR,1,6000,0,6000,4979,1021
7/2/2021 13:00,ROTI,ROTI 2000,3,2000,0,6000,5400,600
7/2/2021 13:00,ff,FULLO BLASTO,1,1000,0,1000,995,5
7/2/2021 13:00,VCO,VITAMIN C500 ORANGE,1,1000,0,1000,575,425
7/2/2021 13:00,8992696422735,DNCO CKLT UHT 110ML,1,2500,0,2500,2041,459
7/2/2021 13:00,8992959107539,SFX WING 23CM,1,5000,0,5000,4091,909
7/2/2021 13:00,8992736424293,SASA BUMBU NASI GORENG 20G,1,2000,0,2000,1136,864
7/2/2021 13:00,8994834005923,SPIX 1000,1,1000,0,1000,850,150
7/2/2021 13:00,8996001305041,ROMA SANDWICH CKLT,1,7000,0,7000,5000,2000
7/2/2021 13:00,089686010824,INDOMIE GORENG SPESIAL,1,2700,0,2700,2452,248
7/2/2021 13:00,8998866202343,MIE SEDAAP KOREAN SPICY,3,2500,0,7500,6069,1431
7/2/2021 13:00,8992761139018,ADES 600ML,2,3500,0,7000,4584,2416
7/2/2021 13:00,8997009510116,LEMON WATER,1,7000,0,7000,5694,1306
7/2/2021 13:00,089686021127,INTER MIE KALDU,1,1000,0,1000,813,187
7/2/2021 13:00,8998989300261,GUDANG GARAM SURYA 12 FILTER,1,18500,0,18500,17200,1300
7/2/2021 13:00,8999801700030,SUSU FOYU,2,11500,0,23000,20900,2100
7/2/2021 13:00,6907992824963,JD MILKY CHOCOLATE,1,3000,0,3000,2600,400
7/2/2021 13:00,8999999027056,LIFEBUOY ANTI KETOMBE 9ML,1,5000,0,5000,4500,500
7/2/2021 13:00,8998009020186,BUAVITA GUAVA 250ML,1,7000,0,7000,6083,917
7/2/2021 13:00,8998899002132,BAY FRESH LEMON 320ML,1,18500,0,18500,16700,1800
7/2/2021 13:00,COKLAT,COKLAT COIN,2,500,0,1000,850,150
7/2/2021 13:00,8992696521797SCT,MILO ACT GO 22G SCT,1,2000,0,2000,1553,447
7/2/2021 13:00,8992752112013,MIZONE,1,5000,0,5000,3800,1200
7/2/2021 13:00,6907992825076,JD WATERMELON APPLE,1,2000,0,2000,1700,300
7/2/2021 13:00,8993379241858,SABUN HARMONY LEMON 70G,2,2000,0,4000,3304,696
7/2/2021 13:00,8998866202244,EKOMIE BUMBU KALDU AYAM,1,1000,0,1000,798,202
7/2/2021 13:11,8997009510017,YOU C1000 LEMON,2,10000,0,20000,18332,1668
7/2/2021 13:11,8992761145033,FANTA STRAW PET 250ML,2,3500,0,7000,4834,2166
7/2/2021 13:11,COKLAT,COKLAT COIN,3,500,0,1500,1275,225
7/2/2021 13:11,8999999516208,ROYCO FDS CHICKEN NEW 230G,2,10000,0,20000,18000,2000
7/2/2021 13:11,8998866202404,NOODLE SEDAAP MIE KOREAN SPICY CHICKEN CUP,1,5000,0,5000,4002,998
7/2/2021 13:11,089686010190,INDOMIE KARI AYAM,1,2800,0,2800,2522,278
7/2/2021 13:11,HT,HOT-HOT,1,500,0,500,350,150
7/2/2021 13:11,YP,YUPI,2,250,0,500,416,84
7/2/2021 13:11,8997028590014,ARGUS 220ML,3,500,0,1500,906,594
7/2/2021 13:11,089686048704,SARIMIE GORENG AYAM KCP ISI 2,1,3500,0,3500,3120,380
7/2/2021 13:11,8998009020186,BUAVITA GUAVA 250ML,2,7000,0,14000,12166,1834
7/2/2021 13:11,8998989500166,GUDANG GARAM MERAH BESAR 16KS,1,18000,0,18000,17000,1000
7/2/2021 13:11,GL,GULA 1 LITER,1,11500,0,11500,10500,1000
7/2/2021 13:11,8995333060772,TERIGU GATOT KACA 500GR,1,4500,0,4500,4065,435
7/2/2021 13:11,8996001440001GT,TB SUSU JAHE,1,13000,0,13000,8700,4300
7/2/2021 13:11,8998866501026,MINYAK GORENG SEDAAP POUCH 1 L,1,15000,0,15000,14110,890
7/2/2021 13:11,8996001301142,ROMA KELAPA,2,8000,0,16000,13256,2744
7/2/2021 13:11,8996001414002SCT,TB CAPPUCINO SCT,1,1500,0,1500,1350,150
7/2/2021 13:11,8992761145026,SPRITE PET 250ML,1,3500,0,3500,2417,1083
7/2/2021 13:11,8993379260026,SABUN MEDICARE BLACK,1,2500,0,2500,2237,263
7/2/2021 13:11,ROTI,ROTI 2000,5,2000,0,10000,9000,1000
7/2/2021 13:11,bb,BENG-BENG,4,1500,0,6000,5800,200
7/2/2021 13:11,SF SOSIS,SAFFANAH ROTI SOSIS,1,6000,0,6000,5500,500
7/2/2021 13:11,8999999036690,LUX TS MAGICAL ORCHID,3,3500,0,10500,8400,2100
7/2/2021 13:11,8993379152017,SABUN CUCI SURYA 200G,1,3000,0,3000,2281,719
7/2/2021 13:11,8991102384841,WFR TANGO LONG CKLT 130G,1,5000,0,5000,4345,655
7/2/2021 13:11,TBR,TEPUNG BERAS ROSE BRAND,1,8000,0,8000,5800,2200
7/2/2021 13:11,8994907000428,KECAP SACHET ABC,2,500,0,1000,708,292
7/2/2021 13:11,8993989311279,CLAS MILD 12,1,17000,0,17000,15700,1300
7/2/2021 13:11,8996001318980,BETTER 120G,1,6000,0,6000,5100,900
7/2/2021 13:11,JGR SHN,JOGER SHINY SACHET,1,500,0,500,437,63
7/2/2021 13:25,ARG,ARGUS 220ML,1,14500,0,14500,12500,2000
7/2/2021 13:26,8992775318201,GERY SNACK BANTAL COKLAT,1,2000,0,2000,1712,288
7/2/2021 13:26,8993083929837,BISKITOP BLACK COOKIES,1,27000,0,27000,23700,3300
7/2/2021 13:45,8998009020186,BUAVITA GUAVA 250ML,2,7000,0,14000,12166,1834
7/2/2021 13:45,6921101219235,YAKUAT JELLY,2,2000,0,4000,3500,500
7/2/2021 14:10,8992761166052,FRESTEA MELATI 350ML,2,4500,0,9000,6000,3000
7/2/2021 14:10,8992761002022,SPRITE PET 390ML,1,5500,0,5500,4300,1200
7/2/2021 14:10,8992761002015,COCA COLA PET 390ML,1,5500,0,5500,4333,1167
7/2/2021 14:10,BTS,BIMURA TARO SEAWEED 250G,1,10000,0,10000,9300,700
7/2/2021 14:22,8992761145033,FANTA STRAW PET 250ML,1,3500,0,3500,2417,1083
7/2/2021 14:22,JGR SHN,JOGER SHINY SACHET,1,500,0,500,437,63
7/2/2021 14:23,8992979120013,TOTAL BUNGA SOFTENER,1,13000,0,13000,11532,1468
7/2/2021 15:40,8991909101016,URBAN MILD 16,2,17000,0,34000,31600,2400
7/2/2021 15:40,8992761166205,FRESTEA GREEN HONEY 350ML,3,4500,0,13500,9000,4500
7/2/2021 15:41,KOPIKO,KOPIKO,2,250,0,500,350,150
7/2/2021 16:29,ROTI,ROTI 2000,3,2000,0,6000,5400,600
7/2/2021 16:29,8998989300261,GUDANG GARAM SURYA 12 FILTER,1,18500,0,18500,17200,1300
7/2/2021 16:29,KOPIKO,KOPIKO,2,250,0,500,350,150
7/2/2021 16:59,SF BOX,SAFFANAH ROTI BOX,1,12000,0,12000,10500,1500
7/2/2021 16:59,ROTI,ROTI 2000,4,2000,0,8000,7200,800
7/2/2021 18:48,089686043273,INDOMIE SAMBAL RICA,2,2700,0,5400,4904,496
7/2/2021 19:21,ROTI,ROTI 2000,2,2000,0,4000,3600,400
7/2/2021 19:21,MILKITA,MILKITA,4,250,0,1000,800,200
7/2/2021 19:44,8991909101016,URBAN MILD 16,1,17000,0,17000,15800,1200
7/2/2021 20:24,8992775211410,PILUS GARUDA PEDAS,1,5000,0,5000,4886,114
7/2/2021 20:24,8991102281430,PERMEN MINTZ DUOMINT,1,4500,0,4500,4000,500
7/2/2021 20:24,8998866200301,MIE SEDAAP GORENG,1,2500,0,2500,2023,477
7/2/2021 20:24,8998866202343,MIE SEDAAP KOREAN SPICY,1,2500,0,2500,2023,477
7/2/2021 20:24,8994834006128,TICTIC PEDAS,2,2000,0,4000,3400,600
7/2/2021 20:24,8998866202244,EKOMIE BUMBU KALDU AYAM,2,1000,0,2000,1596,404
7/2/2021 20:24,089686021219,INTER MIE GORENG,2,1000,0,2000,1770,230
7/2/2021 20:33,8999909010567,234 DJI SAM SOE 16,2,22000,0,44000,43000,1000
7/2/2021 20:50,8998009010569,ULTRA CHO 200,1,5000,0,5000,3830,1170
7/2/2021 21:20,8998866201377,KRISBEE FRIES KENTANG GORENG 68 GR,2,5500,0,11000,9240,1760
7/2/2021 21:20,8996001600399,LE MINERAL 1500ML,1,5000,0,5000,4042,958
7/2/2021 21:20,VCO,VITAMIN C500 ORANGE,4,1000,0,4000,2300,1700
7/2/2021 22:08,8992696521797SCT,MILO ACT GO 22G SCT,1,2000,0,2000,1553,447
7/2/2021 22:08,6907992823645,JD COCONUT BLISS,1,4000,0,4000,3500,500
7/2/2021 22:08,COKLAT,COKLAT COIN,2,500,0,1000,850,150
7/2/2021 22:15,8997007780689,JIZZY MINERAL,1,3000,0,3000,1187,1813
7/2/2021 22:15,8992775318201,GERY SNACK BANTAL COKLAT,1,2000,0,2000,1712,288
7/2/2021 22:15,8998898830125,KKB ENER-G ANGGUR,1,5500,0,5500,4824,676
7/3/2021 10:46,8998866501033,MINYAK GORENG SEDAAP POUCH 2L,3,29000,0,87000,83238,3762
7/3/2021 10:46,8995333060703,TERIGU KOMPAS 1KG,1,10500,0,10500,9816,684
7/3/2021 10:46,bb,BENG-BENG,1,1500,0,1500,1450,50
7/3/2021 11:11,8999999571887,MOLTO EDP PURPLE 10ML,1,5000,0,5000,4800,200
7/3/2021 11:11,8998866609036,DAIA BUNGA GUSSET 565G,1,10000,0,10000,8700,1300
7/3/2021 11:11,8998866610261,DAIA VIOLET GUSSET BAG 290 GR,1,5000,0,5000,4450,550
7/3/2021 11:11,8997009510055,YOU C1000,1,10000,0,10000,9166,834
7/3/2021 11:11,8998866202299,KECAP MANIS SEDAAP SPC REFILL 220ML,1,9500,0,9500,8500,1000
7/3/2021 11:11,8999909096004,SAMPOERNA 16 FILTER,1,24000,0,24000,23000,1000
7/3/2021 11:11,ROTI,ROTI 2000,4,2000,0,8000,7200,800
7/3/2021 11:11,8992775203422,GARUDA ROSTA OVEN 100G,1,8000,0,8000,7322,678
7/3/2021 11:11,8994834003752,TICTIC,2,2000,0,4000,3400,600
7/3/2021 11:11,089686611878,QTELA TEMPE,2,6000,0,12000,10740,1260
7/3/2021 11:11,8991102281430,PERMEN MINTZ DUOMINT,1,4500,0,4500,4000,500
7/3/2021 11:11,8991001770301,SELAMAT CLACK VANILA,1,13000,0,13000,11800,1200
7/3/2021 11:11,8998989500166,GUDANG GARAM MERAH BESAR 16KS,1,18000,0,18000,17000,1000
7/3/2021 11:11,8998989500128,GUDANG GARAM MERAH KECIL 12KS,1,14000,0,14000,13000,1000
7/3/2021 11:11,8999999706081,PEPSODENT WHITE 75G,2,5000,0,10000,7700,2300
7/3/2021 11:26,8994935000070,MINYAK DUNIA 450 ML,1,7500,0,7500,6779,721
7/3/2021 12:01,8992696404441,BEAR BRAND 189ML,1,9000,0,9000,7887,1113
7/3/2021 12:01,8999999710880,PEPSODENT ACTION123 HERBAL 75G,1,7500,0,7500,6650,850
7/3/2021 12:01,8999999559861,AXE DARK POCKET FRAG 17ML,1,10000,0,10000,8000,2000
7/3/2021 12:01,8997025914042,ATB MARIE SUSU 185G,1,7000,0,7000,4554,2446
7/3/2021 12:01,BKM,BKM COKLAT SACHET,3,1500,0,4500,3450,1050
7/3/2021 12:22,ff,FULLO BLASTO,4,1000,0,4000,3980,20
7/3/2021 12:22,VTM,VITAMIN,2,500,0,1000,850,150
7/3/2021 12:40,8998989110167,SURYA GUDANG GARAM 16 FILTER,1,25000,0,25000,23200,1800
7/3/2021 12:40,8998989300261,GUDANG GARAM SURYA 12 FILTER,1,18500,0,18500,17200,1300
7/3/2021 13:34,8999999059316,LIFEBUOY TS MILDCARE 75G,1,3000,0,3000,2640,360
7/3/2021 13:34,8999999707835,CLOSEUP GREEN 65G,1,7000,0,7000,6000,1000
7/3/2021 13:34,8998866679572,SOKLIN LANTAI MERAH 780ML,1,12000,0,12000,10020,1980
7/3/2021 13:34,GL,GULA 1 LITER,1,11500,0,11500,10500,1000
7/3/2021 14:24,089686060362,POP MIE SOTO AYAM JUMBO,1,4500,0,4500,3833,667
7/3/2021 14:24,MENTOS,MENTOS,2,250,0,500,350,150
7/3/2021 14:27,9556040040038,SUSU F&N,2,33000,0,66000,60000,6000
7/3/2021 14:27,8992761166038,MMP ORANGE 300ML,1,5000,0,5000,3750,1250
7/3/2021 14:35,8996001305041,ROMA SANDWICH CKLT,1,7000,0,7000,5000,2000
7/3/2021 14:35,8998866201711,KRISBEE KRUNCHY JAGUNG BAKAR MENTEGA 75 GR,1,5500,0,5500,4400,1100
7/3/2021 14:35,089686010824,INDOMIE GORENG SPESIAL,3,2700,0,8100,7356,744
7/3/2021 14:35,089686011036,INDOMIE GORENG PEDAS,3,2700,0,8100,7356,744
7/3/2021 14:35,8998866201377,KRISBEE FRIES KENTANG GORENG 68 GR,1,5500,0,5500,4620,880
7/3/2021 14:35,8998866201865,KRISBEE PILLOW CHOCOLAVA 120 GR,1,8000,0,8000,7250,750
7/3/2021 14:35,8998866202343,MIE SEDAAP KOREAN SPICY,2,2500,0,5000,4046,954
7/3/2021 16:15,MENTOS,MENTOS,2,250,0,500,350,150
7/3/2021 16:15,8998989110167,SURYA GUDANG GARAM 16 FILTER,1,25000,0,25000,23200,1800
7/3/2021 16:51,8992761002015,COCA COLA PET 390ML,1,5500,0,5500,4333,1167
7/3/2021 16:51,8992761002039,FANTA STRAWBERRY PET 390 ML,1,5500,0,5500,4300,1200
7/3/2021 16:51,8992761122331,FRESTEA APPEL 500ML,2,6500,0,13000,9416,3584
7/3/2021 17:23,8995333060703,TERIGU KOMPAS 1KG,2,10500,0,21000,19632,1368
7/3/2021 17:23,8991188943062,SASA 250G,1,10000,0,10000,8500,1500
7/3/2021 17:23,8993335523363,TOTAL ALMEERA 250G,2,5000,0,10000,8200,1800
7/3/2021 17:23,8998866613002,CREAM EKONOMI PINK 455G,2,5500,0,11000,9500,1500
7/3/2021 17:23,8999999710866,PEPSODENT 123 HERBAL 190G,1,18000,0,18000,17500,500
7/3/2021 17:23,8999999390198,SUNLIGHT LIME NEW POUCH 755ML,1,17000,0,17000,15400,1600
7/3/2021 17:23,8999999016128,RINSO MOLTO ROSE FRESH 750ML,1,15000,0,15000,12507,2493
7/3/2021 17:23,8998866200561,EKOMIE SUPER 600GR,1,10000,0,10000,8615,1385
7/3/2021 17:49,8998866604963,POWDET DAIA LEMON 290GR,1,5000,0,5000,4450,550
7/3/2021 18:11,GL,GULA 1 LITER,1,11500,0,11500,10500,1000
7/3/2021 18:12,GL,GULA 1 LITER,1,11500,0,11500,10500,1000
7/3/2021 18:17,8992775000663,GERY SNACK KEJU,1,2000,0,2000,1712,288
7/3/2021 18:17,8991102387286SCT,TANGO LONG CKLT 47G,1,2000,0,2000,1551,449
7/3/2021 18:17,8996001318430,BETTER 1000,1,1000,0,1000,820,180
7/3/2021 18:50,JGR SHN,JOGER SHINY SACHET,4,500,0,2000,1748,252
7/3/2021 18:51,8997027300089,NOMOS,1,4000,0,4000,2963,1037
7/3/2021 18:51,8998989110167,SURYA GUDANG GARAM 16 FILTER,1,25000,0,25000,23200,1800
7/3/2021 19:02,GL,GULA 1 LITER,1,11500,0,11500,10500,1000
7/3/2021 19:15,8998009010231,ULTRA CHO 250,5,6000,0,30000,23920,6080
7/3/2021 22:01,JGR SHN,JOGER SHINY SACHET,1,500,0,500,437,63
7/3/2021 22:01,8992761145026,SPRITE PET 250ML,1,3500,0,3500,2417,1083
7/3/2021 22:01,8992775211410,PILUS GARUDA PEDAS,1,5000,0,5000,4886,114
7/3/2021 22:36,8998866501033,MINYAK GORENG SEDAAP POUCH 2L,1,29000,0,29000,27746,1254
7/3/2021 22:36,8991188943062,SASA 250G,1,10000,0,10000,8500,1500
7/3/2021 22:36,8997011700123,BIHUN JAGUNG 300GR,1,6000,0,6000,4979,1021
7/3/2021 22:36,GL,GULA 1 LITER,1,11500,0,11500,10500,1000
7/3/2021 22:36,8994935000049,MINYAK GORENG DAMAI 5L,1,75000,0,75000,73780,1220
7/3/2021 22:36,8998866610438,SOKLIN SOFTERGENT RED BAG 770G & PIRING,1,18000,0,18000,16680,1320
7/3/2021 22:36,bb,BENG-BENG,1,1500,0,1500,1450,50
7/3/2021 22:36,8993571002196,CAP 19 OBAT KURAP AIR 10ML,1,5000,0,5000,3637,1363
7/3/2021 22:37,8998866803694,SOKLIN SOFTERGENT PURPLE BAG 770 & PIRING,1,18000,0,18000,16680,1320
7/3/2021 22:38,8998866200301,MIE SEDAAP GORENG,2,2500,0,5000,4046,954
7/4/2021 11:45,8998989300261,GUDANG GARAM SURYA 12 FILTER,1,18500,0,18500,17200,1300
7/4/2021 11:45,KOPIKO,KOPIKO,2,250,0,500,350,150
7/4/2021 14:28,089686834055,FREISS JERUK,1,11000,0,11000,8750,2250
7/4/2021 14:33,8991102989381,TANGO LONG BUBBLEGUM 130G,1,5000,0,5000,4345,655
7/4/2021 15:37,8993226365522,GARAM MEJA GYURI 200GR,2,2000,0,4000,3400,600
7/4/2021 15:37,TS,TISSUE TESSY,1,5000,0,5000,4200,800
7/4/2021 15:50,8994867000179,ROKOK PENA MILD 16,1,14500,0,14500,13500,1000
7/4/2021 15:50,KOPIKO,KOPIKO,2,250,0,500,350,150
7/4/2021 15:55,6907992823874,JD CRUNCHY CHOCO BLUEBERRY,1,5500,0,5500,4700,800
7/4/2021 16:31,8998989500166,GUDANG GARAM MERAH BESAR 16KS,2,18000,0,36000,34000,2000
7/4/2021 16:31,GL,GULA 1 LITER,1,11500,0,11500,10500,1000
7/4/2021 16:32,MILKITA,MILKITA,6,250,0,1500,1200,300
7/4/2021 16:54,8994834006128,TICTIC PEDAS,2,2000,0,4000,3400,600
7/4/2021 16:54,8999999529833,CLEAR SHP ICM UNISEX 9 ML,1,10500,0,10500,9300,1200
7/4/2021 16:54,KOPIKO,KOPIKO,2,250,0,500,350,150
7/4/2021 16:56,8998866202770,MIE SEDAAP SALERO PADANG,4,2500,0,10000,9448,552
7/4/2021 16:56,8998866203104,MIE SEDAAP SINGAPORE,4,2500,0,10000,9064,936
7/4/2021 17:11,6907992823904,JD CRUNCHY CHOCOLATE VAN,2,8000,0,16000,13600,2400
7/4/2021 17:53,8999999571924,MOLTO PURE 1OML,1,5000,0,5000,4800,200
7/4/2021 17:53,8999999007768,FAIR&LOVELY MULTIVITAMIN  CREAM 9 ML,2,4500,0,9000,6400,2600
7/4/2021 17:53,8993560026028,DETTOL SENSITIVE,1,20000,0,20000,18524,1476
7/4/2021 17:53,8998866618298,DAIA CLEAN&FRESH HJB 320GR,1,5000,0,5000,4450,550
7/4/2021 17:57,8998866679572,SOKLIN LANTAI MERAH 780ML,1,12000,0,12000,10020,1980
7/4/2021 18:48,8996001600269,LE MINERAL 600ML,1,3000,0,3000,1688,1312
7/4/2021 18:48,8996001600399,LE MINERAL 1500ML,1,5000,0,5000,4042,958
7/4/2021 20:03,8999099920691,SGM 1+ MADU 1000G,1,85000,0,85000,78510,6490
7/4/2021 20:03,8992959508992,SWEETY SILVER PANTS L 28,1,56800,0,56800,51819,4981
7/4/2021 20:03,8992696404441,BEAR BRAND 189ML,1,9000,0,9000,7887,1113
7/4/2021 20:03,8999909096004,SAMPOERNA 16 FILTER,1,24000,0,24000,23000,1000
7/4/2021 21:26,8998866200325,MIE SEDAAP SOTO,1,2500,0,2500,1952,548
7/4/2021 21:26,089686011036,INDOMIE GORENG PEDAS,1,2700,0,2700,2452,248
7/4/2021 21:26,MILKITA,MILKITA,4,250,0,1000,800,200
7/4/2021 21:26,KOPIKO,KOPIKO,4,250,0,1000,700,300
7/4/2021 21:26,MENTOS,MENTOS,4,250,0,1000,700,300
7/4/2021 21:33,8999999037765,PEPSODENT WHITE 225G,1,12000,0,12000,10750,1250
7/4/2021 21:33,8999999529734,CLEAR IC MTHL 160ML,1,23700,0,23700,21400,2300
7/4/2021 22:08,MILKITA,MILKITA,2,250,0,500,400,100
7/4/2021 22:08,VTM,VITAMIN,2,500,0,1000,850,150
7/4/2021 22:08,8998989300261,GUDANG GARAM SURYA 12 FILTER,1,18500,0,18500,17200,1300
7/4/2021 22:10,ROTI,ROTI 2000,2,2000,0,4000,3600,400
7/4/2021 22:10,8997007780689,JIZZY MINERAL,2,3000,0,6000,2374,3626
7/5/2021 11:20,8992761164539,NUTRIBOOST ORANGE 300ML,1,6500,0,6500,5300,1200
7/5/2021 11:20,8991002304413,RELAXA GRAPE MINT,1,5000,0,5000,4500,500
7/5/2021 11:20,JGR SHN,JOGER SHINY SACHET,1,500,0,500,437,63
7/5/2021 11:52,ROTI,ROTI 2000,2,2000,0,4000,3600,400
7/5/2021 11:52,PRG,PARAGO,6,500,0,3000,2400,600
7/5/2021 12:42,8992959117514,SFX NON WING 20,1,10000,0,10000,9091,909
7/5/2021 12:42,8993989311699,CLAS MILD 16 FILTER,1,23000,0,23000,21700,1300
7/5/2021 13:08,6907992823942,JD JUJUBE,1,4500,0,4500,3800,700
7/5/2021 13:08,8999909010567,234 DJI SAM SOE 16,2,22000,0,44000,43000,1000
7/5/2021 13:09,8998866501033,MINYAK GORENG SEDAAP POUCH 2L,1,29000,0,29000,27746,1254
7/5/2021 13:09,089686611519,QTELA SINGKONG,1,5000,0,5000,4266,734
7/5/2021 13:09,8999999516208,ROYCO FDS CHICKEN NEW 230G,1,10000,0,10000,9000,1000
7/5/2021 13:55,8992957220186,COKLAT RUSA,1,2000,0,2000,1700,300
7/5/2021 13:55,8997231980015,O'JELLY MINI APPLE,1,3000,0,3000,2250,750
7/5/2021 13:55,8997231980022,O'JELLY MINI STRAWBERRY,1,3000,0,3000,2250,750
7/5/2021 15:20,8999999524722,SUNLIGHT LIME NEW PCH 435ML,1,10000,0,10000,9100,900
7/5/2021 15:24,8993989311279,CLAS MILD 12,1,17000,0,17000,15700,1300
7/5/2021 16:55,8998989110167,SURYA GUDANG GARAM 16 FILTER,1,25000,0,25000,23200,1800
7/5/2021 17:04,8999999525088,MOLTO AIO BLUE SPK 250ML,1,9800,0,9800,8910,890
7/5/2021 17:04,8996001600269,LE MINERAL 600ML,1,3000,0,3000,1688,1312
7/5/2021 17:04,8998009010569,ULTRA CHO 200,1,5000,0,5000,3830,1170
7/5/2021 17:20,8992959930748,CONFI PANTS L10,2,5000,0,10000,8516,1484
7/5/2021 17:29,8993989311699,CLAS MILD 16 FILTER,1,23000,0,23000,21700,1300
7/5/2021 17:29,CHYK,CAHAYA MINYAK TERAPI,1,60000,0,60000,50000,10000
7/5/2021 17:38,8991001502933,CHACHA TUBE,2,7500,0,15000,12800,2200
7/5/2021 17:38,8998866202060,POTABEE AYAM BAKAR PEDAS 35 GR,1,5000,0,5000,4150,850
7/5/2021 17:42,CC,NICE FACIAL KILOAN 900 GR DUO,1,34500,0,34500,31325,3175
7/5/2021 17:42,8996001414002GT,TB CAPPUCINO,1,15000,0,15000,13500,1500
7/5/2021 17:42,8998866679572,SOKLIN LANTAI MERAH 780ML,1,12000,0,12000,10020,1980
7/5/2021 17:42,8998866605137,CLING BIRU POUCH 425ML,1,4000,0,4000,3250,750
7/5/2021 17:42,8999999524838,SUNLIGHT MINT POUCH 755ML,1,17000,0,17000,15400,1600
7/5/2021 17:43,8997218380074,ICHITAN MILK TEA,1,8000,0,8000,6583,1417
7/5/2021 17:43,8992959073209,HN PANTS XL 20,1,40000,0,40000,37425,2575
7/5/2021 17:43,8998866201452,POTABEE REGULER BBQ BEEF 35GR,1,5000,0,5000,4150,850
7/5/2021 17:46,8998866202619,MIE SEDAAP KOREAN SPICY SOUP,2,2500,0,5000,4546,454
7/5/2021 17:46,8996001414002SCT,TB CAPPUCINO SCT,1,1500,0,1500,1350,150
7/5/2021 18:53,8998866107457,POSH SUMMER LOVE 150ML,1,19500,0,19500,17500,2000
7/5/2021 19:29,8992628022156,BIMOLI KLASIK TOUCH 1 LT,1,16000,0,16000,14350,1650
7/5/2021 19:46,8998866202053,POTABEE AYAM BAKAR PEDAS 68GR,1,8000,0,8000,7200,800
7/5/2021 19:46,8992775001691,GARUDA ROSTA WAGYU BEEF,1,8000,0,8000,7322,678
7/5/2021 19:46,8992775001783,GERY SALUT MALKIST,1,6500,0,6500,5516,984
7/5/2021 19:46,8992775311325,GERY SNACK&SEREAL 100G,1,7000,0,7000,6012,988
7/5/2021 19:46,8992775311998,GERY CHOCOLATOS,1,17000,0,17000,15483,1517
7/5/2021 20:33,8998866202435,JAPOTA UMAMI JAPANESE SEAWEED 35GR,1,5000,0,5000,4150,850
7/5/2021 20:33,COKLAT,COKLAT COIN,10,500,0,5000,4250,750
7/5/2021 20:45,8996001600375,LE MINERAL 330ML,1,43200,0,43200,34080,9120
7/5/2021 21:18,8998866108126,POSH HIJAB WINTER MAGIC 150ML,1,19500,0,19500,17500,2000
7/5/2021 21:18,8999999533731,CITRA TS NATURE WHITE 70G,1,2200,0,2200,1900,300
7/5/2021 21:19,8996001600375,LE MINERAL 330ML,1,2000,0,2000,1417,583
7/5/2021 21:19,8996001600269,LE MINERAL 600ML,1,3000,0,3000,1688,1312
7/5/2021 21:19,8886013213208,FRENCH FREIS 2000,1,5000,0,5000,3750,1250
7/5/2021 21:19,8992696523081,MILO UHT 110ML,1,2500,0,2500,1962,538
7/5/2021 21:51,6926546662141,GUNTING EMIGO,1,15000,0,15000,12000,3000
7/5/2021 21:54,8992959508312,SWEETY SILVER PANTS XL RTG,1,15500,0,15500,13944,1556
7/5/2021 22:30,8999909085114,SAMPOERNA KRETEK HIJAU 12,1,13000,0,13000,11650,1350
7/6/2021 10:06,8998866501033,MINYAK GORENG SEDAAP POUCH 2L,3,29000,0,87000,83238,3762
7/6/2021 10:18,8992753102204,BKM COKLAT 370G,1,11300,0,11300,9500,1800
7/6/2021 10:20,8998989300261,GUDANG GARAM SURYA 12 FILTER,1,18500,0,18500,17200,1300
7/6/2021 10:26,8992628020152,BIMOLI POUCH 2L,1,31000,0,31000,29800,1200
7/6/2021 10:26,711844120433,SAMBAL ABC 600 ML,1,22000,0,22000,20300,1700
7/6/2021 10:26,8995333060703,TERIGU KOMPAS 1KG,2,10500,0,21000,19632,1368
7/6/2021 10:26,GL,GULA 1 LITER,2,11500,0,23000,21000,2000
7/6/2021 11:37,GL,GULA 1 LITER,4,11500,0,46000,42000,4000
7/6/2021 11:52,8993989311699,CLAS MILD 16 FILTER,1,23000,0,23000,21700,1300
7/6/2021 12:09,PRG,PARAGO,8,500,0,4000,3200,800
7/6/2021 12:34,8886013213208,FRENCH FREIS 2000,1,5000,0,5000,3750,1250
7/6/2021 12:34,8998866201483,POTABEE REGULER GRILLED SEAWEED 35GR,1,5000,0,5000,4150,850
7/6/2021 12:34,8992696523081,MILO UHT 110ML,2,2500,0,5000,3924,1076
7/6/2021 12:34,RT 1000,ROTI 1000,4,1000,0,4000,3200,800
7/6/2021 12:34,8998866601429,POWDET DAIA BUNGA BAG 290GR,1,5000,0,5000,4450,550
7/6/2021 12:34,HT,HOT-HOT,2,500,0,1000,700,300
7/6/2021 12:35,BALON,BALON CABUT,2,1000,0,2000,1800,200
7/6/2021 13:04,8999909000377,SAMPOERNA AVOLUTION,1,30000,0,30000,28450,1550
7/6/2021 15:24,8996001600146,TEH PUCUK HARUM 350ML,1,3000,0,3000,2314,686
7/6/2021 15:24,8992775318201,GERY SNACK BANTAL COKLAT,1,2000,0,2000,1712,288
7/6/2021 15:24,PD,PENDEKAR,1,500,0,500,350,150
7/6/2021 15:34,8997007780689,JIZZY MINERAL,2,3000,0,6000,2374,3626
7/6/2021 15:34,ROTI,ROTI 2000,1,2000,0,2000,1800,200
7/6/2021 15:34,SS,SUPER SNAPS,1,1500,0,1500,1333,167
7/6/2021 15:34,PRG,PARAGO,1,500,0,500,400,100
7/6/2021 15:34,8993007000024,INDOMILK UHT VANILA,1,5000,0,5000,3470,1530
7/6/2021 15:34,089686060126,POP MIE BASO JUMBO,1,4500,0,4500,3833,667
7/6/2021 15:34,PD,PENDEKAR,4,500,0,2000,1400,600
7/6/2021 17:19,kp,KALPA,1,2000,0,2000,1666,334
7/6/2021 17:19,8992775001653,GERY SALUT CHOCOLATE COCONUT,1,2000,0,2000,1476,524
7/6/2021 18:40,8996001600399,LE MINERAL 1500ML,1,5000,0,5000,4042,958
7/6/2021 20:09,6907992823645,JD COCONUT BLISS,1,4000,0,4000,3500,500
7/6/2021 20:09,8998866200301,MIE SEDAAP GORENG,1,2500,0,2500,2023,477
7/6/2021 20:09,8997009510017,YOU C1000 LEMON,2,10000,0,20000,18332,1668
7/6/2021 20:09,8992696404441,BEAR BRAND 189ML,1,9000,0,9000,7887,1113
7/6/2021 20:14,RB,RED BOLD,1,19000,0,19000,17900,1100
7/6/2021 20:14,8994867007161,ROKOK PENA GOLD 20,1,17000,0,17000,15500,1500
7/6/2021 20:22,8999999538422,CLEAR SHP ICM UNISEX 55 ML,1,5000,0,5000,3750,1250
7/6/2021 20:22,8998989300261,GUDANG GARAM SURYA 12 FILTER,1,18500,0,18500,17200,1300
7/6/2021 20:46,BM,BENG-BENG MAXX,2,2500,0,5000,4082,918
7/6/2021 20:46,089686021127,INTER MIE KALDU,5,1000,0,5000,4065,935
7/6/2021 20:46,8993379260804,SABUN MEDICARE BLUE,1,2500,0,2500,2237,263
7/6/2021 20:46,8998866888622,GIV MERAH KOTAK 76G,2,2000,0,4000,3640,360
7/6/2021 20:46,8997210107877,VORTEX SMART 3,1,5000,0,5000,4750,250
7/6/2021 20:46,8999999559854,AXE BLACK POCKET FRAG 17ML,1,10000,0,10000,8000,2000
7/6/2021 20:46,8992222050401,GATSBY WATER GLOSS KUNING 30GR,1,5000,0,5000,3700,1300
7/6/2021 20:46,KT,KUNING TELUR,1,2500,0,2500,2000,500
7/6/2021 20:46,8992959971109,SFX COMFORT SLIM 36CM 12+1,1,17000,0,17000,15152,1848
7/6/2021 20:46,ARG,ARGUS 220ML,1,14500,0,14500,12500,2000
7/6/2021 20:46,8999999195656,SARI WANGI 50X1.85,1,10000,0,10000,9500,500
7/6/2021 20:46,8999999524722,SUNLIGHT LIME NEW PCH 435ML,1,10000,0,10000,9100,900
7/6/2021 20:46,8998009020186,BUAVITA GUAVA 250ML,1,7000,0,7000,6083,917
7/6/2021 20:46,8992696521797SCT,MILO ACT GO 22G SCT,1,2000,0,2000,1553,447
7/6/2021 20:46,8995333060703,TERIGU KOMPAS 1KG,4,10500,0,42000,39264,2736
7/6/2021 20:46,RT MENARA,ROTI TAWAR MENARA,1,8000,0,8000,7200,800
7/6/2021 20:46,RT KJ,ROTI KASUR JUMBO,1,8000,0,8000,7200,800
7/6/2021 20:46,8992761139018,ADES 600ML,1,3500,0,3500,2292,1208
7/6/2021 20:46,RT BAKPIA,ROTI BAKPIA,2,1000,0,2000,1500,500
7/6/2021 20:46,8992775000076,GERY SNACK RING CKLT,1,2000,0,2000,1712,288
7/6/2021 20:46,KOPIKO,KOPIKO,4,250,0,1000,700,300
7/6/2021 20:46,089686021219,INTER MIE GORENG,4,1000,0,4000,3540,460
7/6/2021 20:46,8996001305003,SARI GANDUM SANDWICH,1,6000,0,6000,5100,900
7/6/2021 20:46,8996001600665,COOL TIME,1,3500,0,3500,2750,750
7/6/2021 20:46,8991188943536,SASA SANTAN KELAPA 65ML,1,3000,0,3000,2437,563
7/6/2021 20:46,MILKITA,MILKITA,6,250,0,1500,1200,300
7/6/2021 21:34,8993007000024,INDOMILK UHT VANILA,1,5000,0,5000,3470,1530
7/7/2021 10:52,8992761139018,ADES 600ML,1,3500,0,3500,2292,1208
7/7/2021 10:52,8991909101016,URBAN MILD 16,1,17000,0,17000,15800,1200
7/7/2021 10:52,123124,KOREK BIASA,1,2000,0,2000,1800,200
7/7/2021 10:52,bb,BENG-BENG,1,1500,0,1500,1450,50
7/7/2021 10:52,8991102022347,SIKAT GIGI FORMULA RIPPLE,1,5000,0,5000,4583,417
7/7/2021 10:53,8992696405417SCT,DNCO INSTANT 27G SCT,2,3500,0,7000,5914,1086
7/7/2021 10:53,8992696521797SCT,MILO ACT GO 22G SCT,1,2000,0,2000,1553,447
7/7/2021 10:58,8998866501033,MINYAK GORENG SEDAAP POUCH 2L,2,29000,0,58000,55492,2508
7/7/2021 10:58,8998866501026,MINYAK GORENG SEDAAP POUCH 1 L,1,15000,0,15000,14110,890
7/7/2021 10:58,8992959953044,SWEETY BRONZE XL1,1,2500,0,2500,2250,250
7/7/2021 10:58,8994834003752,TICTIC,1,2000,0,2000,1700,300
7/7/2021 10:58,RT BAKPIA,ROTI BAKPIA,1,1000,0,1000,750,250
7/7/2021 10:58,8998866804516,GIV LEMON KOTAK 76G,2,2000,0,4000,3640,360
7/7/2021 10:58,8998866609142,GIV MULBERRY SILK KOTAK 76G,2,2000,0,4000,3640,360
7/7/2021 10:58,8999999706081,PEPSODENT WHITE 75G,1,5000,0,5000,3850,1150
7/7/2021 12:31,PRG,PARAGO,6,500,0,3000,2400,600
7/7/2021 12:47,8992770034151,MASAKO 250GR,1,10000,0,10000,8000,2000
7/7/2021 13:13,8992770034175,MASAKO,1,5000,0,5000,4000,1000
7/7/2021 13:13,8993226112508,GARAM REFINA,1,3000,0,3000,2461,539
7/7/2021 13:20,8991002105409,KOPI KAPAL API,1,20000,0,20000,18888,1112
7/7/2021 13:39,8991102989381,TANGO LONG BUBBLEGUM 130G,1,5000,0,5000,4345,655
7/7/2021 13:39,8992775002735,CHOCOLATOS SUSU COKELAT,1,4000,0,4000,3520,480
7/7/2021 13:39,8997028590014,ARGUS 220ML,1,500,0,500,302,198
7/7/2021 13:39,8998866202619,MIE SEDAAP KOREAN SPICY SOUP,2,2500,0,5000,4546,454
7/7/2021 13:39,PRG,PARAGO,1,500,0,500,400,100
7/7/2021 13:39,8998989300261,GUDANG GARAM SURYA 12 FILTER,1,18500,0,18500,17200,1300
7/7/2021 13:39,8994907000428,KECAP SACHET ABC,1,500,0,500,354,146
7/7/2021 13:55,8999909096004,SAMPOERNA 16 FILTER,1,24000,0,24000,23000,1000
7/7/2021 14:45,8999999524722,SUNLIGHT LIME NEW PCH 435ML,1,10000,0,10000,9100,900
7/7/2021 14:45,8999999524807,SUNLIGHT HABBATUSSAUDA POUCH 755ML,1,17000,0,17000,15400,1600
7/7/2021 14:45,8995333032113,TERIGU GATOT KACA 1 KG,1,8500,0,8500,8012,488
7/7/2021 14:45,GL,GULA 1 LITER,2,11500,0,23000,21000,2000
7/7/2021 14:45,8998866501033,MINYAK GORENG SEDAAP POUCH 2L,1,29000,0,29000,27746,1254
7/7/2021 14:45,8991002105409,KOPI KAPAL API,1,20000,0,20000,18888,1112
7/7/2021 14:45,8993007002967,KRIMER KENTAL MANIS,2,10500,0,21000,18958,2042
7/7/2021 14:45,8996001351888,WFR WAFELLO,1,17000,0,17000,15500,1500
7/7/2021 14:45,RT BAKPIA,ROTI BAKPIA,1,1000,0,1000,750,250
7/7/2021 14:52,ARG,ARGUS 220ML,3,14500,0,43500,37500,6000
7/7/2021 15:24,8993324850449,BABY LOVE COTTON BUDS,1,5000,0,5000,4500,500
7/7/2021 15:24,8991111102603,JB SHAMPOO GOLD 100ML,1,9200,0,9200,8250,950
7/7/2021 15:24,4801010531234,JB BATH BLUE 200 (REFILL),1,14000,0,14000,13530,470
7/7/2021 15:24,8999999719395,VASELINE HW UV LIGHTENING 100ML,1,12900,0,12900,11805,1095
7/7/2021 15:24,8999999043674,LUX BW CAMELLIA WHITE LD REFF 450 ML,1,25000,0,25000,22330,2670
7/7/2021 15:24,8999999041229,DOVE SHP DNDRUFF CARE 160ML,1,24300,0,24300,22000,2300
7/7/2021 16:27,8998989110167,SURYA GUDANG GARAM 16 FILTER,1,25000,0,25000,23200,1800
7/7/2021 17:40,8992959953167,SWEETY BRONZE S36+2,1,48000,0,48000,45682,2318
7/7/2021 17:40,ROTI,ROTI 2000,1,2000,0,2000,1800,200
7/7/2021 17:56,8996001600399,LE MINERAL 1500ML,1,5000,0,5000,4042,958
7/7/2021 17:56,8992759120264,LARISST 220,1,10000,0,10000,9200,800
7/7/2021 17:56,8992696405417SCT,DNCO INSTANT 27G SCT,3,3500,0,10500,8871,1629
7/7/2021 18:05,8992759120264,LARISST 220,1,10000,0,10000,9200,800
7/7/2021 18:52,KT,KUNING TELUR,1,2500,0,2500,2000,500
7/7/2021 19:00,8992628022156,BIMOLI KLASIK TOUCH 1 LT,1,16000,0,16000,14350,1650
7/7/2021 19:00,8992957220087,COKLAT SINGA,1,2000,0,2000,1700,300
7/7/2021 19:04,8999909010567,234 DJI SAM SOE 16,2,22000,0,44000,43000,1000
7/7/2021 19:10,ARG,ARGUS 220ML,1,14500,0,14500,12500,2000
7/7/2021 19:10,GL,GULA 1 LITER,1,11500,0,11500,10500,1000
7/7/2021 19:11,8992957220087,COKLAT SINGA,2,2000,0,4000,3400,600
7/7/2021 20:39,8998866202343,MIE SEDAAP KOREAN SPICY,1,2500,0,2500,2023,477
7/7/2021 22:28,PD,PENDEKAR,1,500,0,500,350,150
7/7/2021 22:28,8992761145033,FANTA STRAW PET 250ML,1,3500,0,3500,2417,1083
7/8/2021 8:57,711844110083,KECAP ABC 275 ML,1,14500,0,14500,13400,1100
7/8/2021 8:57,GL,GULA 1 LITER,4,11500,0,46000,42000,4000
7/8/2021 8:57,8997025914059,HATARI SEE HONG,1,6000,0,6000,4911,1089
7/8/2021 9:01,8998989300261,GUDANG GARAM SURYA 12 FILTER,1,18500,0,18500,17200,1300
7/8/2021 9:01,RT MENARA,ROTI TAWAR MENARA,1,8000,0,8000,7200,800
7/8/2021 9:01,8998866203104,MIE SEDAAP SINGAPORE,1,2500,0,2500,2266,234
7/8/2021 9:01,KOPIKO,KOPIKO,2,250,0,500,350,150
7/8/2021 9:01,8991002105409,KOPI KAPAL API,1,20000,0,20000,18888,1112
7/8/2021 9:01,RT BAKPIA,ROTI BAKPIA,5,1000,0,5000,3750,1250
7/8/2021 9:01,8998989110167,SURYA GUDANG GARAM 16 FILTER,1,25000,0,25000,23200,1800
7/8/2021 9:01,8992730002992,HAI CANDY,1,7000,0,7000,6000,1000
7/8/2021 9:01,8997025914059,HATARI SEE HONG,1,6000,0,6000,4911,1089
7/8/2021 9:01,8998009020186,BUAVITA GUAVA 250ML,1,7000,0,7000,6083,917
7/8/2021 9:37,8998866200325,MIE SEDAAP SOTO,4,2500,0,10000,7808,2192
7/8/2021 9:37,089686011494,INDOMIE SOTO PADANG,2,2600,0,5200,4634,566
7/8/2021 9:37,089686041705,INDOMIE GORENG JUMBO,3,3500,0,10500,9429,1071
7/8/2021 9:37,8996001301142,ROMA KELAPA,1,8000,0,8000,6628,1372
7/8/2021 9:37,8993007002967,KRIMER KENTAL MANIS,1,10500,0,10500,9479,1021
7/8/2021 12:01,8998866501033,MINYAK GORENG SEDAAP POUCH 2L,2,29000,0,58000,55492,2508
7/8/2021 12:14,8998989110167,SURYA GUDANG GARAM 16 FILTER,1,25000,0,25000,23200,1800
7/8/2021 12:14,8994935000070,MINYAK DUNIA 450 ML,1,7500,0,7500,6779,721
7/8/2021 12:14,8993989311699,CLAS MILD 16 FILTER,1,23000,0,23000,21700,1300
7/8/2021 12:14,8998866200844,NOODLE SEDAAP MIE KARI SPESIAL CUP 81 GR,1,4500,0,4500,3650,850
7/8/2021 12:38,8999999537180,CLEAR SHP LEMON FRESH 9 ML,1,10500,0,10500,9300,1200
7/8/2021 12:38,8992979130012,TOTAL LEMON SOFTENER,1,13000,0,13000,11532,1468
7/8/2021 12:38,8934868015024,REXONA DEO LOTION FREE SPIRIT 9G,12,4500,0,54000,46800,7200
7/8/2021 14:10,089686834055,FREISS JERUK,1,11000,0,11000,8750,2250
7/8/2021 14:40,8998866202619,MIE SEDAAP KOREAN SPICY SOUP,2,2500,0,5000,4546,454
7/8/2021 14:40,8991909101016,URBAN MILD 16,1,17000,0,17000,15800,1200
7/8/2021 14:40,8998866200837,NOODLE SEDAAPMIE SOTO CUP 81 GR,1,4500,0,4500,3650,850
7/8/2021 14:40,8997013790108,BIMURA KACANG TELUR 25G,1,1000,0,1000,875,125
7/8/2021 14:40,HT,HOT-HOT,1,500,0,500,350,150
7/8/2021 14:42,BALON,BALON CABUT,5,1000,0,5000,4500,500
7/8/2021 14:42,8999999195649,SARI WANGI 25X1.86G,1,6000,0,6000,5050,950
7/8/2021 14:42,8991102384841,WFR TANGO LONG CKLT 130G,1,5000,0,5000,4345,655
7/8/2021 14:42,8992775001691,GARUDA ROSTA WAGYU BEEF,1,8000,0,8000,7322,678
7/8/2021 14:42,kp,KALPA,2,2000,0,4000,3332,668
7/8/2021 14:42,8992957220117,COKLAT BERUANG,1,2000,0,2000,1700,300
7/8/2021 14:42,8992957220063,COKLAT BANGO,1,2000,0,2000,1700,300
7/8/2021 14:42,8992957220087,COKLAT SINGA,1,2000,0,2000,1700,300
7/8/2021 14:51,123124,KOREK BIASA,1,2000,0,2000,1800,200
7/8/2021 14:51,8998989300261,GUDANG GARAM SURYA 12 FILTER,1,18500,0,18500,17200,1300
7/8/2021 15:05,711844110144,KECAP ABC 225 ML,1,9000,0,9000,8200,800
7/8/2021 15:05,8995333060703,TERIGU KOMPAS 1KG,1,10500,0,10500,9816,684
7/8/2021 15:05,HT,HOT-HOT,1,500,0,500,350,150
7/8/2021 15:08,8991102213189,BLASTER UNGU,1,5000,0,5000,3106,1894
7/8/2021 16:51,8998866808699,ROYALE PURPLE DAWN 13ML,1,5000,0,5000,4500,500
7/8/2021 17:53,8992959954034,SWEETY BRONZE NB 24,1,29000,0,29000,26762,2238
7/8/2021 17:56,8998866200882,SUKSESMIE GORENG AYAM KRMS 133GR,1,3500,0,3500,3047,453
7/8/2021 17:56,089686021219,INTER MIE GORENG,1,1000,0,1000,885,115
7/8/2021 17:56,HT,HOT-HOT,1,500,0,500,350,150
7/8/2021 17:56,8999999401023,MOLTO PEWANGI PINK 820ML,1,12500,0,12500,11275,1225
7/8/2021 17:56,8991102387286SCT,TANGO LONG CKLT 47G,3,2000,0,6000,4653,1347
7/8/2021 17:56,8994867000179,ROKOK PENA MILD 16,1,14500,0,14500,13500,1000
7/8/2021 17:56,PRG,PARAGO,4,500,0,2000,1600,400
7/8/2021 18:25,RT KN,ROTI KASUR NANAS,1,8000,0,8000,7200,800
7/8/2021 18:25,RSK,ROTI SUSU KOTAK,1,7500,0,7500,6500,1000
7/8/2021 18:25,CSM,ROTI COKLAT MATAHARI,1,6000,0,6000,5000,1000
7/8/2021 18:26,8992775203422,GARUDA ROSTA OVEN 100G,1,8000,0,8000,7322,678
7/8/2021 18:26,089686611519,QTELA SINGKONG,1,5000,0,5000,4266,734
7/8/2021 18:26,8994834003752,TICTIC,1,2000,0,2000,1700,300
7/8/2021 18:32,GL,GULA 1 LITER,1,11500,0,11500,10500,1000
7/8/2021 18:32,8999999195656,SARI WANGI 50X1.85,1,10000,0,10000,9500,500
7/8/2021 18:46,8991909101016,URBAN MILD 16,1,17000,0,17000,15800,1200
7/8/2021 18:46,089686021219,INTER MIE GORENG,2,1000,0,2000,1770,230
7/8/2021 19:34,8999909028234,234 DJI SAM SOE 12,1,17000,0,17000,15850,1150
7/8/2021 19:39,8992761145026,SPRITE PET 250ML,2,3500,0,7000,4834,2166
7/8/2021 19:39,8992761164539,NUTRIBOOST ORANGE 300ML,1,6500,0,6500,5300,1200
7/8/2021 19:39,8992775318201,GERY SNACK BANTAL COKLAT,1,2000,0,2000,1712,288
7/8/2021 20:11,8996001600269,LE MINERAL 600ML,1,3000,0,3000,1688,1312
7/8/2021 20:11,8992775001783,GERY SALUT MALKIST,1,6500,0,6500,5516,984
7/8/2021 20:20,8992761111519,COCA COLA SLIM CAM 250ML,1,5000,0,5000,3750,1250
7/8/2021 20:20,8998009010569,ULTRA CHO 200,1,5000,0,5000,3830,1170
7/8/2021 20:20,8992775002735,CHOCOLATOS SUSU COKELAT,1,4000,0,4000,3520,480
7/8/2021 20:20,8992761164546,NUTRIBOOST STRAWBERRY 300ML,1,6500,0,6500,5300,1200
7/8/2021 20:20,8992775001691,GARUDA ROSTA WAGYU BEEF,1,8000,0,8000,7322,678
7/8/2021 20:25,8996001600399,LE MINERAL 1500ML,2,5000,0,10000,8084,1916
7/8/2021 20:27,8994834003752,TICTIC,2,2000,0,4000,3400,600
7/8/2021 20:48,8999999555191,SAHAJA PENCUCI PRG JRUK NIPIS  BTL 650ML,1,19000,0,19000,17250,1750
7/8/2021 20:48,8993072254056,MELROSE COTTON BUDS KCL,1,3000,0,3000,2450,550
7/8/2021 21:46,8993989311279,CLAS MILD 12,1,17000,0,17000,15700,1300
7/8/2021 22:15,9556001004673,MILO NESTLE MALAYSIA ACTIVE GO,1,85000,0,85000,80000,5000
7/8/2021 22:15,GL,GULA 1 LITER,3,11500,0,34500,31500,3000
7/8/2021 22:15,8998666002525GT,TB TORA CAFE CAPPUCINO,1,9000,0,9000,7800,1200
7/8/2021 22:15,RT BAKPIA,ROTI BAKPIA,1,1000,0,1000,750,250
7/8/2021 22:15,8850507001152,MOTU ATV,1,10000,0,10000,8000,2000
7/8/2021 22:17,8993001003908,INDOMILK KENTAL MANIS 545G,1,15000,0,15000,13333,1667
7/9/2021 12:01,6907992823867,JD CRUNCHY CHOCOLATE MALT,1,5500,0,5500,4700,800
7/9/2021 12:12,8993989311699,CLAS MILD 16 FILTER,1,23000,0,23000,21700,1300
7/9/2021 12:12,089686044249,SUPERMI NUTRIMI STEAK AYAM,2,3500,0,7000,5600,1400
7/9/2021 12:12,089686043204,INDOMIE MIE ACEH,1,2700,0,2700,2452,248
7/9/2021 12:12,RT BAKPIA,ROTI BAKPIA,3,1000,0,3000,2250,750
7/9/2021 12:12,8998866200561,EKOMIE SUPER 600GR,1,10000,0,10000,8615,1385
7/9/2021 12:12,8996001312445,MALKIST CAPPUCINO,1,6500,0,6500,5400,1100
7/9/2021 12:12,8998866202619,MIE SEDAAP KOREAN SPICY SOUP,2,2500,0,5000,4546,454
7/9/2021 12:12,8998866202343,MIE SEDAAP KOREAN SPICY,2,2500,0,5000,4046,954
7/9/2021 12:12,8999909096004,SAMPOERNA 16 FILTER,1,24000,0,24000,23000,1000
7/9/2021 12:12,8997012321204,MAXX BUMBU BALADO,1,5000,0,5000,4100,900
7/9/2021 12:12,8991002105409,KOPI KAPAL API,1,20000,0,20000,18888,1112
7/9/2021 12:12,8996001338056,TAMARIN,1,6000,0,6000,5100,900
7/9/2021 12:12,ROTI,ROTI 2000,2,2000,0,4000,3600,400
7/9/2021 12:12,BALON,BALON CABUT,2,1000,0,2000,1800,200
7/9/2021 12:12,HT,HOT-HOT,3,500,0,1500,1050,450
7/9/2021 12:12,JGR SHN,JOGER SHINY SACHET,1,500,0,500,437,63
7/9/2021 12:12,8996001600269,LE MINERAL 600ML,1,3000,0,3000,1688,1312
7/9/2021 12:12,8998866201520,KOPI TOP TORAJA MURNI,1,11000,0,11000,9600,1400
7/9/2021 12:12,8999999534752,PEPSODENT ACTION123 CHARCOAL 65G,1,7400,0,7400,6710,690
7/9/2021 12:12,8992696521797SCT,MILO ACT GO 22G SCT,1,2000,0,2000,1553,447
7/9/2021 12:12,8996001312353,MALKIST KELAPA KOPYOR,2,6700,0,13400,10800,2600
7/9/2021 12:12,RT CD,ROTI COKLAT DURIAN,1,8000,0,8000,7200,800
7/9/2021 12:12,8998866200301,MIE SEDAAP GORENG,1,2500,0,2500,2023,477
7/9/2021 12:12,8998866200882,SUKSESMIE GORENG AYAM KRMS 133GR,1,3500,0,3500,3047,453
7/9/2021 12:12,8997231980022,O'JELLY MINI STRAWBERRY,1,3000,0,3000,2250,750
7/9/2021 12:12,MILKITA,MILKITA,2,250,0,500,400,100
7/9/2021 12:14,8998866201964,MINYAK GORENG SABRINA 2L POUCH,1,28000,0,28000,26753,1247
7/9/2021 13:01,8998866501033,MINYAK GORENG SEDAAP POUCH 2L,3,29000,0,87000,83238,3762
7/9/2021 14:45,8998866501033,MINYAK GORENG SEDAAP POUCH 2L,1,29000,0,29000,27746,1254
7/9/2021 14:45,TBR,TEPUNG BERAS ROSE BRAND,1,8000,0,8000,5800,2200
7/9/2021 15:14,GL,GULA 1 LITER,1,11500,0,11500,10500,1000
7/9/2021 17:19,SWAL,SENDAL SWALLOW,1,18000,0,18000,16500,1500
7/9/2021 17:23,6907992823966,JD BLUEBERRY,1,3500,0,3500,3000,500
7/9/2021 17:23,6907992824963,JD MILKY CHOCOLATE,1,3000,0,3000,2600,400
7/9/2021 17:23,8999909010567,234 DJI SAM SOE 16,1,22000,0,22000,21500,500
7/9/2021 17:25,8999909002821,MARLBORO BLACK 16,1,22000,0,22000,20850,1150
7/9/2021 18:10,ARG,ARGUS 220ML,3,14500,0,43500,37500,6000
7/9/2021 18:20,TG,TEH GELAS,5,1000,0,5000,3645,1355
7/9/2021 18:20,8998866202664,POTABEE WAGYU BEEF STEAK 68 GR,1,8000,0,8000,7200,800
7/9/2021 18:20,089686611519,QTELA SINGKONG,1,5000,0,5000,4266,734
7/9/2021 18:20,RT BAKPIA,ROTI BAKPIA,10,1000,0,10000,7500,2500
7/9/2021 18:56,PD,PENDEKAR,1,500,0,500,350,150
7/9/2021 18:56,8992761145026,SPRITE PET 250ML,1,3500,0,3500,2417,1083
7/9/2021 19:20,TG MARKISA,TEH GELAS MARKISA,3,2000,0,6000,3534,2466
7/9/2021 19:26,8998866501026,MINYAK GORENG SEDAAP POUCH 1 L,1,15000,0,15000,14110,890
7/9/2021 19:51,8997011700123,BIHUN JAGUNG 300GR,1,6000,0,6000,4979,1021
7/9/2021 20:07,8996001318980,BETTER 120G,1,6000,0,6000,5100,900
7/9/2021 20:07,8992696422735,DNCO CKLT UHT 110ML,1,2500,0,2500,2041,459
7/9/2021 20:07,8998866201483,POTABEE REGULER GRILLED SEAWEED 35GR,1,5000,0,5000,4150,850
7/9/2021 20:07,8992730002992,HAI CANDY,1,7000,0,7000,6000,1000
7/9/2021 20:07,8997009510017,YOU C1000 LEMON,1,10000,0,10000,9166,834
7/9/2021 20:35,8996001600375,LE MINERAL 330ML,1,2000,0,2000,1417,583
7/9/2021 20:35,8996001600269,LE MINERAL 600ML,1,3000,0,3000,1688,1312
7/9/2021 20:35,6907992823843,JD MOCHA CRISPY,1,5000,0,5000,4400,600
7/9/2021 21:13,8999999195649,SARI WANGI 25X1.86G,1,6000,0,6000,5050,950
7/9/2021 21:37,8998009020520,BUAVITA MINI GUAVA 125ML,1,6000,0,6000,5250,750
7/9/2021 21:37,8993007000024,INDOMILK UHT VANILA,1,5000,0,5000,3470,1530
7/9/2021 21:46,GL,GULA 1 LITER,2,11500,0,23000,21000,2000
7/9/2021 21:59,8992696404441,BEAR BRAND 189ML,2,9000,0,18000,15774,2226
7/10/2021 10:48,8998866202244,EKOMIE BUMBU KALDU AYAM,5,1000,0,5000,3990,1010
7/10/2021 10:48,8997009510017,YOU C1000 LEMON,1,10000,0,10000,9166,834
7/10/2021 10:48,8992696404441,BEAR BRAND 189ML,1,9000,0,9000,7887,1113
7/10/2021 10:51,TBR,TEPUNG BERAS ROSE BRAND,1,8000,0,8000,5800,2200
7/10/2021 10:51,8997012321204,MAXX BUMBU BALADO,1,5000,0,5000,4100,900
7/10/2021 10:51,8996001301142,ROMA KELAPA,1,8000,0,8000,6628,1372
7/10/2021 10:51,8992775913000SCT,CHOCOLATOS CKLT DRINK SCT,4,2000,0,8000,6344,1656
7/10/2021 10:51,8998866501033,MINYAK GORENG SEDAAP POUCH 2L,3,29000,0,87000,83238,3762
7/10/2021 10:51,711844340008,ABC TERASI,1,7000,0,7000,5800,1200
7/10/2021 10:51,HT,HOT-HOT,1,500,0,500,350,150
7/10/2021 10:51,BALON,BALON CABUT,2,1000,0,2000,1800,200
7/10/2021 11:16,8992957220025,GOLDEN CITY MINI,1,3000,0,3000,2500,500
7/10/2021 11:16,6907992825076,JD WATERMELON APPLE,2,2000,0,4000,3400,600
7/10/2021 11:16,8992957220087,COKLAT SINGA,1,2000,0,2000,1700,300
7/10/2021 11:16,8992957220063,COKLAT BANGO,2,2000,0,4000,3400,600
7/10/2021 11:48,8994867007161,ROKOK PENA GOLD 20,1,17000,0,17000,15500,1500
7/10/2021 11:56,8994867007161,ROKOK PENA GOLD 20,1,17000,0,17000,15500,1500
7/10/2021 11:56,8999909002821,MARLBORO BLACK 16,1,22000,0,22000,20850,1150
7/10/2021 12:27,8998866200325,MIE SEDAAP SOTO,6,2500,0,15000,11712,3288
7/10/2021 13:02,RB,RED BOLD,1,19000,0,19000,17900,1100
7/10/2021 13:09,BALON,BALON CABUT,2,1000,0,2000,1800,200
7/10/2021 14:24,8998866202619,MIE SEDAAP KOREAN SPICY SOUP,1,2500,0,2500,2273,227
7/10/2021 14:24,8993470672827,SAKU-SAKU SAPI PANGGANG,1,2000,0,2000,1530,470
7/10/2021 14:24,HT,HOT-HOT,1,500,0,500,350,150
7/10/2021 14:24,8998899002132,BAY FRESH LEMON 320ML,1,18500,0,18500,16700,1800
7/10/2021 15:04,BRS5,BERAS BUMN 5KG,1,64000,0,64000,50500,13500
7/10/2021 15:08,BG,BERAS GURIH PASAR RAME,1,60000,0,60000,56000,4000
7/10/2021 16:25,8999999706449,CLOSEUP ICY WHITE 65G,1,9000,0,9000,7865,1135
7/10/2021 16:30,8992696523067,MILO ACTVGO UHT 180ML,1,4500,0,4500,3515,985
7/10/2021 16:30,PD,PENDEKAR,1,500,0,500,350,150
7/10/2021 16:42,6907992823973,JD PINEAPPLE,1,5000,0,5000,4300,700
7/10/2021 16:42,8999999538453,SUNSILK SHP SOFT AND  SMOOTH 55 ML,1,5000,0,5000,3750,1250
7/10/2021 16:48,8998866693608,SOKLIN FLOORCLENER HIJAU 900ML,1,14000,0,14000,12436,1564
7/10/2021 16:48,8999999042608,RINSO MOLTO PARFUME ESSENCE 750ML,1,15000,0,15000,12507,2493
7/10/2021 16:48,8999999706081,PEPSODENT WHITE 75G,1,5000,0,5000,3850,1150
7/10/2021 16:48,8999999048501,SUNSILK RFR ANTI DDRF 170ML,1,22200,0,22200,20020,2180
7/10/2021 16:48,089686440133,BUMBU KARE,1,5000,0,5000,4500,500
7/10/2021 16:48,8991002105409,KOPI KAPAL API,1,20000,0,20000,18888,1112
7/10/2021 16:48,8992759120264,LARISST 220,1,10000,0,10000,9200,800
7/10/2021 16:48,8999999524722,SUNLIGHT LIME NEW PCH 435ML,1,10000,0,10000,9100,900
7/10/2021 16:48,VCL,VITAMIN C500 LEMON,10,1000,0,10000,5750,4250
7/10/2021 17:54,9556001004673,MILO NESTLE MALAYSIA ACTIVE GO,1,85000,0,85000,80000,5000
7/10/2021 18:00,8992759120264,LARISST 220,1,10000,0,10000,9200,800
7/10/2021 18:00,8996001351888,WFR WAFELLO,1,17000,0,17000,15500,1500
7/10/2021 18:40,8998989500166,GUDANG GARAM MERAH BESAR 16KS,2,18000,0,36000,34000,2000
7/10/2021 18:55,GL,GULA 1 LITER,1,11500,0,11500,10500,1000
7/10/2021 19:24,ARG,ARGUS 220ML,6,14500,0,87000,75000,12000
7/10/2021 20:05,RT MENARA,ROTI TAWAR MENARA,1,8000,0,8000,7200,800
7/10/2021 20:05,8998989110167,SURYA GUDANG GARAM 16 FILTER,1,25000,0,25000,23200,1800
7/10/2021 20:05,BALON,BALON CABUT,2,1000,0,2000,1800,200
7/10/2021 21:27,089686041705,INDOMIE GORENG JUMBO,2,3500,0,7000,6286,714
7/10/2021 21:27,8998866203104,MIE SEDAAP SINGAPORE,2,2500,0,5000,4532,468
7/10/2021 21:33,8992761166038,MMP ORANGE 300ML,2,5000,0,10000,7500,2500
7/10/2021 21:50,8999909010567,234 DJI SAM SOE 16,1,22000,0,22000,21500,500
7/10/2021 21:57,8998866501026,MINYAK GORENG SEDAAP POUCH 1 L,1,15000,0,15000,14110,890
7/10/2021 21:57,8996001318980,BETTER 120G,1,6000,0,6000,5100,900
7/10/2021 21:57,8998866202060,POTABEE AYAM BAKAR PEDAS 35 GR,1,5000,0,5000,4150,850
7/10/2021 21:57,711844330009,ABC SARDEN TOMAT,1,10000,0,10000,8000,2000
7/10/2021 21:57,8998866203104,MIE SEDAAP SINGAPORE,1,2500,0,2500,2266,234
7/10/2021 21:57,8992388111206,MIE ABC SELERA PEDAS-GULAI AYAM PEDAS,1,2500,0,2500,2022,478
7/10/2021 21:57,089686010190,INDOMIE KARI AYAM,1,2800,0,2800,2522,278
7/10/2021 21:57,POTO,KERUPUK PANJANG,1,5000,0,5000,4000,1000
7/10/2021 21:57,8992696404441,BEAR BRAND 189ML,1,9000,0,9000,7887,1113
7/10/2021 21:57,8999801700030,SUSU FOYU,1,11500,0,11500,10450,1050
7/10/2021 21:57,8992759120264,LARISST 220,1,10000,0,10000,9200,800
7/10/2021 21:57,8999999024468,CITRA FRESH EHITE 400ML,1,20800,0,20800,18950,1850
7/10/2021 21:57,8999999059781,SUNLIGHT LIME NEW POUCH 210ML,1,5000,0,5000,4300,700
7/10/2021 21:57,8999999030186,PEPSODENT ACTION 123 COMPLETE 190G,1,14000,0,14000,13200,800
7/10/2021 21:57,8998866618298,DAIA CLEAN&FRESH HJB 320GR,1,5000,0,5000,4450,550
7/10/2021 21:57,8994037800608,WENIS UNGU,1,8000,0,8000,6500,1500
7/10/2021 21:57,8999999528829,CITRA SAKURA FAIR UV 120ML,1,11200,0,11200,10082,1118
7/10/2021 21:57,8998866610742,NOVO FAMILY PINK 76G,1,2000,0,2000,1820,180
7/10/2021 21:57,8994907000428,KECAP SACHET ABC,4,500,0,2000,1416,584
7/11/2021 11:22,8999999514495,RINSO MOLTO ROSE FRESH 215ML,1,5000,0,5000,4250,750
7/11/2021 11:22,MOLTO PINK,MOLTO ALL IN ONE 11 ML,2,500,0,1000,800,200
7/11/2021 11:22,JGR SHN,JOGER SHINY SACHET,1,500,0,500,437,63
7/11/2021 11:22,BALON,BALON CABUT,1,1000,0,1000,900,100
7/11/2021 11:22,GL,GULA 1 LITER,1,11500,0,11500,10500,1000
7/11/2021 11:22,8998866202770,MIE SEDAAP SALERO PADANG,2,2500,0,5000,4724,276
7/11/2021 11:22,8998666002525SCT,TB TORA CAFE CAPPUCINO SCT,5,1000,0,5000,3900,1100
7/11/2021 11:49,8996001312438,MALKIST CAPPUCINO SCT,2,1000,0,2000,1640,360
7/11/2021 11:49,8996001312582,MALKIST KELAPA KOPYOR SCT,1,1000,0,1000,820,180
7/11/2021 11:49,BALON,BALON CABUT,2,1000,0,2000,1800,200
7/11/2021 11:53,8992775913000SCT,CHOCOLATOS CKLT DRINK SCT,4,2000,0,8000,6344,1656
7/11/2021 11:53,8991102987639,WFR TANGO LONG VNL 130G,1,5000,0,5000,3773,1227
7/11/2021 12:07,8998866500708,FLORIDINA ORANGE,1,3000,0,3000,2500,500
7/11/2021 12:34,8999999530266,LIFEBUOY MATCHA GREENTEA 100ML,2,10500,0,21000,18810,2190
7/11/2021 12:34,9556001025272,NESCAFE LATTE 240ML,1,8500,0,8500,7834,666
7/11/2021 12:34,8993560026028,DETTOL SENSITIVE,1,20000,0,20000,18524,1476
7/11/2021 12:39,8992759120264,LARISST 220,1,10000,0,10000,9200,800
7/11/2021 12:39,8999908082800,MARINA HEALTHY AND GLOW,1,10000,0,10000,8500,1500
7/11/2021 12:39,8886013213208,FRENCH FREIS 2000,1,5000,0,5000,3750,1250
7/11/2021 12:39,8998866202466,JAPOTA HAPPY HONEY BUTTER,1,5000,0,5000,4150,850
7/11/2021 12:40,8998866201964,MINYAK GORENG SABRINA 2L POUCH,1,28000,0,28000,26753,1247
7/11/2021 12:40,8998866201377,KRISBEE FRIES KENTANG GORENG 68 GR,1,5500,0,5500,4620,880
7/11/2021 17:35,8996001600375,LE MINERAL 330ML,2,2000,0,4000,2834,1166
7/11/2021 17:35,76239878,MARLBORO GOLD,1,30000,0,30000,27700,2300
7/11/2021 17:35,8998009040023,TEH KOTAK,1,5000,0,5000,2827,2173
7/11/2021 17:35,8998009010569,ULTRA CHO 200,1,5000,0,5000,3830,1170
7/11/2021 17:36,089686021219,INTER MIE GORENG,5,1000,0,5000,4425,575
7/11/2021 17:36,089686021127,INTER MIE KALDU,1,1000,0,1000,813,187
7/11/2021 17:37,8992752112013,MIZONE,1,5000,0,5000,3800,1200
7/11/2021 17:37,8992761145026,SPRITE PET 250ML,2,3500,0,7000,4834,2166
7/11/2021 18:32,8999909010567,234 DJI SAM SOE 16,1,22000,0,22000,21500,500
7/11/2021 18:54,8998989110167,SURYA GUDANG GARAM 16 FILTER,1,25000,0,25000,23200,1800
7/11/2021 18:54,123124,KOREK BIASA,1,2000,0,2000,1800,200
7/11/2021 18:59,8998989300261,GUDANG GARAM SURYA 12 FILTER,1,18500,0,18500,17200,1300
7/11/2021 18:59,MILKITA,MILKITA,2,250,0,500,400,100
7/11/2021 18:59,BALON,BALON CABUT,1,1000,0,1000,900,100
7/11/2021 19:03,8998989110167,SURYA GUDANG GARAM 16 FILTER,1,25000,0,25000,23200,1800
7/11/2021 19:06,8999999557355,ZWITSAL BABY BOTTLE CLEANER 135 ML,1,5000,0,5000,4000,1000
7/11/2021 19:44,8999999042646,RINSO MOLTO ROSE FRESH LIQ 40ML,2,6000,0,12000,9634,2366
7/11/2021 20:05,089686043273,INDOMIE SAMBAL RICA,2,2700,0,5400,4904,496
7/11/2021 20:33,8998989500166,GUDANG GARAM MERAH BESAR 16KS,1,18000,0,18000,17000,1000
7/11/2021 20:37,VCL,VITAMIN C500 LEMON,16,1000,0,16000,9200,6800
7/11/2021 21:12,8992775913000GT,CHOCOLATOS CKLT DRINK,1,18000,0,18000,15862,2138
7/11/2021 21:12,ROTI,ROTI 2000,2,2000,0,4000,3600,400
7/11/2021 21:12,RT BAKPIA,ROTI BAKPIA,13,1000,0,13000,9750,3250
7/11/2021 21:12,8992761164478,FRESTEA MILK TEA,1,8000,0,8000,6575,1425
7/11/2021 21:12,8997009510123,ORANGE WATER,1,7000,0,7000,6089,911
7/11/2021 21:13,6907992825076,JD WATERMELON APPLE,2,2000,0,4000,3400,600
7/11/2021 21:13,PD,PENDEKAR,1,500,0,500,350,150
7/11/2021 21:13,HT,HOT-HOT,1,500,0,500,350,150
7/11/2021 22:12,8992730002992,HAI CANDY,1,7000,0,7000,6000,1000
7/11/2021 22:12,8850507001152,MOTU ATV,1,10000,0,10000,8000,2000
7/11/2021 22:12,123,BETREI JAM,1,5500,0,5500,5000,500
7/11/2021 22:32,089686611519,QTELA SINGKONG,1,5000,0,5000,4266,734
7/12/2021 10:49,8992761166205,FRESTEA GREEN HONEY 350ML,3,4500,0,13500,9000,4500
7/12/2021 10:49,8993176110135,MINYAK TELON LANG 30ML,1,10000,0,10000,8167,1833
7/12/2021 10:49,8999999502003,"SARIMURNI RL RB 1,8G",1,1500,0,1500,1207,293
7/12/2021 10:49,8996001305041,ROMA SANDWICH CKLT,1,7000,0,7000,5000,2000
7/12/2021 10:49,8996001355237,SUPER STAR,1,11000,0,11000,9900,1100
7/12/2021 10:50,8992761139018,ADES 600ML,3,3500,0,10500,6876,3624
7/12/2021 11:07,8999999059316,LIFEBUOY TS MILDCARE 75G,1,3000,0,3000,2640,360
7/12/2021 11:07,BALON,BALON CABUT,4,1000,0,4000,3600,400
7/12/2021 11:40,8998989121163,SURYA PRO MERAH,1,20000,0,20000,18600,1400
7/12/2021 11:40,8992761002015,COCA COLA PET 390ML,1,5500,0,5500,4333,1167
7/12/2021 12:23,8992959974018,SFX SIRIH 36CM 12+1,1,17000,0,17000,15958,1042
7/12/2021 12:23,8999909002876,SAMPOERNA ULTRAMILD 12,1,16000,0,16000,14600,1400
7/12/2021 12:57,8998866501033,MINYAK GORENG SEDAAP POUCH 2L,1,29000,0,29000,27746,1254
7/12/2021 12:57,BM,BENG-BENG MAXX,1,2500,0,2500,2041,459
7/12/2021 12:57,VTM,VITAMIN,1,500,0,500,425,75
7/12/2021 12:57,089686048704,SARIMIE GORENG AYAM KCP ISI 2,2,3500,0,7000,6240,760
7/12/2021 13:20,GL,GULA 1 LITER,2,11500,0,23000,21000,2000
7/12/2021 13:20,8998866200646,KOPI TOP MURNI,1,11000,0,11000,9600,1400
7/12/2021 13:23,8999999401245,RINSO ANTI NODA NCLASSIC 1.4KG,1,36500,0,36500,33147,3353
7/12/2021 13:23,8998989300261,GUDANG GARAM SURYA 12 FILTER,1,18500,0,18500,17200,1300
7/12/2021 13:23,BALON,BALON CABUT,2,1000,0,2000,1800,200
7/12/2021 13:23,MILKITA,MILKITA,2,250,0,500,400,100
7/12/2021 13:35,6907992824963,JD MILKY CHOCOLATE,1,3000,0,3000,2600,400
7/12/2021 13:35,6907992823669,JD MILKY STRAW,1,3000,0,3000,2600,400
7/12/2021 13:35,6907992823829,JD MILKY MILK,1,3000,0,3000,2600,400
7/12/2021 13:35,8997231980039,O`JELLY KONYAKU (MAXI APPLE STRAWBERRY),1,5000,0,5000,4620,380
7/12/2021 13:35,BALON,BALON CABUT,10,1000,0,10000,9000,1000
7/12/2021 14:15,RT KJ,ROTI KASUR JUMBO,2,8000,0,16000,14400,1600
7/12/2021 14:15,8999999526863,MOLTO ALL IN ONE PINK 11ML,3,5500,0,16500,14400,2100
7/12/2021 14:15,8996001402023GT,TB TORA SUSU,1,13000,0,13000,9333,3667
7/12/2021 14:15,8998866201490,POTABEE REGULER GRILLED SEAWED 68 GR,1,8000,0,8000,7200,800
7/12/2021 14:15,8998866201483,POTABEE REGULER GRILLED SEAWEED 35GR,2,5000,0,10000,8300,1700
7/12/2021 14:15,8998866201452,POTABEE REGULER BBQ BEEF 35GR,1,5000,0,5000,4150,850
7/12/2021 14:15,711844110144,KECAP ABC 225 ML,1,9000,0,9000,8200,800
7/12/2021 14:48,GL,GULA 1 LITER,2,11500,0,23000,21000,2000
7/12/2021 14:50,8999999534097,PEPSODENT PGB FCM 75G,1,5000,0,5000,3850,1150
7/12/2021 14:50,8999908082800,MARINA HEALTHY AND GLOW,1,10000,0,10000,8500,1500
7/12/2021 14:50,8993379121204,SABUN MEDICARE RED,1,2500,0,2500,2237,263
7/12/2021 14:50,8993379260804,SABUN MEDICARE BLUE,1,2500,0,2500,2237,263
7/12/2021 14:50,8999908059802,MY BABY POWDER KUNING,1,5000,0,5000,3276,1724
7/12/2021 14:50,8999999031930,PEPSODENT TB TRIPLE CLEAN,1,3500,0,3500,2850,650
7/12/2021 14:50,HT,HOT-HOT,1,500,0,500,350,150
7/12/2021 15:15,8998866501026,MINYAK GORENG SEDAAP POUCH 1 L,1,15000,0,15000,14110,890
7/12/2021 15:15,8992696404441,BEAR BRAND 189ML,1,9000,0,9000,7887,1113
7/12/2021 16:03,8996001355978,BENG-BENG SHARE IT 9.5G,1,10000,0,10000,8700,1300
7/12/2021 16:03,8996001600375,LE MINERAL 330ML,2,2000,0,4000,2834,1166
7/12/2021 16:03,8991001111883,SILVERQUEEN CHUNKYBAR 33G,1,8000,0,8000,7150,850
7/12/2021 16:16,SLAIM,SLAIM WARNA,2,2000,0,4000,3486,514
7/12/2021 16:35,8992761145026,SPRITE PET 250ML,1,3500,0,3500,2417,1083
7/12/2021 16:35,8999909002876,SAMPOERNA ULTRAMILD 12,1,16000,0,16000,14600,1400
7/12/2021 16:35,8992957220087,COKLAT SINGA,1,2000,0,2000,1700,300
7/12/2021 16:39,8998989300261,GUDANG GARAM SURYA 12 FILTER,1,18500,0,18500,17200,1300
7/12/2021 16:39,8992730002992,HAI CANDY,1,7000,0,7000,6000,1000
7/12/2021 17:02,8996001600375,LE MINERAL 330ML,1,2000,0,2000,1417,583
7/12/2021 17:02,PD,PENDEKAR,1,500,0,500,350,150
7/12/2021 17:02,8997028590014,ARGUS 220ML,1,500,0,500,302,198
7/12/2021 17:15,8998866202930,SEDAAP AYAM JERIT CUP,1,4500,0,4500,3738,762
7/12/2021 17:15,089686049053,SARIMI PUAS,1,3000,0,3000,2400,600
7/12/2021 17:15,KP,KERIPIK PISANG,1,5000,0,5000,5000,0
7/12/2021 17:34,COKLAT,COKLAT COIN,2,500,0,1000,850,150
7/12/2021 17:34,8998866501033,MINYAK GORENG SEDAAP POUCH 2L,1,29000,0,29000,27746,1254
7/12/2021 17:35,8998989110167,SURYA GUDANG GARAM 16 FILTER,1,25000,0,25000,23200,1800
7/12/2021 17:53,8991102714846,MILKIDO CKLT,1,3000,0,3000,2153,847
7/12/2021 17:53,8998866203104,MIE SEDAAP SINGAPORE,1,2500,0,2500,2266,234
7/12/2021 17:53,RSK,ROTI SUSU KOTAK,1,7500,0,7500,6500,1000
7/12/2021 18:07,8992761145033,FANTA STRAW PET 250ML,1,3500,0,3500,2417,1083
7/12/2021 18:19,8998866203104,MIE SEDAAP SINGAPORE,1,2500,0,2500,2266,234
7/12/2021 18:19,8998866202923,FLORIDINA COCO,1,3000,0,3000,2500,500
7/12/2021 18:19,8996001312438,MALKIST CAPPUCINO SCT,1,1000,0,1000,820,180
7/12/2021 18:19,089686021127,INTER MIE KALDU,1,1000,0,1000,813,187
7/12/2021 18:19,JGR SHN,JOGER SHINY SACHET,1,500,0,500,437,63
7/12/2021 18:22,8997009510017,YOU C1000 LEMON,1,10000,0,10000,9166,834
7/12/2021 18:22,089686043204,INDOMIE MIE ACEH,2,2700,0,5400,4904,496
7/12/2021 18:22,8996001301142,ROMA KELAPA,1,8000,0,8000,6628,1372
7/12/2021 19:19,8999909010567,234 DJI SAM SOE 16,1,22000,0,22000,21500,500
7/12/2021 19:36,ARG,ARGUS 220ML,1,14500,0,14500,12500,2000
7/12/2021 19:56,8993001003908,INDOMILK KENTAL MANIS 545G,1,15000,0,15000,13333,1667
7/12/2021 19:57,8992761145033,FANTA STRAW PET 250ML,3,3500,0,10500,7251,3249
7/12/2021 19:57,8992761145026,SPRITE PET 250ML,3,3500,0,10500,7251,3249
7/12/2021 19:57,8992957220063,COKLAT BANGO,1,2000,0,2000,1700,300
7/12/2021 20:02,8998866613729,EMERON LOVELY NTRL 100ML,1,3500,0,3500,2900,600
7/12/2021 20:02,8994935000070,MINYAK DUNIA 450 ML,1,7500,0,7500,6779,721
7/12/2021 20:55,8999999555450,VIXAL PEMB PORS BIRU 190ML,1,5000,0,5000,4200,800
7/12/2021 20:55,8999999524722,SUNLIGHT LIME NEW PCH 435ML,1,10000,0,10000,9100,900
7/12/2021 20:55,8934868015024,REXONA DEO LOTION FREE SPIRIT 9G,3,2500,0,7500,6000,1500
7/12/2021 20:55,kp,KALPA,3,2000,0,6000,4998,1002
7/12/2021 20:55,8992957220087,COKLAT SINGA,1,2000,0,2000,1700,300
7/12/2021 20:55,8992957220186,COKLAT RUSA,1,2000,0,2000,1700,300
7/12/2021 20:55,8998866609036,DAIA BUNGA GUSSET 565G,1,10000,0,10000,8700,1300
7/12/2021 20:55,GL,GULA 1 LITER,1,11500,0,11500,10500,1000
7/12/2021 20:55,8998866808699,ROYALE PURPLE DAWN 13ML,1,5000,0,5000,4500,500
7/12/2021 20:55,8998866201377,KRISBEE FRIES KENTANG GORENG 68 GR,1,5500,0,5500,4620,880
7/12/2021 21:06,8992696521797SCT,MILO ACT GO 22G SCT,1,2000,0,2000,1553,447
7/12/2021 21:06,MENTOS,MENTOS,4,250,0,1000,700,300
7/12/2021 22:09,8998989300261,GUDANG GARAM SURYA 12 FILTER,1,18500,0,18500,17200,1300
7/12/2021 22:09,8992761139018,ADES 600ML,1,3500,0,3500,2292,1208
7/12/2021 22:23,8992761002022,SPRITE PET 390ML,1,5500,0,5500,4300,1200
7/12/2021 22:24,8997218380074,ICHITAN MILK TEA,1,8000,0,8000,6583,1417
7/12/2021 22:24,8999999528812,CITRA  GOLDEN WHITE 120ML,1,11100,0,11100,10082,1018
7/12/2021 22:38,8993571002196,CAP 19 OBAT KURAP AIR 10ML,1,5000,0,5000,3637,1363
7/12/2021 22:38,8886001038011,BENG-BENG SCT,1,1500,0,1500,1450,50
7/12/2021 22:38,8998989110167,SURYA GUDANG GARAM 16 FILTER,1,25000,0,25000,23200,1800
7/13/2021 11:48,GL,GULA 1 LITER,4,11500,0,46000,42000,4000
7/13/2021 11:48,8992696523067,MILO ACTVGO UHT 180ML,1,4500,0,4500,3515,985
7/13/2021 11:48,8996001600375,LE MINERAL 330ML,1,2000,0,2000,1417,583
7/13/2021 11:48,8998866201452,POTABEE REGULER BBQ BEEF 35GR,1,5000,0,5000,4150,850
7/13/2021 11:48,9556001174659,MILO ACT GO 240ML,1,8500,0,8500,7437,1063
7/13/2021 11:48,8850507002197,TOK TAK FRUIT CANDY,1,7500,0,7500,6250,1250
7/13/2021 11:48,BALON,BALON CABUT,2,1000,0,2000,1800,200
7/13/2021 11:48,HT,HOT-HOT,1,500,0,500,350,150
7/13/2021 11:48,CLUB,AIR CLUB,1,3000,0,3000,1452,1548
7/13/2021 11:48,ROTI,ROTI 2000,2,2000,0,4000,3600,400
7/13/2021 11:48,8998866202602,KRISBEE FRENCH FRIES 18GR,1,2000,0,2000,1500,500
7/13/2021 11:48,RT BAKPIA,ROTI BAKPIA,2,1000,0,2000,1500,500
7/13/2021 11:48,8996001302620,MALKIST COKLAT SCT,2,1000,0,2000,1680,320
7/13/2021 11:48,8997231980039,O`JELLY KONYAKU (MAXI APPLE STRAWBERRY),1,5000,0,5000,4620,380
7/13/2021 11:48,8996001440049,ENERGEN,2,1500,0,3000,2400,600
7/13/2021 11:48,CSM,ROTI COKLAT MATAHARI,1,6000,0,6000,5000,1000
7/13/2021 11:48,8993989311699,CLAS MILD 16 FILTER,1,23000,0,23000,21700,1300
7/13/2021 11:48,8991102714846,MILKIDO CKLT,1,3000,0,3000,2153,847
7/13/2021 11:48,8991102281430,PERMEN MINTZ DUOMINT,1,4500,0,4500,4000,500
7/13/2021 11:48,8996001305041,ROMA SANDWICH CKLT,1,7000,0,7000,5000,2000
7/13/2021 11:48,8998009020186,BUAVITA GUAVA 250ML,2,7000,0,14000,12166,1834
7/13/2021 11:48,8996001600597,KOPIKO LUCKY DAY,1,5000,0,5000,4283,717
7/13/2021 11:48,8994834003752,TICTIC,1,2000,0,2000,1700,300
7/13/2021 11:48,8992761145033,FANTA STRAW PET 250ML,1,3500,0,3500,2417,1083
7/13/2021 11:48,MENTOS,MENTOS,6,250,0,1500,1050,450
7/13/2021 12:39,8851019210193,POCKY CHOCO BANANA 47G,1,7300,0,7300,5671,1629
7/13/2021 12:46,8850507000094,POLICE BONCHA,1,2000,0,2000,800,1200
7/13/2021 12:58,8998989500166,GUDANG GARAM MERAH BESAR 16KS,1,18000,0,18000,17000,1000
7/13/2021 12:58,GL,GULA 1 LITER,1,11500,0,11500,10500,1000
7/13/2021 12:58,8999909004221,SAMPOERNA ULTRAMILD 16,1,22000,0,22000,20350,1650
7/13/2021 13:20,8998866501033,MINYAK GORENG SEDAAP POUCH 2L,3,29000,0,87000,83238,3762
7/13/2021 13:23,8992775318201,GERY SNACK BANTAL COKLAT,1,2000,0,2000,1712,288
7/13/2021 13:23,8886001038011,BENG-BENG SCT,2,1500,0,3000,2900,100
7/13/2021 13:23,8996001355756,BENG-BENG MAXX SCT,1,2500,0,2500,2041,459
7/13/2021 14:01,6907992823867,JD CRUNCHY CHOCOLATE MALT,1,5500,0,5500,4700,800
7/13/2021 14:01,6907992823621,JD CREAMY YOGURT,1,3000,0,3000,2600,400
7/13/2021 14:01,JGR SHN,JOGER SHINY SACHET,1,500,0,500,437,63
7/13/2021 14:03,6907992823966,JD BLUEBERRY,1,3500,0,3500,3000,500
7/13/2021 14:03,6907992823669,JD MILKY STRAW,1,3000,0,3000,2600,400
7/13/2021 14:42,8991001780492,SELAMAT COKLAT,1,13000,0,13000,11800,1200
7/13/2021 14:42,8992761122430,FRESTEA GREEN HONEY 500ML,1,6500,0,6500,4708,1792
7/13/2021 14:42,8992761002039,FANTA STRAWBERRY PET 390 ML,1,5500,0,5500,4300,1200
7/13/2021 14:48,8992696404441,BEAR BRAND 189ML,1,9000,0,9000,7887,1113
7/13/2021 14:48,8997009510017,YOU C1000 LEMON,1,10000,0,10000,9166,834
7/13/2021 15:05,8995333060703,TERIGU KOMPAS 1KG,2,10500,0,21000,19632,1368
7/13/2021 15:05,8992628020152,BIMOLI POUCH 2L,1,31000,0,31000,29800,1200
7/13/2021 15:05,GL,GULA 1 LITER,2,11500,0,23000,21000,2000
7/13/2021 15:05,8999999049447,REXONA WMN RO ADVANCED WHITE 45 ML,1,16500,0,16500,14900,1600
7/13/2021 15:05,8996001318911,BETTER ISI 4,2,2000,0,4000,3400,600
7/13/2021 15:05,8992628510158,SIMAS PALMIA,1,6000,0,6000,4832,1168
7/13/2021 15:05,ROTI,ROTI 2000,2,2000,0,4000,3600,400
7/13/2021 15:05,JGR SHN,JOGER SHINY SACHET,3,500,0,1500,1311,189
7/13/2021 16:57,8998989110167,SURYA GUDANG GARAM 16 FILTER,1,25000,0,25000,23200,1800
7/13/2021 16:57,8998989300261,GUDANG GARAM SURYA 12 FILTER,1,18500,0,18500,17200,1300
7/13/2021 17:26,8992959953310,SWEETY BRONZE M58,1,85000,0,85000,80304,4696
7/13/2021 17:26,8996001318430,BETTER 1000,1,1000,0,1000,820,180
7/13/2021 17:33,089686060362,POP MIE SOTO AYAM JUMBO,2,4500,0,9000,7666,1334
7/13/2021 17:33,8995333060703,TERIGU KOMPAS 1KG,1,10500,0,10500,9816,684
7/13/2021 17:33,089686041705,INDOMIE GORENG JUMBO,2,3500,0,7000,6286,714
7/13/2021 17:33,089686043273,INDOMIE SAMBAL RICA,2,2700,0,5400,4904,496
7/13/2021 17:33,8998866200325,MIE SEDAAP SOTO,2,2500,0,5000,3904,1096
7/13/2021 17:38,8992694247163,ZWITSAL SOAP RICH N HON 70G,1,4000,0,4000,3410,590
7/13/2021 17:38,8999999537180,CLEAR SHP LEMON FRESH 9 ML,1,10500,0,10500,9300,1200
7/13/2021 17:38,COBRA,LEM TIKUS COBRA,1,20000,0,20000,15000,5000
7/13/2021 17:38,8998866500708,FLORIDINA ORANGE,1,3000,0,3000,2500,500
7/13/2021 17:38,8992696404441,BEAR BRAND 189ML,1,9000,0,9000,7887,1113
7/13/2021 17:38,8992959953143,SWEEETY BRONZE XL20,1,45000,0,45000,42620,2380
7/13/2021 17:38,8991102385060,TANGO WAFFLE CHOX,1,9000,0,9000,8498,502
7/13/2021 17:38,089686043617,INDOMIE MIEGHETTI,1,2700,0,2700,2452,248
7/13/2021 17:38,8998866200301,MIE SEDAAP GORENG,1,2500,0,2500,2023,477
7/13/2021 17:38,8991102714846,MILKIDO CKLT,1,3000,0,3000,2153,847
7/13/2021 17:53,8992959954058,SWEETY BRONZE NB 44,1,48000,0,48000,45682,2318
7/13/2021 18:02,8994867007161,ROKOK PENA GOLD 20,1,17000,0,17000,15500,1500
7/13/2021 18:32,8991111101330,JB OIL 200ML,1,28000,0,28000,26080,1920
7/13/2021 18:39,BALON,BALON CABUT,1,1000,0,1000,900,100
7/13/2021 18:58,8998866203104,MIE SEDAAP SINGAPORE,2,2500,0,5000,4532,468
7/13/2021 18:58,089686043617,INDOMIE MIEGHETTI,1,2700,0,2700,2452,248
7/13/2021 18:58,8998866106979,CIPTADENT TB CHARCOAL PROTEC,1,6000,0,6000,5250,750
7/13/2021 18:58,089686041705,INDOMIE GORENG JUMBO,2,3500,0,7000,6286,714
7/13/2021 18:58,089686049053,SARIMI PUAS,1,3000,0,3000,2400,600
7/13/2021 18:59,KOPIKO,KOPIKO,5,250,0,1250,875,375
7/13/2021 20:16,BRS5,BERAS BUMN 5KG,1,64000,0,64000,50500,13500
7/13/2021 20:16,8994867000162,ROKOK PUNDIMAS KRETEK16,1,10000,0,10000,8600,1400
7/13/2021 20:16,8996001600146,TEH PUCUK HARUM 350ML,2,3000,0,6000,4628,1372
7/13/2021 20:16,8997011700123,BIHUN JAGUNG 300GR,1,6000,0,6000,4979,1021
7/13/2021 20:16,8998866608459,POWDET DAIA PUTIH BAG 290GR,1,5000,0,5000,4450,550
7/13/2021 20:51,8999909002821,MARLBORO BLACK 16,1,22000,0,22000,20850,1150
7/13/2021 21:10,8998866202244,EKOMIE BUMBU KALDU AYAM,3,1000,0,3000,2394,606
7/13/2021 21:10,8997013790108,BIMURA KACANG TELUR 25G,1,1000,0,1000,875,125
7/13/2021 21:11,8999999516208,ROYCO FDS CHICKEN NEW 230G,1,10000,0,10000,9000,1000
7/13/2021 21:11,8991188943062,SASA 250G,1,10000,0,10000,8500,1500
7/13/2021 21:21,8991102228053,TEH GELAS BOTOL,1,3000,0,3000,1695,1305
7/13/2021 21:21,8992775002582,DILAN CHOCO,1,2000,0,2000,1503,497
7/13/2021 21:28,8997025914059,HATARI SEE HONG,1,6000,0,6000,4911,1089
7/13/2021 21:28,8997025911058,HATARI SHP KELAPA,1,6000,0,6000,4911,1089
7/13/2021 21:58,8999999706081,PEPSODENT WHITE 75G,1,5000,0,5000,3850,1150
7/13/2021 21:58,8999999519711,PEPSODENT TB HIMALAYAN ROCK SALT,1,13300,0,13300,12045,1255
7/13/2021 21:58,8998989300261,GUDANG GARAM SURYA 12 FILTER,1,18500,0,18500,17200,1300
7/13/2021 21:59,MENTOS,MENTOS,13,250,0,3250,2275,975
7/13/2021 22:04,RB,RED BOLD,1,19000,0,19000,17900,1100
7/13/2021 22:24,9556001025272,NESCAFE LATTE 240ML,1,8500,0,8500,7834,666
7/13/2021 22:24,8992761139018,ADES 600ML,1,3500,0,3500,2292,1208
7/13/2021 22:24,8992775002582,DILAN CHOCO,1,2000,0,2000,1503,497
7/13/2021 22:25,8998866201865,KRISBEE PILLOW CHOCOLAVA 120 GR,1,8000,0,8000,7250,750
7/13/2021 22:30,8998866610087,JAVANA ORIGINAL 350ML,1,3000,0,3000,2150,850
7/13/2021 22:30,MENTOS,MENTOS,4,250,0,1000,700,300
7/13/2021 22:30,MILKITA,MILKITA,4,250,0,1000,800,200
7/14/2021 12:06,8992761139018,ADES 600ML,1,3500,0,3500,2292,1208
7/14/2021 12:28,8999999529918,CLEAR SPR FRESH APPLE 80ML,1,11300,0,11300,10120,1180
7/14/2021 12:30,8998866500708,FLORIDINA ORANGE,1,3000,0,3000,2500,500
7/14/2021 12:30,8998866501033,MINYAK GORENG SEDAAP POUCH 2L,1,29000,0,29000,27746,1254
7/14/2021 13:20,8998866501033,MINYAK GORENG SEDAAP POUCH 2L,2,29000,0,58000,55492,2508
7/14/2021 13:20,8998989300261,GUDANG GARAM SURYA 12 FILTER,1,18500,0,18500,17200,1300
7/14/2021 13:35,8998866602273,HERSPROTEX SOFTCARE MAX,1,3500,0,3500,2950,550
7/14/2021 14:38,8992959953167,SWEETY BRONZE S36+2,1,48000,0,48000,45682,2318
7/14/2021 15:05,8996001305041,ROMA SANDWICH CKLT,1,7000,0,7000,5000,2000
7/14/2021 15:05,8998866201964,MINYAK GORENG SABRINA 2L POUCH,1,28000,0,28000,26753,1247
7/14/2021 15:05,RSK,ROTI SUSU KOTAK,1,7500,0,7500,6500,1000
7/14/2021 15:10,8999999195649,SARI WANGI 25X1.86G,1,6000,0,6000,5050,950
7/14/2021 15:33,8992753102204,BKM COKLAT 370G,2,11300,0,22600,19000,3600
7/14/2021 15:33,8991102384841,WFR TANGO LONG CKLT 130G,2,5000,0,10000,8690,1310
7/14/2021 15:33,8996001305058,ROMA SANDWICH KACANG,1,7000,0,7000,5000,2000
7/14/2021 15:33,8996001305041,ROMA SANDWICH CKLT,1,7000,0,7000,5000,2000
7/14/2021 15:33,RT MENARA,ROTI TAWAR MENARA,1,8000,0,8000,7200,800
7/14/2021 18:48,8997009510123,ORANGE WATER,1,7000,0,7000,6089,911
7/14/2021 18:48,8992957220087,COKLAT SINGA,1,2000,0,2000,1700,300
7/14/2021 18:48,8992957220063,COKLAT BANGO,1,2000,0,2000,1700,300
7/14/2021 18:48,COKLAT,COKLAT COIN,1,500,0,500,425,75
7/14/2021 19:41,8991188943536,SASA SANTAN KELAPA 65ML,3,3000,0,9000,7311,1689
7/14/2021 19:41,MILKITA,MILKITA,4,250,0,1000,800,200
7/14/2021 20:10,8999909085114,SAMPOERNA KRETEK HIJAU 12,1,13000,0,13000,11650,1350
7/14/2021 20:10,8999909096004,SAMPOERNA 16 FILTER,1,24000,0,24000,23000,1000
7/14/2021 21:05,8998989500166,GUDANG GARAM MERAH BESAR 16KS,1,18000,0,18000,17000,1000
7/14/2021 21:25,8994867007161,ROKOK PENA GOLD 20,1,17000,0,17000,15500,1500
7/14/2021 21:25,8999909002821,MARLBORO BLACK 16,1,22000,0,22000,20850,1150
7/14/2021 21:30,8992222091961,PUCELLE MIST COL SPRAY 75ML,1,13000,0,13000,11650,1350
7/14/2021 22:32,8999909010567,234 DJI SAM SOE 16,2,22000,0,44000,43000,1000
7/14/2021 22:35,8996001318430,BETTER 1000,1,1000,0,1000,820,180
7/14/2021 22:35,8996001318980,BETTER 120G,1,6000,0,6000,5100,900
7/15/2021 12:55,8998989500166,GUDANG GARAM MERAH BESAR 16KS,1,18000,0,18000,17000,1000
7/15/2021 12:55,RB,RED BOLD,1,19000,0,19000,17900,1100
7/15/2021 12:59,MILKITA,MILKITA,4,250,0,1000,800,200
7/15/2021 13:00,8994907001272,KECAP ABC 700 ML,1,22500,0,22500,21000,1500
7/15/2021 13:00,8994935000049,MINYAK GORENG DAMAI 5L,1,75000,0,75000,73780,1220
7/15/2021 14:53,8999909096004,SAMPOERNA 16 FILTER,1,24000,0,24000,23000,1000
7/15/2021 14:53,HT,HOT-HOT,2,500,0,1000,700,300
7/15/2021 15:08,8999909002821,MARLBORO BLACK 16,1,22000,0,22000,20850,1150
7/15/2021 15:26,8999999045920,LIFEBUOY TS TOTAL 10 110GR,1,15000,0,15000,14245,755
7/15/2021 16:04,8992959953334,SWEETY BRONZE XL42,2,80000,0,160000,150910,9090
7/15/2021 16:04,711844120419,SAMBAL ABC 275 ML,1,12000,0,12000,10800,1200
7/15/2021 16:04,8998866612173,SOKLIN SOFTERGENT PINK 770G & PIRING,1,18000,0,18000,16055,1945
7/15/2021 16:04,8999999524722,SUNLIGHT LIME NEW PCH 435ML,1,10000,0,10000,9100,900
7/15/2021 16:04,8993226112508,GARAM REFINA,1,3000,0,3000,2461,539
7/15/2021 16:04,8998866200301,MIE SEDAAP GORENG,2,2500,0,5000,4046,954
7/15/2021 16:04,8992775000076,GERY SNACK RING CKLT,1,2000,0,2000,1712,288
7/15/2021 16:35,8998989500166,GUDANG GARAM MERAH BESAR 16KS,1,18000,0,18000,17000,1000
7/15/2021 16:36,8994935000049,MINYAK GORENG DAMAI 5L,1,75000,0,75000,73780,1220
7/15/2021 16:38,8992959971109,SFX COMFORT SLIM 36CM 12+1,1,17000,0,17000,15152,1848
7/15/2021 16:39,JD VM,JD VANILLA MILKSHAKE,1,5000,0,5000,4300,700
7/15/2021 16:40,8999999059781,SUNLIGHT LIME NEW POUCH 210ML,1,5000,0,5000,4300,700
7/15/2021 16:42,8999908204202,MY BABY MINYAK TELON 60ML,1,18000,0,18000,16900,1100
7/15/2021 16:57,8994867000179,ROKOK PENA MILD 16,1,14500,0,14500,13500,1000
7/15/2021 17:00,8998989300261,GUDANG GARAM SURYA 12 FILTER,1,18500,0,18500,17200,1300
7/15/2021 17:00,HT,HOT-HOT,1,500,0,500,350,150
7/15/2021 17:28,8992959304235,SFX COMFORT SLIM 29CM 8S,1,8000,0,8000,7387,613
7/15/2021 17:28,8991001111883,SILVERQUEEN CHUNKYBAR 33G,1,8000,0,8000,7150,850
7/15/2021 17:29,ff,FULLO BLASTO,1,1000,0,1000,995,5
7/15/2021 17:46,8993989311699,CLAS MILD 16 FILTER,1,23000,0,23000,21700,1300
7/15/2021 18:21,8998866602556,NUVO FAMILY MERAH 76G,1,2000,0,2000,1820,180
7/15/2021 18:21,8991001111883,SILVERQUEEN CHUNKYBAR 33G,1,8000,0,8000,7150,850
7/15/2021 18:24,8996001440124,ENERGEN VANILA,15,1500,0,22500,17250,5250
7/15/2021 18:24,089686021141,INTER MIE SOTO,5,1000,0,5000,4270,730
7/15/2021 18:24,089686021127,INTER MIE KALDU,5,1000,0,5000,4065,935
7/15/2021 18:40,8998866202244,EKOMIE BUMBU KALDU AYAM,1,1000,0,1000,798,202
7/15/2021 19:11,8996001600146,TEH PUCUK HARUM 350ML,1,3000,0,3000,2314,686
7/15/2021 19:13,8998866200578,MIE SEDAAP KARI KENTAL,1,2500,0,2500,2263,237
7/15/2021 19:13,8997218380135,ICHITAN GREEN TEA,1,8000,0,8000,6583,1417
7/15/2021 19:19,8999909085114,SAMPOERNA KRETEK HIJAU 12,1,13000,0,13000,11650,1350
7/15/2021 19:46,8997028900837,SABUN PAPAYA,1,10000,0,10000,9375,625
7/15/2021 19:46,8998866201865,KRISBEE PILLOW CHOCOLAVA 120 GR,1,8000,0,8000,7250,750
7/15/2021 19:46,8999999031930,PEPSODENT TB TRIPLE CLEAN,1,3500,0,3500,2850,650
7/15/2021 19:46,8999999037765,PEPSODENT WHITE 225G,1,12000,0,12000,10750,1250
7/15/2021 19:46,8996001355237,SUPER STAR,1,11000,0,11000,9900,1100
7/15/2021 19:46,8992761145026,SPRITE PET 250ML,1,3500,0,3500,2417,1083
7/15/2021 19:46,8999999531508,MOLTO HYGIENE SC 10ML,24,500,0,12000,11520,480
7/15/2021 19:46,8998866107495,ZINC HAIRFALL TREATH SHT 10ML,1,5000,0,5000,4500,500
7/15/2021 19:46,8998866612173,SOKLIN SOFTERGENT PINK 770G & PIRING,1,18000,0,18000,16055,1945
7/15/2021 20:13,8991102281430,PERMEN MINTZ DUOMINT,1,5000,0,5000,4000,1000
7/15/2021 20:40,8999999530495,AXE HIGH HOLD MATTE WAX 75G,1,23200,0,23200,20845,2355
7/15/2021 20:44,8998989110167,SURYA GUDANG GARAM 16 FILTER,1,25000,0,25000,23200,1800
7/15/2021 20:52,6907992823621,JD CREAMY YOGURT,1,3000,0,3000,2600,400
7/15/2021 20:52,8994867007161,ROKOK PENA GOLD 20,1,17000,0,17000,15500,1500
7/15/2021 21:04,8997009510017,YOU C1000 LEMON,1,10000,0,10000,9166,834
7/15/2021 21:22,8992775315057,GERY SALUT MALKIST COKLAT,1,6500,0,6500,5516,984
7/15/2021 21:22,8992705025124,AGAR-AGAR SATELIT MERAH,1,3500,0,3500,2604,896
7/15/2021 21:22,8999999531478,MOLTO BLACK PURPLE,1,5500,0,5500,4800,700
7/15/2021 21:22,RT BAKPIA,ROTI BAKPIA,5,1000,0,5000,3750,1250
7/15/2021 21:22,8992959953327,SWEETY BRONZE L52,1,85000,0,85000,80304,4696
7/15/2021 21:22,8998866612173,SOKLIN SOFTERGENT PINK 770G & PIRING,1,18000,0,18000,16055,1945
7/15/2021 21:22,8993379200886,SABUN HARMONY ORANGE 70G,1,2000,0,2000,1652,348
7/15/2021 21:22,8993379200855,SABUN HARMONY STRAWBERRY 70G,1,2000,0,2000,1652,348
7/15/2021 21:22,8994834003752,TICTIC,1,2000,0,2000,1700,300
7/15/2021 21:22,8993083140058,BISKITOP COCONUT,2,27000,0,54000,50400,3600
7/15/2021 21:22,8850007014478,JB POWDER ACTIVE FRESH 100G,1,7000,0,7000,6030,970
7/15/2021 21:22,8996001312438,MALKIST CAPPUCINO SCT,3,1000,0,3000,2460,540
7/15/2021 21:22,8998989500166,GUDANG GARAM MERAH BESAR 16KS,1,18000,0,18000,17000,1000
7/15/2021 21:22,8997028590014,ARGUS 220ML,2,500,0,1000,604,396
7/15/2021 21:22,RT 1000,ROTI 1000,7,1000,0,7000,5600,1400
7/15/2021 21:22,8999801700030,SUSU FOYU,1,11500,0,11500,10450,1050
7/15/2021 21:22,089686834055,FREISS JERUK,1,11000,0,11000,8750,2250
7/15/2021 21:22,8998866202602,KRISBEE FRENCH FRIES 18GR,1,2000,0,2000,1500,500
7/15/2021 21:22,8992775001691,GARUDA ROSTA WAGYU BEEF,2,8000,0,16000,14644,1356
7/15/2021 21:22,VCL,VITAMIN C500 LEMON,3,1000,0,3000,1725,1275
7/15/2021 21:22,8993083929905,BISKITOP WAFER,1,30000,0,30000,27000,3000
7/15/2021 21:22,8993072254056,MELROSE COTTON BUDS KCL,3,3000,0,9000,7350,1650
7/15/2021 21:22,123124,KOREK BIASA,2,2000,0,4000,3600,400
7/15/2021 21:22,8992628020152,BIMOLI POUCH 2L,1,31000,0,31000,29800,1200
7/15/2021 21:22,BALON,BALON CABUT,1,1000,0,1000,900,100
7/15/2021 21:22,8992775318201,GERY SNACK BANTAL COKLAT,4,2000,0,8000,6848,1152
7/15/2021 21:22,8850507002968,A1 KING TRUCK,1,16500,0,16500,15500,1000
7/15/2021 21:22,8996001312582,MALKIST KELAPA KOPYOR SCT,2,1000,0,2000,1640,360
7/15/2021 21:22,ROTI,ROTI 2000,6,2000,0,12000,10800,1200
7/15/2021 21:22,8994907001272,KECAP ABC 700 ML,1,22500,0,22500,21000,1500
7/15/2021 21:22,089686386127,BUMBU RACIK NASI GORENG SOSIS,2,2000,0,4000,3240,760
7/15/2021 21:22,8999999059323,LIFEBUOY TS LEMONFRESH 75G,3,3000,0,9000,7920,1080
7/15/2021 21:22,6907992823959,JD HAWTHORN BERRY,2,2000,0,4000,3400,600
7/15/2021 21:22,6907992823829,JD MILKY MILK,1,3000,0,3000,2600,400
7/15/2021 21:22,8998866608718,DAIA SOFTENER PINK,1,5000,0,5000,4450,550
7/15/2021 21:22,8998866200561,EKOMIE SUPER 600GR,1,10000,0,10000,8615,1385
7/15/2021 21:22,8994907000428,KECAP SACHET ABC,5,500,0,2500,1770,730
7/15/2021 21:22,8998989300261,GUDANG GARAM SURYA 12 FILTER,1,18500,0,18500,17200,1300
7/15/2021 21:22,8992696523067,MILO ACTVGO UHT 180ML,1,4500,0,4500,3515,985
7/15/2021 21:22,8992959953112,SWEETY BRONZE S20,1,30000,0,30000,26540,3460
7/15/2021 21:22,8995150109418,M+SUSU RASA MANGGA,1,5000,0,5000,4000,1000
7/15/2021 21:22,8998866501033,MINYAK GORENG SEDAAP POUCH 2L,3,29000,0,87000,83238,3762
7/15/2021 21:22,8996001305041,ROMA SANDWICH CKLT,1,7000,0,7000,5000,2000
7/15/2021 21:22,711844340008,ABC TERASI,1,7000,0,7000,5800,1200
7/15/2021 21:22,8997231980039,O`JELLY KONYAKU (MAXI APPLE STRAWBERRY),1,5000,0,5000,4620,380
7/15/2021 21:22,089686021127,INTER MIE KALDU,2,1000,0,2000,1626,374
7/15/2021 21:24,8992959953020,SWEETY BRONZE M1,2,3000,0,6000,5342,658
7/15/2021 21:26,8992775318201,GERY SNACK BANTAL COKLAT,1,2000,0,2000,1712,288
7/15/2021 21:26,8999999059781,SUNLIGHT LIME NEW POUCH 210ML,1,5000,0,5000,4300,700
7/15/2021 21:26,8851019210193,POCKY CHOCO BANANA 47G,1,7300,0,7300,5671,1629
7/15/2021 21:26,8998866609036,DAIA BUNGA GUSSET 565G,1,10000,0,10000,8700,1300
7/15/2021 21:26,8999999538439,CLEAR SHP CSC UNISEX 55ML,1,5000,0,5000,3750,1250
7/15/2021 21:26,CS,CONE SNACK,2,500,0,1000,1000,0
7/15/2021 21:26,8996001304549,SLAI OLAI 1000,1,1000,0,1000,825,175
7/15/2021 21:26,8998866808699,ROYALE PURPLE DAWN 13ML,1,5000,0,5000,4500,500
7/16/2021 11:25,RT 1000,ROTI 1000,2,1000,0,2000,1600,400
7/16/2021 11:39,089686041705,INDOMIE GORENG JUMBO,2,3500,0,7000,6286,714
7/16/2021 12:21,ff,FULLO BLASTO,1,1000,0,1000,995,5
7/16/2021 12:21,8992775002582,DILAN CHOCO,1,2000,0,2000,1503,497
7/16/2021 12:21,ROTI,ROTI 2000,1,2000,0,2000,1800,200
7/16/2021 12:21,8992628022156,BIMOLI KLASIK TOUCH 1 LT,1,16000,0,16000,14350,1650
7/16/2021 12:21,8992775311325,GERY SNACK&SEREAL 100G,1,7000,0,7000,6012,988
7/16/2021 12:21,8998989300261,GUDANG GARAM SURYA 12 FILTER,1,18500,0,18500,17200,1300
7/16/2021 12:21,8998898830125,KKB ENER-G ANGGUR,1,5500,0,5500,4824,676
7/16/2021 12:21,8996001600641,TORA CAPPUCINO,1,3500,0,3500,2750,750
7/16/2021 12:21,34678,SENDAL JEPIT,1,15000,0,15000,13500,1500
7/16/2021 12:21,8998866501033,MINYAK GORENG SEDAAP POUCH 2L,2,29000,0,58000,55492,2508
7/16/2021 12:21,8992694247163,ZWITSAL SOAP RICH N HON 70G,1,4000,0,4000,3410,590
7/16/2021 12:21,8998866608718,DAIA SOFTENER PINK,1,5000,0,5000,4450,550
7/16/2021 12:21,8994935000070,MINYAK DUNIA 450 ML,1,7500,0,7500,6779,721
7/16/2021 12:21,MOLTO PINK,MOLTO ALL IN ONE 11 ML,4,500,0,2000,1600,400
7/16/2021 12:21,YP,YUPI,2,250,0,500,416,84
7/16/2021 12:38,GL,GULA 1 LITER,1,11500,0,11500,10500,1000
7/16/2021 12:38,8992959974001,SFX SIRIH SLIM 36CM 6+1,1,10000,0,10000,8315,1685
7/16/2021 13:11,8998989500166,GUDANG GARAM MERAH BESAR 16KS,2,18000,0,36000,34000,2000
7/16/2021 13:39,PUL,PULPEN,2,1500,0,3000,1666,1334
7/16/2021 13:39,8993072254018,MELROSE COTTON BUDS BSR,1,5000,0,5000,4050,950
7/16/2021 14:38,RT 1000,ROTI 1000,2,1000,0,2000,1600,400
7/16/2021 14:38,8991102714846,MILKIDO CKLT,1,3000,0,3000,2153,847
7/16/2021 14:38,8998866200851,NOODLE SEDAAP MIE BAKSO SPESIAL CUP 77 GR,2,4500,0,9000,7300,1700
7/16/2021 15:14,8999909002821,MARLBORO BLACK 16,1,22000,0,22000,20850,1150
7/16/2021 17:16,VTM,VITAMIN,1,500,0,500,425,75
7/16/2021 17:16,MENTOS,MENTOS,2,250,0,500,350,150
7/16/2021 17:25,8992761166038,MMP ORANGE 300ML,1,5000,0,5000,3750,1250
7/16/2021 17:43,8998866200325,MIE SEDAAP SOTO,4,2500,0,10000,7808,2192
7/16/2021 17:43,ROTI,ROTI 2000,2,2000,0,4000,3600,400
7/16/2021 18:55,BG,BERAS GURIH PASAR RAME,1,60000,0,60000,56000,4000
7/16/2021 18:55,8998866501033,MINYAK GORENG SEDAAP POUCH 2L,1,29000,0,29000,27746,1254
7/16/2021 18:55,8996001305058,ROMA SANDWICH KACANG,1,7000,0,7000,5000,2000
7/16/2021 19:09,TBR,TEPUNG BERAS ROSE BRAND,2,8000,0,16000,11600,4400
7/16/2021 19:12,ff,FULLO BLASTO,1,1000,0,1000,995,5
7/16/2021 19:12,8996001312438,MALKIST CAPPUCINO SCT,1,1000,0,1000,820,180
7/16/2021 19:14,8992696523081,MILO UHT 110ML,1,2500,0,2500,1962,538
7/16/2021 19:14,8992696422735,DNCO CKLT UHT 110ML,1,2500,0,2500,2041,459
7/16/2021 19:14,CS,CONE SNACK,4,500,0,2000,2000,0
7/16/2021 20:01,8998866203104,MIE SEDAAP SINGAPORE,3,2500,0,7500,6798,702
7/16/2021 20:01,8998989300261,GUDANG GARAM SURYA 12 FILTER,1,18500,0,18500,17200,1300
7/16/2021 20:07,089686535143,SUN KACANG HIJAU,1,8500,0,8500,7410,1090
7/16/2021 20:28,8993989311699,CLAS MILD 16 FILTER,1,23000,0,23000,21700,1300
7/16/2021 20:46,8851019210193,POCKY CHOCO BANANA 47G,1,7300,0,7300,5671,1629
7/16/2021 20:50,8998989110167,SURYA GUDANG GARAM 16 FILTER,1,25000,0,25000,23200,1800
7/16/2021 20:54,8996001600146,TEH PUCUK HARUM 350ML,1,3000,0,3000,2314,686
7/16/2021 20:59,8997009510017,YOU C1000 LEMON,1,10000,0,10000,9166,834
7/16/2021 21:29,8999999059781,SUNLIGHT LIME NEW POUCH 210ML,1,5000,0,5000,4300,700
7/16/2021 21:29,8999999538422,CLEAR SHP ICM UNISEX 55 ML,1,5000,0,5000,3750,1250
7/16/2021 21:29,8992759120264,LARISST 220,1,10000,0,10000,9200,800
7/16/2021 21:29,8992761164478,FRESTEA MILK TEA,1,8000,0,8000,6575,1425
7/16/2021 21:29,8998866106979,CIPTADENT TB CHARCOAL PROTEC,1,6000,0,6000,5250,750
7/17/2021 12:38,6907992823621,JD CREAMY YOGURT,1,3000,0,3000,2600,400
7/17/2021 12:58,8995150101719,M+SUSU RASA SODA GEMBIRA,1,5000,0,5000,4000,1000
7/17/2021 13:01,8994867000162,ROKOK PUNDIMAS KRETEK16,1,10000,0,10000,8600,1400
7/17/2021 14:52,8997028590014,ARGUS 220ML,4,500,0,2000,1208,792
7/17/2021 15:42,8998866202930,SEDAAP AYAM JERIT CUP,1,4500,0,4500,3738,762
7/17/2021 15:42,8992761145026,SPRITE PET 250ML,1,3500,0,3500,2417,1083
7/17/2021 16:37,8996001302316,MALKIST ABON SCT,1,1000,0,1000,840,160
7/17/2021 16:40,8996001304020,SLAI OLAI NANAS,1,8500,0,8500,7700,800
7/17/2021 16:40,8999999059309,LIFEBUOY TS TOTAL 10 DG 75G,1,3000,0,3000,2640,360
7/17/2021 16:40,RT BAKPIA,ROTI BAKPIA,2,1000,0,2000,1500,500
7/17/2021 16:42,8991001121400,SILVERQUEEN ALMOND 65G,1,15000,0,15000,13200,1800
7/17/2021 17:42,ROTI,ROTI 2000,1,2000,0,2000,1800,200
7/17/2021 17:42,8992775002582,DILAN CHOCO,1,2000,0,2000,1503,497
7/17/2021 17:42,8999999502003,"SARIMURNI RL RB 1,8G",2,1500,0,3000,2414,586
7/17/2021 17:42,8992759120264,LARISST 220,1,10000,0,10000,9200,800
7/17/2021 18:18,711844110144,KECAP ABC 225 ML,1,9000,0,9000,8200,800
7/17/2021 18:18,8997210107877,VORTEX SMART 3,1,5000,0,5000,4750,250
7/17/2021 18:18,8998989500166,GUDANG GARAM MERAH BESAR 16KS,1,18000,0,18000,17000,1000
7/17/2021 19:06,8992959002032,SWEETY SILVER PANTS L 36,1,72000,0,72000,68182,3818
7/17/2021 19:28,8998989110167,SURYA GUDANG GARAM 16 FILTER,1,25000,0,25000,23200,1800
7/17/2021 19:35,711844110144,KECAP ABC 225 ML,1,9000,0,9000,8200,800
7/17/2021 19:35,8998866501033,MINYAK GORENG SEDAAP POUCH 2L,1,29000,0,29000,27746,1254
7/17/2021 19:35,8999999059781,SUNLIGHT LIME NEW POUCH 210ML,1,5000,0,5000,4300,700
7/17/2021 19:35,8999999559045,SUNLIGHT LIME CREAM 110G,1,2000,0,2000,1800,200
7/17/2021 19:35,GL,GULA 1 LITER,1,11500,0,11500,10500,1000
7/17/2021 19:51,089686043204,INDOMIE MIE ACEH,2,2700,0,5400,4904,496
7/17/2021 19:51,8998866200325,MIE SEDAAP SOTO,3,2500,0,7500,5856,1644
7/17/2021 19:51,8992388111145,MIE ABC SELERA PEDAS- SUP TOMAT PEDAS,2,2500,0,5000,4046,954
7/17/2021 19:51,089686041705,INDOMIE GORENG JUMBO,1,3500,0,3500,3143,357
7/17/2021 19:51,089686044249,SUPERMI NUTRIMI STEAK AYAM,1,3500,0,3500,2800,700
7/17/2021 19:51,8998866202770,MIE SEDAAP SALERO PADANG,2,2500,0,5000,4724,276
7/17/2021 19:51,8998866200561,EKOMIE SUPER 600GR,1,10000,0,10000,8615,1385
7/17/2021 19:51,8993007003063,ENAAK 500G,1,11000,0,11000,9625,1375
7/17/2021 19:51,8992753100101,BKM FULL CREAM GOLD 370,1,15000,0,15000,14000,1000
7/17/2021 19:51,SF TAWAR KUPAS,SAFFANAH ROTI TAWAR KUPAS,1,10000,0,10000,9000,1000
7/17/2021 19:51,8999909004221,SAMPOERNA ULTRAMILD 16,1,22000,0,22000,20350,1650
7/17/2021 20:03,GL,GULA 1 LITER,4,11500,0,46000,42000,4000
7/17/2021 20:03,6907992825076,JD WATERMELON APPLE,1,2000,0,2000,1700,300
7/17/2021 20:03,ROTI,ROTI 2000,2,2000,0,4000,3600,400
7/17/2021 20:03,RT 1000,ROTI 1000,1,1000,0,1000,800,200
7/17/2021 20:03,8993176110074,MINYAK KAYU PUTIH 60ML,1,20000,0,20000,17333,2667
7/17/2021 20:03,8999999544126,FAIR&LOVELY BB CREAM 15 MG,1,20000,0,20000,17625,2375
7/17/2021 20:03,8999999558086,RINSO MOLTO FERFUME ESSENSE PWD 44G,2,1000,0,2000,1610,390
7/17/2021 20:03,8994867000162,ROKOK PUNDIMAS KRETEK16,1,10000,0,10000,8600,1400
7/17/2021 20:03,8999999059323,LIFEBUOY TS LEMONFRESH 75G,1,3000,0,3000,2640,360
7/17/2021 20:03,8999999059309,LIFEBUOY TS TOTAL 10 DG 75G,1,3000,0,3000,2640,360
7/17/2021 20:03,MLTO PINK,MOLTO ALL IN ONE,6,1000,0,6000,4800,1200
7/17/2021 20:03,8999999059781,SUNLIGHT LIME NEW POUCH 210ML,1,5000,0,5000,4300,700
7/17/2021 20:03,TEMBAK,TEMBAK SNIPPER,1,3500,0,3500,2500,1000
7/17/2021 20:03,8997012321174,CHILLI-QU,1,1000,0,1000,800,200
7/17/2021 20:03,8998866601429,POWDET DAIA BUNGA BAG 290GR,1,5000,0,5000,4450,550
7/17/2021 20:03,TBR,TEPUNG BERAS ROSE BRAND,1,8000,0,8000,5800,2200
7/17/2021 20:03,8998866501026,MINYAK GORENG SEDAAP POUCH 1 L,1,15000,0,15000,14110,890
7/17/2021 20:03,8999909002821,MARLBORO BLACK 16,1,22000,0,22000,20850,1150
7/17/2021 20:03,SF SOSIS,SAFFANAH ROTI SOSIS,1,6000,0,6000,5500,500
7/17/2021 20:03,8999909010567,234 DJI SAM SOE 16,1,22000,0,22000,21500,500
7/17/2021 20:03,6907992823843,JD MOCHA CRISPY,1,5000,0,5000,4400,600
7/17/2021 20:03,8992628020152,BIMOLI POUCH 2L,1,31000,0,31000,29800,1200
7/17/2021 20:03,8992933213119,NUTRIJELL LECI,1,6000,0,6000,5041,959
7/17/2021 20:03,8997013790108,BIMURA KACANG TELUR 25G,1,1000,0,1000,875,125
7/17/2021 20:03,JGR SHN,JOGER SHINY SACHET,1,500,0,500,437,63
7/17/2021 20:03,8992775318201,GERY SNACK BANTAL COKLAT,1,2000,0,2000,1712,288
7/17/2021 20:03,8992933243116,NUTRIJELLL KELAPA,2,6000,0,12000,9666,2334
7/17/2021 20:03,711844150027,ABC NANAS,1,13000,0,13000,12241,759
7/17/2021 20:04,8992959073209,HN PANTS XL 20,1,40000,0,40000,37425,2575
7/17/2021 20:08,8999908204202,MY BABY MINYAK TELON 60ML,1,18000,0,18000,16900,1100
7/17/2021 20:09,8992725910417,LISTERINE FRESH BURST 100ML,1,7500,0,7500,6800,700
7/17/2021 20:09,8991001111883,SILVERQUEEN CHUNKYBAR 33G,1,8000,0,8000,7150,850
7/17/2021 20:09,SF SOSIS,SAFFANAH ROTI SOSIS,1,6000,0,6000,5500,500
7/17/2021 20:09,SF GULUNG,SAFFANAH ROTI GULUNG,1,6000,0,6000,5500,500
7/17/2021 20:45,8994867000162,ROKOK PUNDIMAS KRETEK16,1,10000,0,10000,8600,1400
7/17/2021 21:15,8999908389008,HEMAVITON C1000,1,8000,0,8000,6000,2000
7/17/2021 21:15,JGR SHN,JOGER SHINY SACHET,4,500,0,2000,1748,252
7/17/2021 22:05,8998866202343,MIE SEDAAP KOREAN SPICY,2,2500,0,5000,4046,954
7/18/2021 11:53,8998866501033,MINYAK GORENG SEDAAP POUCH 2L,1,29000,0,29000,27746,1254
7/18/2021 11:53,8997011700123,BIHUN JAGUNG 300GR,1,6000,0,6000,4979,1021
7/18/2021 11:56,8991102714846,MILKIDO CKLT,1,3000,0,3000,2153,847
7/18/2021 12:14,8997012321174,CHILLI-QU,1,1000,0,1000,800,200
7/18/2021 12:17,8997012321204,MAXX BUMBU BALADO,1,5000,0,5000,4100,900
7/18/2021 12:17,SF SOSIS,SAFFANAH ROTI SOSIS,1,6000,0,6000,5500,500
7/18/2021 12:17,TUSTEL,TUSUK TELINGA,1,1000,0,1000,833,167
7/18/2021 12:17,8992696405417SCT,DNCO INSTANT 27G SCT,1,3500,0,3500,2957,543
7/18/2021 12:17,8992775318201,GERY SNACK BANTAL COKLAT,1,2000,0,2000,1712,288
7/18/2021 12:17,6907992823843,JD MOCHA CRISPY,1,5000,0,5000,4400,600
7/18/2021 12:17,8996001414002SCT,TB CAPPUCINO SCT,3,1500,0,4500,4050,450
7/18/2021 12:17,JGR SHN,JOGER SHINY SACHET,1,500,0,500,437,63
7/18/2021 12:17,8997028590014,ARGUS 220ML,2,500,0,1000,604,396
7/18/2021 12:17,MILKITA,MILKITA,4,250,0,1000,800,200
7/18/2021 12:17,11222,LEM KOREA,1,10000,0,10000,8000,2000
7/18/2021 12:17,8999909002821,MARLBORO BLACK 16,1,22000,0,22000,20850,1150
7/18/2021 12:36,9556001004673,MILO NESTLE MALAYSIA ACTIVE GO,1,85000,0,85000,80000,5000
7/18/2021 12:36,711844110021,KECAP ABC 600 ML,1,22000,0,22000,20700,1300
7/18/2021 12:36,8997021300092,LARISSA BAWANG 250GR,1,5500,0,5500,5125,375
7/18/2021 12:36,8998866607315,SOKLIN SOFTERGENT SAKURA 770G & PIRING,2,18000,0,36000,33360,2640
7/18/2021 12:36,8850507002968,A1 KING TRUCK,1,16500,0,16500,15500,1000
7/18/2021 12:36,TEMBAK,TEMBAK SNIPPER,1,3500,0,3500,2500,1000
7/18/2021 14:21,8994867000162,ROKOK PUNDIMAS KRETEK16,1,10000,0,10000,8600,1400
7/18/2021 14:29,6907992823621,JD CREAMY YOGURT,1,3000,0,3000,2600,400
7/18/2021 14:29,BALON,BALON CABUT,1,1000,0,1000,900,100
7/18/2021 14:29,6907992823829,JD MILKY MILK,1,3000,0,3000,2600,400
7/18/2021 14:29,HT,HOT-HOT,1,500,0,500,350,150
7/18/2021 14:29,6907992823867,JD CRUNCHY CHOCOLATE MALT,1,5500,0,5500,4700,800
7/18/2021 14:51,8998866501026,MINYAK GORENG SEDAAP POUCH 1 L,12,15000,0,180000,169320,10680
7/18/2021 14:51,8998866106979,CIPTADENT TB CHARCOAL PROTEC,1,6000,0,6000,5250,750
7/18/2021 14:51,VCL,VITAMIN C500 LEMON,5,1000,0,5000,2875,2125
7/18/2021 14:51,8999908389008,HEMAVITON C1000,1,8000,0,8000,6000,2000
7/18/2021 14:52,8994037800042,WENIS MERAH,1,8000,0,8000,6500,1500
7/18/2021 14:52,8992775211434,PILUS GARUDA SAPI PANGGANG,1,5000,0,5000,4810,190
7/18/2021 14:53,6907992823867,JD CRUNCHY CHOCOLATE MALT,1,5500,0,5500,4700,800
7/18/2021 14:53,089686060126,POP MIE BASO JUMBO,2,4500,0,9000,7666,1334
7/18/2021 14:56,8992388111145,MIE ABC SELERA PEDAS- SUP TOMAT PEDAS,4,2500,0,10000,8092,1908
7/18/2021 14:56,8991102022347,SIKAT GIGI FORMULA RIPPLE,1,5000,0,5000,4583,417
7/18/2021 14:56,711844610064,LARISSA SINGKONG 250GR,1,5000,0,5000,4545,455
7/18/2021 14:56,8999999034726,PONDS MEN WHITE BOOST 50G,1,18500,0,18500,17160,1340
7/18/2021 14:56,8999999538422,CLEAR SHP ICM UNISEX 55 ML,1,5000,0,5000,3750,1250
7/18/2021 14:56,8999999401023,MOLTO PEWANGI PINK 820ML,1,12500,0,12500,11275,1225
7/18/2021 14:58,GL,GULA 1 LITER,2,11500,0,23000,21000,2000
7/18/2021 14:58,8999999042592,RINSO MOLTO PERFUME ESSENSE LIQ 4OML,1,5500,0,5500,4817,683
7/18/2021 14:58,8999999042646,RINSO MOLTO ROSE FRESH LIQ 40ML,1,6000,0,6000,4817,1183
7/18/2021 14:58,8992761111533,SPRITE SLIM CAM250ML,1,5000,0,5000,3750,1250
7/18/2021 14:58,8997028900837,SABUN PAPAYA,1,10000,0,10000,9375,625
7/18/2021 15:40,CLUB,AIR CLUB,1,3000,0,3000,1452,1548
7/18/2021 16:20,8998866609494,SOKLIN SOFTERGEN 280G BIRU,1,5000,0,5000,4425,575
7/18/2021 16:20,8998866611725,EKONOMI PENCUCI PIRING  LIQ 290ML,1,5000,0,5000,4200,800
7/18/2021 16:20,8998866501026,MINYAK GORENG SEDAAP POUCH 1 L,1,15000,0,15000,14110,890
7/18/2021 16:20,WC,WAFER COKELAT MADE,1,1000,0,1000,800,200
7/18/2021 16:20,JL,JELLY,2,500,0,1000,800,200
7/18/2021 16:28,8999999030179,PEPSODENT ACTION 123 COMPLETE 75G,1,6700,0,6700,5170,1530
7/18/2021 16:31,8999999037765,PEPSODENT WHITE 225G,1,12000,0,12000,10750,1250
7/18/2021 16:31,8992775211434,PILUS GARUDA SAPI PANGGANG,1,5000,0,5000,4810,190
7/18/2021 16:31,8998866501026,MINYAK GORENG SEDAAP POUCH 1 L,1,15000,0,15000,14110,890
7/18/2021 17:05,8998009010569,ULTRA CHO 200,2,5000,0,10000,7660,2340
7/18/2021 17:05,8992696523067,MILO ACTVGO UHT 180ML,1,4500,0,4500,3515,985
7/18/2021 17:05,8992696422735,DNCO CKLT UHT 110ML,1,2500,0,2500,2041,459
7/18/2021 17:05,6907992823669,JD MILKY STRAW,2,3000,0,6000,5200,800
7/18/2021 17:05,6907992825076,JD WATERMELON APPLE,1,2000,0,2000,1700,300
7/18/2021 17:05,6907992823829,JD MILKY MILK,1,3000,0,3000,2600,400
7/18/2021 17:14,8999999195649,SARI WANGI 25X1.86G,2,6000,0,12000,10100,1900
7/18/2021 17:14,6907992823935,JD SWEETCORN,1,3500,0,3500,3000,500
7/18/2021 17:55,8993989311699,CLAS MILD 16 FILTER,1,23000,0,23000,21700,1300
7/18/2021 18:34,089686043273,INDOMIE SAMBAL RICA,2,2700,0,5400,4904,496
7/18/2021 18:36,8997009510017,YOU C1000 LEMON,1,10000,0,10000,9166,834
7/18/2021 18:36,8992696404441,BEAR BRAND 189ML,1,9000,0,9000,7887,1113
7/18/2021 18:36,SF KEMASAN,SAFFANAH ROTI KEMASAN,1,3500,0,3500,3000,500
7/18/2021 18:38,PD,PENDEKAR,2,500,0,1000,700,300
7/18/2021 18:38,MILKITA,MILKITA,2,250,0,500,400,100
7/18/2021 18:38,VTM,VITAMIN,1,500,0,500,425,75
7/18/2021 18:44,8998866202244,EKOMIE BUMBU KALDU AYAM,1,1000,0,1000,798,202
7/18/2021 19:03,8991002105409,KOPI KAPAL API,1,20000,0,20000,18888,1112
7/18/2021 19:03,8992761139018,ADES 600ML,1,3500,0,3500,2292,1208
7/18/2021 19:03,8992761145033,FANTA STRAW PET 250ML,1,3500,0,3500,2417,1083
7/18/2021 19:03,TBR,TEPUNG BERAS ROSE BRAND,2,8000,0,16000,11600,4400
7/18/2021 19:03,8996001414002SCT,TB CAPPUCINO SCT,1,1500,0,1500,1350,150
7/18/2021 20:02,8999999538453,SUNSILK SHP SOFT AND  SMOOTH 55 ML,1,5000,0,5000,3750,1250
7/18/2021 20:02,8998866105651,EMERON LOVELY NOUR&BRIGHT 200ML,1,7500,0,7500,6475,1025
7/18/2021 20:02,8999999004248,CITRA NATURAL WHITE SCRUB 200ML,1,16200,0,16200,14550,1650
7/18/2021 20:02,8996001410042GT,TB TORA MOKA,1,13000,0,13000,8700,4300
7/18/2021 20:04,8995333060772,TERIGU GATOT KACA 500GR,1,4500,0,4500,4065,435
7/18/2021 20:04,8991111112084,C&C DAILY PORE CLEANSER 50G,1,14000,0,14000,12900,1100
7/18/2021 20:04,VCL,VITAMIN C500 LEMON,2,1000,0,2000,1150,850
7/18/2021 20:41,ARG,ARGUS 220ML,1,15000,0,15000,13300,1700
7/18/2021 20:42,GL,GULA 1 LITER,1,11500,0,11500,10500,1000
7/18/2021 20:42,ROTI,ROTI 2000,3,2000,0,6000,5400,600
7/18/2021 20:54,8998866202343,MIE SEDAAP KOREAN SPICY,1,2500,0,2500,2023,477
7/18/2021 20:54,8992775002735,CHOCOLATOS SUSU COKELAT,1,4000,0,4000,3520,480
7/18/2021 21:40,8998989110167,SURYA GUDANG GARAM 16 FILTER,1,25000,0,25000,23200,1800
7/18/2021 21:51,8998866200301,MIE SEDAAP GORENG,2,2500,0,5000,4046,954
7/18/2021 21:51,089686010190,INDOMIE KARI AYAM,1,2800,0,2800,2522,278
7/18/2021 22:11,8994867007161,ROKOK PENA GOLD 20,1,17000,0,17000,15500,1500
7/18/2021 23:04,089686048704,SARIMIE GORENG AYAM KCP ISI 2,2,3500,0,7000,6240,760
7/18/2021 23:04,089686044249,SUPERMI NUTRIMI STEAK AYAM,2,3500,0,7000,5600,1400
7/18/2021 23:04,8998866200325,MIE SEDAAP SOTO,2,2500,0,5000,3904,1096
7/18/2021 23:04,711844120433,SAMBAL ABC 600 ML,1,22000,0,22000,20300,1700
7/18/2021 23:04,8992628020152,BIMOLI POUCH 2L,1,31000,0,31000,29800,1200
7/18/2021 23:04,GL,GULA 1 LITER,2,11500,0,23000,21000,2000
7/18/2021 23:04,8999999524722,SUNLIGHT LIME NEW PCH 435ML,1,10000,0,10000,9100,900
7/18/2021 23:05,YP,YUPI,8,250,0,2000,1664,336
7/18/2021 23:10,089686021219,INTER MIE GORENG,1,1000,0,1000,885,115
7/18/2021 23:10,089686021127,INTER MIE KALDU,2,1000,0,2000,1626,374
7/19/2021 15:18,AMPLOP,AMPLOP,1,250,0,250,140,110
7/19/2021 15:18,8992959953334,SWEETY BRONZE XL42,1,80000,0,80000,75455,4545
7/19/2021 15:18,8992761122331,FRESTEA APPEL 500ML,1,6500,0,6500,4708,1792
7/19/2021 15:18,8991102384841,WFR TANGO LONG CKLT 130G,1,5000,0,5000,4345,655
7/19/2021 15:18,8991102989381,TANGO LONG BUBBLEGUM 130G,1,5000,0,5000,4345,655
7/19/2021 15:18,8992759120264,LARISST 220,1,10000,0,10000,9200,800
7/19/2021 15:18,8998866202664,POTABEE WAGYU BEEF STEAK 68 GR,1,8000,0,8000,7200,800
7/19/2021 15:18,8998866201469,POTABEE REGULER BBQ BEEF 68 GR,1,8000,0,8000,7200,800
7/19/2021 15:18,8998866202619,MIE SEDAAP KOREAN SPICY SOUP,2,2500,0,5000,4546,454
7/19/2021 15:18,8998866200301,MIE SEDAAP GORENG,7,2500,0,17500,14161,3339
7/19/2021 15:18,8999999192150,ROYCO FDS CHICKEN 100GR,1,5000,0,5000,4300,700
7/19/2021 15:18,711844110021,KECAP ABC 600 ML,1,22000,0,22000,20700,1300
7/19/2021 15:18,8999999524838,SUNLIGHT MINT POUCH 755ML,1,17000,0,17000,15400,1600
7/19/2021 15:18,8999999534769,PEPSODENT ACTION123 CHARCOAL 160G,1,16800,0,16800,15345,1455
7/19/2021 15:18,8999999551223,RINSO ACTIVE FRESH LIQ 700ML,1,19500,0,19500,17900,1600
7/19/2021 15:18,8996001355008,BENG-BENG SP20G,1,29000,0,29000,26500,2500
7/19/2021 15:18,8994867007161,ROKOK PENA GOLD 20,1,17000,0,17000,15500,1500
7/19/2021 15:48,8998866202435,JAPOTA UMAMI JAPANESE SEAWEED 35GR,1,5000,0,5000,4150,850
7/19/2021 15:48,8998866201865,KRISBEE PILLOW CHOCOLAVA 120 GR,1,8000,0,8000,7250,750
7/19/2021 15:48,8992761139018,ADES 600ML,1,3500,0,3500,2292,1208
7/19/2021 15:48,MILKITA,MILKITA,8,250,0,2000,1600,400
7/19/2021 16:42,ARG,ARGUS 220ML,2,15000,0,30000,26600,3400
7/19/2021 17:06,8993989311699,CLAS MILD 16 FILTER,1,23000,0,23000,21700,1300
7/19/2021 17:06,8999999534097,PEPSODENT PGB FCM 75G,1,5000,0,5000,3850,1150
7/19/2021 17:48,123124,KOREK BIASA,1,2000,0,2000,1800,200
7/19/2021 17:48,8999999538422,CLEAR SHP ICM UNISEX 55 ML,1,5000,0,5000,3750,1250
7/19/2021 17:55,8992761145026,SPRITE PET 250ML,2,3500,0,7000,4834,2166
7/19/2021 17:55,8992761145033,FANTA STRAW PET 250ML,2,3500,0,7000,4834,2166
7/19/2021 18:01,8999999707859,CLOSEUP GREEN 160G,1,15000,0,15000,13600,1400
7/19/2021 18:01,8999999055769,FAIR&LOVELY MVIT FC FOAM 50 G,1,12500,0,12500,11180,1320
7/19/2021 18:01,8992856892507,VITALIS PINK 120ML,1,22000,0,22000,19900,2100
7/19/2021 18:01,HT,HOT-HOT,1,500,0,500,350,150
7/19/2021 18:15,8996001600399,LE MINERAL 1500ML,2,5000,0,10000,8084,1916
7/19/2021 18:15,PD,PENDEKAR,1,500,0,500,350,150
7/19/2021 18:15,MOBIL,GULA GULA HP,1,2000,0,2000,1700,300
7/19/2021 18:15,ARG,ARGUS 220ML,1,14500,0,14500,13300,1200
7/19/2021 18:24,123124,KOREK BIASA,1,2000,0,2000,1800,200
7/19/2021 18:24,8998989300261,GUDANG GARAM SURYA 12 FILTER,1,18500,0,18500,17200,1300
7/19/2021 18:24,8992761111533,SPRITE SLIM CAM250ML,2,5000,0,10000,7500,2500
7/19/2021 18:24,ROTI,ROTI 2000,4,2000,0,8000,7200,800
7/19/2021 18:39,8991102987639,WFR TANGO LONG VNL 130G,1,5000,0,5000,3773,1227
7/19/2021 18:57,GL,GULA 1 LITER,2,11500,0,23000,21000,2000
7/19/2021 18:57,8992979130012,TOTAL LEMON SOFTENER,1,13000,0,13000,11532,1468
7/19/2021 19:08,ARG,ARGUS 220ML,1,14500,0,14500,13300,1200
7/19/2021 19:08,711844110113,KECAP ABC 135 ML,1,7000,0,7000,6400,600
7/19/2021 19:22,MENTOS,MENTOS,6,250,0,1500,1050,450
7/19/2021 19:22,MILKITA,MILKITA,2,250,0,500,400,100
7/19/2021 19:45,8992761111533,SPRITE SLIM CAM250ML,1,5000,0,5000,3750,1250
7/19/2021 20:41,PD,PENDEKAR,2,500,0,1000,700,300
7/19/2021 20:41,HT,HOT-HOT,2,500,0,1000,700,300
7/19/2021 20:59,089686834055,FREISS JERUK,2,11000,0,22000,17500,4500
7/19/2021 21:14,8998866200301,MIE SEDAAP GORENG,1,2500,0,2500,2023,477
7/19/2021 21:27,8991102714846,MILKIDO CKLT,2,3000,0,6000,4306,1694
7/19/2021 21:38,8992959953099,SWEETY BRONZE XL7,1,16000,0,16000,15190,810
7/19/2021 21:45,8992761136178,SPRITE 1L,5,10000,0,50000,45000,5000
7/19/2021 22:24,8992761136178,SPRITE 1L,2,10000,0,20000,18000,2000
7/19/2021 22:24,ROTI,ROTI 2000,1,2000,0,2000,1800,200
7/19/2021 22:24,8992775318201,GERY SNACK BANTAL COKLAT,1,2000,0,2000,1712,288
7/19/2021 22:24,8992761139018,ADES 600ML,1,3500,0,3500,2292,1208
7/19/2021 22:28,ARG,ARGUS 220ML,1,14500,0,14500,13300,1200
7/20/2021 17:30,711844110083,KECAP ABC 275 ML,1,14500,0,14500,13400,1100
7/20/2021 17:30,711844120419,SAMBAL ABC 275 ML,1,12000,0,12000,10800,1200
7/22/2021 12:19,BALON,BALON CABUT,5,1000,0,5000,4500,500
7/22/2021 12:47,8991102714846,MILKIDO CKLT,1,3000,0,3000,2153,847
7/22/2021 12:47,8992761145026,SPRITE PET 250ML,1,3500,0,3500,2417,1083
7/22/2021 12:47,8992761145033,FANTA STRAW PET 250ML,1,3500,0,3500,2417,1083
7/22/2021 12:47,8998866200813,NOODLE SEDAAP MIE GORENG CUP 85 GR,1,5000,0,5000,3917,1083
7/22/2021 12:47,089686043204,INDOMIE MIE ACEH,2,2700,0,5400,4904,496
7/22/2021 12:47,8992761136161,COCACOLA 1L,2,10000,0,20000,18000,2000
7/22/2021 12:56,8999999390198,SUNLIGHT LIME NEW POUCH 755ML,2,17000,0,34000,30800,3200
7/22/2021 12:56,ROTI,ROTI 2000,6,2000,0,12000,10800,1200
7/22/2021 12:56,8991102987639,WFR TANGO LONG VNL 130G,3,5000,0,15000,11319,3681
7/22/2021 12:56,711844110083,KECAP ABC 275 ML,1,14500,0,14500,13400,1100
7/22/2021 12:56,ARG,ARGUS 220ML,1,14500,0,14500,13300,1200
7/22/2021 12:56,8998866203104,MIE SEDAAP SINGAPORE,2,2500,0,5000,4532,468
7/22/2021 12:56,PRG,PARAGO,2,500,0,1000,800,200
7/22/2021 12:56,8996001318430,BETTER 1000,1,1000,0,1000,820,180
7/22/2021 12:56,AMPLOP,AMPLOP,2,250,0,500,280,220
7/22/2021 12:56,RT BAKPIA,ROTI BAKPIA,6,1000,0,6000,4500,1500
7/22/2021 12:56,8999999531515,MOLTO WHITE MUSK SC 10ML,1,5500,0,5500,4800,700
7/22/2021 12:56,8992979190986,TOTAL PUTIH SOFTENER,1,13000,0,13000,11532,1468
7/22/2021 12:56,TS,TISSUE TESSY,1,5000,0,5000,4200,800
7/22/2021 12:56,8996001302316,MALKIST ABON SCT,1,1000,0,1000,840,160
7/22/2021 12:56,8992775913000SCT,CHOCOLATOS CKLT DRINK SCT,4,2000,0,8000,6344,1656
7/22/2021 12:56,SF TAWAR ORI,SAFFANAH TAWAR ORI,1,9000,0,9000,8000,1000
7/22/2021 12:56,8992696404441,BEAR BRAND 189ML,1,9000,0,9000,7887,1113
7/22/2021 12:56,8998866202930,SEDAAP AYAM JERIT CUP,1,4500,0,4500,3738,762
7/22/2021 13:04,8996001600610,TORA MILKY LATTE 180ML,1,3500,0,3500,2750,750
7/22/2021 13:04,8998866203104,MIE SEDAAP SINGAPORE,1,2500,0,2500,2266,234
7/22/2021 13:04,8998866202619,MIE SEDAAP KOREAN SPICY SOUP,1,2500,0,2500,2273,227
7/22/2021 13:04,8992761122331,FRESTEA APPEL 500ML,2,6500,0,13000,9416,3584
7/22/2021 13:04,8998866200561,EKOMIE SUPER 600GR,1,10000,0,10000,8615,1385
7/22/2021 13:04,8995333032113,TERIGU GATOT KACA 1 KG,1,8500,0,8500,8012,488
7/22/2021 13:04,COKLAT,COKLAT COIN,3,500,0,1500,1275,225
7/22/2021 13:04,8991102228053,TEH GELAS BOTOL,1,3000,0,3000,1695,1305
7/22/2021 13:04,8998866611701,EKONOMI PENCUCI PIRING  LIQ 132ML,1,2000,0,2000,1337,663
7/22/2021 13:04,9556001004673,MILO NESTLE MALAYSIA ACTIVE GO,1,85000,0,85000,80000,5000
7/22/2021 13:33,8999909096004,SAMPOERNA 16 FILTER,1,24000,0,24000,23000,1000
7/22/2021 13:33,8992761002039,FANTA STRAWBERRY PET 390 ML,1,5500,0,5500,4300,1200
7/22/2021 13:33,8996001600269,LE MINERAL 600ML,1,3000,0,3000,1688,1312
7/22/2021 13:33,8992761166038,MMP ORANGE 300ML,1,5000,0,5000,3750,1250
7/22/2021 13:33,8992761002022,SPRITE PET 390ML,1,5500,0,5500,4300,1200
7/22/2021 13:33,8992775000076,GERY SNACK RING CKLT,1,2000,0,2000,1712,288
7/22/2021 13:33,8992775211410,PILUS GARUDA PEDAS,1,5000,0,5000,4886,114
7/22/2021 13:33,8992775000663,GERY SNACK KEJU,1,2000,0,2000,1712,288
7/22/2021 13:33,123124,KOREK BIASA,1,2000,0,2000,1800,200
7/22/2021 13:52,8991102281416,PERMEN MINTZ PPMINT,1,5000,0,5000,4000,1000
7/22/2021 14:38,ARG,ARGUS 220ML,1,14500,0,14500,13300,1200
7/22/2021 14:39,8996001600146,TEH PUCUK HARUM 350ML,1,3000,0,3000,2314,686
7/22/2021 14:56,8998866105637,EMERON LOVELY MOIST&BRIGHT 200ML,1,7500,0,7500,6475,1025
7/22/2021 14:56,HT,HOT-HOT,1,500,0,500,350,150
7/22/2021 16:40,8992696404441,BEAR BRAND 189ML,1,9000,0,9000,7887,1113
7/22/2021 16:40,8992775110157,GARUDA KACANG KULIT,1,5000,0,5000,3925,1075
7/22/2021 17:20,8991188943536,SASA SANTAN KELAPA 65ML,2,3000,0,6000,4874,1126
7/22/2021 17:20,8993226112508,GARAM REFINA,1,3000,0,3000,2461,539
7/22/2021 18:03,TEMBAK,TEMBAK SNIPPER,1,3500,0,3500,2500,1000
7/22/2021 18:03,BALON,BALON CABUT,1,1000,0,1000,900,100
7/22/2021 18:35,8998866202343,MIE SEDAAP KOREAN SPICY,1,2500,0,2500,2023,477
7/22/2021 18:35,8998866202343,MIE SEDAAP KOREAN SPICY,1,2500,0,2500,2023,477
7/22/2021 18:46,089686060027,POP MIE AYAM JUMBO,1,4500,0,4500,3833,667
7/22/2021 19:11,8998866202770,MIE SEDAAP SALERO PADANG,1,2500,0,2500,2362,138
7/22/2021 19:11,8998866613262,SUKSESMIE SOTO 111 GR,1,3500,0,3500,2770,730
7/22/2021 19:11,089686044249,SUPERMI NUTRIMI STEAK AYAM,1,3500,0,3500,2800,700
7/22/2021 19:11,8998866613729,EMERON LOVELY NTRL 100ML,1,3500,0,3500,2900,600
7/22/2021 19:17,8999999016128,RINSO MOLTO ROSE FRESH 750ML,2,15000,0,30000,25014,4986
7/22/2021 19:17,8998866201964,MINYAK GORENG SABRINA 2L POUCH,1,28000,0,28000,26753,1247
7/22/2021 19:17,8999999057640,MOLTO EDP BLK PURPLE 20ML,5,1000,0,5000,4000,1000
7/22/2021 19:17,8991002330504,RELAXA MANGO MINT,1,5000,0,5000,4500,500
7/22/2021 19:17,8996001355978,BENG-BENG SHARE IT 9.5G,1,10000,0,10000,8700,1300
7/22/2021 19:24,8998989300261,GUDANG GARAM SURYA 12 FILTER,1,18500,0,18500,17200,1300
7/23/2021 11:39,RT BAKPIA,ROTI BAKPIA,1,1000,0,1000,750,250
7/23/2021 11:55,8992775318201,GERY SNACK BANTAL COKLAT,1,2000,0,2000,1712,288
7/23/2021 15:11,6907992825076,JD WATERMELON APPLE,1,2000,0,2000,1700,300
7/23/2021 15:47,6907992823645,JD COCONUT BLISS,1,4000,0,4000,3500,500
7/23/2021 15:48,8991001121615,SILVERQUEEN NUT,1,15000,0,15000,13200,1800
7/23/2021 16:01,GL,GULA 1 LITER,5,11500,0,57500,52500,5000
7/23/2021 16:01,8995102703534,TERASI DUO 6 GR,1,4000,0,4000,3720,280
7/23/2021 16:02,8999999007768,FAIR&LOVELY MULTIVITAMIN  CREAM 9 ML,2,4500,0,9000,6400,2600
7/23/2021 16:03,8994834006128,TICTIC PEDAS,2,2000,0,4000,3400,600
7/23/2021 16:14,711844140011,ABC SAUS TIRAM 425ML,1,28000,0,28000,26000,2000
7/23/2021 16:19,8996001600399,LE MINERAL 1500ML,1,5000,0,5000,4042,958
7/23/2021 16:40,8992761002022,SPRITE PET 390ML,1,5500,0,5500,4300,1200
7/23/2021 16:40,8992761166052,FRESTEA MELATI 350ML,1,4500,0,4500,3000,1500
7/23/2021 16:40,8993571003827,CAP 19 BEDAK SALICYL MENTHOL 100G,1,8000,0,8000,7000,1000
7/23/2021 16:41,BALON,BALON CABUT,2,1000,0,2000,1800,200
7/23/2021 16:42,896867700494,CLUB 1500ML,1,5000,0,5000,2987,2013
7/23/2021 17:12,8992761122331,FRESTEA APPEL 500ML,1,6500,0,6500,4708,1792
7/23/2021 17:12,089686021219,INTER MIE GORENG,2,1000,0,2000,1770,230
7/23/2021 17:12,PD,PENDEKAR,2,500,0,1000,700,300
7/23/2021 17:38,8992694242717,ZWITSAL NAT ALOE VERA PWD 100G,1,8400,0,8400,7590,810
7/23/2021 17:38,8992694242502,ZWITZAL SOAP CALSSIC 70G,1,3800,0,3800,3410,390
7/23/2021 17:39,8997231980039,O`JELLY KONYAKU (MAXI APPLE STRAWBERRY),1,5000,0,5000,4620,380
7/23/2021 17:39,8992775002582,DILAN CHOCO,1,2000,0,2000,1503,497
7/23/2021 18:16,8991001503114,CHACHA MILK CHOCOLATE 35G,1,5500,0,5500,4900,600
7/23/2021 18:16,8997210107877,VORTEX SMART 3,1,5000,0,5000,4750,250
7/23/2021 19:38,8992388133017,NU MILK TEA ORI 330ML,1,6000,0,6000,5125,875
7/23/2021 19:38,8993379200855,SABUN HARMONY STRAWBERRY 70G,1,2000,0,2000,1652,348
7/23/2021 19:38,8993379152017,SABUN CUCI SURYA 200G,1,3000,0,3000,2281,719
7/23/2021 19:38,8996001301562,MALKIST TABUR KELAPA,1,1000,0,1000,820,180
7/23/2021 19:38,8999999055769,FAIR&LOVELY MVIT FC FOAM 50 G,1,12500,0,12500,11180,1320
7/23/2021 19:38,JL,JELLY,2,500,0,1000,800,200
7/23/2021 19:38,8991102384841,WFR TANGO LONG CKLT 130G,1,5000,0,5000,4345,655
7/23/2021 19:38,8991102989381,TANGO LONG BUBBLEGUM 130G,1,5000,0,5000,4345,655
7/23/2021 19:38,8992959117590,SFX DS REG FLOW WING 20,1,12000,0,12000,11250,750
7/23/2021 19:38,8992775000250GT,CHOCOLATOS MATCHA DRINK,1,18000,0,18000,15862,2138
7/23/2021 19:38,8992775002582,DILAN CHOCO,1,2000,0,2000,1503,497
7/23/2021 19:38,8991188943062,SASA 250G,5,10000,0,50000,42500,7500
7/23/2021 19:55,8998866201964,MINYAK GORENG SABRINA 2L POUCH,1,28000,0,28000,26753,1247
7/23/2021 20:01,8992761111533,SPRITE SLIM CAM250ML,4,5000,0,20000,15000,5000
7/23/2021 20:01,8998989300261,GUDANG GARAM SURYA 12 FILTER,1,18500,0,18500,17200,1300
7/23/2021 20:10,8998866501026,MINYAK GORENG SEDAAP POUCH 1 L,24,14110,0,338640,338640,0
7/23/2021 20:45,ROTI,ROTI 2000,1,2000,0,2000,1800,200
7/23/2021 20:49,8999999552343,LUX BW BIRD OF PARADISE 250ML,1,20000,0,20000,17900,2100
7/23/2021 20:50,8998989300261,GUDANG GARAM SURYA 12 FILTER,1,18500,0,18500,17200,1300
7/23/2021 21:45,8991102714846,MILKIDO CKLT,1,3000,0,3000,2153,847
7/23/2021 21:45,ROTI,ROTI 2000,1,2000,0,2000,1800,200
7/23/2021 21:57,8992736424293,SASA BUMBU NASI GORENG 20G,2,2000,0,4000,2272,1728
7/23/2021 21:57,RT BAKPIA,ROTI BAKPIA,1,1000,0,1000,750,250
7/23/2021 21:57,8998866108317,EMERON HJB ANTDNDF 10ML,1,5000,0,5000,4185,815
7/23/2021 22:03,9311931024036,COFFEEMIX SCT,1,1500,0,1500,1200,300
7/23/2021 22:03,8999999192150,ROYCO FDS CHICKEN 100GR,1,5000,0,5000,4300,700
7/23/2021 22:03,8997027490018,LADAMAS MERICA BUBUK,1,9500,0,9500,8898,602
7/23/2021 22:03,8992775002933,GERY MALKIST DOUBLE ABON,1,6500,0,6500,5516,984
7/23/2021 22:03,RT BAKPIA,ROTI BAKPIA,1,1000,0,1000,750,250
7/23/2021 22:03,RT MNTG,ROTI SISIR MENTEGA,1,2000,0,2000,1600,400
7/23/2021 22:03,6907992825076,JD WATERMELON APPLE,2,2000,0,4000,3400,600
7/23/2021 22:03,8996001600146,TEH PUCUK HARUM 350ML,1,3000,0,3000,2314,686
7/23/2021 22:03,8998866201483,POTABEE REGULER GRILLED SEAWEED 35GR,1,5000,0,5000,4150,850
7/23/2021 22:03,ff,FULLO BLASTO,1,1000,0,1000,995,5
7/23/2021 22:03,8992761145026,SPRITE PET 250ML,1,3500,0,3500,2417,1083
7/23/2021 22:03,8992761002022,SPRITE PET 390ML,1,5500,0,5500,4300,1200
7/23/2021 22:03,8992696430860,KOKO KRUNCH 80G,1,9000,0,9000,8063,937
7/23/2021 22:03,8993007000680,INDOMILK 1L,1,16500,0,16500,14792,1708
7/23/2021 22:03,8994867000162,ROKOK PUNDIMAS KRETEK16,2,10000,0,20000,17200,2800
7/23/2021 22:12,8996001600399,LE MINERAL 1500ML,1,5000,0,5000,4042,958
7/23/2021 22:21,089686043273,INDOMIE SAMBAL RICA,2,2700,0,5400,4904,496
7/23/2021 22:44,089686611519,QTELA SINGKONG,1,5000,0,5000,4266,734
7/23/2021 23:01,MILKITA,MILKITA,4,250,0,1000,800,200
7/24/2021 12:49,8998898852127,KKB ENER-G MANGGA,1,5500,0,5500,4824,676
7/24/2021 12:49,8998866500708,FLORIDINA ORANGE,1,3000,0,3000,2500,500
7/24/2021 12:50,MILKITA,MILKITA,2,250,0,500,400,100
7/24/2021 12:59,8999999195649,SARI WANGI 25X1.86G,1,6000,0,6000,5050,950
7/24/2021 12:59,8995333032113,TERIGU GATOT KACA 1 KG,1,8500,0,8500,8012,488
7/24/2021 13:17,8992759120264,LARISST 220,1,10000,0,10000,9200,800
7/24/2021 13:17,TBR,TEPUNG BERAS ROSE BRAND,1,8000,0,8000,5800,2200
7/24/2021 13:17,ARG,ARGUS 220ML,1,14500,0,14500,13300,1200
7/24/2021 13:17,089686834307,FREISS LECI,1,11000,0,11000,8750,2250
7/24/2021 13:17,RT MNTG,ROTI SISIR MENTEGA,1,2000,0,2000,1600,400
7/24/2021 13:17,8991188943536,SASA SANTAN KELAPA 65ML,1,3000,0,3000,2437,563
7/24/2021 13:17,YP,YUPI,2,250,0,500,416,84
7/24/2021 13:17,MILKITA,MILKITA,4,250,0,1000,800,200
7/24/2021 13:17,PRG,PARAGO,1,500,0,500,400,100
7/24/2021 13:17,RT 1000,ROTI 1000,2,1000,0,2000,1600,400
7/24/2021 13:17,8992775000663,GERY SNACK KEJU,1,2000,0,2000,1712,288
7/24/2021 13:17,8998866202244,EKOMIE BUMBU KALDU AYAM,3,1000,0,3000,2394,606
7/24/2021 13:17,8998989300261,GUDANG GARAM SURYA 12 FILTER,1,18500,0,18500,17200,1300
7/24/2021 13:17,8998866202435,JAPOTA UMAMI JAPANESE SEAWEED 35GR,2,5000,0,10000,8300,1700
7/24/2021 13:17,8996001318980,BETTER 120G,1,6000,0,6000,5100,900
7/24/2021 13:17,8998866201865,KRISBEE PILLOW CHOCOLAVA 120 GR,1,8000,0,8000,7250,750
7/24/2021 13:17,8996001305003,SARI GANDUM SANDWICH,1,6000,0,6000,5100,900
7/24/2021 13:17,8998009010569,ULTRA CHO 200,2,5000,0,10000,7660,2340
7/24/2021 13:17,TEMBAK,TEMBAK SNIPPER,1,3500,0,3500,2500,1000
7/24/2021 13:17,8998866201452,POTABEE REGULER BBQ BEEF 35GR,1,5000,0,5000,4150,850
7/24/2021 13:17,8998866609494,SOKLIN SOFTERGEN 280G BIRU,1,5000,0,5000,4425,575
7/24/2021 13:17,8992959117514,SFX NON WING 20,1,10000,0,10000,9091,909
7/24/2021 13:17,8992761111533,SPRITE SLIM CAM250ML,1,5000,0,5000,3750,1250
7/24/2021 13:17,8998866200646,KOPI TOP MURNI,1,11000,0,11000,9600,1400
7/24/2021 13:21,8992761111533,SPRITE SLIM CAM250ML,1,5000,0,5000,3750,1250
7/24/2021 13:21,8998866201452,POTABEE REGULER BBQ BEEF 35GR,1,5000,0,5000,4150,850
7/24/2021 13:21,8999999528966,CITRA FRESH WHITE 120ML,1,13200,0,13200,11875,1325
7/24/2021 13:21,8999999520892,FAIR&LOVELY POWDER CREAM 20 G,1,18500,0,18500,16830,1670
7/24/2021 13:21,8992959974001,SFX SIRIH SLIM 36CM 6+1,1,10000,0,10000,8315,1685
7/24/2021 13:21,8998009010569,ULTRA CHO 200,1,5000,0,5000,3830,1170
7/24/2021 13:21,8996001305003,SARI GANDUM SANDWICH,1,6000,0,6000,5100,900
7/24/2021 13:21,8998866201889,KRISBEE PILLOW STRAWBERRY ICE CREAM 120GR,1,8000,0,8000,7250,750
7/24/2021 13:21,8998866202466,JAPOTA HAPPY HONEY BUTTER,1,5000,0,5000,4150,850
7/24/2021 13:21,8998866601429,POWDET DAIA BUNGA BAG 290GR,1,5000,0,5000,4450,550
7/24/2021 13:21,8999999557447,PEPSODENT ACTION123 SIWAK 110G,1,9000,0,9000,8000,1000
7/24/2021 13:21,8996001600269,LE MINERAL 600ML,1,3000,0,3000,1688,1312
7/24/2021 13:21,8994834003752,TICTIC,1,2000,0,2000,1700,300
7/24/2021 13:34,MLTO PINK,MOLTO ALL IN ONE,8,1000,0,8000,6400,1600
7/24/2021 13:34,8998866609029,DAIA PUTIH GUSSWET 565G,1,10000,0,10000,8700,1300
7/24/2021 13:34,8999999706081,PEPSODENT WHITE 75G,1,5000,0,5000,3850,1150
7/24/2021 13:34,8998866200844,NOODLE SEDAAP MIE KARI SPESIAL CUP 81 GR,1,4500,0,4500,3650,850
7/24/2021 13:34,8992761145033,FANTA STRAW PET 250ML,2,3500,0,7000,4834,2166
7/24/2021 13:34,8998866200325,MIE SEDAAP SOTO,6,2500,0,15000,11712,3288
7/24/2021 13:34,8993379152017,SABUN CUCI SURYA 200G,1,3000,0,3000,2281,719
7/24/2021 13:34,8996001355237,SUPER STAR,2,11000,0,22000,19800,2200
7/24/2021 13:34,8998866200561,EKOMIE SUPER 600GR,1,10000,0,10000,8615,1385
7/24/2021 13:34,8992696404441,BEAR BRAND 189ML,1,9000,0,9000,7887,1113
7/24/2021 13:34,8992959974018,SFX SIRIH 36CM 12+1,1,17000,0,17000,15958,1042
7/24/2021 13:34,8992761164478,FRESTEA MILK TEA,1,8000,0,8000,6575,1425
7/24/2021 13:34,8998866202312,NOODLE SEDAAP TASTY BAKMI AYAM 129 GR,1,5000,0,5000,4167,833
7/24/2021 13:34,8998866203104,MIE SEDAAP SINGAPORE,1,2500,0,2500,2266,234
7/24/2021 13:34,MENTOS,MENTOS,4,250,0,1000,700,300
7/24/2021 13:34,GL,GULA 1 LITER,3,11500,0,34500,31500,3000
7/24/2021 13:34,8998009040023,TEH KOTAK,1,5000,0,5000,2827,2173
7/24/2021 13:35,8992761111533,SPRITE SLIM CAM250ML,3,5000,0,15000,11250,3750
7/24/2021 13:35,RT KN,ROTI KASUR NANAS,1,8000,0,8000,7200,800
7/24/2021 13:35,SNDL,SENDAL BLACK,1,15000,0,15000,10833,4167
7/24/2021 13:35,896867700494,AIR CLUB 1500ML,1,5000,0,5000,2987,2013
7/24/2021 13:52,8998866202244,EKOMIE BUMBU KALDU AYAM,4,1000,0,4000,3192,808
7/24/2021 13:52,089686021127,INTER MIE KALDU,3,1000,0,3000,2439,561
7/24/2021 13:52,089686021141,INTER MIE SOTO,3,1000,0,3000,2562,438
7/24/2021 14:42,711844120433,SAMBAL ABC 600 ML,1,22000,0,22000,20300,1700
7/24/2021 16:07,8993989311699,CLAS MILD 16 FILTER,1,23000,0,23000,21700,1300
7/24/2021 16:12,089686021127,INTER MIE KALDU,2,1000,0,2000,1626,374
7/24/2021 16:12,8998866200561,EKOMIE SUPER 600GR,1,10000,0,10000,8615,1385
7/24/2021 16:15,8996001600146,TEH PUCUK HARUM 350ML,1,3000,0,3000,2314,686
7/24/2021 16:22,8992761166052,FRESTEA MELATI 350ML,1,4500,0,4500,3000,1500
7/24/2021 17:20,089686535044,SUN BERAS MERAH,1,8500,0,8500,7410,1090
7/24/2021 17:35,8994867007161,ROKOK PENA GOLD 20,1,17000,0,17000,15500,1500
7/24/2021 18:11,8998866501033,MINYAK GORENG SEDAAP POUCH 2L,1,29000,0,29000,27746,1254
7/24/2021 18:11,8999999030186,PEPSODENT ACTION 123 COMPLETE 190G,1,14000,0,14000,13200,800
7/24/2021 19:12,JGR SHN,JOGER SHINY SACHET,2,500,0,1000,874,126
7/24/2021 20:42,8998989110167,SURYA GUDANG GARAM 16 FILTER,1,25000,0,25000,23200,1800
7/24/2021 20:43,8992761166052,FRESTEA MELATI 350ML,1,4500,0,4500,3000,1500
7/24/2021 20:43,MENTOS,MENTOS,2,250,0,500,350,150
7/24/2021 21:10,8992959117590,SFX DS REG FLOW WING 20,1,12000,0,12000,11250,750
7/24/2021 21:10,8999999571924,MOLTO PURE 1OML,1,5000,0,5000,4800,200
7/24/2021 21:10,8993324850449,BABY LOVE COTTON BUDS,1,5000,0,5000,4500,500
7/24/2021 21:10,8998866202466,JAPOTA HAPPY HONEY BUTTER,1,5000,0,5000,4150,850
7/24/2021 21:10,MBL,MOBIL,2,5000,0,10000,7000,3000
7/24/2021 21:10,8993001003908,INDOMILK KENTAL MANIS 545G,1,15000,0,15000,13333,1667
7/24/2021 22:37,8998866202770,MIE SEDAAP SALERO PADANG,1,2500,0,2500,2362,138
7/24/2021 22:37,8996001402023SCT,TB TORA SUSU SCT,1,1500,0,1500,848,652
7/24/2021 22:37,8999909085114,SAMPOERNA KRETEK HIJAU 12,1,13000,0,13000,11650,1350
7/24/2021 22:37,6907992823874,JD CRUNCHY CHOCO BLUEBERRY,1,5500,0,5500,4700,800
7/24/2021 22:38,8991102987875,WFR TANGO POUCH CKL 115G,1,8000,0,8000,6786,1214
7/24/2021 22:38,8998866203104,MIE SEDAAP SINGAPORE,2,2500,0,5000,4532,468
7/24/2021 22:38,8991102989381,TANGO LONG BUBBLEGUM 130G,1,5000,0,5000,4345,655
7/24/2021 22:38,8992775002582,DILAN CHOCO,1,2000,0,2000,1503,497
7/25/2021 11:16,8992736424293,SASA BUMBU NASI GORENG 20G,3,2000,0,6000,3408,2592
7/25/2021 11:16,8992770154026,SAJIKU SAYUR SOP,2,2500,0,5000,4000,1000
7/25/2021 11:16,8996001312438,MALKIST CAPPUCINO SCT,2,1000,0,2000,1640,360
7/25/2021 11:16,8996001302316,MALKIST ABON SCT,2,1000,0,2000,1680,320
7/25/2021 11:16,8996001312582,MALKIST KELAPA KOPYOR SCT,1,1000,0,1000,820,180
7/25/2021 11:16,8992628022156,BIMOLI KLASIK TOUCH 1 LT,1,16000,0,16000,14350,1650
7/25/2021 11:16,TBR,TEPUNG BERAS ROSE BRAND,1,8000,0,8000,5800,2200
7/25/2021 11:16,8995333000822,TERIGU KOMPAS SOFT 500GR,1,5500,0,5500,4967,533
7/25/2021 11:16,8992696521797SCT,MILO ACT GO 22G SCT,1,2000,0,2000,1553,447
7/25/2021 11:16,8998866202770,MIE SEDAAP SALERO PADANG,4,2500,0,10000,9448,552
7/25/2021 11:16,8850507002951,BONCHA EGG SQUISHY,1,12000,0,12000,10841,1159
7/25/2021 11:16,8992759120264,LARISST 220,1,10000,0,10000,9200,800
7/25/2021 11:16,8996001600399,LE MINERAL 1500ML,1,5000,0,5000,4042,958
7/25/2021 11:16,GL,GULA 1 LITER,1,11500,0,11500,10500,1000
7/25/2021 11:16,8997231980039,O`JELLY KONYAKU (MAXI APPLE STRAWBERRY),1,5000,0,5000,4620,380
7/25/2021 11:16,8994935000070,MINYAK DUNIA 450 ML,1,7500,0,7500,6779,721
7/25/2021 11:16,8998898853100,SUSU JAHE,2,1500,0,3000,2360,640
7/25/2021 11:52,8999999558086,RINSO MOLTO FERFUME ESSENSE PWD 44G,2,1000,0,2000,1610,390
7/25/2021 11:53,8999999558086,RINSO MOLTO FERFUME ESSENSE PWD 44G,1,1000,0,1000,805,195
7/25/2021 11:53,MOLTO PINK,MOLTO ALL IN ONE 11 ML,4,500,0,2000,1600,400
7/25/2021 11:53,8993007001557,INDOMILK SKM 37G,2,1500,0,3000,2162,838
7/25/2021 11:53,8991102385060,TANGO WAFFLE CHOX,1,9000,0,9000,8498,502
7/25/2021 11:54,8993470671752,JOGER STICK DUO KACANG,1,1000,0,1000,850,150
7/25/2021 12:42,8998866202930,SEDAAP AYAM JERIT CUP,1,4500,0,4500,3738,762
7/25/2021 12:42,8996001600146,TEH PUCUK HARUM 350ML,1,3000,0,3000,2314,686
7/25/2021 12:42,8992761122331,FRESTEA APPEL 500ML,1,6500,0,6500,4708,1792
7/25/2021 13:14,GL,GULA 1 LITER,1,11500,0,11500,10500,1000
7/25/2021 13:14,8992959107539,SFX WING 23CM,4,500,0,2000,2000,0
7/25/2021 13:14,8999999195656,SARI WANGI 50X1.85,1,10000,0,10000,9500,500
7/25/2021 13:29,089686010190,INDOMIE KARI AYAM,3,2800,0,8400,7566,834
7/25/2021 13:29,PD,PENDEKAR,1,500,0,500,350,150
7/25/2021 13:29,WC,WAFER COKELAT MADE,1,1000,0,1000,800,200
7/25/2021 13:31,ARG,ARGUS 220ML,1,14500,0,14500,13300,1200
7/25/2021 13:31,RT,ROTI,1,9000,0,9000,8000,1000
7/25/2021 13:39,8992775001783,GERY SALUT MALKIST KELAPA,1,6500,0,6500,5516,984
7/25/2021 13:39,8991001780492,SELAMAT COKLAT,1,13000,0,13000,11800,1200
7/25/2021 14:19,GL,GULA 1 LITER,4,11500,0,46000,42000,4000
7/25/2021 14:19,COKLAT,COKLAT COIN,10,500,0,5000,4250,750
7/25/2021 14:19,8991102230308,BLASTER PINK,1,5000,0,5000,3106,1894
7/25/2021 14:21,8991002307209,COFFE CANDY,1,5000,0,5000,4500,500
7/25/2021 14:24,089686010190,INDOMIE KARI AYAM,2,2800,0,5600,5044,556
7/25/2021 14:33,ARG,ARGUS 220ML,6,14500,0,87000,79800,7200
7/25/2021 15:15,8992775311325,GERY SNACK&SEREAL 100G,2,7000,0,14000,12024,1976
7/25/2021 15:15,8999999031930,PEPSODENT TB TRIPLE CLEAN,1,3500,0,3500,2850,650
7/25/2021 15:15,8992775312414,GERY CHOCO HEZELNUT,1,11000,0,11000,9983,1017
7/25/2021 15:15,RT ISI 6,ROTI ISI 6,1,6000,0,6000,5000,1000
7/25/2021 15:39,PRG,PARAGO,2,500,0,1000,800,200
7/25/2021 15:39,6907992825076,JD WATERMELON APPLE,2,2000,0,4000,3400,600
7/25/2021 15:39,6907992824963,JD MILKY CHOCOLATE,1,3000,0,3000,2600,400
7/25/2021 15:39,8997028590014,ARGUS 220ML,2,500,0,1000,604,396
7/25/2021 15:42,8996001354018,WFR KALPA,1,20200,0,20200,18400,1800
7/25/2021 15:42,8992775310212,GERY PASTA COKELAT,1,18000,0,18000,16029,1971
7/25/2021 15:42,6907992825076,JD WATERMELON APPLE,1,2000,0,2000,1700,300
7/25/2021 15:42,8992761166205,FRESTEA GREEN HONEY 350ML,2,4500,0,9000,6000,3000
7/25/2021 15:42,6907992823591,JD STRAW MILKSHAKE,2,5000,0,10000,8600,1400
7/25/2021 15:42,MOBIL,GULA GULA HP,2,2000,0,4000,3400,600
7/25/2021 15:42,PD,PENDEKAR,1,500,0,500,350,150
7/25/2021 15:42,HT,HOT-HOT,1,500,0,500,350,150
7/25/2021 15:45,HT,HOT-HOT,1,500,0,500,350,150
7/25/2021 16:18,8999909002821,MARLBORO BLACK 16,1,22000,0,22000,20850,1150
7/25/2021 16:18,8994867007161,ROKOK PENA GOLD 20,1,17000,0,17000,15500,1500
7/25/2021 16:57,8998866201889,KRISBEE PILLOW STRAWBERRY ICE CREAM 120GR,1,8000,0,8000,7250,750
7/25/2021 16:57,6907992825076,JD WATERMELON APPLE,1,2000,0,2000,1700,300
7/25/2021 17:18,8991111111971,C&C FACIAL WASH 100ML,1,17500,0,17500,16070,1430
7/25/2021 17:18,8999999559861,AXE DARK POCKET FRAG 17ML,1,10000,0,10000,8000,2000
7/25/2021 17:18,8999999027049,LIFEBUOY PRWTN RMBT RNTK 9ML,1,5000,0,5000,4500,500
7/25/2021 17:18,8999999006006,RINSO ANTI NODA CLASSISC 750ML,1,15000,0,15000,12507,2493
7/25/2021 17:18,8993324850449,BABY LOVE COTTON BUDS,1,5000,0,5000,4500,500
7/25/2021 17:18,8997231980039,O`JELLY KONYAKU (MAXI APPLE STRAWBERRY),1,5000,0,5000,4620,380
7/25/2021 17:18,8992775000076,GERY SNACK RING CKLT,1,2000,0,2000,1712,288
7/25/2021 17:18,JL,JELLY,1,500,0,500,400,100
7/25/2021 17:29,JL,JELLY,1,500,0,500,400,100
7/25/2021 17:30,8992775211434,PILUS GARUDA SAPI PANGGANG,1,5000,0,5000,4810,190
7/25/2021 17:30,8998866203104,MIE SEDAAP SINGAPORE,1,2500,0,2500,2266,234
7/25/2021 17:37,8994867000162,ROKOK PUNDIMAS KRETEK16,3,10000,0,30000,25800,4200
7/25/2021 18:09,8997231980039,O`JELLY KONYAKU (MAXI APPLE STRAWBERRY),2,5000,0,10000,9240,760
7/25/2021 18:48,089686021141,INTER MIE SOTO,2,1000,0,2000,1708,292
7/25/2021 18:48,089686021219,INTER MIE GORENG,2,1000,0,2000,1770,230
7/25/2021 19:00,8998989110167,SURYA GUDANG GARAM 16 FILTER,1,25000,0,25000,23200,1800
7/25/2021 19:00,8998866200301,MIE SEDAAP GORENG,2,2500,0,5000,4046,954
7/25/2021 19:00,089686060027,POP MIE AYAM JUMBO,1,4500,0,4500,3833,667
7/25/2021 19:08,8992761139018,ADES 600ML,1,3500,0,3500,2292,1208
7/25/2021 19:11,8996001600146,TEH PUCUK HARUM 350ML,2,3000,0,6000,4628,1372
7/25/2021 19:11,SF KEMASAN,SAFFANAH ROTI KEMASAN,1,3500,0,3500,3000,500
7/25/2021 19:11,JL,JELLY,6,500,0,3000,2400,600
7/25/2021 19:13,MTR,MOTOR,1,5000,0,5000,3500,1500
7/25/2021 19:13,TEMBAK,TEMBAK SNIPPER,1,3500,0,3500,2500,1000
7/25/2021 19:13,8886013213208,FRENCH FREIS 2000,2,5000,0,10000,7500,2500
7/25/2021 19:13,JL,JELLY,5,500,0,2500,2000,500
7/25/2021 19:13,8991001503107,CHACHA PEANUT 35GR,1,5500,0,5500,4900,600
7/25/2021 19:13,KOPIKO,KOPIKO,2,250,0,500,350,150
7/25/2021 19:24,089686060362,POP MIE SOTO AYAM JUMBO,1,4500,0,4500,3833,667
7/25/2021 19:24,COKLAT,COKLAT COIN,3,500,0,1500,1275,225
7/25/2021 19:41,8992761139018,ADES 600ML,1,3500,0,3500,2292,1208
7/25/2021 19:43,8999909096004,SAMPOERNA 16 FILTER,1,24000,0,24000,23000,1000
7/25/2021 19:59,8999999560720,MOLTO TRIKA JAPANESE PEACH 720ML,1,5000,0,5000,4000,1000
7/25/2021 19:59,711844140059,ABC SAUS TIRAM 135 ML,1,8500,0,8500,7750,750
7/25/2021 19:59,711844110113,KECAP ABC 135 ML,1,7000,0,7000,6400,600
7/25/2021 19:59,8999999059323,LIFEBUOY TS LEMONFRESH 75G,2,3000,0,6000,5280,720
7/25/2021 20:12,8998866201964,MINYAK GORENG SABRINA 2L POUCH,1,28000,0,28000,26753,1247
7/25/2021 20:12,JL,JELLY,4,500,0,2000,1600,400
7/25/2021 20:36,8999909010567,234 DJI SAM SOE 16,1,22000,0,22000,21500,500
7/25/2021 21:04,8991002105409,KOPI KAPAL API,1,20000,0,20000,18888,1112
7/25/2021 21:08,8997025911058,HATARI SHP KELAPA,1,6000,0,6000,4911,1089
7/25/2021 21:08,8993470279651,JOGER CHOCKY BAR,5,1000,0,5000,4335,665
7/25/2021 21:16,8992959508312,SWEETY SILVER PANTS XL RTG,1,15500,0,15500,13944,1556
7/25/2021 21:48,8991102714860,MILKIDO STRAW,1,3000,0,3000,2153,847
7/25/2021 22:05,089686010190,INDOMIE KARI AYAM,1,2800,0,2800,2522,278
7/25/2021 22:05,RT BAKPIA,ROTI BAKPIA,1,1000,0,1000,750,250
7/25/2021 22:10,ARG,ARGUS 220ML,2,14500,0,29000,26600,2400
7/25/2021 22:13,6907992824963,JD MILKY CHOCOLATE,1,3000,0,3000,2600,400
7/25/2021 22:17,6907992823645,JD COCONUT BLISS,1,4000,0,4000,3500,500
7/25/2021 22:17,6907992823829,JD MILKY MILK,1,3000,0,3000,2600,400
7/26/2021 11:53,8998866203104,MIE SEDAAP SINGAPORE,2,2500,0,5000,4532,468
7/26/2021 11:53,PRG,PARAGO,1,500,0,500,400,100
7/26/2021 11:53,8997210107877,VORTEX SMART 3,1,5000,0,5000,4750,250
7/26/2021 11:53,8998989300261,GUDANG GARAM SURYA 12 FILTER,1,18500,0,18500,17200,1300
7/26/2021 11:53,8993470671752,JOGER STICK DUO KACANG,1,1000,0,1000,850,150
7/26/2021 11:53,HT,HOT-HOT,2,500,0,1000,700,300
7/26/2021 11:53,8992761111540,FANTA STRAWBERY SLIM CAM 250ML,2,5000,0,10000,7500,2500
7/26/2021 11:53,8998866201889,KRISBEE PILLOW STRAWBERRY ICE CREAM 120GR,1,8000,0,8000,7250,750
7/26/2021 11:53,8992775001691,GARUDA ROSTA WAGYU BEEF,1,8000,0,8000,7322,678
7/26/2021 11:53,8851019210193,POCKY CHOCO BANANA 47G,1,7300,0,7300,5671,1629
7/26/2021 11:53,8992696404441,BEAR BRAND 189ML,1,9000,0,9000,7887,1113
7/26/2021 11:53,8998866200301,MIE SEDAAP GORENG,1,2500,0,2500,2023,477
7/26/2021 11:53,PD,PENDEKAR,1,500,0,500,350,150
7/26/2021 11:53,8997009510116,LEMON WATER,1,7000,0,7000,5694,1306
7/26/2021 11:53,8997009510123,ORANGE WATER,1,7000,0,7000,6089,911
7/26/2021 12:57,8998866200301,MIE SEDAAP GORENG,1,2500,0,2500,2023,477
7/26/2021 12:57,8998866200325,MIE SEDAAP SOTO,1,2500,0,2500,1952,548
7/26/2021 12:57,8998866202404,NOODLE SEDAAP MIE KOREAN SPICY CHICKEN CUP,1,5000,0,5000,4002,998
7/26/2021 12:57,8998866200837,NOODLE SEDAAPMIE SOTO CUP 81 GR,1,4500,0,4500,3650,850
7/26/2021 13:02,8994834006128,TICTIC PEDAS,3,2000,0,6000,5100,900
7/26/2021 13:02,8992696422735,DNCO CKLT UHT 110ML,1,2500,0,2500,2041,459
7/26/2021 13:02,8992696523081,MILO UHT 110ML,2,2500,0,5000,3924,1076
7/26/2021 13:02,8992775002582,DILAN CHOCO,1,2000,0,2000,1503,497
7/26/2021 13:02,COKLAT,COKLAT COIN,1,500,0,500,425,75
7/26/2021 13:44,8998989300261,GUDANG GARAM SURYA 12 FILTER,1,18500,0,18500,17200,1300
7/26/2021 13:44,VCL,VITAMIN C500 LEMON,20,1000,0,20000,11500,8500
7/26/2021 13:56,HT,HOT-HOT,2,500,0,1000,700,300
7/26/2021 13:56,8992775001653,GERY SALUT CHOCOLATE COCONUT,1,2000,0,2000,1476,524
7/26/2021 13:56,8992775002582,DILAN CHOCO,1,2000,0,2000,1503,497
7/26/2021 14:02,8997011700123,BIHUN JAGUNG 300GR,2,6000,0,12000,9958,2042
7/26/2021 14:42,8999999529604,CLEAR SHP COMPLETE CARE MEN 160ML,1,24800,0,24800,22700,2100
7/26/2021 15:31,8999909096004,SAMPOERNA 16 FILTER,1,24000,0,24000,23000,1000
7/26/2021 15:41,8998866203104,MIE SEDAAP SINGAPORE,1,2500,0,2500,2266,234
7/26/2021 15:41,089686044249,SUPERMI NUTRIMI STEAK AYAM,1,3500,0,3500,2800,700
7/26/2021 16:45,8998866201520,KOPI TOP TORAJA MURNI,1,11000,0,11000,9600,1400
7/26/2021 16:45,8999909002821,MARLBORO BLACK 16,1,22000,0,22000,20850,1150
7/26/2021 16:45,8997009510123,ORANGE WATER,1,7000,0,7000,6089,911
7/26/2021 17:25,8997231980039,O`JELLY KONYAKU (MAXI APPLE STRAWBERRY),2,5000,0,10000,9240,760
7/26/2021 17:52,8996001355756,BENG-BENG MAXX SCT,1,2500,0,2500,2041,459
7/26/2021 17:52,8992775002582,DILAN CHOCO,1,2000,0,2000,1503,497
7/26/2021 17:52,ff,FULLO BLASTO,1,1000,0,1000,995,5
7/26/2021 17:53,ff,FULLO BLASTO,1,1000,0,1000,995,5
7/26/2021 18:27,8999999037765,PEPSODENT WHITE 225G,1,12000,0,12000,10750,1250
7/26/2021 18:27,8998866608459,POWDET DAIA PUTIH BAG 290GR,1,5000,0,5000,4450,550
7/26/2021 18:27,8992946512223,SHINZUI,1,4000,0,4000,2500,1500
7/26/2021 18:29,089686021219,INTER MIE GORENG,4,1000,0,4000,3540,460
7/26/2021 18:29,8997028590014,ARGUS 220ML,2,500,0,1000,604,396
7/26/2021 18:52,8991102300544,WFR TANGO VNL 176G,1,10000,0,10000,8694,1306
7/26/2021 18:52,8992747180126,VIXAL PEMB PORS 470ML,1,15000,0,15000,13420,1580
7/26/2021 18:52,8992959508992,SWEETY SILVER PANTS L 28,1,56800,0,56800,51819,4981
7/26/2021 19:03,8999999707835,CLOSEUP GREEN 65G,1,7000,0,7000,6000,1000
7/26/2021 19:03,8998866106979,CIPTADENT TB CHARCOAL PROTEC,1,6000,0,6000,5250,750
7/26/2021 19:32,8992696404441,BEAR BRAND 189ML,1,9000,0,9000,7887,1113
7/26/2021 19:32,8999909003439,MARLBORO CRAFTED 12,1,8000,0,8000,7250,750
7/26/2021 19:56,8992959953037,SWEETY BRONZE L1,1,3000,0,3000,2671,329
7/26/2021 20:24,8998898853100,SUSU JAHE,2,1500,0,3000,2360,640
7/26/2021 20:26,8996001600146,TEH PUCUK HARUM 350ML,1,3000,0,3000,2314,686
7/26/2021 20:26,8997012321174,CHILLI-QU,1,1000,0,1000,800,200
7/26/2021 20:26,089686043617,INDOMIE MIEGHETTI,1,2700,0,2700,2452,248
7/26/2021 20:26,JL,JELLY,2,500,0,1000,800,200
7/26/2021 20:26,MENTOS,MENTOS,1,250,0,250,175,75
7/26/2021 20:30,8998866201452,POTABEE REGULER BBQ BEEF 35GR,1,5000,0,5000,4150,850
7/26/2021 20:30,JL,JELLY,2,500,0,1000,800,200
7/26/2021 20:31,8998866200301,MIE SEDAAP GORENG,1,2500,0,2500,2023,477
7/26/2021 20:31,8998866613262,SUKSESMIE SOTO 111 GR,1,3500,0,3500,2770,730
7/26/2021 21:40,GL,GULA 1 LITER,1,11500,0,11500,10500,1000
7/26/2021 21:40,8998989300261,GUDANG GARAM SURYA 12 FILTER,1,18500,0,18500,17200,1300
7/26/2021 22:14,8992959953174,SWEETY BRONZE M34+2,1,58000,0,58000,53182,4818
7/26/2021 22:14,8992388112401,MIE ABC SELERA PEDAS- GORENG AYAM PEDAS LIMAU,2,2600,0,5200,4736,464
7/27/2021 10:51,8999999192150,ROYCO FDS CHICKEN 100GR,1,5000,0,5000,4300,700
7/27/2021 10:51,8999999538439,CLEAR SHP CSC UNISEX 55ML,1,5000,0,5000,3750,1250
7/27/2021 10:51,8996001318911,BETTER ISI 4,1,2000,0,2000,1700,300
7/27/2021 10:51,8997231980039,O`JELLY KONYAKU (MAXI APPLE STRAWBERRY),1,5000,0,5000,4620,380
7/27/2021 10:51,8998866200325,MIE SEDAAP SOTO,2,2500,0,5000,3904,1096
7/27/2021 10:51,RT 1000,ROTI 1000,1,1000,0,1000,800,200
7/27/2021 10:51,8994867000179,ROKOK PENA MILD 16,1,14500,0,14500,13500,1000
7/27/2021 10:51,8993989311699,CLAS MILD 16 FILTER,1,23000,0,23000,21700,1300
7/27/2021 10:55,089686043617,INDOMIE MIEGHETTI,2,2700,0,5400,4904,496
7/27/2021 11:00,8998866202244,EKOMIE BUMBU KALDU AYAM,4,1000,0,4000,3192,808
7/27/2021 11:00,8998866202404,NOODLE SEDAAP MIE KOREAN SPICY CHICKEN CUP,2,5000,0,10000,8004,1996
7/27/2021 11:04,8992696523081,MILO UHT 110ML,2,2500,0,5000,3924,1076
7/27/2021 11:04,8998866202602,KRISBEE FRENCH FRIES 18GR,2,2000,0,4000,3000,1000
7/27/2021 11:09,8997231980039,O`JELLY KONYAKU (MAXI APPLE STRAWBERRY),1,5000,0,5000,4620,380
7/27/2021 12:08,GL,GULA 1 LITER,2,11500,0,23000,21000,2000
7/27/2021 12:08,8999999524807,SUNLIGHT HABBATUSSAUDA POUCH 755ML,1,17000,0,17000,15400,1600
7/27/2021 12:08,8991002105409,KOPI KAPAL API,1,20000,0,20000,18888,1112
7/27/2021 12:59,8994037800042,WENIS MERAH,1,8000,0,8000,6500,1500
7/27/2021 12:59,8998866600101,CREAM EKONOMI LEMON 455G,1,5500,0,5500,4750,750
7/27/2021 13:03,089686043273,INDOMIE SAMBAL RICA,1,2700,0,2700,2452,248
7/27/2021 13:07,8998989500166,GUDANG GARAM MERAH BESAR 16KS,2,18000,0,36000,34000,2000
7/27/2021 14:07,8998866201964,MINYAK GORENG SABRINA 2L POUCH,1,28000,0,28000,26753,1247
7/27/2021 14:07,8995333032113,TERIGU GATOT KACA 1 KG,1,8500,0,8500,8012,488
7/27/2021 14:20,ARG,ARGUS 220ML,4,14500,0,58000,53200,4800
7/27/2021 14:59,8992628510158,SIMAS PALMIA,1,6000,0,6000,4832,1168
7/27/2021 15:01,711844110144,KECAP ABC 225 ML,1,9000,0,9000,8200,800
7/27/2021 15:01,8996001354018,WFR KALPA,1,20200,0,20200,18400,1800
7/27/2021 15:01,8992775310212,GERY PASTA COKELAT,1,18000,0,18000,16029,1971
7/27/2021 15:01,089686010190,INDOMIE KARI AYAM,2,2800,0,5600,5044,556
7/27/2021 15:01,8998866200301,MIE SEDAAP GORENG,3,2500,0,7500,6069,1431
7/27/2021 15:01,8992761166205,FRESTEA GREEN HONEY 350ML,1,4500,0,4500,3000,1500
7/28/2021 11:17,8992959953198,SWEETY BRONZE  XL 26+2,1,60000,0,60000,54091,5909
7/28/2021 11:46,8993365600089,MADU TJ JOYBEE JERUK 200ML,1,20000,0,20000,9440,10560
7/28/2021 11:46,8992761122331,FRESTEA APPEL 500ML,1,6500,0,6500,4708,1792
7/28/2021 11:46,GL,GULA 1 LITER,2,11500,0,23000,21000,2000
7/28/2021 11:46,8996001402023SCT,TB TORA SUSU SCT,7,1500,0,10500,5936,4564
7/28/2021 11:46,BTS,BIMURA TARO SEAWEED 250G,1,10000,0,10000,9300,700
7/28/2021 11:46,8998866202343,MIE SEDAAP KOREAN SPICY,1,2500,0,2500,2023,477
7/28/2021 11:46,8999999059309,LIFEBUOY TS TOTAL 10 DG 75G,1,3000,0,3000,2640,360
7/28/2021 11:46,8998866202244,EKOMIE BUMBU KALDU AYAM,6,1000,0,6000,4788,1212
7/28/2021 11:46,089686021219,INTER MIE GORENG,3,1000,0,3000,2655,345
7/28/2021 11:46,8992696523081,MILO UHT 110ML,1,2500,0,2500,1962,538
7/28/2021 11:46,8994867000179,ROKOK PENA MILD 16,1,14500,0,14500,13500,1000
7/28/2021 11:46,8998989300261,GUDANG GARAM SURYA 12 FILTER,2,18500,0,37000,34400,2600
7/28/2021 11:46,8998989500166,GUDANG GARAM MERAH BESAR 16KS,1,18000,0,18000,17000,1000
7/28/2021 11:46,MILKITA,MILKITA,2,250,0,500,400,100
7/28/2021 12:31,8996001338056,TAMARIN,1,6000,0,6000,5100,900
7/28/2021 12:31,8886013257400,TWISTKO,2,1000,0,2000,1800,200
7/28/2021 12:31,6907992823669,JD MILKY STRAW,1,3000,0,3000,2600,400
7/28/2021 13:18,8992761166038,MMP ORANGE 300ML,1,5000,0,5000,3750,1250
7/28/2021 13:18,089686386127,BUMBU RACIK NASI GORENG SOSIS,1,2000,0,2000,1620,380
7/28/2021 13:18,MILKITA,MILKITA,2,250,0,500,400,100
7/28/2021 13:24,76239878,MARLBORO GOLD,1,30000,0,30000,27700,2300
7/28/2021 13:24,76164217,MARLBORO MERAH,1,30000,0,30000,27700,2300
7/28/2021 13:49,8992696404441,BEAR BRAND 189ML,1,9000,0,9000,7887,1113
7/28/2021 13:49,6907992825076,JD WATERMELON APPLE,1,2000,0,2000,1700,300
7/28/2021 13:49,6907992823669,JD MILKY STRAW,1,3000,0,3000,2600,400
7/28/2021 14:01,8998866501026,MINYAK GORENG SEDAAP POUCH 1 L,24,14110,0,338640,338640,0
7/28/2021 14:01,8997210107877,VORTEX SMART 3,120,4750,0,570000,570000,0
7/28/2021 14:07,GL,GULA 1 LITER,1,11500,0,11500,10500,1000
7/28/2021 14:26,8992696404441,BEAR BRAND 189ML,1,9000,0,9000,7887,1113
7/28/2021 14:26,8996001312582,MALKIST KELAPA KOPYOR SCT,1,1000,0,1000,820,180
7/28/2021 14:26,8991001770301,SELAMAT CLACK VANILA,1,13000,0,13000,11800,1200
7/28/2021 14:26,896867700494,AIR CLUB 1500ML,1,5000,0,5000,2987,2013
7/28/2021 14:31,8996001600146,TEH PUCUK HARUM 350ML,1,3000,0,3000,2314,686
7/28/2021 15:32,RT ISI 6,ROTI ISI 6,1,6000,0,6000,5000,1000
7/28/2021 16:47,TGL,TEH GELAS DOS,1,20000,0,20000,17496,2504
7/28/2021 18:49,8999999558086,RINSO MOLTO FERFUME ESSENSE PWD 44G,2,1000,0,2000,1610,390
7/28/2021 18:49,089686043273,INDOMIE SAMBAL RICA,1,2700,0,2700,2452,248
7/28/2021 18:49,8998866693608,SOKLIN FLOORCLENER HIJAU 900ML,1,14000,0,14000,12436,1564
7/28/2021 18:53,8994935000070,MINYAK DUNIA 450 ML,1,7500,0,7500,6779,721
7/28/2021 19:16,8991102228053,TEH GELAS BOTOL,1,3000,0,3000,1695,1305
7/28/2021 19:16,JL,JELLY,4,500,0,2000,1600,400
7/28/2021 19:54,GL,GULA 1 LITER,2,11500,0,23000,21000,2000
7/28/2021 20:15,8998866200301,MIE SEDAAP GORENG,2,2500,0,5000,4046,954
7/28/2021 20:45,8999801700054,SUSU FOYU 1 KG,1,22000,0,22000,19791,2209
7/28/2021 22:15,8998866106979,CIPTADENT TB CHARCOAL PROTEC,1,6000,0,6000,5250,750
7/28/2021 22:15,8998866102605,KODOMO TB REG 2IN1,1,7500,0,7500,6600,900
7/28/2021 22:15,8991002121065,GOOD DAY AVOCADO DELIGHT,1,6000,0,6000,4295,1705
7/28/2021 22:16,8999999195656,SARI WANGI 50X1.85,1,10000,0,10000,9500,500
7/28/2021 22:16,8992775000250GT,CHOCOLATOS MATCHA DRINK,1,18000,0,18000,15862,2138
7/28/2021 22:16,8991102384841,WFR TANGO LONG CKLT 130G,1,5000,0,5000,4345,655
7/28/2021 22:16,8991002121065,GOOD DAY AVOCADO DELIGHT,1,6000,0,6000,4295,1705
7/28/2021 22:16,VCO,VITAMIN C500 ORANGE,1,1000,0,1000,575,425
7/28/2021 22:16,896867700494,AIR CLUB 1500ML,1,5000,0,5000,2987,2013
7/28/2021 22:17,8992959974018,SFX SIRIH 36CM 12+1,1,17000,0,17000,15958,1042
7/28/2021 22:20,8999908284907,MY BABY MINYAK TELON 90ML,1,25000,0,25000,22700,2300
7/28/2021 22:32,8998866692601,SOKLIN FLOORCLENER HIJAU 450ML,1,7000,0,7000,6385,615
7/29/2021 12:52,8999909010567,234 DJI SAM SOE 16,1,22000,0,22000,21500,500
7/29/2021 12:52,8998866202770,MIE SEDAAP SALERO PADANG,1,2500,0,2500,2362,138
7/29/2021 12:52,8998989110167,SURYA GUDANG GARAM 16 FILTER,1,25000,0,25000,23200,1800
7/29/2021 12:52,GL,GULA 1 LITER,1,11500,0,11500,10500,1000
7/29/2021 12:52,RT ISI 6,ROTI ISI 6,1,6000,0,6000,5000,1000
7/29/2021 12:52,8991188943536,SASA SANTAN KELAPA 65ML,1,3000,0,3000,2437,563
7/29/2021 12:52,8998866501033,MINYAK GORENG SEDAAP POUCH 2L,1,29000,0,29000,27746,1254
7/29/2021 12:52,8992696523081,MILO UHT 110ML,1,2500,0,2500,1962,538
7/29/2021 12:52,8994834003752,TICTIC,2,2000,0,4000,3400,600
7/29/2021 13:18,8997009510123,ORANGE WATER,2,7000,0,14000,12178,1822
7/29/2021 13:18,8998866200646,KOPI TOP MURNI,2,11000,0,22000,19200,2800
7/29/2021 13:41,8993989311699,CLAS MILD 16 FILTER,1,23000,0,23000,21700,1300
7/29/2021 14:28,8992696523067,MILO ACTVGO UHT 180ML,1,4500,0,4500,3515,985
7/29/2021 17:00,8998866601429,POWDET DAIA BUNGA BAG 290GR,1,5000,0,5000,4450,550
7/29/2021 17:34,MARS,MARSHMELLOW,8,500,0,4000,3464,536
7/29/2021 17:42,PD,PENDEKAR,1,500,0,500,350,150
7/29/2021 17:42,HT,HOT-HOT,1,500,0,500,350,150
7/29/2021 17:42,8993470411433,JOGER CLASSIC,1,1000,0,1000,850,150
7/29/2021 17:44,8991102714860,MILKIDO STRAW,1,3000,0,3000,2153,847
7/29/2021 17:49,8996001355978,BENG-BENG SHARE IT 9.5G,1,10000,0,10000,8700,1300
7/29/2021 17:49,8991001770301,SELAMAT CLACK VANILA,1,13000,0,13000,11800,1200
7/29/2021 18:03,8996001600399,LE MINERAL 1500ML,1,5000,0,5000,4042,958
7/29/2021 19:19,8992628022156,BIMOLI KLASIK TOUCH 1 LT,1,16000,0,16000,14350,1650
7/29/2021 19:19,GL,GULA 1 LITER,1,11500,0,11500,10500,1000
7/29/2021 19:19,8997002060168,KRP SINGKOG PDS PANDA DUO,1,8000,0,8000,7300,700
7/29/2021 19:19,8995333032113,TERIGU GATOT KACA 1 KG,1,8500,0,8500,8012,488
7/29/2021 19:19,8992979190986,TOTAL PUTIH SOFTENER,2,13000,0,26000,23064,2936
7/29/2021 19:19,8999999707859,CLOSEUP GREEN 160G,1,15000,0,15000,13600,1400
7/29/2021 19:19,8998866600538,SOKLIN FLOORCLENER PINK 400ML,1,6000,0,6000,5025,975
7/29/2021 19:19,8999999561123,MOLTO PEWANGI PURPLE 820ML,1,12500,0,12500,11275,1225
7/29/2021 19:19,8999999048242,SUNSILK SHP SOFT&SMOOTH 9ML,1,11000,0,11000,9300,1700
7/29/2021 19:19,8999999548698,LUXTS VALVET JASMINE 4X60G,1,8500,0,8500,7650,850
7/29/2021 20:28,711844610095,LARISSA UDANG 500 GR,2,11000,0,22000,19580,2420
7/29/2021 20:28,8999801700054,SUSU FOYU 1 KG,1,22000,0,22000,19791,2209
7/29/2021 21:01,8998989110167,SURYA GUDANG GARAM 16 FILTER,1,25000,0,25000,23200,1800
7/29/2021 21:18,8992736225401,SASA TEPUNG BAKWAN 235G,1,5000,0,5000,4455,545
7/29/2021 21:18,8996001600146,TEH PUCUK HARUM 350ML,1,3000,0,3000,2314,686
7/29/2021 21:18,RT BAKPIA,ROTI BAKPIA,1,1000,0,1000,750,250
7/29/2021 21:18,8992775002582,DILAN CHOCO,1,2000,0,2000,1503,497
7/29/2021 21:18,8996001600399,LE MINERAL 1500ML,1,5000,0,5000,4042,958
7/29/2021 21:18,8998866202602,KRISBEE FRENCH FRIES 18GR,1,2000,0,2000,1500,500
7/29/2021 21:18,8991002105430,KAPAL API 65G,1,5000,0,5000,4145,855
7/29/2021 21:18,8999999195649,SARI WANGI 25X1.86G,1,6000,0,6000,5050,950
7/29/2021 21:18,8998866201964,MINYAK GORENG SABRINA 2L POUCH,1,28000,0,28000,26753,1247
7/29/2021 21:18,8991102714846,MILKIDO CKLT,2,3000,0,6000,4306,1694
7/29/2021 21:18,8998989300261,GUDANG GARAM SURYA 12 FILTER,1,18500,0,18500,17200,1300
7/29/2021 21:18,8992696422650,NESCAFE FRENCH VANILLA,1,5000,0,5000,4099,901
7/29/2021 21:20,GGK,PERMEN KARET,4,500,0,2000,1600,400
7/29/2021 21:36,8999999502393,ROYCO FDS CHICKEN 8G,1,5000,0,5000,4500,500
7/29/2021 21:36,8997025914059,HATARI SEE HONG,1,6000,0,6000,4911,1089
7/29/2021 21:36,8998666001306GT,TB CREAMY LATTE,1,13000,0,13000,9900,3100
7/29/2021 21:36,8993001003908,INDOMILK KENTAL MANIS 545G,1,15000,0,15000,13333,1667
7/29/2021 21:36,8999999571924,MOLTO PURE 1OML,1,5000,0,5000,4800,200
7/29/2021 21:46,8992696404441,BEAR BRAND 189ML,1,9000,0,9000,7887,1113
7/29/2021 21:46,8992959508312,SWEETY SILVER PANTS XL RTG,1,15500,0,15500,13944,1556
7/29/2021 21:46,8998866200837,NOODLE SEDAAPMIE SOTO CUP 81 GR,1,4500,0,4500,3650,850
7/29/2021 21:46,MOBIL,GULA GULA HP,1,2000,0,2000,1700,300
7/29/2021 22:23,6907992823850,JD CHOCO CIRLE,1,5500,0,5500,4700,800
7/29/2021 22:23,8991002122000,ABC CHOCO MALT COFFE,1,3000,0,3000,2278,722
7/30/2021 10:28,MLTO PINK,MOLTO ALL IN ONE,2,1000,0,2000,1600,400
7/30/2021 10:28,8992696404441,BEAR BRAND 189ML,1,9000,0,9000,7887,1113
7/30/2021 10:28,8992775315057,GERY SALUT MALKIST COKLAT,1,6500,0,6500,5516,984
7/30/2021 10:28,8992959117538,SFX COMFORT SLIM WING 20,1,12000,0,12000,10947,1053
7/30/2021 10:28,8991102714846,MILKIDO CKLT,1,3000,0,3000,2153,847
7/30/2021 10:28,089686048704,SARIMIE GORENG AYAM KCP ISI 2,1,3500,0,3500,3120,380
7/30/2021 10:28,8997210107877,VORTEX SMART 3,1,5000,0,5000,4750,250
7/30/2021 10:28,8999999559854,AXE BLACK POCKET FRAG 17ML,1,10000,0,10000,8000,2000
7/30/2021 10:28,8998898853100,SUSU JAHE,1,1500,0,1500,1180,320
7/30/2021 10:28,8998866501033,MINYAK GORENG SEDAAP POUCH 2L,1,29000,0,29000,27746,1254
7/30/2021 10:28,8998989300261,GUDANG GARAM SURYA 12 FILTER,1,18500,0,18500,17200,1300
7/30/2021 10:28,CC,NICE FACIAL KILOAN 900 GR DUO,1,34500,0,34500,31325,3175
7/30/2021 10:28,GL,GULA 1 LITER,1,11500,0,11500,10500,1000
7/30/2021 10:28,8999999045913,LIFEBUOY MILDCARE 110GR,1,15000,0,15000,14245,755
7/30/2021 10:28,8999999195649,SARI WANGI 25X1.86G,1,6000,0,6000,5050,950
7/30/2021 10:28,GGK,PERMEN KARET,1,500,0,500,400,100
7/30/2021 10:54,GL,GULA 1 LITER,1,11500,0,11500,10500,1000
7/30/2021 10:58,8992628605151,AMANDA MARGARINE,1,5000,0,5000,3806,1194
7/30/2021 10:58,8997001245887,TERIGU KITA 1KG,1,9500,0,9500,8500,1000
7/30/2021 10:58,8999999192150,ROYCO FDS CHICKEN 100GR,1,5000,0,5000,4300,700
7/30/2021 10:58,MENTOS,MENTOS,2,250,0,500,350,150
7/30/2021 11:10,GGK,PERMEN KARET,2,500,0,1000,800,200
7/30/2021 11:13,8999999556341,MOLTO EDP PINK ROSE 20ML,15,1000,0,15000,12000,3000
7/30/2021 11:13,8999999057640,MOLTO EDP BLK PURPLE 20ML,5,1000,0,5000,4000,1000
7/30/2021 12:07,8998866202732,MILKU STROBERI 200ML,1,3000,0,3000,2375,625
7/30/2021 12:16,ARG,ARGUS 220ML,4,14500,0,58000,53200,4800
7/30/2021 12:28,8999909003439,MARLBORO CRAFTED 12,1,8000,0,8000,7250,750
7/30/2021 12:38,8991111112084,C&C DAILY PORE CLEANSER 50G,1,14000,0,14000,12900,1100
7/30/2021 12:38,8994834003752,TICTIC,1,2000,0,2000,1700,300
7/30/2021 12:38,8992761166212,FRESTEA APPLE 350ML,1,4500,0,4500,3000,1500
7/30/2021 13:08,8998866203104,MIE SEDAAP SINGAPORE,2,2500,0,5000,4532,468
7/30/2021 13:08,089686011036,INDOMIE GORENG PEDAS,2,2700,0,5400,4904,496
7/30/2021 13:08,8998866202619,MIE SEDAAP KOREAN SPICY SOUP,4,2500,0,10000,9092,908
7/30/2021 13:08,089686021219,INTER MIE GORENG,10,1000,0,10000,8850,1150
7/30/2021 13:08,089686021127,INTER MIE KALDU,10,1000,0,10000,8130,1870
7/30/2021 13:08,8996001600399,LE MINERAL 1500ML,1,5000,0,5000,4042,958
7/30/2021 13:28,089686043051,INDOMIE COTO MAKASSAR,2,2800,0,5600,5050,550
7/30/2021 13:28,8992628022156,BIMOLI KLASIK TOUCH 1 LT,1,16000,0,16000,14350,1650
7/30/2021 13:28,8998866200301,MIE SEDAAP GORENG,2,2500,0,5000,4046,954
7/30/2021 14:41,ROTI,ROTI 2000,1,2000,0,2000,1800,200
7/30/2021 14:42,8999999536244,SUNSILK SHP THICK N LONG170ML,1,20000,0,20000,18150,1850
7/30/2021 14:45,8992761002022,SPRITE PET 390ML,1,5500,0,5500,4300,1200
7/30/2021 14:45,8991102387286SCT,TANGO LONG CKLT 47G,1,2000,0,2000,1551,449
7/30/2021 14:49,6907992823874,JD CRUNCHY CHOCO BLUEBERRY,1,5500,0,5500,4700,800
7/30/2021 16:33,089686043273,INDOMIE SAMBAL RICA,5,2700,0,13500,12260,1240
7/30/2021 16:33,089686021219,INTER MIE GORENG,4,1000,0,4000,3540,460
7/30/2021 16:33,8993072254056,MELROSE COTTON BUDS KCL,1,3000,0,3000,2450,550
7/30/2021 16:33,KOPIKO,KOPIKO,6,250,0,1500,1050,450
7/30/2021 16:54,001,PASEO SMART FACIAL SF 250S GT,1,10000,0,10000,9500,500
7/30/2021 16:54,ARG,ARGUS 220ML,2,14500,0,29000,26600,2400
7/30/2021 17:33,8996001600146,TEH PUCUK HARUM 350ML,1,3000,0,3000,2314,686
7/30/2021 17:33,8992761166212,FRESTEA APPLE 350ML,1,4500,0,4500,3000,1500
7/30/2021 17:50,8998866609043,DAIA SOFTENER GUSSET 565G,1,10000,0,10000,8700,1300
7/30/2021 17:50,8992959508992,SWEETY SILVER PANTS L 28,1,56800,0,56800,51819,4981
7/30/2021 17:50,8992775311998,GERY CHOCOLATOS,1,17000,0,17000,15483,1517
7/30/2021 17:51,BB,PASEO SMARTY FACIAL TRAVEL PACK 50S GT,2,3000,0,6000,3960,2040
7/30/2021 17:51,8997018720018,SIRUP DHT,1,23000,0,23000,20958,2042
7/30/2021 18:58,8992745320326,STELLA ORG 200ML,1,15000,0,15000,13300,1700
7/30/2021 19:08,8999909085114,SAMPOERNA KRETEK HIJAU 12,1,13000,0,13000,11650,1350
7/30/2021 19:56,8999909085114,SAMPOERNA KRETEK HIJAU 12,1,13000,0,13000,11650,1350
7/30/2021 20:04,8993989311699,CLAS MILD 16 FILTER,1,23000,0,23000,21700,1300
7/30/2021 20:07,089686060362,POP MIE SOTO AYAM JUMBO,2,4500,0,9000,7666,1334
7/30/2021 20:07,8998009020186,BUAVITA GUAVA 250ML,4,7000,0,28000,24332,3668
7/30/2021 20:07,8998866200851,NOODLE SEDAAP MIE BAKSO SPESIAL CUP 77 GR,1,4500,0,4500,3650,850
7/30/2021 20:07,8998866200813,NOODLE SEDAAP MIE GORENG CUP 85 GR,2,5000,0,10000,7834,2166
7/30/2021 20:09,8992761111533,SPRITE SLIM CAM250ML,1,5000,0,5000,3750,1250
7/30/2021 20:55,8998989500128,GUDANG GARAM MERAH KECIL 12KS,2,14000,0,28000,26000,2000
7/30/2021 21:55,8992959508312,SWEETY SILVER PANTS XL RTG,1,15500,0,15500,13944,1556
7/30/2021 21:55,8992959953037,SWEETY BRONZE L1,2,3000,0,6000,5342,658
7/30/2021 22:08,8886001038011,BENG-BENG SCT,2,1500,0,3000,2900,100
7/30/2021 22:08,RT MENARA,ROTI TAWAR MENARA,1,8000,0,8000,7200,800
7/30/2021 22:08,8886001038011,BENG-BENG SCT,1,1500,0,1500,1450,50
7/30/2021 22:37,8993072254056,MELROSE COTTON BUDS KCL,1,3000,0,3000,2450,550
7/31/2021 10:21,089686440287,OPOR AYAM,1,5000,0,5000,4500,500
7/31/2021 10:21,8997011700123,BIHUN JAGUNG 300GR,1,6000,0,6000,4979,1021
7/31/2021 10:21,8991188943543,SASA SANTAN KELAPA 200ML,2,9500,0,19000,16800,2200
7/31/2021 10:33,8994867000179,ROKOK PENA MILD 16,1,14500,0,14500,13500,1000
7/31/2021 10:51,089686043051,INDOMIE COTO MAKASSAR,2,2800,0,5600,5050,550
7/31/2021 10:51,ROTI,ROTI 2000,2,2000,0,4000,3600,400
7/31/2021 10:51,BTS,BIMURA TARO SEAWEED 250G,1,10000,0,10000,9300,700
7/31/2021 10:57,9556001004673,MILO NESTLE MALAYSIA ACTIVE GO,1,85000,0,85000,80000,5000
7/31/2021 10:57,8992628020152,BIMOLI POUCH 2L,1,31000,0,31000,29800,1200
7/31/2021 10:57,ROTI,ROTI 2000,2,2000,0,4000,3600,400
7/31/2021 13:39,8998866500708,FLORIDINA ORANGE,1,3000,0,3000,2500,500
7/31/2021 13:56,8992775315057,GERY SALUT MALKIST COKLAT,1,6500,0,6500,5516,984
7/31/2021 13:56,8992775002933,GERY MALKIST DOUBLE ABON,1,6500,0,6500,5516,984
7/31/2021 14:09,8998989110167,SURYA GUDANG GARAM 16 FILTER,1,25000,0,25000,23200,1800
7/31/2021 14:11,8996001440001SCT,TB SUSU JAHE SCT,2,1500,0,3000,1740,1260
7/31/2021 14:11,8993379200879,SABUN HARMONY MELON 70G,1,2000,0,2000,1652,348
7/31/2021 14:11,8998866500708,FLORIDINA ORANGE,1,3000,0,3000,2500,500
7/31/2021 14:11,8886013213208,FRENCH FREIS 2000,1,5000,0,5000,3750,1250
7/31/2021 14:11,BAYFLAST,BAYPLAST,4,500,0,2000,1400,600
7/31/2021 15:10,8999908082800,MARINA HEALTHY AND GLOW,1,10000,0,10000,8500,1500
7/31/2021 15:10,8999908010704,MARINA BRIGHT AND FRESH,1,10000,0,10000,8500,1500
7/31/2021 16:30,CK,COOKIEZ,2,1000,0,2000,1450,550
7/31/2021 16:32,8998989300261,GUDANG GARAM SURYA 12 FILTER,1,18500,0,18500,17200,1300
7/31/2021 16:55,8998866611718,EKONOMI PENCUCI PIRING  LIQ 780ML,1,12000,0,12000,10900,1100
7/31/2021 16:55,8998866610223,DAIA VIOLET BAG 850G & PIRING,1,18000,0,18000,15627,2373
7/31/2021 16:55,SKT,SIKAT CUCI,1,6000,0,6000,5000,1000
7/31/2021 16:57,8992959953198,SWEETY BRONZE  XL 26+2,1,60000,0,60000,54091,5909
7/31/2021 16:57,8999999032128,ZWITSAL BATH NAT HAIR&BODY 100ML,1,12100,0,12100,10835,1265
7/31/2021 16:57,8999999706180,PEPSODENT WHITE 190GR,1,10000,0,10000,9350,650
7/31/2021 16:57,8998866202923,FLORIDINA COCO,1,3000,0,3000,2500,500
7/31/2021 16:58,001,PASEO SMART FACIAL SF 250S GT,1,10000,0,10000,9500,500
7/31/2021 17:17,8992775305164,GERY MALKIST GREEN TEA,1,6500,0,6500,5500,1000
7/31/2021 17:17,8997218380135,ICHITAN GREEN TEA,1,8000,0,8000,6583,1417
7/31/2021 17:44,8991102714860,MILKIDO STRAW,1,3000,0,3000,2153,847
7/31/2021 17:47,ARG,ARGUS 220ML,1,14500,0,14500,13300,1200
7/31/2021 17:56,8998009010569,ULTRA CHO 200,1,5000,0,5000,3830,1170
7/31/2021 18:48,HT,HOT-HOT,2,500,0,1000,700,300
7/31/2021 19:06,ARG,ARGUS 220ML,1,14500,0,14500,13300,1200
7/31/2021 19:06,8997027300089,NOMOS,1,4000,0,4000,2963,1037
7/31/2021 19:06,8996001600146,TEH PUCUK HARUM 350ML,1,3000,0,3000,2314,686
7/31/2021 19:12,8993989311699,CLAS MILD 16 FILTER,1,23000,0,23000,21700,1300
7/31/2021 19:12,8992761164478,FRESTEA MILK TEA,1,8000,0,8000,6575,1425
7/31/2021 19:12,8998866201452,POTABEE REGULER BBQ BEEF 35GR,1,5000,0,5000,4150,850
7/31/2021 19:58,GL,GULA 1 LITER,4,11500,0,46000,42000,4000
7/31/2021 20:14,8992696422735,DNCO CKLT UHT 110ML,1,2500,0,2500,2041,459
7/31/2021 20:14,8992696523081,MILO UHT 110ML,1,2500,0,2500,1962,538
7/31/2021 20:14,8994834003752,TICTIC,2,2000,0,4000,3400,600
7/31/2021 20:22,8993989311699,CLAS MILD 16 FILTER,1,23000,0,23000,21700,1300
7/31/2021 20:22,089686014280,SUPERMI AYAM BAWANG,2,2500,0,5000,4624,376
7/31/2021 20:22,089686010107,INDOMIE KALDU AYAM,1,2500,0,2500,2150,350
7/31/2021 21:27,GL,GULA 1 LITER,1,11500,0,11500,10500,1000
7/31/2021 21:27,8997027300089,NOMOS,1,4000,0,4000,2963,1037
7/31/2021 21:27,8993379260026,SABUN MEDICARE BLACK,1,2500,0,2500,2237,263
7/31/2021 21:27,8993379260804,SABUN MEDICARE BLUE,1,2500,0,2500,2237,263
7/31/2021 21:27,8991002105584,KAPAL API 6.5 G,10,500,0,5000,3900,1100
7/31/2021 21:27,8998866200882,SUKSESMIE GORENG AYAM KRMS 133GR,1,3500,0,3500,3047,453
7/31/2021 21:27,HT,HOT-HOT,2,500,0,1000,700,300
7/31/2021 21:28,ROTI,ROTI 2000,3,2000,0,6000,5400,600
7/31/2021 21:40,8999999528829,CITRA SAKURA FAIR UV 120ML,1,11200,0,11200,10082,1118
7/31/2021 21:40,8992222091961,PUCELLE MIST COL SPRAY 75ML,1,13000,0,13000,11650,1350
7/31/2021 21:40,8991111109114,JB BEDTIME 150+50G,1,10000,0,10000,9210,790
7/31/2021 21:40,8999999555122,MOLTO K-ROMANCE 20ML,10,1000,0,10000,8000,2000
7/31/2021 21:40,8998866201377,KRISBEE FRIES KENTANG GORENG 68 GR,1,5500,0,5500,4620,880
7/31/2021 21:40,089686010824,INDOMIE GORENG SPESIAL,4,2700,0,10800,9808,992
7/31/2021 21:40,8997218380135,ICHITAN GREEN TEA,1,8000,0,8000,6583,1417
8/1/2021 12:51,8992959954058,SWEETY BRONZE NB 44,1,48000,0,48000,45682,2318
8/1/2021 12:51,8992759120264,LARISST 220,1,10000,0,10000,9200,800
8/1/2021 13:42,8998989110167,SURYA GUDANG GARAM 16 FILTER,1,25000,0,25000,23200,1800
8/1/2021 14:07,8992696404441,BEAR BRAND 189ML,1,9000,0,9000,7887,1113
8/1/2021 14:43,GL,GULA 1 LITER,2,11500,0,23000,21000,2000
8/1/2021 14:43,ROTI,ROTI 2000,5,2000,0,10000,9000,1000
8/1/2021 14:43,089686060102,POP MIE PEDE GLEDEEK,1,5000,0,5000,4450,550
8/1/2021 14:43,8996001600399,LE MINERAL 1500ML,1,5000,0,5000,4042,958
8/1/2021 14:43,SLAIM,SLAIM WARNA,1,2000,0,2000,1743,257
8/1/2021 14:46,089686067002,POP MIE PDS DOWER RS AYAM,1,5000,0,5000,4450,550
8/1/2021 14:46,089686043617,INDOMIE MIEGHETTI,1,2700,0,2700,2452,248
8/1/2021 14:46,8997028590014,ARGUS 220ML,4,500,0,2000,1208,792
8/1/2021 14:46,8997009510017,YOU C1000 LEMON,1,10000,0,10000,9166,834
8/1/2021 14:54,8997009510017,YOU C1000 LEMON,2,10000,0,20000,18332,1668
8/1/2021 14:54,8992959953037,SWEETY BRONZE L1,2,3000,0,6000,5342,658
8/1/2021 14:54,089686386127,BUMBU RACIK NASI GORENG SOSIS,1,2000,0,2000,1620,380
8/1/2021 14:54,8998989500166,GUDANG GARAM MERAH BESAR 16KS,2,18000,0,36000,34000,2000
8/1/2021 14:54,GGK,PERMEN KARET,1,500,0,500,400,100
8/1/2021 14:54,8993226365522,GARAM MEJA GYURI 200GR,2,2000,0,4000,3400,600
8/1/2021 14:54,089686010190,INDOMIE KARI AYAM,2,2800,0,5600,5044,556
8/1/2021 14:54,8992696521797GT,MILO ACT GO 22G GT,1,20000,0,20000,17090,2910
8/1/2021 14:54,8992761139018,ADES 600ML,1,3500,0,3500,2292,1208
8/1/2021 14:54,8992761122430,FRESTEA GREEN HONEY 500ML,1,6500,0,6500,4708,1792
8/1/2021 14:54,8994834006128,TICTIC PEDAS,1,2000,0,2000,1700,300
8/1/2021 14:54,8992696404441,BEAR BRAND 189ML,2,9000,0,18000,15774,2226
8/1/2021 14:54,8994867007161,ROKOK PENA GOLD 20,1,17000,0,17000,15500,1500
8/1/2021 14:54,8996001600146,TEH PUCUK HARUM 350ML,1,3000,0,3000,2314,686
8/1/2021 14:54,8998866201841,GOLDA DOLCE LATTE 200ML,1,3000,0,3000,2500,500
8/1/2021 14:54,001,PASEO SMART FACIAL SF 250S GT,1,10000,0,10000,9500,500
8/1/2021 14:54,8998989300261,GUDANG GARAM SURYA 12 FILTER,1,18500,0,18500,17200,1300
8/1/2021 14:54,8992696523081,MILO UHT 110ML,2,2500,0,5000,3924,1076
8/1/2021 14:54,8992696422735,DNCO CKLT UHT 110ML,2,2500,0,5000,4082,918
8/1/2021 14:54,8994834003752,TICTIC,1,2000,0,2000,1700,300
8/1/2021 14:54,8998866201452,POTABEE REGULER BBQ BEEF 35GR,1,5000,0,5000,4150,850
8/1/2021 14:54,8994867000179,ROKOK PENA MILD 16,1,14500,0,14500,13500,1000
8/1/2021 14:54,8999909010567,234 DJI SAM SOE 16,2,22000,0,44000,43000,1000
8/1/2021 15:32,CK,COOKIEZ,2,1000,0,2000,1450,550
8/1/2021 15:34,8996001355817,BENG-BENG MAXX,1,27000,0,27000,24500,2500
8/1/2021 15:34,8996001600399,LE MINERAL 1500ML,3,5000,0,15000,12126,2874
8/1/2021 15:36,8996001318430,BETTER 1000,2,1000,0,2000,1640,360
8/1/2021 15:36,8992775000076,GERY SNACK RING CKLT,1,2000,0,2000,1712,288
8/1/2021 15:36,8998009040023,TEH KOTAK,1,5000,0,5000,2827,2173
8/1/2021 15:36,8991001503107,CHACHA PEANUT 35GR,1,5500,0,5500,4900,600
8/1/2021 15:36,HT,HOT-HOT,1,500,0,500,350,150
8/1/2021 15:51,001,PASEO SMART FACIAL SF 250S GT,1,10000,0,10000,9500,500
8/1/2021 15:51,8992696404441,BEAR BRAND 189ML,1,9000,0,9000,7887,1113
8/1/2021 16:19,GGK,PERMEN KARET,4,500,0,2000,1600,400
8/1/2021 16:19,8994834003752,TICTIC,2,2000,0,4000,3400,600
8/1/2021 16:19,8998866501033,MINYAK GORENG SEDAAP POUCH 2L,1,29000,0,29000,27746,1254
8/1/2021 16:24,8994834003752,TICTIC,2,2000,0,4000,3400,600
8/1/2021 16:48,8992761139018,ADES 600ML,1,3500,0,3500,2292,1208
8/1/2021 17:06,VCO,VITAMIN C500 ORANGE,6,1000,0,6000,3450,2550
8/1/2021 17:20,8992696422735,DNCO CKLT UHT 110ML,1,2500,0,2500,2041,459
8/1/2021 17:20,8994834003752,TICTIC,1,2000,0,2000,1700,300
8/1/2021 17:30,8991004011906,KOPI BORONG,1,10000,0,10000,8333,1667
8/1/2021 17:30,GL,GULA 1 LITER,1,11500,0,11500,10500,1000
8/1/2021 17:30,8998989300261,GUDANG GARAM SURYA 12 FILTER,1,18500,0,18500,17200,1300
8/1/2021 18:10,GGK,PERMEN KARET,10,500,0,5000,4000,1000
8/1/2021 18:39,8998866203104,MIE SEDAAP SINGAPORE,1,2500,0,2500,2266,234
8/1/2021 18:39,8998866202770,MIE SEDAAP SALERO PADANG,1,2500,0,2500,2362,138
8/1/2021 19:12,ff,FULLO BLASTO,3,1000,0,3000,2985,15
8/1/2021 19:12,GGK,PERMEN KARET,1,500,0,500,400,100
8/1/2021 19:56,GL,GULA 1 LITER,1,11500,0,11500,10500,1000
8/1/2021 19:57,8886013213208,FRENCH FREIS 2000,1,5000,0,5000,3750,1250
8/1/2021 20:03,ARG,ARGUS 220ML,2,14500,0,29000,26600,2400
8/1/2021 20:16,8998866613736,EMERON LOVELY NAT 200ML,1,6000,0,6000,5075,925
8/1/2021 20:16,8991111101408,JB POWDER 50G,1,3500,0,3500,3000,500
8/1/2021 20:16,8992959974018,SFX SIRIH 36CM 12+1,1,17000,0,17000,15958,1042
8/1/2021 20:18,8992959953037,SWEETY BRONZE L1,2,3000,0,6000,5342,658
8/1/2021 20:30,ROTI,ROTI 2000,3,2000,0,6000,5400,600
8/1/2021 20:30,9556001025272,NESCAFE LATTE 240ML,1,8500,0,8500,7834,666
8/1/2021 20:30,8991102714860,MILKIDO STRAW,1,3000,0,3000,2153,847
8/1/2021 20:30,8996001402023SCT,TB TORA SUSU SCT,1,1500,0,1500,848,652
8/1/2021 20:30,8992775000076,GERY SNACK RING CKLT,1,2000,0,2000,1712,288
8/1/2021 20:30,089686060126,POP MIE BASO JUMBO,1,4500,0,4500,3833,667
8/1/2021 20:38,ARG,ARGUS 220ML,4,14500,0,58000,53200,4800
8/1/2021 20:49,GL,GULA 1 LITER,1,11500,0,11500,10500,1000
8/1/2021 20:49,8991102385121,WFR TANGO VNL 7G,1,8300,0,8300,7455,845
8/1/2021 20:51,8998866202770,MIE SEDAAP SALERO PADANG,1,2500,0,2500,2362,138
8/1/2021 20:51,089686010824,INDOMIE GORENG SPESIAL,1,2700,0,2700,2452,248
8/1/2021 20:51,089686021127,INTER MIE KALDU,1,1000,0,1000,813,187
8/1/2021 20:51,089686043051,INDOMIE COTO MAKASSAR,2,2800,0,5600,5050,550
8/1/2021 20:58,8998866610087,JAVANA ORIGINAL 350ML,1,3000,0,3000,2150,850
8/1/2021 20:58,8991102989381,TANGO LONG BUBBLEGUM 130G,1,5000,0,5000,4345,655
8/1/2021 21:02,8998989110167,SURYA GUDANG GARAM 16 FILTER,1,25000,0,25000,23200,1800
8/1/2021 21:02,8994867000162,ROKOK PUNDIMAS KRETEK16,1,10000,0,10000,8600,1400
8/1/2021 21:02,8991102714631,TANGO TETRA CKLT,1,5000,0,5000,4545,455
8/1/2021 21:08,001,PASEO SMART FACIAL SF 250S GT,3,10000,0,30000,28500,1500
8/1/2021 21:18,8997231980039,O`JELLY KONYAKU (MAXI APPLE STRAWBERRY),2,5000,0,10000,9240,760
8/1/2021 21:20,8992959508312,SWEETY SILVER PANTS XL RTG,1,15500,0,15500,13944,1556
8/1/2021 21:20,COKLAT,COKLAT COIN,1,500,0,500,425,75
8/1/2021 22:00,8886001038011,BENG-BENG SCT,1,1500,0,1500,1450,50
8/1/2021 22:00,GGK,PERMEN KARET,1,500,0,500,400,100
8/1/2021 22:00,8998989110167,SURYA GUDANG GARAM 16 FILTER,1,25000,0,25000,23200,1800
8/2/2021 10:58,8992979130012,TOTAL LEMON SOFTENER,1,13000,0,13000,11532,1468
8/2/2021 11:07,8994867000179,ROKOK PENA MILD 16,1,14500,0,14500,13500,1000
8/2/2021 11:07,8991188943536,SASA SANTAN KELAPA 65ML,1,3000,0,3000,2437,563
8/2/2021 11:38,8995333000822,TERIGU KOMPAS SOFT 500GR,1,5500,0,5500,4967,533
8/2/2021 11:38,8999999524722,SUNLIGHT LIME NEW PCH 435ML,1,10000,0,10000,9100,900
8/2/2021 12:07,089686021127,INTER MIE KALDU,2,1000,0,2000,1626,374
8/2/2021 12:07,089686010824,INDOMIE GORENG SPESIAL,2,2700,0,5400,4904,496
8/2/2021 12:07,8994834005923,SPIX 1000,5,1000,0,5000,4250,750
8/2/2021 12:07,8994834001901,SUKI,3,1000,0,3000,2283,717
8/2/2021 12:07,8999908042408,MY BABY POWDER BIRU,1,5000,0,5000,3275,1725
8/2/2021 12:11,8998866611725,EKONOMI PENCUCI PIRING  LIQ 290ML,1,5000,0,5000,4200,800
8/2/2021 12:11,8999999531492,MOLTO GLAMOUR,1,5000,0,5000,4800,200
8/2/2021 12:11,8991102387286SCT,TANGO LONG CKLT 47G,2,2000,0,4000,3102,898
8/2/2021 12:15,8997028590014,ARGUS 220ML,4,500,0,2000,1208,792
8/2/2021 12:21,8991909101016,URBAN MILD 16,1,17000,0,17000,15800,1200
8/2/2021 12:37,GGK,PERMEN KARET,2,500,0,1000,800,200
8/2/2021 12:50,8998866202695,KOPI MAYOR,1,6000,0,6000,4500,1500
8/2/2021 12:57,8998866501033,MINYAK GORENG SEDAAP POUCH 2L,3,29000,0,87000,83238,3762
8/2/2021 12:57,ROTI,ROTI 2000,1,2000,0,2000,1800,200
8/2/2021 12:57,CK,COOKIEZ,2,1000,0,2000,1450,550
8/2/2021 14:20,8886001038011,BENG-BENG SCT,2,1500,0,3000,2900,100
8/2/2021 14:20,6907992825076,JD WATERMELON APPLE,1,2000,0,2000,1700,300
8/2/2021 14:55,8992761139018,ADES 600ML,3,3500,0,10500,6876,3624
8/2/2021 14:55,8886057883665,KRATING DAENG,1,6000,0,6000,4286,1714
8/2/2021 15:00,8991102213189,BLASTER UNGU,1,5000,0,5000,3106,1894
8/2/2021 15:16,8992761166212,FRESTEA APPLE 350ML,1,4500,0,4500,3000,1500
8/2/2021 15:16,8998866202770,MIE SEDAAP SALERO PADANG,1,2500,0,2500,2362,138
8/2/2021 15:16,8998866200325,MIE SEDAAP SOTO,1,2500,0,2500,1952,548
8/2/2021 15:16,8998866200301,MIE SEDAAP GORENG,1,2500,0,2500,2023,477
8/2/2021 15:44,8997218380074,ICHITAN MILK TEA,1,8000,0,8000,6583,1417
8/2/2021 15:50,8993989311699,CLAS MILD 16 FILTER,1,23000,0,23000,21700,1300
8/2/2021 16:36,711844150027,ABC NANAS,1,13000,0,13000,12241,759
8/2/2021 16:36,8995333060772,TERIGU GATOT KACA 500GR,1,4500,0,4500,4065,435
8/2/2021 16:36,8998866608008,KECAP MANIS SEDAAP BOTOL 135 ML,1,6500,0,6500,5875,625
8/2/2021 16:36,8999999192150,ROYCO FDS CHICKEN 100GR,1,5000,0,5000,4300,700
8/2/2021 16:36,8998866609494,SOKLIN SOFTERGEN 280G BIRU,1,5000,0,5000,4425,575
8/2/2021 16:36,8992696523081,MILO UHT 110ML,1,2500,0,2500,1962,538
8/2/2021 17:01,VCO,VITAMIN C500 ORANGE,3,1000,0,3000,1725,1275
8/2/2021 17:01,8992775002933,GERY MALKIST DOUBLE ABON,1,6500,0,6500,5516,984
8/2/2021 17:01,8992388133345,NU MILK TEA TEH TARIK 330ML,1,6000,0,6000,5125,875
8/2/2021 18:04,GL,GULA 1 LITER,1,11500,0,11500,10500,1000
8/2/2021 18:04,PD,PENDEKAR,1,500,0,500,350,150
8/2/2021 18:04,8993989311279,CLAS MILD 12,1,17000,0,17000,15700,1300
8/2/2021 18:08,GGK,PERMEN KARET,4,500,0,2000,1600,400
8/2/2021 18:08,8994834003752,TICTIC,1,2000,0,2000,1700,300
8/2/2021 18:19,8992759120264,LARISST 220,1,10000,0,10000,9200,800
8/2/2021 18:19,MARS,MARSHMELLOW,2,500,0,1000,866,134
8/2/2021 18:19,8999099923005,SGM 6-12 600G,1,53000,0,53000,51951,1049
8/2/2021 18:27,8886013213208,FRENCH FREIS 2000,1,5000,0,5000,3750,1250
8/2/2021 18:27,089686041705,INDOMIE GORENG JUMBO,1,3500,0,3500,3143,357
8/2/2021 18:27,8998866202060,POTABEE AYAM BAKAR PEDAS 35 GR,1,5000,0,5000,4150,850
8/2/2021 18:27,8994834003752,TICTIC,1,2000,0,2000,1700,300
8/2/2021 18:27,8850507000094,POLICE BONCHA,2,2000,0,4000,1600,2400
8/2/2021 18:27,8998009010231,ULTRA CHO 250,1,6000,0,6000,4784,1216
8/2/2021 18:27,8992761166038,MMP ORANGE 300ML,1,5000,0,5000,3750,1250
8/2/2021 19:09,8992959974001,SFX SIRIH SLIM 36CM 6+1,1,10000,0,10000,8315,1685
8/2/2021 19:09,8998989110167,SURYA GUDANG GARAM 16 FILTER,1,25000,0,25000,23200,1800
8/2/2021 19:19,8999999195649,SARI WANGI 25X1.86G,1,6000,0,6000,5050,950
8/2/2021 19:19,8999999529673,CLEARA  IC MENTHOL 80ML,1,11200,0,11200,10120,1080
8/2/2021 19:19,8998866619004,ROYALE SUNNY DAY,1,5000,0,5000,4560,440
8/2/2021 19:19,8998866609036,DAIA BUNGA GUSSET 565G,1,10000,0,10000,8700,1300
8/2/2021 19:19,8992959117583,SFX DS REG FLOW WING 20,1,5000,0,5000,4288,712
8/2/2021 19:19,8999999524722,SUNLIGHT LIME NEW PCH 435ML,1,10000,0,10000,9100,900
8/2/2021 19:19,8998866602570,NUVO FAMILY KUNING 76G,1,2000,0,2000,1820,180
8/2/2021 19:19,001,PASEO SMART FACIAL SF 250S GT,1,10000,0,10000,9500,500
8/2/2021 19:19,8997013790108,BIMURA KACANG TELUR 25G,3,1000,0,3000,2625,375
8/2/2021 19:19,8994834001901,SUKI,2,1000,0,2000,1522,478
8/2/2021 19:52,8994834003752,TICTIC,1,2000,0,2000,1700,300
8/2/2021 19:52,ROTI,ROTI 2000,2,2000,0,4000,3600,400
8/2/2021 19:53,GL,GULA 1 LITER,1,11500,0,11500,10500,1000
8/2/2021 19:53,8998989500166,GUDANG GARAM MERAH BESAR 16KS,2,18000,0,36000,34000,2000
8/2/2021 19:55,MILKITA,MILKITA,2,250,0,500,400,100
8/2/2021 20:07,8998866202619,MIE SEDAAP KOREAN SPICY SOUP,1,2500,0,2500,2273,227
8/2/2021 20:07,089686041705,INDOMIE GORENG JUMBO,1,3500,0,3500,3143,357
8/2/2021 20:07,089686048704,SARIMIE GORENG AYAM KCP ISI 2,1,3500,0,3500,3120,380
8/2/2021 20:07,8998866613262,SUKSESMIE SOTO 111 GR,1,3500,0,3500,2770,730
8/2/2021 20:07,089686010343,INDOMIE SOTO MIE,2,2600,0,5200,4734,466
8/2/2021 20:09,8998866610438,SOKLIN SOFTERGENT RED BAG 770G & PIRING,1,18000,0,18000,16680,1320
8/2/2021 21:00,GGK,PERMEN KARET,20,500,0,10000,8000,2000
8/2/2021 21:26,8992628605151,AMANDA MARGARINE,1,5000,0,5000,3806,1194
8/2/2021 21:26,8992761164546,NUTRIBOOST STRAWBERRY 300ML,1,6500,0,6500,5300,1200
8/2/2021 21:41,8994935000285,MINYAK GORENG DUNIA 4500ML,1,70000,0,70000,66433,3567
8/2/2021 21:41,8992959117514,SFX NON WING 20,1,10000,0,10000,9091,909
8/2/2021 22:41,8992696404441,BEAR BRAND 189ML,1,9000,0,9000,7887,1113
8/2/2021 22:41,089686611618,QTELA BARBEQUE,1,5000,0,5000,4266,734
8/2/2021 22:41,8992761164539,NUTRIBOOST ORANGE 300ML,1,6500,0,6500,5300,1200
8/2/2021 22:41,ff,FULLO BLASTO,1,1000,0,1000,995,5
8/2/2021 22:41,896867700494,AIR CLUB 1500ML,1,5000,0,5000,2987,2013
8/2/2021 22:41,RT ISI 6,ROTI ISI 6,1,6000,0,6000,5000,1000
8/2/2021 22:44,8994867000162,ROKOK PUNDIMAS KRETEK16,1,10000,0,10000,8600,1400
8/2/2021 22:44,8992696404441,BEAR BRAND 189ML,1,9000,0,9000,7887,1113
8/2/2021 22:47,RB,RED BOLD,1,19000,0,19000,17900,1100
8/2/2021 22:48,8992696422735,DNCO CKLT UHT 110ML,1,2500,0,2500,2041,459
8/2/2021 22:48,8994834003752,TICTIC,1,2000,0,2000,1700,300
8/2/2021 22:51,8996001600146,TEH PUCUK HARUM 350ML,1,3000,0,3000,2314,686
8/2/2021 22:51,8992959953037,SWEETY BRONZE L1,2,3000,0,6000,5342,658
8/2/2021 22:55,GL,GULA 1 LITER,1,11500,0,11500,10500,1000
8/2/2021 22:55,ROTI,ROTI 2000,2,2000,0,4000,3600,400
8/2/2021 22:55,RT MNTG,ROTI SISIR MENTEGA,1,2000,0,2000,1600,400
8/2/2021 22:55,8999999195656,SARI WANGI 50X1.85,1,10000,0,10000,9500,500
8/2/2021 22:55,COKLAT,COKLAT COIN,1,500,0,500,425,75
8/3/2021 9:40,8993226112508,GARAM REFINA,1,3000,0,3000,2461,539
8/3/2021 9:40,8998666002525SCT,TB TORA CAFE CAPPUCINO SCT,5,1000,0,5000,3900,1100
8/3/2021 9:45,8998866608459,POWDET DAIA PUTIH BAG 290GR,1,5000,0,5000,4450,550
8/3/2021 9:45,8999999571924,MOLTO PURE 1OML,1,5000,0,5000,4800,200
8/3/2021 9:45,ROTI,ROTI 2000,3,2000,0,6000,5400,600
8/3/2021 9:45,8993989311699,CLAS MILD 16 FILTER,2,23000,0,46000,43400,2600
8/3/2021 9:45,089686535044,SUN BERAS MERAH,1,8500,0,8500,7410,1090
8/3/2021 9:45,8992628020152,BIMOLI POUCH 2L,1,31000,0,31000,29800,1200
8/3/2021 9:45,8992979130012,TOTAL LEMON SOFTENER,1,13000,0,13000,11532,1468
8/3/2021 9:45,8999999057640,MOLTO EDP BLK PURPLE 20ML,5,1000,0,5000,4000,1000
8/3/2021 9:45,089686043051,INDOMIE COTO MAKASSAR,1,2800,0,2800,2525,275
8/3/2021 9:45,8996001318430,BETTER 1000,3,1000,0,3000,2460,540
8/3/2021 9:45,8994834003752,TICTIC,1,2000,0,2000,1700,300
8/3/2021 9:45,8992696422735,DNCO CKLT UHT 110ML,1,2500,0,2500,2041,459
8/3/2021 9:45,VTM,VITAMIN,2,500,0,1000,850,150
8/3/2021 9:45,GGK,PERMEN KARET,4,500,0,2000,1600,400
8/3/2021 9:45,8994834006128,TICTIC PEDAS,1,2000,0,2000,1700,300
8/3/2021 9:45,089686010343,INDOMIE SOTO MIE,2,2600,0,5200,4734,466
8/3/2021 9:45,8999999033200,LIFEBUOY SHP ANTI KETOMBE 70+21 ML,1,8000,0,8000,7260,740
8/3/2021 9:45,8998866501033,MINYAK GORENG SEDAAP POUCH 2L,2,29000,0,58000,55492,2508
8/3/2021 9:45,8992775315057,GERY SALUT MALKIST COKLAT,1,6500,0,6500,5516,984
8/3/2021 9:58,8991111101316,JB OIL 50ML,1,9500,0,9500,8700,800
8/3/2021 9:58,8996001305041,ROMA SANDWICH CKLT,1,7000,0,7000,5000,2000
8/3/2021 9:58,8998009010231,ULTRA CHO 250,1,6000,0,6000,4784,1216
8/3/2021 10:09,8999999524838,SUNLIGHT MINT POUCH 755ML,1,17000,0,17000,15400,1600
8/3/2021 10:09,8992775610008,TING-TING GARUDA 2.5G,1,7500,0,7500,6296,1204
8/3/2021 10:09,8992753100101,BKM FULL CREAM GOLD 370,1,15000,0,15000,14000,1000
8/3/2021 10:09,8999999048488,SUNSILK SHP REFRESH ANTI DDRF 70+21ML,1,10000,0,10000,9075,925
8/3/2021 10:09,VCL,VITAMIN C500 LEMON,6,1000,0,6000,3450,2550
8/3/2021 10:56,8993007003063,ENAAK 500G,1,11000,0,11000,9625,1375
8/3/2021 10:56,8991002103238,GOOD DAY MOCACINNO,2,1500,0,3000,1780,1220
8/3/2021 10:56,8998866107518,ZINC BLACK SHINE SHT 10ML,1,5000,0,5000,4500,500
8/3/2021 10:56,8992933219111,NUTRIJELL CINCAU,2,6000,0,12000,10000,2000
8/3/2021 10:56,8992959117583,SFX DS REG FLOW WING 20,1,5000,0,5000,4288,712
8/3/2021 10:56,8991002103832,GOOD DAY CHOCOCINNO,2,1500,0,3000,1780,1220
8/3/2021 10:56,8992959953167,SWEETY BRONZE S36+2,1,48000,0,48000,45682,2318
8/3/2021 10:56,RB,RED BOLD,1,19000,0,19000,17900,1100
8/3/2021 10:59,8998866106498,EMERON  LOVELY NTRL VT 100ML,1,3500,0,3500,2900,600
8/3/2021 10:59,8992696521797SCT,MILO ACT GO 22G SCT,2,2000,0,4000,3106,894
8/3/2021 10:59,8998866888622,GIV MERAH KOTAK 76G,1,2000,0,2000,1820,180
8/3/2021 13:14,KJ,KINDER JOY,1,2000,0,2000,1583,417
8/3/2021 13:42,6907992823911,JD CRUNCHY HONEYDEW MELON,1,8000,0,8000,6800,1200
8/3/2021 13:42,6907992823904,JD CRUNCHY CHOCOLATE VAN,1,8000,0,8000,6800,1200
8/3/2021 13:42,6907992824963,JD MILKY CHOCOLATE,3,3000,0,9000,7800,1200
8/3/2021 13:54,8995333000822,TERIGU KOMPAS SOFT 500GR,1,5500,0,5500,4967,533
8/3/2021 13:54,8994867000179,ROKOK PENA MILD 16,1,14500,0,14500,13500,1000
8/3/2021 13:54,8992775315057,GERY SALUT MALKIST COKLAT,1,6500,0,6500,5516,984
8/3/2021 13:56,8992959971093,SFX COMFORT SLIME 6,1,8500,0,8500,7798,702
8/3/2021 13:58,8994867000162,ROKOK PUNDIMAS KRETEK16,1,10000,0,10000,8600,1400
8/3/2021 13:58,8992761166205,FRESTEA GREEN HONEY 350ML,1,4500,0,4500,3000,1500
8/3/2021 13:58,HT,HOT-HOT,2,500,0,1000,700,300
8/3/2021 13:58,MBL,MOBIL,1,5000,0,5000,3500,1500
8/3/2021 14:10,8994867000162,ROKOK PUNDIMAS KRETEK16,1,10000,0,10000,8600,1400
8/3/2021 14:10,8992705045122,AGAR-AGAR SATELIT HIJAU,2,3500,0,7000,5208,1792
8/3/2021 14:34,8999801700054,SUSU FOYU 1 KG,1,22000,0,22000,19791,2209
8/3/2021 14:41,001,PASEO SMART FACIAL SF 250S GT,2,10000,0,20000,19000,1000
8/3/2021 15:07,HT,HOT-HOT,4,500,0,2000,1400,600
8/3/2021 15:29,8991689668006,SWALLOW,1,3500,0,3500,3500,0
8/3/2021 15:33,8996001600146,TEH PUCUK HARUM 350ML,1,3000,0,3000,2314,686
8/3/2021 17:17,8991102714631,TANGO TETRA CKLT,1,5000,0,5000,4545,455
8/3/2021 17:17,8998866202732,MILKU STROBERI 200ML,1,3000,0,3000,2375,625
8/3/2021 17:17,VTM,VITAMIN,1,500,0,500,425,75
8/3/2021 17:17,TG APEL,TEH GELAS APEL,1,2000,0,2000,1178,822
8/3/2021 17:17,PD,PENDEKAR,4,500,0,2000,1400,600
8/3/2021 17:17,8994834003752,TICTIC,1,2000,0,2000,1700,300
8/3/2021 17:17,GGK,PERMEN KARET,2,500,0,1000,800,200
8/3/2021 17:33,8998866501026,MINYAK GORENG SEDAAP POUCH 1 L,2,15000,0,30000,28220,1780
8/3/2021 17:37,8998866202312,NOODLE SEDAAP TASTY BAKMI AYAM 129 GR,1,5000,0,5000,4167,833
8/3/2021 17:47,ARG,ARGUS 220ML,4,14500,0,58000,53200,4800
8/3/2021 17:48,8999999007768,FAIR&LOVELY MULTIVITAMIN  CREAM 9 ML,2,4500,0,9000,6400,2600
8/3/2021 17:48,ARG,ARGUS 220ML,4,14500,0,58000,53200,4800
8/3/2021 17:49,ARG,ARGUS 220ML,4,14500,0,58000,53200,4800
8/3/2021 18:07,8998898853100,SUSU JAHE,6,1500,0,9000,7080,1920
8/3/2021 18:44,8991102020305,FORMULA TRIPLE ACTION,1,3000,0,3000,2500,500
8/3/2021 18:44,8999999706180,PEPSODENT WHITE 190GR,1,10000,0,10000,9350,650
8/3/2021 18:44,8993379241858,SABUN HARMONY LEMON 70G,2,2000,0,4000,3304,696
8/3/2021 18:44,089686010107,INDOMIE KALDU AYAM,5,2500,0,12500,10750,1750
8/3/2021 18:44,089686010824,INDOMIE GORENG SPESIAL,5,2700,0,13500,12260,1240
8/3/2021 18:44,8998666001924GT,TB TORA CAFE CHOCO LATTE,1,9000,0,9000,7800,1200
8/3/2021 18:44,8999999529284,MOLTO EDP FRENCH LILY SC 10ML,1,5500,0,5500,4800,700
8/3/2021 18:44,8999999006006,RINSO ANTI NODA CLASSISC 750ML,1,15000,0,15000,12507,2493
8/3/2021 18:44,8992979190986,TOTAL PUTIH SOFTENER,1,13000,0,13000,11532,1468
8/3/2021 18:44,8994037703749,WENIS JERUK,1,8000,0,8000,6500,1500
8/3/2021 20:35,8994935000070,MINYAK DUNIA 450 ML,1,7500,0,7500,6779,721
8/3/2021 20:35,8992770061034,SAJIKU,2,2000,0,4000,3000,1000
8/3/2021 21:02,8992761002022,SPRITE PET 390ML,1,5500,0,5500,4300,1200
8/3/2021 21:02,089686010107,INDOMIE KALDU AYAM,1,2500,0,2500,2150,350
8/3/2021 21:02,8998866202237,NOODLE SEDAAP TASTY AYAM GEPREK 124 GR,1,5000,0,5000,4167,833
8/3/2021 21:55,089686010107,INDOMIE KALDU AYAM,1,2500,0,2500,2150,350
8/3/2021 21:55,089686010824,INDOMIE GORENG SPESIAL,1,2700,0,2700,2452,248
8/3/2021 21:55,8998866501026,MINYAK GORENG SEDAAP POUCH 1 L,2,15000,0,30000,28220,1780
8/3/2021 21:56,GL,GULA 1 LITER,1,11500,0,11500,10500,1000
8/3/2021 21:59,8998866202404,NOODLE SEDAAP MIE KOREAN SPICY CHICKEN CUP,2,5000,0,10000,8004,1996
8/3/2021 22:01,8998989110167,SURYA GUDANG GARAM 16 FILTER,1,25000,0,25000,23200,1800
8/3/2021 22:07,TG MARKISA,TEH GELAS MARKISA,1,2000,0,2000,1178,822
8/3/2021 22:11,8996001600399,LE MINERAL 1500ML,1,5000,0,5000,4042,958
8/3/2021 22:13,089686021219,INTER MIE GORENG,1,1000,0,1000,885,115
8/3/2021 22:14,8992702000063,INDOMILK COKLAT 370G,1,10000,0,10000,9020,980
8/3/2021 22:16,8998866202770,MIE SEDAAP SALERO PADANG,3,2500,0,7500,7086,414
8/3/2021 22:37,8998866501026,MINYAK GORENG SEDAAP POUCH 1 L,1,15000,0,15000,14110,890
8/3/2021 22:40,ROTI,ROTI 2000,1,2000,0,2000,1800,200
8/3/2021 22:41,ROTI,ROTI 2000,1,2000,0,2000,1800,200
8/3/2021 22:42,ROTI,ROTI 2000,1,2000,0,2000,1800,200
8/3/2021 22:43,8998866202770,MIE SEDAAP SALERO PADANG,1,2500,0,2500,2362,138
8/3/2021 22:43,089686010107,INDOMIE KALDU AYAM,1,2500,0,2500,2150,350
8/3/2021 22:48,8992761166052,FRESTEA MELATI 350ML,1,4500,0,4500,3000,1500
8/3/2021 22:49,8992775318201,GERY SNACK BANTAL COKLAT,1,2000,0,2000,1712,288
8/3/2021 22:50,8998866201452,POTABEE REGULER BBQ BEEF 35GR,1,5000,0,5000,4150,850
8/3/2021 22:52,8998866202732,MILKU STROBERI 200ML,1,3000,0,3000,2375,625
8/3/2021 22:53,8992761166205,FRESTEA GREEN HONEY 350ML,1,4500,0,4500,3000,1500
8/3/2021 23:02,TG APEL,TEH GELAS APEL,1,2000,0,2000,1178,822
8/3/2021 23:04,TG,TEH GELAS,1,1000,0,1000,729,271
8/3/2021 23:05,TG APEL,TEH GELAS APEL,1,2000,0,2000,1178,822
8/3/2021 23:05,8999999001179,LIFEBUOY BW COOLFRESH LD REFF 450 ML,1,25000,0,25000,22110,2890
8/3/2021 23:07,8999999571924,MOLTO PURE 1OML,1,5000,0,5000,4800,200
8/3/2021 23:09,8998989300261,GUDANG GARAM SURYA 12 FILTER,1,18500,0,18500,17200,1300
8/4/2021 11:54,8998866202237,NOODLE SEDAAP TASTY AYAM GEPREK 124 GR,1,5000,0,5000,4167,833
8/4/2021 16:27,089686021219,INTER MIE GORENG,2,1000,0,2000,1770,230
8/4/2021 17:57,8991188943536,SASA SANTAN KELAPA 65ML,2,3000,0,6000,4874,1126
8/4/2021 20:10,ARG,ARGUS 220ML,1,14500,0,14500,13300,1200
8/4/2021 20:11,8998009010569,ULTRA CHO 200,1,5000,0,5000,3830,1170
8/4/2021 20:12,8998866201841,GOLDA DOLCE LATTE 200ML,1,3000,0,3000,2500,500
8/4/2021 20:12,8998009040023,TEH KOTAK,1,5000,0,5000,2827,2173
8/4/2021 20:15,ROTI,ROTI 2000,4,2000,0,8000,7200,800
8/4/2021 20:16,ARG,ARGUS 220ML,1,14500,0,14500,13300,1200
8/4/2021 20:17,BB,PASEO SMARTY FACIAL TRAVEL PACK 50S GT,1,3000,0,3000,1980,1020
8/4/2021 20:21,8993470279651,JOGER CHOCKY BAR,3,1000,0,3000,2601,399
8/4/2021 20:22,8886001038011,BENG-BENG SCT,2,1500,0,3000,2900,100
8/4/2021 20:26,8996001302316,MALKIST ABON SCT,1,1000,0,1000,840,160
8/4/2021 20:30,8992959953037,SWEETY BRONZE L1,2,3000,0,6000,5342,658
8/4/2021 20:31,8998898853100,SUSU JAHE,1,1500,0,1500,1180,320
8/4/2021 20:32,8994834006128,TICTIC PEDAS,1,2000,0,2000,1700,300
8/4/2021 20:34,089686535044,SUN BERAS MERAH,1,8500,0,8500,7410,1090
8/4/2021 20:36,8996001355978,BENG-BENG SHARE IT 9.5G,1,10000,0,10000,8700,1300
8/4/2021 20:37,GL,GULA 1 LITER,2,11500,0,23000,21000,2000
8/4/2021 21:01,8992959508862,SWEETY SILVER PANTS M 8,1,16800,0,16800,15229,1571
8/4/2021 21:01,8998866203104,MIE SEDAAP SINGAPORE,4,2500,0,10000,9064,936
8/4/2021 21:01,8998989300261,GUDANG GARAM SURYA 12 FILTER,1,18500,0,18500,17200,1300
8/4/2021 21:24,089686021219,INTER MIE GORENG,2,1000,0,2000,1770,230
8/4/2021 21:24,8997028590014,ARGUS 220ML,2,500,0,1000,604,396
8/4/2021 21:25,8992759218046,JOLLY KLNR FCL CR LUNAK EMBOSS 10 ROLL,3,9000,0,27000,24225,2775
8/4/2021 21:25,gula,GULA,3,11500,0,34500,30000,4500
8/4/2021 21:33,8996001355978,BENG-BENG SHARE IT 9.5G,2,10000,0,20000,17400,2600
8/4/2021 21:33,089686010343,INDOMIE SOTO MIE,4,2600,0,10400,9468,932
8/4/2021 21:33,089686043051,INDOMIE COTO MAKASSAR,3,2800,0,8400,7575,825
8/4/2021 21:33,9556001004673,MILO NESTLE MALAYSIA ACTIVE GO,1,85000,0,85000,80000,5000
8/4/2021 21:33,8999999037765,PEPSODENT WHITE 225G,1,12000,0,12000,10750,1250
8/4/2021 21:33,8999999524722,SUNLIGHT LIME NEW PCH 435ML,1,10000,0,10000,9100,900
8/4/2021 21:33,8999999706661,PEPSODENT TB DBL CARE SENSITIVE,1,11500,0,11500,10400,1100
8/4/2021 21:33,8999999525590,PEPSODENT TB KIDS,1,12900,0,12900,11700,1200
8/4/2021 21:33,8998866805414,SOKLIN SMART SOFTERNER 800G & PIRING,1,20000,0,20000,18630,1370
8/4/2021 21:33,8999801700054,SUSU FOYU 1 KG,1,22000,0,22000,19791,2209
8/4/2021 21:33,8998866611237,FRES&NATURAL DARKBLUE 100ML,1,11500,0,11500,10310,1190
8/4/2021 21:33,8999999502393,ROYCO FDS CHICKEN 8G,1,5000,0,5000,4500,500
8/4/2021 21:34,8998866202466,JAPOTA HAPPY HONEY BUTTER,1,5000,0,5000,4150,850
8/4/2021 21:45,8999909002821,MARLBORO BLACK 16,1,22000,0,22000,20850,1150
8/4/2021 22:03,8998989300261,GUDANG GARAM SURYA 12 FILTER,1,18500,0,18500,17200,1300
8/4/2021 22:19,089686010824,INDOMIE GORENG SPESIAL,2,2700,0,5400,4904,496
8/4/2021 22:19,8998866200882,SUKSESMIE GORENG AYAM KRMS 133GR,2,3500,0,7000,6094,906
8/4/2021 22:51,GL,GULA 1 LITER,2,11500,0,23000,21000,2000
8/4/2021 22:52,8999999502393,ROYCO FDS CHICKEN 8G,1,5000,0,5000,4500,500
8/4/2021 22:54,089686021141,INTER MIE SOTO,2,1000,0,2000,1708,292
8/4/2021 22:55,8992696404441,BEAR BRAND 189ML,1,9000,0,9000,7887,1113
8/4/2021 23:08,8995333060772,TERIGU GATOT KACA 500GR,1,4500,0,4500,4065,435
8/4/2021 23:08,8995333032113,TERIGU GATOT KACA 1 KG,1,8500,0,8500,8012,488
8/4/2021 23:08,8998866501026,MINYAK GORENG SEDAAP POUCH 1 L,1,15000,0,15000,14110,890
8/4/2021 23:08,8994935000070,MINYAK DUNIA 450 ML,1,7500,0,7500,6779,721
8/4/2021 23:08,089686043051,INDOMIE COTO MAKASSAR,1,2800,0,2800,2525,275
8/4/2021 23:08,089686010824,INDOMIE GORENG SPESIAL,1,2700,0,2700,2452,248
8/4/2021 23:08,089686010343,INDOMIE SOTO MIE,1,2600,0,2600,2367,233
8/4/2021 23:08,8998866202770,MIE SEDAAP SALERO PADANG,3,2500,0,7500,7086,414
8/4/2021 23:08,8992628510158,SIMAS PALMIA,1,6000,0,6000,4832,1168
8/4/2021 23:08,8997027490018,LADAMAS MERICA BUBUK,1,9500,0,9500,8898,602
8/4/2021 23:15,8993072254018,MELROSE COTTON BUDS BSR,1,5000,0,5000,4050,950
8/5/2021 11:50,8992761166052,FRESTEA MELATI 350ML,1,4500,0,4500,3000,1500
8/5/2021 12:38,8998866105491,EMERON LOVELY SMOTH&BRIGHT 100ML,1,4300,0,4300,3800,500
8/5/2021 16:35,8992696523081,MILO UHT 110ML,2,2500,0,5000,3924,1076
8/5/2021 16:40,8992696422735,DNCO CKLT UHT 110ML,1,2500,0,2500,2041,459
8/5/2021 16:40,8994834006128,TICTIC PEDAS,1,2000,0,2000,1700,300
8/5/2021 17:43,8998989300261,GUDANG GARAM SURYA 12 FILTER,1,18500,0,18500,17200,1300
8/5/2021 17:43,8999909096004,SAMPOERNA 16 FILTER,1,24000,0,24000,23000,1000
8/5/2021 17:47,711844150027,ABC NANAS,2,13000,0,26000,24482,1518
8/5/2021 17:52,8998866203104,MIE SEDAAP SINGAPORE,4,2500,0,10000,9064,936
8/5/2021 18:19,8998866501026,MINYAK GORENG SEDAAP POUCH 1 L,1,15000,0,15000,14110,890
8/5/2021 18:31,8992761111533,SPRITE SLIM CAM250ML,3,5000,0,15000,11250,3750
8/5/2021 19:09,8999909982000,SAMPOERNA 12 FILTER,1,18000,0,18000,16000,2000
8/5/2021 19:09,6907992823942,JD JUJUBE,1,4500,0,4500,3800,700
8/5/2021 19:14,8992959020005,SWEETY SILVER PANTS XXL 5,1,16800,0,16800,15228,1572
8/5/2021 19:26,8993989311699,CLAS MILD 16 FILTER,1,23000,0,23000,21700,1300
8/5/2021 19:34,8991102714860,MILKIDO STRAW,1,3000,0,3000,2153,847
8/5/2021 20:06,8994867000162,ROKOK PUNDIMAS KRETEK16,1,10000,0,10000,8600,1400
8/5/2021 21:02,8999909002821,MARLBORO BLACK 16,1,22000,0,22000,20850,1150
8/5/2021 21:16,8994867000162,ROKOK PUNDIMAS KRETEK16,1,10000,0,10000,8600,1400
8/5/2021 21:17,8992959953037,SWEETY BRONZE L1,2,3000,0,6000,5342,658
8/5/2021 21:17,YP,YUPI,2,250,0,500,416,84
8/5/2021 21:17,MILKITA,MILKITA,2,250,0,500,400,100
8/5/2021 21:44,ARG,ARGUS 220ML,1,14500,0,14500,13300,1200
8/5/2021 21:44,089686010824,INDOMIE GORENG SPESIAL,1,2700,0,2700,2452,248
8/5/2021 21:44,6907992823645,JD COCONUT BLISS,1,4000,0,4000,3500,500
8/5/2021 21:55,8991002122000,ABC CHOCO MALT COFFE,1,3000,0,3000,2278,722
8/5/2021 22:20,8992628510158,SIMAS PALMIA,1,6000,0,6000,4832,1168
8/5/2021 22:20,8995333032113,TERIGU GATOT KACA 1 KG,1,8500,0,8500,8012,488
8/5/2021 22:20,MENTOS,MENTOS,2,250,0,500,350,150
8/5/2021 22:26,8997027300089,NOMOS,1,4000,0,4000,2963,1037
8/5/2021 22:26,8998989300261,GUDANG GARAM SURYA 12 FILTER,1,18500,0,18500,17200,1300
8/5/2021 22:26,8994867007161,ROKOK PENA GOLD 20,1,17000,0,17000,15500,1500
8/6/2021 10:39,8998898847109,KOPI JAHE,2,1500,0,3000,2360,640
8/6/2021 10:39,8991002103238,GOOD DAY MOCACINNO,1,1500,0,1500,890,610
8/6/2021 11:30,HT,HOT-HOT,8,500,0,4000,2800,1200
8/6/2021 11:30,VTM,VITAMIN,10,500,0,5000,4250,750
8/6/2021 11:30,GGK,PLAYGUM PERMEN KARET,12,500,0,6000,4800,1200
8/6/2021 11:30,MBL,MOBIL,1,5000,0,5000,3500,1500
8/6/2021 11:30,123124,KOREK BIASA,2,2000,0,4000,2600,1400
8/6/2021 11:30,ROTI,ROTI 2000,9,2000,0,18000,16200,1800
8/6/2021 11:30,8992959508862,SWEETY SILVER PANTS M 8,1,16800,0,16800,15229,1571
8/6/2021 11:30,8992959953037,SWEETY BRONZE L1,2,3000,0,6000,5342,658
8/6/2021 11:30,8991102714846,MILKIDO CKLT,2,3000,0,6000,4306,1694
8/6/2021 11:30,8998866202770,MIE SEDAAP SALERO PADANG,5,2500,0,12500,11810,690
8/6/2021 11:30,8998866200882,SUKSESMIE GORENG AYAM KRMS 133GR,2,3500,0,7000,6094,906
8/6/2021 11:30,ARG,ARGUS 220ML,2,14500,0,29000,26600,2400
8/6/2021 11:30,8999909002821,MARLBORO BLACK 16,1,22000,0,22000,20850,1150
8/6/2021 11:30,8991102714860,MILKIDO STRAW,2,3000,0,6000,4306,1694
8/6/2021 11:30,8992775311325,GERY SNACK&SEREAL 100G,1,7000,0,7000,6012,988
8/6/2021 11:30,8886013213208,FRENCH FREIS 2000,2,5000,0,10000,7500,2500
8/6/2021 11:30,8994834003752,TICTIC,3,2000,0,6000,5100,900
8/6/2021 11:30,8996001600399,LE MINERAL 1500ML,1,5000,0,5000,4042,958
8/6/2021 11:30,8992959953327,SWEETY BRONZE L52,1,85000,0,85000,80304,4696
8/6/2021 11:30,BALON,BALON CABUT,3,1000,0,3000,2700,300
8/6/2021 11:30,RT 1000,ROTI 1000,1,1000,0,1000,800,200
8/6/2021 11:30,8993470671752,JOGER STICK DUO KACANG,2,1000,0,2000,1700,300
8/6/2021 11:30,8992959508930,SWEETY SILVER PANTS L 54,1,108000,0,108000,99697,8303
8/6/2021 11:30,8992694246340,ZWITSAL SHP NAT AVKS 100ML,1,11800,0,11800,10395,1405
8/6/2021 11:30,COKLAT,COKLAT COIN,1,500,0,500,425,75
8/6/2021 11:30,MENTOS,MENTOS,2,250,0,500,350,150
8/6/2021 11:30,GL,GULA 1 LITER,2,11500,0,23000,21000,2000
8/6/2021 11:30,8992628022156,BIMOLI KLASIK TOUCH 1 LT,1,16000,0,16000,14350,1650
8/6/2021 11:30,8991102384841,WFR TANGO LONG CKLT 130G,1,5000,0,5000,4345,655
8/6/2021 11:30,8991102989381,TANGO LONG BUBBLEGUM 130G,1,5000,0,5000,4345,655
8/6/2021 11:30,8991102300421,WFR TANGO COKLAT 176GR,1,10000,0,10000,8694,1306
8/6/2021 11:30,8993001003908,INDOMILK KENTAL MANIS 545G,1,15000,0,15000,13333,1667
8/6/2021 11:30,8998989500166,GUDANG GARAM MERAH BESAR 16KS,1,18000,0,18000,17000,1000
8/6/2021 11:30,MILKITA,MILKITA,8,250,0,2000,1600,400
8/6/2021 11:30,8997012321174,CHILLI-QU,4,1000,0,4000,3200,800
8/6/2021 11:30,JL,JELLY,4,500,0,2000,1600,400
8/6/2021 11:30,TG,TEH GELAS,1,1000,0,1000,729,271
8/6/2021 11:30,MARS,MARSHMELLOW,1,500,0,500,433,67
8/6/2021 11:30,8992959508312,SWEETY SILVER PANTS XL RTG,1,15500,0,15500,13944,1556
8/6/2021 11:30,089686021219,INTER MIE GORENG,1,1000,0,1000,885,115
8/6/2021 11:30,089686021141,INTER MIE SOTO,1,1000,0,1000,854,146
8/6/2021 11:30,8999909000377,SAMPOERNA AVOLUTION,1,30000,0,30000,28450,1550
8/6/2021 11:30,8994867007161,ROKOK PENA GOLD 20,1,17000,0,17000,15500,1500
8/6/2021 11:30,8992959953310,SWEETY BRONZE M58,1,85000,0,85000,80304,4696
8/6/2021 11:30,8998866501026,MINYAK GORENG SEDAAP POUCH 1 L,2,15000,0,30000,28220,1780
8/6/2021 11:30,8994867000162,ROKOK PUNDIMAS KRETEK16,2,10000,0,20000,17200,2800
8/6/2021 11:30,8993058304201,BEJO JAHE MERAH,2,3000,0,6000,3786,2214
8/6/2021 11:30,8991002103238,GOOD DAY MOCACINNO,1,1500,0,1500,890,610
8/6/2021 11:30,TG APEL,TEH GELAS APEL,2,2000,0,4000,2356,1644
8/6/2021 11:30,8994834006128,TICTIC PEDAS,4,2000,0,8000,6800,1200
8/6/2021 11:30,8992696523067,MILO ACTVGO UHT 180ML,1,4500,0,4500,3515,985
8/6/2021 11:30,8991102281416,PERMEN MINTZ PPMINT,2,5000,0,10000,8000,2000
8/6/2021 11:30,RT ISI 6,ROTI ISI 6,1,6000,0,6000,5000,1000
8/6/2021 11:30,8998866804516,GIV LEMON KOTAK 76G,1,2000,0,2000,1820,180
8/6/2021 11:30,8992775001691,GARUDA ROSTA WAGYU BEEF,1,8000,0,8000,7322,678
8/6/2021 11:30,8998989300261,GUDANG GARAM SURYA 12 FILTER,2,18500,0,37000,34400,2600
8/6/2021 11:30,089686017748,SARIMIE GORENG ISI 2,3,3500,0,10500,9360,1140
8/6/2021 11:30,8996001440124,ENERGEN VANILA,3,1500,0,4500,3450,1050
8/6/2021 11:30,8998866200837,NOODLE SEDAAPMIE SOTO CUP 81 GR,1,4500,0,4500,3650,850
8/6/2021 11:30,8998009020186,BUAVITA GUAVA 250ML,1,7000,0,7000,6083,917
8/6/2021 11:30,8991102987875,WFR TANGO POUCH CKL 115G,1,8000,0,8000,6786,1214
8/6/2021 11:30,8999909982000,SAMPOERNA 12 FILTER,1,18000,0,18000,16000,2000
8/6/2021 11:30,8998866202671,NOODLE SEDAAP MIE KOREAN SPICY SOUP CUP,1,5000,0,5000,4002,998
8/6/2021 11:30,089686611878,QTELA TEMPE,1,6000,0,6000,5370,630
8/6/2021 11:30,089686043051,INDOMIE COTO MAKASSAR,2,2800,0,5600,5050,550
8/6/2021 11:30,8997013790108,BIMURA KACANG TELUR 25G,2,1000,0,2000,1750,250
8/6/2021 11:30,711844610095,LARISSA UDANG 500 GR,2,11000,0,22000,19580,2420
8/6/2021 11:30,8999909001909,MAGNUM REVAMP BLACK 12,1,18000,0,18000,16300,1700
8/6/2021 11:30,8991002105409,KOPI KAPAL API,1,20000,0,20000,18888,1112
8/6/2021 11:30,8991002114067,PIKOPI,1,1000,0,1000,545,455
8/6/2021 11:30,8991002122000,ABC CHOCO MALT COFFE,1,3000,0,3000,2278,722
8/6/2021 11:30,8996001600269,LE MINERAL 600ML,2,3000,0,6000,3376,2624
8/6/2021 11:30,TG MARKISA,TEH GELAS MARKISA,1,2000,0,2000,1178,822
8/6/2021 11:30,KOPIKO,KOPIKO,2,250,0,500,350,150
8/6/2021 11:30,8996001318430,BETTER 1000,1,1000,0,1000,820,180
8/6/2021 11:30,8998866613262,SUKSESMIE SOTO 111 GR,2,3500,0,7000,5540,1460
8/6/2021 11:30,8996001302316,MALKIST ABON SCT,3,1000,0,3000,2520,480
8/6/2021 11:30,8999999059309,LIFEBUOY TS TOTAL 10 DG 75G,1,3000,0,3000,2640,360
8/6/2021 11:30,8993379200879,SABUN HARMONY MELON 70G,1,2000,0,2000,1652,348
8/6/2021 11:30,089686043204,INDOMIE MIE ACEH,2,2700,0,5400,4904,496
8/6/2021 11:30,8996001355237,SUPER STAR,1,11000,0,11000,9900,1100
8/6/2021 11:30,8992702000018,INDOMILK PUTIH 370G,1,10000,0,10000,9020,980
8/6/2021 11:30,8998866202732,MILKU STROBERI 200ML,1,3000,0,3000,2375,625
8/6/2021 11:30,RT MNTG,ROTI SISIR MENTEGA,1,2000,0,2000,1600,400
8/6/2021 11:30,8999999524722,SUNLIGHT LIME NEW PCH 435ML,1,10000,0,10000,9100,900
8/6/2021 11:30,001,PASEO SMART FACIAL SF 250S GT,1,10000,0,10000,9500,500
8/6/2021 11:30,8992761166212,FRESTEA APPLE 350ML,1,4500,0,4500,3000,1500
8/6/2021 11:30,089686834055,FREISS JERUK,1,11000,0,11000,8750,2250
8/6/2021 11:30,8992742360844,POLYTEX SABUT STENLESS,1,4000,0,4000,2200,1800
8/6/2021 11:30,8998866203104,MIE SEDAAP SINGAPORE,4,2500,0,10000,9064,936
8/6/2021 11:30,8998866609487,SOKLIN SOFTERGEN 280G,1,5000,0,5000,4425,575
8/6/2021 11:30,8999999195656,SARI WANGI 50X1.85,1,10000,0,10000,9500,500
8/6/2021 11:30,089686067002,POP MIE PDS DOWER RS AYAM,1,5000,0,5000,4450,550
8/6/2021 11:30,8992761002039,FANTA STRAWBERRY PET 390 ML,1,5500,0,5500,4300,1200
8/6/2021 11:30,8992761002022,SPRITE PET 390ML,1,5500,0,5500,4300,1200
8/6/2021 11:58,8992775002933,GERY MALKIST DOUBLE ABON,1,6500,0,6500,5516,984
8/6/2021 11:58,8992761166205,FRESTEA GREEN HONEY 350ML,1,4500,0,4500,3000,1500
8/6/2021 12:11,8992761164478,FRESTEA MILK TEA,1,8000,0,8000,6575,1425
8/6/2021 12:11,JL,JELLY,4,500,0,2000,1600,400
8/6/2021 12:15,8991909101016,URBAN MILD 16,1,17000,0,17000,15800,1200
8/6/2021 12:15,123124,KOREK BIASA,1,2000,0,2000,1300,700
8/6/2021 12:41,8999999042592,RINSO MOLTO PERFUME ESSENSE LIQ 4OML,1,6000,0,6000,4817,1183
8/6/2021 12:41,8998009010569,ULTRA CHO 200,1,5000,0,5000,3830,1170
8/6/2021 13:16,8998989500166,GUDANG GARAM MERAH BESAR 16KS,1,18000,0,18000,17000,1000
8/6/2021 13:16,MILKITA,MILKITA,8,250,0,2000,1600,400
8/6/2021 13:22,8994867000162,ROKOK PUNDIMAS KRETEK16,1,10000,0,10000,8600,1400
8/6/2021 13:22,GGK,PLAYGUM PERMEN KARET,2,500,0,1000,800,200
8/6/2021 13:51,8999999049409,REXONA MEN ICE COOL 45 ML,1,15000,0,15000,13550,1450
8/6/2021 13:51,8992761139018,ADES 600ML,1,3500,0,3500,2292,1208
8/6/2021 13:54,8991188943536,SASA SANTAN KELAPA 65ML,2,3000,0,6000,4874,1126
8/6/2021 14:00,GL,GULA 1 LITER,3,11500,0,34500,31500,3000
8/6/2021 14:12,8998898830125,KKB ENER-G ANGGUR,1,5500,0,5500,4824,676
8/6/2021 14:12,8997013790108,BIMURA KACANG TELUR 25G,2,1000,0,2000,1750,250
8/6/2021 14:12,089686067002,POP MIE PDS DOWER RS AYAM,1,5000,0,5000,4450,550
8/6/2021 14:17,COKLAT,COKLAT COIN,2,500,0,1000,850,150
8/6/2021 14:17,JGR SHN,JOGER SHINY SACHET,1,500,0,500,437,63
8/6/2021 14:17,JL,JELLY,1,500,0,500,400,100
8/6/2021 14:41,8993989311699,CLAS MILD 16 FILTER,1,23000,0,23000,21700,1300
8/6/2021 15:38,089686021141,INTER MIE SOTO,5,1000,0,5000,4270,730
8/6/2021 15:38,6907992825076,JD WATERMELON APPLE,5,2000,0,10000,8500,1500
8/6/2021 15:38,6907992824963,JD MILKY CHOCOLATE,1,3000,0,3000,2600,400
8/6/2021 16:08,ARG,ARGUS 220ML,4,14500,0,58000,53200,4800
8/6/2021 16:21,ROTI,ROTI 2000,2,2000,0,4000,3600,400
8/6/2021 17:10,8992696404441,BEAR BRAND 189ML,2,9000,0,18000,15774,2226
8/6/2021 17:10,8997009510123,ORANGE WATER,1,7000,0,7000,6089,911
8/6/2021 17:10,8998989300261,GUDANG GARAM SURYA 12 FILTER,1,18500,0,18500,17200,1300
8/6/2021 17:46,8997018720018,SIRUP DHT,1,23000,0,23000,20958,2042
8/6/2021 17:46,8998866202671,NOODLE SEDAAP MIE KOREAN SPICY SOUP CUP,1,5000,0,5000,4002,998
8/6/2021 17:57,8996001600269,LE MINERAL 600ML,1,3000,0,3000,1688,1312
8/6/2021 17:57,8886013257400,TWISTKO,1,1000,0,1000,900,100
8/6/2021 17:57,ROTI,ROTI 2000,1,2000,0,2000,1800,200
8/6/2021 17:57,8996001600375,LE MINERAL 330ML,1,2000,0,2000,1417,583
8/6/2021 17:57,GGK,PLAYGUM PERMEN KARET,1,500,0,500,400,100
8/6/2021 18:36,8992696523081,MILO UHT 110ML,1,2500,0,2500,1962,538
8/6/2021 18:36,8994834006128,TICTIC PEDAS,2,2000,0,4000,3400,600
8/6/2021 18:36,8992696422735,DNCO CKLT UHT 110ML,1,3000,0,3000,2041,959
8/6/2021 18:36,089686021219,INTER MIE GORENG,3,1000,0,3000,2655,345
8/6/2021 18:36,TG MARKISA,TEH GELAS MARKISA,1,2000,0,2000,1178,822
8/6/2021 19:35,8999999706661,PEPSODENT TB DBL CARE SENSITIVE,3,11500,0,34500,31200,3300
8/6/2021 19:35,76164217,MARLBORO MERAH,1,30000,0,30000,27700,2300
8/6/2021 19:35,8999999706661,PEPSODENT TB DBL CARE SENSITIVE,3,11500,0,34500,31200,3300
8/6/2021 19:37,089686043051,INDOMIE COTO MAKASSAR,1,2800,0,2800,2525,275
8/6/2021 19:37,8991102022460,FORMULA DIAMOND,1,3000,0,3000,2500,500
8/6/2021 19:37,8999999520151,PEPSODENT TB FAMILY SOFT,2,2500,0,5000,3800,1200
8/6/2021 19:37,8991102020305,FORMULA TRIPLE ACTION,1,3000,0,3000,2500,500
8/6/2021 19:37,089686010107,INDOMIE KALDU AYAM,2,2500,0,5000,4300,700
8/6/2021 19:37,089686043273,INDOMIE SAMBAL RICA,3,2700,0,8100,7356,744
8/6/2021 19:37,8991188943062,SASA 250G,1,10000,0,10000,8500,1500
8/6/2021 19:37,GL,GULA 1 LITER,1,11500,0,11500,10500,1000
8/6/2021 19:45,8998898847109,KOPI JAHE,5,1500,0,7500,5900,1600
8/6/2021 19:45,GGK,PLAYGUM PERMEN KARET,1,500,0,500,400,100
8/6/2021 20:02,8993989311699,CLAS MILD 16 FILTER,1,23000,0,23000,21700,1300
8/6/2021 20:02,089686021127,INTER MIE KALDU,1,1000,0,1000,813,187
8/6/2021 20:20,76239878,MARLBORO GOLD,1,30000,0,30000,27700,2300
8/6/2021 20:22,8992761166038,MMP ORANGE 300ML,3,5000,0,15000,11250,3750
8/6/2021 20:22,8992761111519,COCA COLA SLIM CAM 250ML,1,5000,0,5000,3750,1250
8/6/2021 20:34,8996001600399,LE MINERAL 1500ML,1,5000,0,5000,4042,958
8/6/2021 21:44,8995333032113,TERIGU GATOT KACA 1 KG,2,8500,0,17000,16024,976
8/6/2021 21:44,8994935000070,MINYAK DUNIA 450 ML,1,7500,0,7500,6779,721
8/6/2021 21:44,8998866501026,MINYAK GORENG SEDAAP POUCH 1 L,1,15000,0,15000,14110,890
8/6/2021 21:44,GL,GULA 1 LITER,1,11500,0,11500,10500,1000
8/6/2021 21:58,8992959953174,SWEETY BRONZE M34+2,1,58000,0,58000,53182,4818
8/6/2021 21:58,8992775002582,DILAN CHOCO,1,2000,0,2000,1503,497
8/6/2021 21:58,ARG,ARGUS 220ML,1,14500,0,14500,13300,1200
8/6/2021 21:58,8999909000544,MARLBORO F BLACK,1,29000,0,29000,27800,1200
8/6/2021 21:58,8992696404441,BEAR BRAND 189ML,1,9000,0,9000,7887,1113
8/6/2021 22:22,9556001025272,NESCAFE LATTE 240ML,1,8500,0,8500,7834,666
8/6/2021 22:22,8996001600399,LE MINERAL 1500ML,1,5000,0,5000,4042,958
8/6/2021 22:51,8991102714846,MILKIDO CKLT,1,3000,0,3000,2153,847
8/6/2021 22:51,ROTI,ROTI 2000,3,2000,0,6000,5400,600
8/6/2021 22:51,8992761164546,NUTRIBOOST STRAWBERRY 300ML,1,6500,0,6500,5300,1200
8/7/2021 9:34,8999909010567,234 DJI SAM SOE 16,2,22000,0,44000,43000,1000
8/7/2021 9:34,8999909096004,SAMPOERNA 16 FILTER,2,24000,0,48000,46000,2000
8/7/2021 9:39,8992696422735,DNCO CKLT UHT 110ML,1,3000,0,3000,2041,959
8/7/2021 9:39,8994834006128,TICTIC PEDAS,1,2000,0,2000,1700,300
8/7/2021 10:02,8996001338056,TAMARIN,1,6000,0,6000,5100,900
8/7/2021 10:40,8992761139018,ADES 600ML,1,3500,0,3500,2292,1208
8/7/2021 10:40,8992761166205,FRESTEA GREEN HONEY 350ML,1,4500,0,4500,3000,1500
8/7/2021 10:43,8998989110167,SURYA GUDANG GARAM 16 FILTER,1,25000,0,25000,23200,1800
8/7/2021 10:44,8996001338056,TAMARIN,1,6000,0,6000,5100,900
8/7/2021 10:52,8998866610261,DAIA VIOLET GUSSET BAG 290 GR,1,5000,0,5000,4450,550
8/7/2021 10:53,8998989100120,GUDANG GARAM MINI,1,18000,0,18000,16600,1400
8/7/2021 11:21,8992979130012,TOTAL LEMON SOFTENER,1,13000,0,13000,11532,1468
8/7/2021 11:21,ROTI,ROTI 2000,1,2000,0,2000,1800,200
8/7/2021 11:21,GL,GULA 1 LITER,4,11500,0,46000,42000,4000
8/7/2021 12:09,6907992825076,JD WATERMELON APPLE,1,2000,0,2000,1700,300
8/7/2021 12:09,HT,HOT-HOT,2,500,0,1000,700,300
8/7/2021 12:10,8992696404441,BEAR BRAND 189ML,2,9000,0,18000,15774,2226
8/7/2021 12:17,8997009510123,ORANGE WATER,3,7000,0,21000,18267,2733
8/7/2021 12:17,8998866501026,MINYAK GORENG SEDAAP POUCH 1 L,1,15000,0,15000,14110,890
8/7/2021 12:17,VCO,VITAMIN C500 ORANGE,5,1000,0,5000,2875,2125
8/7/2021 12:38,8992761166205,FRESTEA GREEN HONEY 350ML,1,4500,0,4500,3000,1500
8/7/2021 12:38,089686043204,INDOMIE MIE ACEH,1,2700,0,2700,2452,248
8/7/2021 12:38,YP,YUPI,1,250,0,250,208,42
8/7/2021 12:43,9556001025272,NESCAFE LATTE 240ML,1,8500,0,8500,7834,666
8/7/2021 12:43,8999908389008,HEMAVITON C1000,1,8000,0,8000,6000,2000
8/7/2021 12:43,8991102320184,TANGO CHOCO JAVAMOCCA,1,5000,0,5000,4330,670
8/7/2021 12:43,ROTI,ROTI 2000,1,2000,0,2000,1800,200
8/7/2021 12:43,8998009020186,BUAVITA GUAVA 250ML,1,7000,0,7000,6083,917
8/7/2021 12:54,8993989311279,CLAS MILD 12,1,17000,0,17000,15700,1300
8/7/2021 13:15,8993989311279,CLAS MILD 12,2,17000,0,34000,31400,2600
8/7/2021 14:54,8999909982000,SAMPOERNA 12 FILTER,1,18000,0,18000,16000,2000
8/7/2021 15:20,8998866201841,GOLDA DOLCE LATTE 200ML,1,3000,0,3000,2500,500
8/7/2021 15:20,ROTI,ROTI 2000,4,2000,0,8000,7200,800
8/7/2021 15:44,8993007001359,INDOMILK KM SCT 37G,4,1500,0,6000,4332,1668
8/7/2021 17:10,8996001600399,LE MINERAL 1500ML,1,5000,0,5000,4042,958
8/7/2021 17:52,8998989300261,GUDANG GARAM SURYA 12 FILTER,1,18500,0,18500,17200,1300
8/7/2021 17:52,8992752112013,MIZONE,4,5000,0,20000,15200,4800
8/7/2021 17:52,8992761111540,FANTA STRAWBERY SLIM CAM 250ML,2,5000,0,10000,7500,2500
8/7/2021 17:52,8992761111533,SPRITE SLIM CAM250ML,1,5000,0,5000,3750,1250
8/7/2021 17:52,8886013213208,FRENCH FREIS 2000,1,5000,0,5000,3750,1250
8/7/2021 17:52,8996001301562,MALKIST TABUR KELAPA,1,1000,0,1000,820,180
8/7/2021 17:52,8992761002022,SPRITE PET 390ML,1,5500,0,5500,4300,1200
8/7/2021 17:52,8996001600399,LE MINERAL 1500ML,1,5000,0,5000,4042,958
8/7/2021 18:29,GGK,PLAYGUM PERMEN KARET,4,500,0,2000,1600,400
8/7/2021 19:00,8992628022156,BIMOLI KLASIK TOUCH 1 LT,1,16000,0,16000,14350,1650
8/7/2021 19:01,8999909096004,SAMPOERNA 16 FILTER,1,24000,0,24000,23000,1000
8/7/2021 19:18,8999909096004,SAMPOERNA 16 FILTER,1,24000,0,24000,23000,1000
8/7/2021 19:23,8998866608718,DAIA SOFTENER PINK,1,5000,0,5000,4450,550
8/7/2021 19:25,8994867000162,ROKOK PUNDIMAS KRETEK16,1,10000,0,10000,8600,1400
8/7/2021 20:22,8999999529284,MOLTO EDP FRENCH LILY SC 10ML,2,5500,0,11000,9600,1400
8/7/2021 20:26,COKLAT,COKLAT COIN,12,500,0,6000,5100,900
8/7/2021 20:28,8992957220025,GOLDEN CITY MINI,1,3000,0,3000,2500,500
8/7/2021 20:38,8992775203422,GARUDA ROSTA OVEN 100G,1,8000,0,8000,7322,678
8/7/2021 20:39,GL,GULA 1 LITER,1,11500,0,11500,10500,1000
8/7/2021 21:06,8999999036638,LUX VELVET JAMINE 75G,3,3500,0,10500,8400,2100
8/7/2021 21:09,8992761166212,FRESTEA APPLE 350ML,1,4500,0,4500,3000,1500
8/7/2021 21:16,GL,GULA 1 LITER,1,11500,0,11500,10500,1000
8/7/2021 21:16,8998989500166,GUDANG GARAM MERAH BESAR 16KS,1,18000,0,18000,17000,1000
8/7/2021 21:28,089686611670,QTELA BALADO,1,5000,0,5000,4266,734
8/7/2021 21:33,8992388133017,NU MILK TEA ORI 330ML,1,6000,0,6000,5125,875
8/7/2021 21:35,8998989300261,GUDANG GARAM SURYA 12 FILTER,1,18500,0,18500,17200,1300
8/7/2021 21:47,8998009020186,BUAVITA GUAVA 250ML,1,7000,0,7000,6083,917
8/7/2021 21:47,8996001600375,LE MINERAL 330ML,1,2000,0,2000,1417,583
8/7/2021 21:53,8996001600399,LE MINERAL 1500ML,4,5000,0,20000,16168,3832
8/7/2021 21:54,8999909002821,MARLBORO BLACK 16,1,22000,0,22000,20850,1150
8/7/2021 22:04,8719200177314,BLUE BAND 15G,1,2000,0,2000,1500,500
8/7/2021 22:04,RT MENARA,ROTI TAWAR MENARA,1,8000,0,8000,7200,800
8/7/2021 22:04,8992696404441,BEAR BRAND 189ML,1,9000,0,9000,7887,1113
8/7/2021 22:07,8999909096004,SAMPOERNA 16 FILTER,1,24000,0,24000,23000,1000
8/8/2021 10:16,8996001354001,KALPA SCT,1,2000,0,2000,1666,334
8/8/2021 10:18,8992696523081,MILO UHT 110ML,2,2500,0,5000,3924,1076
8/8/2021 10:18,8992696422735,DNCO CKLT UHT 110ML,1,3000,0,3000,2041,959
8/8/2021 10:18,8886013213208,FRENCH FREIS 2000,1,5000,0,5000,3750,1250
8/8/2021 10:24,089686386011,BUMBU RACIK NASI GORENG,1,2000,0,2000,1450,550
8/8/2021 10:24,8997025914059,HATARI SEE HONG,1,6000,0,6000,4911,1089
8/8/2021 10:27,8999999059323,LIFEBUOY TS LEMONFRESH 75G,2,3000,0,6000,5280,720
8/8/2021 10:33,8992959953020,SWEETY BRONZE M1,1,3000,0,3000,2671,329
8/8/2021 10:38,8999909002876,SAMPOERNA ULTRAMILD 12,1,17000,0,17000,14600,2400
8/8/2021 10:41,8999999195656,SARI WANGI 50X1.85,1,10000,0,10000,9500,500
8/8/2021 10:42,8998866202770,MIE SEDAAP SALERO PADANG,2,2500,0,5000,4724,276
8/8/2021 10:48,8992388133345,NU MILK TEA TEH TARIK 330ML,1,6000,0,6000,5125,875
8/8/2021 10:48,8998866202923,FLORIDINA COCO,2,3000,0,6000,5000,1000
8/8/2021 11:00,8999909096004,SAMPOERNA 16 FILTER,1,24000,0,24000,23000,1000
8/8/2021 11:00,8992761166205,FRESTEA GREEN HONEY 350ML,1,4500,0,4500,3000,1500
8/8/2021 11:01,8992959117583,SFX DS REG FLOW WING 20,1,5000,0,5000,4288,712
8/8/2021 11:49,ARG,ARGUS 220ML,1,14500,0,14500,13300,1200
8/8/2021 11:50,8999909002821,MARLBORO BLACK 16,1,22000,0,22000,20850,1150
8/8/2021 11:52,AMPLOP,AMPLOP,4,250,0,1000,560,440
8/8/2021 11:53,AMPLOP,AMPLOP,8,250,0,2000,1120,880
8/8/2021 11:54,8997025914059,HATARI SEE HONG,1,6000,0,6000,4911,1089
8/8/2021 11:55,8992736424293,SASA BUMBU NASI GORENG 20G,1,2000,0,2000,1136,864
8/8/2021 11:57,8999999558079,RINSO MOLTO ROSE FRESH PWD 44G,1,1000,0,1000,805,195
8/8/2021 12:00,8999999558079,RINSO MOLTO ROSE FRESH PWD 44G,4,1000,0,4000,3220,780
8/8/2021 12:07,8996001600375,LE MINERAL 330ML,19,2000,0,38000,26923,11077
8/8/2021 12:18,8992959117613,SFX DAUN SIRIH 1 WP,1,500,0,500,413,87
8/8/2021 12:28,TG APEL,TEH GELAS APEL,1,2000,0,2000,1178,822
8/8/2021 12:33,8992775318201,GERY SNACK BANTAL COKLAT,1,2000,0,2000,1712,288
8/8/2021 12:33,8994834005923,SPIX 1000,1,1000,0,1000,850,150
8/8/2021 12:33,8992761139018,ADES 600ML,1,3500,0,3500,2292,1208
8/8/2021 12:34,TG APEL,TEH GELAS APEL,1,2000,0,2000,1178,822
8/8/2021 12:45,8991909101016,URBAN MILD 16,1,17000,0,17000,15800,1200
8/8/2021 13:02,089686060102,POP MIE PEDE GLEDEEK,3,5000,0,15000,13350,1650
8/8/2021 13:09,8999909010567,234 DJI SAM SOE 16,1,22000,0,22000,21500,500
8/8/2021 13:29,ff,FULLO BLASTO,1,1000,0,1000,995,5
8/8/2021 13:56,8993274532082,BULO COKLAT,1,1000,0,1000,833,167
8/8/2021 14:01,8994834005923,SPIX 1000,2,1000,0,2000,1700,300
8/8/2021 14:01,8994834001901,SUKI,1,1000,0,1000,761,239
8/8/2021 14:01,8992696422735,DNCO CKLT UHT 110ML,1,3000,0,3000,2041,959
8/8/2021 15:46,8992775311325,GERY SNACK&SEREAL 100G,1,7000,0,7000,6012,988
8/8/2021 15:46,8992761164546,NUTRIBOOST STRAWBERRY 300ML,1,6500,0,6500,5300,1200
8/8/2021 15:55,089686043051,INDOMIE COTO MAKASSAR,1,2800,0,2800,2525,275
8/8/2021 15:55,089686021141,INTER MIE SOTO,12,1000,0,12000,10248,1752
8/8/2021 15:57,089686021141,INTER MIE SOTO,2,1000,0,2000,1708,292
8/8/2021 15:57,089686043051,INDOMIE COTO MAKASSAR,1,2800,0,2800,2525,275
8/8/2021 16:11,8998989110167,SURYA GUDANG GARAM 16 FILTER,1,25000,0,25000,23200,1800
8/8/2021 16:11,089686010824,INDOMIE GORENG SPESIAL,4,2700,0,10800,9808,992
8/8/2021 16:11,089686060362,POP MIE SOTO AYAM JUMBO,1,4500,0,4500,3833,667
8/8/2021 16:21,8992761002015,COCA COLA PET 390ML,2,5500,0,11000,8666,2334
8/8/2021 16:21,8998866679572,SOKLIN LANTAI MERAH 780ML,1,12000,0,12000,10020,1980
8/8/2021 17:07,8991102384841,WFR TANGO LONG CKLT 130G,1,5000,0,5000,4345,655
8/8/2021 17:07,ROTI,ROTI 2000,2,2000,0,4000,3600,400
8/8/2021 17:07,KRZ,KREZZ COKELAT,1,1000,0,1000,715,285
8/8/2021 17:37,8998989110167,SURYA GUDANG GARAM 16 FILTER,1,25000,0,25000,23200,1800
8/8/2021 17:51,8998989110167,SURYA GUDANG GARAM 16 FILTER,1,25000,0,25000,23200,1800
8/8/2021 18:06,RT BAKPIA,ROTI BAKPIA,1,1000,0,1000,750,250
8/8/2021 18:07,8992388133017,NU MILK TEA ORI 330ML,1,6000,0,6000,5125,875
8/8/2021 18:20,8998866611718,EKONOMI PENCUCI PIRING  LIQ 780ML,1,12000,0,12000,10900,1100
8/8/2021 18:33,ARG,ARGUS 220ML,1,14500,0,14500,13300,1200
8/8/2021 18:33,8999909096004,SAMPOERNA 16 FILTER,1,24000,0,24000,23000,1000
8/8/2021 18:33,8996001355237,SUPER STAR,1,11000,0,11000,9900,1100
8/8/2021 18:50,8991689668006,SWALLOW,1,3500,0,3500,3500,0
8/8/2021 18:54,089686067002,POP MIE PDS DOWER RS AYAM,1,5000,0,5000,4450,550
8/8/2021 18:54,8991002121003,GOOD DAY TIRAMISU BLISS,1,6000,0,6000,4295,1705
8/8/2021 19:11,711844340008,ABC TERASI,1,7000,0,7000,5800,1200
8/8/2021 19:29,ROTI,ROTI 2000,1,2000,0,2000,1800,200
8/8/2021 20:05,8994867000162,ROKOK PUNDIMAS KRETEK16,1,10000,0,10000,8600,1400
8/8/2021 21:33,8995333060772,TERIGU GATOT KACA 500GR,1,4500,0,4500,4065,435
8/8/2021 21:33,8995333032113,TERIGU GATOT KACA 1 KG,1,8500,0,8500,8012,488
8/8/2021 21:33,MA,MALKIST ABON,1,9000,0,9000,8400,600
8/8/2021 21:36,8998989300261,GUDANG GARAM SURYA 12 FILTER,1,18500,0,18500,17200,1300
8/8/2021 21:39,6907992823669,JD MILKY STRAW,2,3000,0,6000,5200,800
8/8/2021 22:09,RT MENARA,ROTI TAWAR MENARA,1,8000,0,8000,7200,800
8/8/2021 22:27,089686010343,INDOMIE SOTO MIE,1,2600,0,2600,2367,233
8/8/2021 22:27,089686010824,INDOMIE GORENG SPESIAL,1,2700,0,2700,2452,248
8/8/2021 22:27,089686010107,INDOMIE KALDU AYAM,3,2500,0,7500,6450,1050
8/8/2021 22:36,RT KJ,ROTI KASUR JUMBO,1,8000,0,8000,7200,800
8/9/2021 12:12,8998989500166,GUDANG GARAM MERAH BESAR 16KS,1,18000,0,18000,17000,1000
8/9/2021 12:43,8998866202619,MIE SEDAAP KOREAN SPICY SOUP,2,2500,0,5000,4546,454
8/9/2021 16:44,GGK,PLAYGUM PERMEN KARET,1,500,0,500,400,100
8/9/2021 16:44,ARG,ARGUS 220ML,1,14500,0,14500,13300,1200
8/9/2021 17:05,8991002105430,KAPAL API 65G,1,5000,0,5000,4145,855
8/9/2021 17:18,8991002105409,KOPI KAPAL API,1,20000,0,20000,18888,1112
8/9/2021 17:20,8998866501026,MINYAK GORENG SEDAAP POUCH 1 L,1,15000,0,15000,14110,890
8/9/2021 18:04,089686049053,SARIMI PUAS,1,3000,0,3000,2400,600
8/9/2021 18:04,089686010343,INDOMIE SOTO MIE,1,2600,0,2600,2367,233
8/9/2021 18:10,8997018460150,MARLBORO ICE BURST 20,1,30000,0,30000,27750,2250
8/9/2021 18:21,8991102714846,MILKIDO CKLT,1,3000,0,3000,2153,847
8/9/2021 18:25,8994867000179,ROKOK PENA MILD 16,1,14500,0,14500,13500,1000
8/9/2021 18:28,8998989300261,GUDANG GARAM SURYA 12 FILTER,1,18500,0,18500,17200,1300
8/9/2021 18:33,RT MENARA,ROTI TAWAR MENARA,1,8000,0,8000,7200,800
8/9/2021 18:35,8993989311699,CLAS MILD 16 FILTER,1,23000,0,23000,21700,1300
8/9/2021 18:36,8993989311699,CLAS MILD 16 FILTER,1,23000,0,23000,21700,1300
8/9/2021 19:23,8992979190986,TOTAL PUTIH SOFTENER,1,13000,0,13000,11532,1468
8/9/2021 19:23,8999999059781,SUNLIGHT LIME NEW POUCH 210ML,1,5000,0,5000,4300,700
8/9/2021 19:33,8997009510123,ORANGE WATER,1,7000,0,7000,6089,911
8/9/2021 19:40,8998866203104,MIE SEDAAP SINGAPORE,1,2500,0,2500,2266,234
8/9/2021 20:00,8992702000018,INDOMILK PUTIH 370G,1,10000,0,10000,9020,980
8/9/2021 20:00,089686021127,INTER MIE KALDU,2,1000,0,2000,1626,374
8/9/2021 20:05,GGK,PLAYGUM PERMEN KARET,2,500,0,1000,800,200
8/9/2021 20:08,GGK,PLAYGUM PERMEN KARET,2,500,0,1000,800,200
8/9/2021 20:24,8992959953020,SWEETY BRONZE M1,1,3000,0,3000,2671,329
8/9/2021 20:26,8999909085114,SAMPOERNA KRETEK HIJAU 12,1,13000,0,13000,11650,1350
8/9/2021 20:26,8997018720469,TISSUE SE-KA,1,10000,0,10000,9300,700
8/9/2021 21:05,8997027300089,NOMOS,1,4000,0,4000,2963,1037
8/9/2021 21:44,8999999524722,SUNLIGHT LIME NEW PCH 435ML,1,10000,0,10000,9100,900
8/9/2021 21:52,8992775001820,CHOCOLATOS WAFER CREAM,1,18000,0,18000,16083,1917
8/9/2021 21:52,8996001350515,ZUPERRR KEJU CHOCO,1,10000,0,10000,8000,2000
8/9/2021 22:41,ARG,ARGUS 220ML,1,14500,0,14500,13300,1200
8/10/2021 11:11,089686611878,QTELA TEMPE,1,6000,0,6000,5370,630
8/10/2021 11:11,8991102714846,MILKIDO CKLT,2,3000,0,6000,4306,1694
8/10/2021 11:11,8992696404441,BEAR BRAND 189ML,1,9000,0,9000,7887,1113
8/10/2021 11:11,8991102385091,WFR TANGO CKLT 7G,1,8300,0,8300,7455,845
8/10/2021 11:11,8992959953198,SWEETY BRONZE  XL 26+2,1,60000,0,60000,54091,5909
8/10/2021 11:11,MBL,MOBIL,1,5000,0,5000,3500,1500
8/10/2021 11:27,8998989500166,GUDANG GARAM MERAH BESAR 16KS,1,18000,0,18000,17000,1000
8/10/2021 11:30,8991002105409,KOPI KAPAL API,1,20000,0,20000,18888,1112
8/10/2021 11:56,8999909010567,234 DJI SAM SOE 16,2,22000,0,44000,43000,1000
8/10/2021 14:07,8999909002821,MARLBORO BLACK 16,1,22000,0,22000,20850,1150
8/10/2021 14:29,8998866609487,SOKLIN SOFTERGEN 280G,1,5000,0,5000,4425,575
8/10/2021 14:29,8998866619288,SOKLIN ANTISEP,1,5000,0,5000,4159,841
8/10/2021 14:29,8999999556341,MOLTO EDP PINK ROSE 20ML,6,1000,0,6000,4800,1200
8/10/2021 14:29,8999999526863,MOLTO ALL IN ONE PINK 11ML,1,5500,0,5500,4800,700
8/10/2021 14:40,8993989311699,CLAS MILD 16 FILTER,1,23000,0,23000,21700,1300
8/10/2021 14:49,8995333060703,TERIGU KOMPAS 1KG,1,10500,0,10500,9816,684
8/10/2021 17:25,6907992823829,JD MILKY MILK,1,3000,0,3000,2600,400
8/10/2021 17:54,8999999195656,SARI WANGI 50X1.85,1,10000,0,10000,9500,500
8/10/2021 17:54,8992628020152,BIMOLI POUCH 2L,2,31000,0,62000,59600,2400
8/10/2021 17:54,8998989300261,GUDANG GARAM SURYA 12 FILTER,1,18500,0,18500,17200,1300
8/10/2021 17:54,8992775315095,GERY MALKIST SWEET CHEESE,1,6500,0,6500,5516,984
8/10/2021 17:54,089686021219,INTER MIE GORENG,1,1000,0,1000,885,115
8/10/2021 17:54,GGK,PLAYGUM PERMEN KARET,1,500,0,500,400,100
8/10/2021 18:58,8991002103238,GOOD DAY MOCACINNO,1,1500,0,1500,890,610
8/10/2021 18:58,8997018720469,TISSUE SE-KA,1,10000,0,10000,9300,700
8/10/2021 18:58,8996001355008,BENG-BENG SP20G,1,29000,0,29000,26500,2500
8/10/2021 19:05,8996001600399,LE MINERAL 1500ML,2,5000,0,10000,8084,1916
8/10/2021 19:05,8998989110167,SURYA GUDANG GARAM 16 FILTER,1,25000,0,25000,23200,1800
8/10/2021 19:06,8998989500166,GUDANG GARAM MERAH BESAR 16KS,1,18000,0,18000,17000,1000
8/10/2021 19:09,8991002103238,GOOD DAY MOCACINNO,6,1500,0,9000,5340,3660
8/10/2021 19:23,8993470671752,JOGER STICK DUO KACANG,2,1000,0,2000,1700,300
8/10/2021 19:23,8998866202619,MIE SEDAAP KOREAN SPICY SOUP,1,2700,0,2700,2322,378
8/10/2021 19:27,ARG,ARGUS 220ML,3,14500,0,43500,39900,3600
8/10/2021 19:40,8992628020152,BIMOLI POUCH 2L,1,31000,0,31000,29800,1200
8/10/2021 20:01,8998989300261,GUDANG GARAM SURYA 12 FILTER,1,18500,0,18500,17200,1300
8/10/2021 20:25,089686060102,POP MIE PEDE GLEDEEK,1,5000,0,5000,4450,550
8/10/2021 20:25,8998866200851,NOODLE SEDAAP MIE BAKSO SPESIAL CUP 77 GR,1,4500,0,4500,3738,762
8/10/2021 20:25,8998866604512,FRES&NATURAL SOAP VIOLET 65G,1,1800,0,1800,1425,375
8/10/2021 20:33,TS,TISSUE TESSY,1,5000,0,5000,4200,800
8/10/2021 20:33,089686060102,POP MIE PEDE GLEDEEK,1,5000,0,5000,4450,550
8/10/2021 20:33,8998866200851,NOODLE SEDAAP MIE BAKSO SPESIAL CUP 77 GR,1,4500,0,4500,3738,762
8/10/2021 20:33,8998866604512,FRES&NATURAL SOAP VIOLET 65G,1,1800,0,1800,1425,375
8/10/2021 20:54,8997011700123,BIHUN JAGUNG 300GR,1,6000,0,6000,4979,1021
8/10/2021 21:09,8998866501026,MINYAK GORENG SEDAAP POUCH 1 L,1,15000,0,15000,14110,890
8/10/2021 21:09,8995333060772,TERIGU GATOT KACA 500GR,1,4500,0,4500,4065,435
8/10/2021 21:09,8995333032113,TERIGU GATOT KACA 1 KG,1,8500,0,8500,8012,488
8/10/2021 21:09,711844330146,ABC SARDEN EXTRA PEDAS,1,10000,0,10000,8000,2000
8/10/2021 21:10,8998989300261,GUDANG GARAM SURYA 12 FILTER,1,18500,0,18500,17200,1300
8/10/2021 21:19,089686067002,POP MIE PDS DOWER RS AYAM,1,5000,0,5000,4450,550
8/10/2021 21:25,8719200177314,BLUE BAND 15G,1,2000,0,2000,1500,500
8/10/2021 21:34,8992959953020,SWEETY BRONZE M1,1,3000,0,3000,2671,329
8/10/2021 21:41,8991102320184,TANGO CHOCO JAVAMOCCA,1,5000,0,5000,4330,670
8/10/2021 21:41,8992388133345,NU MILK TEA TEH TARIK 330ML,1,6000,0,6000,5125,875
8/10/2021 21:52,VTM,VITAMIN CIMIN,6,500,0,3000,2550,450
8/10/2021 21:52,GGK,PLAYGUM PERMEN KARET,3,500,0,1500,1200,300
8/10/2021 21:55,8999801700054,SUSU FOYU 1 KG,1,22000,0,22000,19791,2209
8/11/2021 8:21,8992959117590,SFX DS REG FLOW WING 20,1,12000,0,12000,11250,750
8/11/2021 8:31,8993989311279,CLAS MILD 12,1,17000,0,17000,15700,1300
8/11/2021 8:31,8998866608459,POWDET DAIA PUTIH BAG 290GR,1,5000,0,5000,4450,550
8/11/2021 8:36,8996001301562,MALKIST TABUR KELAPA,1,1000,0,1000,820,180
8/11/2021 8:47,8993176110074,MINYAK KAYU PUTIH 60ML,1,20000,0,20000,17333,2667
8/11/2021 9:09,GGK,PLAYGUM PERMEN KARET,2,500,0,1000,800,200
8/11/2021 9:40,8999999059781,SUNLIGHT LIME NEW POUCH 210ML,1,5000,0,5000,4300,700
8/11/2021 9:44,8997210107877,VORTEX SMART 3,1,5000,0,5000,4750,250
8/11/2021 9:54,8998989500166,GUDANG GARAM MERAH BESAR 16KS,1,18000,0,18000,17000,1000
8/11/2021 9:54,GL,GULA 1 LITER,1,11500,0,11500,10500,1000
8/11/2021 10:02,8998866201483,POTABEE REGULER GRILLED SEAWEED 35GR,1,5000,0,5000,4150,850
8/11/2021 12:20,8999999706081,PEPSODENT WHITE 75G,1,5000,0,5000,3850,1150
8/11/2021 12:20,8992696422735,DNCO CKLT UHT 110ML,3,3000,0,9000,6123,2877
8/11/2021 12:20,8999999534097,PEPSODENT PGB FCM 75G,1,5000,0,5000,3850,1150
8/11/2021 12:20,8991102160711,COOKIEZ,1,16000,0,16000,14500,1500
8/11/2021 12:25,GL,GULA 1 LITER,2,11500,0,23000,21000,2000
8/11/2021 12:29,CK,COOKIEZ,1,1000,0,1000,725,275
8/11/2021 12:30,GGK,PLAYGUM PERMEN KARET,2,500,0,1000,800,200
8/11/2021 12:49,8992761111533,SPRITE SLIM CAM250ML,2,5000,0,10000,7500,2500
8/11/2021 12:50,8999909002821,MARLBORO BLACK 16,1,22000,0,22000,20850,1150
8/11/2021 19:28,8996001600399,LE MINERAL 1500ML,1,5000,0,5000,4042,958
8/11/2021 19:28,8999099923005,SGM 6-12 600G,1,53000,0,53000,51951,1049
8/11/2021 19:32,8992761139018,ADES 600ML,1,3500,0,3500,2292,1208
8/11/2021 19:33,ROTI,ROTI 2000,2,2000,0,4000,3600,400
8/11/2021 19:34,ROTI,ROTI 2000,3,2000,0,6000,5400,600
8/11/2021 19:36,089686010343,INDOMIE SOTO MIE,2,2600,0,5200,4734,466
8/11/2021 19:39,8999909096004,SAMPOERNA 16 FILTER,1,24000,0,24000,23000,1000
8/11/2021 19:40,8998989300261,GUDANG GARAM SURYA 12 FILTER,1,18500,0,18500,17200,1300
8/11/2021 19:41,8999909010567,234 DJI SAM SOE 16,1,22000,0,22000,21500,500
8/11/2021 19:42,123124,KOREK BIASA,1,2000,0,2000,1300,700
8/11/2021 19:44,ROTI,ROTI 2000,2,2000,0,4000,3600,400
8/11/2021 19:44,123124,KOREK BIASA,1,2000,0,2000,1300,700
8/11/2021 19:46,8998898853100,SUSU JAHE,1,1500,0,1500,1180,320
8/11/2021 19:47,8997028590014,ARGUS 220ML,10,500,0,5000,3020,1980
8/11/2021 19:48,8993989311699,CLAS MILD 16 FILTER,1,23000,0,23000,21700,1300
8/11/2021 19:50,ROTI,ROTI 2000,2,2000,0,4000,3600,400
8/11/2021 19:51,8997025911058,HATARI SHP KELAPA,1,6000,0,6000,4911,1089
8/11/2021 19:53,VTM,VITAMIN CIMIN,40,500,0,20000,17000,3000
8/11/2021 19:54,123124,KOREK BIASA,1,2000,0,2000,1300,700
8/11/2021 19:57,8996001600399,LE MINERAL 1500ML,10,5000,0,50000,40420,9580
8/11/2021 19:58,ARG,ARGUS 220ML,3,14500,0,43500,39900,3600
8/11/2021 19:59,8993176110074,MINYAK KAYU PUTIH 60ML,2,20000,0,40000,34666,5334
8/11/2021 20:01,ARG,ARGUS 220ML,1,14500,0,14500,13300,1200
8/11/2021 20:01,8886020033431,KAPUR AJAIB ANTI KECOA DAN NYAMUK,1,3000,0,3000,2700,300
8/11/2021 20:02,8998866203104,MIE SEDAAP SINGAPORE,1,2500,0,2500,2266,234
8/11/2021 20:04,8999909010567,234 DJI SAM SOE 16,2,22000,0,44000,43000,1000
8/11/2021 20:05,ARG,ARGUS 220ML,1,14500,0,14500,13300,1200
8/11/2021 20:06,8996001600269,LE MINERAL 600ML,2,3000,0,6000,3376,2624
8/11/2021 20:07,8992761002039,FANTA STRAWBERRY PET 390 ML,1,5500,0,5500,4300,1200
8/11/2021 20:07,8992761002022,SPRITE PET 390ML,1,5500,0,5500,4300,1200
8/11/2021 20:09,RB,RED BOLD,1,19000,0,19000,17900,1100
8/11/2021 20:10,8998989300261,GUDANG GARAM SURYA 12 FILTER,1,18500,0,18500,17200,1300
8/11/2021 20:12,8997028590014,ARGUS 220ML,8,500,0,4000,2416,1584
8/11/2021 20:12,ARG,ARGUS 220ML,1,14500,0,14500,13300,1200
8/11/2021 20:14,8996001600375,LE MINERAL 330ML,2,2000,0,4000,2834,1166
8/11/2021 20:15,GL,GULA 1 LITER,2,11500,0,23000,21000,2000
8/11/2021 20:16,8998989300261,GUDANG GARAM SURYA 12 FILTER,1,18500,0,18500,17200,1300
8/11/2021 20:16,MG,MINYAK GOSOK SAFERTABAT,1,28000,0,28000,25000,3000
8/11/2021 20:17,8999908284907,MY BABY MINYAK TELON 90ML,1,25000,0,25000,22700,2300
8/11/2021 21:56,8992775211410,PILUS GARUDA PEDAS,1,5000,0,5000,4886,114
8/11/2021 22:06,8993989311699,CLAS MILD 16 FILTER,1,23000,0,23000,21700,1300
8/11/2021 22:08,8998989300261,GUDANG GARAM SURYA 12 FILTER,1,18500,0,18500,17200,1300
8/11/2021 22:10,8999909010567,234 DJI SAM SOE 16,1,22000,0,22000,21500,500
8/11/2021 22:23,8992696430860,KOKO KRUNCH 80G,1,9000,0,9000,8063,937
8/11/2021 22:23,089686611670,QTELA BALADO,1,5000,0,5000,4266,734
8/11/2021 22:23,ARG,ARGUS 220ML,1,14500,0,14500,13300,1200
8/11/2021 22:23,8996001305041,ROMA SANDWICH CKLT,1,7000,0,7000,5000,2000
8/11/2021 22:23,8998866202312,NOODLE SEDAAP TASTY BAKMI AYAM 129 GR,1,5000,0,5000,4167,833
8/11/2021 22:23,8999999516208,ROYCO FDS CHICKEN NEW 230G,1,10000,0,10000,9000,1000
8/11/2021 22:23,8998866501026,MINYAK GORENG SEDAAP POUCH 1 L,3,15000,0,45000,42330,2670
8/11/2021 22:38,8996001370063,CHOKI-CHOKI,1,18200,0,18200,16500,1700
8/12/2021 10:18,8886001038011,BENG-BENG SCT,1,1500,0,1500,1450,50
8/12/2021 10:19,711844120419,SAMBAL ABC 275 ML,1,12000,0,12000,10800,1200
8/12/2021 10:19,711844130128,ABC SAUS TOMAT 275 ML,1,10000,0,10000,8800,1200
8/12/2021 11:00,8998866808699,ROYALE PURPLE DAWN 13ML,1,5000,0,5000,4500,500
8/12/2021 11:00,8998866202435,JAPOTA UMAMI JAPANESE SEAWEED 35GR,1,5000,0,5000,4150,850
8/12/2021 11:04,8998989110167,SURYA GUDANG GARAM 16 FILTER,1,25000,0,25000,23200,1800
8/12/2021 11:22,8998989300261,GUDANG GARAM SURYA 12 FILTER,1,18500,0,18500,17200,1300
8/12/2021 11:30,MA,MALKIST ABON,2,9000,0,18000,16800,1200
8/12/2021 11:37,8992959953013,SWEETY BRONZE S1,2,2000,0,4000,2758,1242
8/12/2021 12:43,8998866202923,FLORIDINA COCO,1,3000,0,3000,2500,500
8/12/2021 16:47,8992959954034,SWEETY BRONZE NB 24,1,29000,0,29000,26762,2238
8/12/2021 16:51,8993989311279,CLAS MILD 12,1,17000,0,17000,15700,1300
8/12/2021 17:58,8999999519711,PEPSODENT TB HIMALAYAN ROCK SALT,1,13300,0,13300,12045,1255
8/12/2021 18:13,8999909096004,SAMPOERNA 16 FILTER,1,24000,0,24000,23000,1000
8/12/2021 19:02,8992775318201,GERY SNACK BANTAL COKLAT,1,2000,0,2000,1712,288
8/12/2021 19:02,ff,FULLO BLASTO,2,1000,0,2000,1990,10
8/12/2021 19:11,8999909096004,SAMPOERNA 16 FILTER,1,24000,0,24000,23000,1000
8/12/2021 20:00,8999909010567,234 DJI SAM SOE 16,2,22000,0,44000,43000,1000
8/12/2021 20:16,8993989311279,CLAS MILD 12,1,17000,0,17000,15700,1300
8/12/2021 20:17,8999909096004,SAMPOERNA 16 FILTER,1,24000,0,24000,23000,1000
8/12/2021 20:22,8994420107789,SARDEN SAUS TOMAT,2,7000,0,14000,11666,2334
8/12/2021 20:22,8995333032113,TERIGU GATOT KACA 1 KG,1,8500,0,8500,8012,488
8/12/2021 20:22,8995333060772,TERIGU GATOT KACA 500GR,1,4500,0,4500,4065,435
8/12/2021 20:22,8994935000070,MINYAK DUNIA 450 ML,1,7500,0,7500,6779,721
8/12/2021 20:22,8999908559500,MARINA HYDRO COOL,1,10000,0,10000,8500,1500
8/12/2021 20:22,8998898830125,KKB ENER-G ANGGUR,2,5500,0,11000,9648,1352
8/12/2021 20:25,8991909101016,URBAN MILD 16,1,17000,0,17000,15800,1200
8/12/2021 20:25,8998989300261,GUDANG GARAM SURYA 12 FILTER,1,18500,0,18500,17200,1300
8/12/2021 20:29,8995333060772,TERIGU GATOT KACA 500GR,1,4500,0,4500,4065,435
8/12/2021 20:29,8995333032113,TERIGU GATOT KACA 1 KG,1,8500,0,8500,8012,488
8/12/2021 20:29,8998898830125,KKB ENER-G ANGGUR,2,5500,0,11000,9648,1352
8/12/2021 20:29,8994935000070,MINYAK DUNIA 450 ML,1,7500,0,7500,6779,721
8/12/2021 20:29,8994420107789,SARDEN SAUS TOMAT,2,7000,0,14000,11666,2334
8/12/2021 20:29,8999908559500,MARINA HYDRO COOL,1,10000,0,10000,8500,1500
8/12/2021 20:31,8998989300261,GUDANG GARAM SURYA 12 FILTER,1,18500,0,18500,17200,1300
8/12/2021 20:33,8998989300261,GUDANG GARAM SURYA 12 FILTER,1,18500,0,18500,17200,1300
8/12/2021 20:33,8998009020186,BUAVITA GUAVA 250ML,1,7000,0,7000,6083,917
8/12/2021 20:39,089686021127,INTER MIE KALDU,2,1000,0,2000,1626,374
8/12/2021 20:40,8992628020152,BIMOLI POUCH 2L,1,31000,0,31000,29800,1200
8/12/2021 20:43,8993989311699,CLAS MILD 16 FILTER,1,23000,0,23000,21700,1300
8/12/2021 20:44,6907992825076,JD WATERMELON APPLE,1,2000,0,2000,1700,300
8/12/2021 20:45,7118441101378,KECAP ABC 520 ML,1,19000,0,19000,17800,1200
8/12/2021 21:10,8998866202343,MIE SEDAAP KOREAN SPICY,5,2700,0,13500,12065,1435
8/12/2021 21:39,8999909096004,SAMPOERNA 16 FILTER,1,24000,0,24000,23000,1000
8/13/2021 10:56,8999909002876,SAMPOERNA ULTRAMILD 12,1,17000,0,17000,14600,2400
8/13/2021 10:57,8998898830125,KKB ENER-G ANGGUR,1,5500,0,5500,4824,676
8/13/2021 11:03,8886020033431,KAPUR AJAIB ANTI KECOA DAN NYAMUK,1,3000,0,3000,2700,300
8/13/2021 11:03,6907992823669,JD MILKY STRAW,2,3000,0,6000,5200,800
8/13/2021 11:03,8996001301562,MALKIST TABUR KELAPA,1,1000,0,1000,820,180
8/13/2021 11:05,089686021141,INTER MIE SOTO,3,1000,0,3000,2562,438
8/13/2021 11:05,089686044249,SUPERMI NUTRIMI STEAK AYAM,2,3500,0,7000,5600,1400
8/13/2021 11:06,8999909010567,234 DJI SAM SOE 16,2,22000,0,44000,43000,1000
8/13/2021 11:11,GGK,PLAYGUM PERMEN KARET,2,500,0,1000,800,200
8/13/2021 11:43,8992761111533,SPRITE SLIM CAM250ML,1,5000,0,5000,3750,1250
8/13/2021 11:43,8992752112013,MIZONE,1,5000,0,5000,3800,1200
8/13/2021 11:46,8999909096004,SAMPOERNA 16 FILTER,1,24000,0,24000,23000,1000
8/13/2021 11:46,123124,KOREK BIASA,1,2000,0,2000,1300,700
8/13/2021 11:47,123124,KOREK BIASA,1,2000,0,2000,1300,700
8/13/2021 11:47,8999909096004,SAMPOERNA 16 FILTER,1,24000,0,24000,23000,1000
8/13/2021 13:11,8997025914059,HATARI SEE HONG,1,6000,0,6000,4911,1089
8/13/2021 13:11,8997028590014,ARGUS 220ML,1,500,0,500,302,198
8/13/2021 19:59,8999909002821,MARLBORO BLACK 16,1,22000,0,22000,20850,1150
8/13/2021 20:12,123124,KOREK BIASA,1,2000,0,2000,1300,700
8/13/2021 20:21,8998989100120,GUDANG GARAM MINI,1,18000,0,18000,16600,1400
8/13/2021 20:21,8998989110167,SURYA GUDANG GARAM 16 FILTER,1,25000,0,25000,23200,1800
8/13/2021 20:49,8993989311699,CLAS MILD 16 FILTER,1,23000,0,23000,21700,1300
8/13/2021 20:52,8992761166038,MMP ORANGE 300ML,1,5000,0,5000,3750,1250
8/13/2021 20:53,8996001355237,SUPER STAR,1,11000,0,11000,9900,1100
8/13/2021 20:53,8999909096004,SAMPOERNA 16 FILTER,1,24000,0,24000,23000,1000
8/13/2021 21:29,8992959953099,SWEETY BRONZE XL7,1,16000,0,16000,15190,810
8/13/2021 21:31,8999909096004,SAMPOERNA 16 FILTER,1,24000,0,24000,23000,1000
8/13/2021 21:31,8996001355237,SUPER STAR,1,11000,0,11000,9900,1100
8/13/2021 21:52,GL,GULA 1 LITER,2,11500,0,23000,21000,2000
8/13/2021 21:52,711844110144,KECAP ABC 225 ML,1,9000,0,9000,8200,800
8/13/2021 21:52,RT,ROTI,2,9000,0,18000,16000,2000
8/13/2021 21:52,SMBL,SAMBAL ABC BLINK 335 ML,1,14000,0,14000,12550,1450
8/13/2021 22:18,8998866202312,NOODLE SEDAAP TASTY BAKMI AYAM 129 GR,2,5000,0,10000,8334,1666
8/13/2021 22:18,ARG,ARGUS 220ML,1,14500,0,14500,13300,1200
8/13/2021 22:21,8991102300421,WFR TANGO COKLAT 176GR,1,10000,0,10000,8694,1306
8/13/2021 22:21,ROTI,ROTI 2000,2,2000,0,4000,3600,400
8/13/2021 22:21,PRG,PARAGO,2,500,0,1000,800,200
8/14/2021 9:02,8992761139018,ADES 600ML,2,3500,0,7000,4584,2416
8/14/2021 10:20,8998866501026,MINYAK GORENG SEDAAP POUCH 1 L,6,15000,0,90000,84660,5340
8/14/2021 10:21,8999999571887,MOLTO EDP PURPLE 10ML,1,5000,0,5000,4800,200
8/14/2021 10:54,8996001600399,LE MINERAL 1500ML,1,5000,0,5000,4042,958
8/14/2021 10:54,8999909002876,SAMPOERNA ULTRAMILD 12,1,17000,0,17000,14600,2400
8/14/2021 10:58,8998866607315,SOKLIN SOFTERGENT SAKURA 770G & PIRING,1,18000,0,18000,16680,1320
8/14/2021 10:58,8992628020152,BIMOLI POUCH 2L,1,31000,0,31000,29800,1200
8/14/2021 10:58,8996001302316,MALKIST ABON SCT,1,1000,0,1000,840,160
8/14/2021 12:01,8999909096004,SAMPOERNA 16 FILTER,1,24000,0,24000,23000,1000
8/14/2021 12:06,8992775001691,GARUDA ROSTA WAGYU BEEF,1,8000,0,8000,7322,678
8/14/2021 13:08,8998866202923,FLORIDINA COCO,2,3000,0,6000,5000,1000
8/14/2021 13:08,SNDL,SENDAL BLACK,1,15000,0,15000,10833,4167
8/14/2021 13:08,8886013257400,TWISTKO,4,1000,0,4000,3600,400
8/14/2021 13:12,8991102320184,TANGO CHOCO JAVAMOCCA,1,5000,0,5000,4330,670
8/14/2021 13:27,8992806145417,SCOTCH BRITE,2,3500,0,7000,4814,2186
8/14/2021 13:27,8999999524722,SUNLIGHT LIME NEW PCH 435ML,1,10000,0,10000,9100,900
8/14/2021 13:27,ARG,ARGUS 220ML,1,14500,0,14500,13300,1200
8/14/2021 13:37,8998866501026,MINYAK GORENG SEDAAP POUCH 1 L,1,15000,0,15000,14110,890
8/14/2021 13:37,8999999048174,SUNSILK  BLK SHINE 70+21ML,1,9600,0,9600,8525,1075
8/14/2021 13:37,8999999059781,SUNLIGHT LIME NEW POUCH 210ML,1,5000,0,5000,4300,700
8/14/2021 13:37,8999999059309,LIFEBUOY TS TOTAL 10 DG 75G,1,3000,0,3000,2640,360
8/14/2021 13:37,8999999706081,PEPSODENT WHITE 75G,1,5000,0,5000,3850,1150
8/14/2021 13:37,8998866609029,DAIA PUTIH GUSSWET 565G,1,10000,0,10000,8700,1300
8/14/2021 13:37,089686048704,SARIMIE GORENG AYAM KCP ISI 2,1,3500,0,3500,3120,380
8/14/2021 13:37,ARG,ARGUS 220ML,1,14500,0,14500,13300,1200
8/14/2021 13:38,8996001318911,BETTER ISI 4,1,2000,0,2000,1700,300
8/14/2021 13:38,089686041705,INDOMIE GORENG JUMBO,1,3500,0,3500,3143,357
8/14/2021 13:38,8996001440049,ENERGEN,1,1500,0,1500,1200,300
8/14/2021 13:41,8998866618298,DAIA CLEAN&FRESH HJB 320GR,1,5000,0,5000,4450,550
8/14/2021 16:06,8995333060772,TERIGU GATOT KACA 500GR,1,4500,0,4500,4065,435
8/14/2021 17:24,RT MNTG,ROTI SISIR MENTEGA,5,2000,0,10000,8000,2000
8/14/2021 17:24,8991004011906,KOPI BORONG,1,10000,0,10000,8333,1667
8/14/2021 17:47,8998989300261,GUDANG GARAM SURYA 12 FILTER,1,18500,0,18500,17200,1300
8/14/2021 17:47,8991004011906,KOPI BORONG,1,10000,0,10000,8333,1667
8/14/2021 17:49,8994867007161,ROKOK PENA GOLD 20,1,17000,0,17000,15500,1500
8/14/2021 17:49,8992759120264,LARISST 220,1,10000,0,10000,9200,800
8/14/2021 19:20,8886001038011,BENG-BENG SCT,3,1500,0,4500,4350,150
8/14/2021 19:50,8999999519711,PEPSODENT TB HIMALAYAN ROCK SALT,1,13300,0,13300,12045,1255
8/14/2021 19:50,8991111102986,JB COOTON TOUCH 375ML,1,24000,0,24000,22300,1700
8/14/2021 19:50,8991002105584,KAPAL API 6.5 G,10,500,0,5000,3900,1100
8/14/2021 19:50,8999999534752,PEPSODENT ACTION123 CHARCOAL 65G,1,7400,0,7400,6710,690
8/14/2021 19:50,8999908284907,MY BABY MINYAK TELON 90ML,1,25000,0,25000,22700,2300
8/14/2021 19:50,8999999045265,RINSO MOLTO ROSE FRESH PWD 770GR,1,21600,0,21600,19338,2262
8/14/2021 19:50,8996200900092,HEROCYN 85GR,1,13000,0,13000,11650,1350
8/14/2021 19:50,8999099920691,SGM 1+ MADU 1000G,1,85000,0,85000,78510,6490
8/14/2021 21:09,8998989500166,GUDANG GARAM MERAH BESAR 16KS,1,18000,0,18000,17000,1000
8/14/2021 21:33,8995333032113,TERIGU GATOT KACA 1 KG,2,8500,0,17000,16024,976
8/15/2021 8:24,8993989311699,CLAS MILD 16 FILTER,1,23000,0,23000,21700,1300
8/15/2021 8:31,8992775315057,GERY SALUT MALKIST COKLAT,1,6500,0,6500,5516,984
8/15/2021 8:33,8996001302316,MALKIST ABON SCT,1,1000,0,1000,840,160
8/15/2021 9:00,8992736925134,SASA TEPUNG BUMBU SERBAGUNA,1,5500,0,5500,4700,800
8/15/2021 9:00,ARG,ARGUS 220ML,1,14500,0,14500,13300,1200
8/15/2021 9:03,8998866608459,POWDET DAIA PUTIH BAG 290GR,1,5000,0,5000,4450,550
8/15/2021 9:03,8999999524722,SUNLIGHT LIME NEW PCH 435ML,1,10000,0,10000,9100,900
8/15/2021 9:03,ARG,ARGUS 220ML,1,14500,0,14500,13300,1200
8/15/2021 9:04,8998866202770,MIE SEDAAP SALERO PADANG,1,2500,0,2500,2362,138
8/15/2021 9:11,76239878,MARLBORO GOLD,1,30000,0,30000,27700,2300
8/15/2021 9:23,gula,GULA,3,11500,0,34500,30000,4500
8/15/2021 9:23,8992759120264,LARISST 220,1,10000,0,10000,9200,800
8/15/2021 9:23,8995333060703,TERIGU KOMPAS 1KG,2,10500,0,21000,19632,1368
8/15/2021 9:23,8993072254018,MELROSE COTTON BUDS BSR,1,5000,0,5000,4050,950
8/15/2021 9:45,8998989300261,GUDANG GARAM SURYA 12 FILTER,1,18500,0,18500,17200,1300
8/15/2021 9:48,8992761139018,ADES 600ML,2,3500,0,7000,4584,2416
8/15/2021 9:48,PRG,PARAGO,2,500,0,1000,800,200
8/15/2021 13:59,6907992823867,JD CRUNCHY CHOCOLATE MALT,2,5500,0,11000,9400,1600
8/15/2021 13:59,6907992823935,JD SWEETCORN,1,3500,0,3500,3000,500
8/15/2021 13:59,ARG,ARGUS 220ML,1,14500,0,14500,13300,1200
8/15/2021 16:26,8992696419742,NESCAFE COFFE CREAM,1,5000,0,5000,4099,901
8/15/2021 16:26,8996001600641,TORA CAPPUCINO,1,3500,0,3500,2750,750
8/15/2021 18:11,9556001004673,MILO NESTLE MALAYSIA ACTIVE GO,1,85000,0,85000,80000,5000
8/15/2021 18:56,8997027300089,NOMOS,1,4000,0,4000,2963,1037
8/15/2021 19:29,089686060102,POP MIE PEDE GLEDEEK,1,5000,0,5000,4450,550
8/15/2021 19:57,089686611670,QTELA BALADO,1,5000,0,5000,4266,734
8/15/2021 19:58,8999909002821,MARLBORO BLACK 16,1,22000,0,22000,20850,1150
8/15/2021 20:10,8998866608008,KECAP MANIS SEDAAP BOTOL 135 ML,1,6500,0,6500,5875,625
8/15/2021 20:20,8998898810622,KKB JERUK VIT C1000,1,7500,0,7500,6690,810
8/15/2021 20:21,8991002121089,GOOD DAY ORI CAPPUCINO,1,6000,0,6000,4295,1705
8/15/2021 20:21,8991002121010,GOOD DAY FANTASTIC MOCACINNO,1,6000,0,6000,4295,1705
8/15/2021 20:27,8995333032113,TERIGU GATOT KACA 1 KG,4,8500,0,34000,32048,1952
8/15/2021 20:27,8995333060772,TERIGU GATOT KACA 500GR,1,4500,0,4500,4065,435
8/15/2021 20:29,8998866202343,MIE SEDAAP KOREAN SPICY,1,2700,0,2700,2413,287
8/15/2021 20:50,8998866501026,MINYAK GORENG SEDAAP POUCH 1 L,3,15000,0,45000,42330,2670
8/16/2021 12:04,089686041705,INDOMIE GORENG JUMBO,1,3500,0,3500,3143,357
8/16/2021 12:04,8994867007161,ROKOK PENA GOLD 20,1,17000,0,17000,15500,1500
8/16/2021 12:04,8998989500166,GUDANG GARAM MERAH BESAR 16KS,1,18000,0,18000,17000,1000
8/16/2021 12:04,8998866108317,EMERON HJB ANTDNDF 10ML,1,5000,0,5000,4500,500
8/16/2021 12:04,123124,KOREK BIASA,1,2000,0,2000,1300,700
8/16/2021 12:04,8994935000285,MINYAK GORENG DUNIA 4500ML,1,70000,0,70000,66433,3567
8/16/2021 12:29,8997028590014,ARGUS 220ML,2,500,0,1000,604,396
8/16/2021 20:56,8998866611725,EKONOMI PENCUCI PIRING  LIQ 290ML,1,5000,0,5000,4200,800
8/16/2021 20:56,8998866888639,GIV HIJAU KOTAK 76G,2,2000,0,4000,3640,360
8/16/2021 20:56,8993007003063,ENAAK 500G,1,11000,0,11000,9625,1375
8/16/2021 21:04,8992959953099,SWEETY BRONZE XL7,1,16000,0,16000,15190,810
8/16/2021 21:04,8998866608459,POWDET DAIA PUTIH BAG 290GR,1,5000,0,5000,4450,550
8/16/2021 21:04,8999999531492,MOLTO GLAMOUR,1,5000,0,5000,4800,200
8/16/2021 21:04,TBR,TEPUNG BERAS ROSE BRAND,5,8000,0,40000,29000,11000
8/16/2021 21:07,089686834055,FREISS JERUK,1,11000,0,11000,8750,2250
8/16/2021 21:10,8992222010221,TANCHO TREATMENT,1,17000,0,17000,15650,1350
8/16/2021 21:13,711844150027,ABC NANAS,1,13000,0,13000,12241,759
8/16/2021 21:29,8999909002821,MARLBORO BLACK 16,1,22000,0,22000,20850,1150
8/16/2021 21:34,8992959508985,SWEETY SILVER PANTS M 30,1,56800,0,56800,51819,4981
8/16/2021 21:37,8998866501026,MINYAK GORENG SEDAAP POUCH 1 L,1,15000,0,15000,14110,890
8/16/2021 21:41,8992696404441,BEAR BRAND 189ML,2,9000,0,18000,15774,2226
8/16/2021 21:43,8992696523081,MILO UHT 110ML,2,2500,0,5000,3924,1076
8/16/2021 21:43,8997009510123,ORANGE WATER,1,7000,0,7000,6089,911
8/16/2021 21:43,8998989110167,SURYA GUDANG GARAM 16 FILTER,1,25000,0,25000,23200,1800
8/16/2021 21:46,CLUB,AIR CLUB 600ML,1,3000,0,3000,1452,1548
8/16/2021 21:47,123124,KOREK BIASA,1,2000,0,2000,1300,700
8/16/2021 21:48,PUL,PULPEN,5,1500,0,7500,4165,3335
8/16/2021 21:57,8992696404441,BEAR BRAND 189ML,1,9000,0,9000,7887,1113
8/16/2021 21:57,8998009010569,ULTRA CHO 200,1,5000,0,5000,3830,1170
8/16/2021 21:57,8998866201490,POTABEE REGULER GRILLED SEAWED 68 GR,1,8000,0,8000,7200,800
8/16/2021 22:04,8999909096004,SAMPOERNA 16 FILTER,1,24000,0,24000,23000,1000
8/16/2021 22:04,8998989300261,GUDANG GARAM SURYA 12 FILTER,1,18500,0,18500,17200,1300
8/16/2021 22:12,8998989300261,GUDANG GARAM SURYA 12 FILTER,1,18500,0,18500,17200,1300
8/16/2021 22:13,ARG,ARGUS 220ML,3,14500,0,43500,39900,3600
8/16/2021 22:14,GL,GULA 1 LITER,4,11500,0,46000,42000,4000
8/16/2021 22:17,8992761166038,MMP ORANGE 300ML,2,5000,0,10000,7500,2500
8/16/2021 22:17,9556001004673,MILO NESTLE MALAYSIA ACTIVE GO,1,85000,0,85000,80000,5000
8/16/2021 22:19,8994935000070,MINYAK DUNIA 450 ML,1,7500,0,7500,6779,721
8/16/2021 22:19,8992628510158,SIMAS PALMIA,1,6000,0,6000,4832,1168
8/16/2021 22:19,FUZO,KUACI FUZO,1,1000,0,1000,850,150
8/16/2021 22:19,8991102320184,TANGO CHOCO JAVAMOCCA,1,5000,0,5000,4330,670
8/16/2021 23:10,8992959930533,CONFI PREMIUM PAN XL1,2,8500,0,17000,15570,1430
8/16/2021 23:15,8999999055752,FAIR&LOVELY MVIT FC FOAM 9 G,1,3500,0,3500,2450,1050
8/17/2021 9:22,GL,GULA 1 LITER,1,11500,0,11500,10500,1000
8/17/2021 9:22,8992628022156,BIMOLI KLASIK TOUCH 1 LT,1,16000,0,16000,14350,1650
8/17/2021 9:23,ARG,ARGUS 220ML,2,14500,0,29000,26600,2400
8/17/2021 10:06,8999909010567,234 DJI SAM SOE 16,2,22000,0,44000,43000,1000
8/17/2021 10:47,8995333032113,TERIGU GATOT KACA 1 KG,2,8500,0,17000,16024,976
8/17/2021 10:49,8996001600399,LE MINERAL 1500ML,1,5000,0,5000,4042,958
8/17/2021 10:55,8996001318911,BETTER ISI 4,1,2000,0,2000,1700,300
8/17/2021 10:55,PRG,PARAGO,6,500,0,3000,2400,600
8/17/2021 11:54,8998866501026,MINYAK GORENG SEDAAP POUCH 1 L,5,15000,0,75000,70550,4450
8/17/2021 11:54,8992775318201,GERY SNACK BANTAL COKLAT,1,2000,0,2000,1712,288
8/17/2021 11:54,CK,COOKIEZ,1,1000,0,1000,725,275
8/17/2021 12:12,8998989300261,GUDANG GARAM SURYA 12 FILTER,1,18500,0,18500,17200,1300
8/17/2021 12:12,123124,KOREK BIASA,1,2000,0,2000,1300,700
8/17/2021 16:55,GL,GULA 1 LITER,1,11500,0,11500,10500,1000
8/17/2021 16:55,8992628022156,BIMOLI KLASIK TOUCH 1 LT,1,16000,0,16000,14350,1650
8/17/2021 16:56,ARG,ARGUS 220ML,1,14500,0,14500,13300,1200
8/17/2021 16:59,089686611618,QTELA BARBEQUE,1,5000,0,5000,4266,734
8/17/2021 17:20,8998866501026,MINYAK GORENG SEDAAP POUCH 1 L,3,15000,0,45000,42330,2670
8/17/2021 17:27,ARG,ARGUS 220ML,1,14500,0,14500,13300,1200
8/17/2021 17:29,8992696523081,MILO UHT 110ML,1,2500,0,2500,1962,538
8/17/2021 17:37,8994834006128,TICTIC PEDAS,1,2000,0,2000,1700,300
8/17/2021 18:38,8993989311279,CLAS MILD 12,1,17000,0,17000,15700,1300
8/17/2021 18:38,8998989300261,GUDANG GARAM SURYA 12 FILTER,1,18500,0,18500,17200,1300
8/17/2021 18:55,8999999529918,CLEAR SPR FRESH APPLE 80ML,1,11300,0,11300,10120,1180
8/17/2021 20:00,8993007000086,INDOMILK CKLT 1L,1,16500,0,16500,14791,1709
8/17/2021 20:02,8992696523067,MILO ACTVGO UHT 180ML,2,4500,0,9000,7030,1970
8/17/2021 20:02,8998989300261,GUDANG GARAM SURYA 12 FILTER,1,18500,0,18500,17200,1300
8/17/2021 20:02,123124,KOREK BIASA,1,2000,0,2000,1300,700
8/17/2021 20:10,8994834006128,TICTIC PEDAS,1,2000,0,2000,1700,300
8/17/2021 20:10,8992775110157,GARUDA KACANG KULIT,1,5000,0,5000,3925,1075
8/17/2021 20:11,8998866501026,MINYAK GORENG SEDAAP POUCH 1 L,1,15000,0,15000,14110,890
8/17/2021 20:16,8991102989381,TANGO LONG BUBBLEGUM 130G,1,5000,0,5000,4345,655
8/17/2021 20:22,8999999559533,LIFEBUOY BW TOTAL 10 90ML,1,5000,0,5000,4000,1000
8/17/2021 20:23,ROTI,ROTI 2000,1,2000,0,2000,1800,200
8/17/2021 20:23,8999909096004,SAMPOERNA 16 FILTER,1,24000,0,24000,23000,1000
8/17/2021 20:25,8996001600399,LE MINERAL 1500ML,1,5000,0,5000,4042,958
8/17/2021 20:36,8992775001783,GERY SALUT MALKIST KELAPA,1,6500,0,6500,5516,984
8/17/2021 20:36,8991102320184,TANGO CHOCO JAVAMOCCA,1,5000,0,5000,4330,670
8/17/2021 20:36,8991909101016,URBAN MILD 16,1,17000,0,17000,15800,1200
8/17/2021 20:36,8886013213208,FRENCH FREIS 2000,2,5000,0,10000,7500,2500
8/17/2021 20:38,8997011700123,BIHUN JAGUNG 300GR,1,6000,0,6000,4979,1021
8/17/2021 20:38,8991102320184,TANGO CHOCO JAVAMOCCA,1,5000,0,5000,4330,670
8/17/2021 20:38,6907992823652,JD CHOCOLATE MILKSHAKE,2,6000,0,12000,10400,1600
8/17/2021 20:42,8998866201841,GOLDA DOLCE LATTE 200ML,2,3000,0,6000,5000,1000
8/17/2021 20:50,089686611618,QTELA BARBEQUE,1,5000,0,5000,4266,734
8/17/2021 20:50,8992959953020,SWEETY BRONZE M1,2,3000,0,6000,5342,658
8/17/2021 20:53,8886022941512,BATERAI ALKALINE 03,1,11000,0,11000,9970,1030
8/17/2021 20:58,8993072254056,MELROSE COTTON BUDS KCL,1,3000,0,3000,2450,550
8/17/2021 21:02,8998866501026,MINYAK GORENG SEDAAP POUCH 1 L,1,15000,0,15000,14110,890
8/17/2021 21:02,ARG,ARGUS 220ML,1,14500,0,14500,13300,1200
8/17/2021 21:02,8994867007161,ROKOK PENA GOLD 20,1,17000,0,17000,15500,1500
8/17/2021 21:05,8886013213208,FRENCH FREIS 2000,3,5000,0,15000,11250,3750
8/17/2021 21:09,8992761166052,FRESTEA MELATI 350ML,1,4500,0,4500,3000,1500
8/17/2021 21:10,8998866200837,NOODLE SEDAAPMIE SOTO CUP 81 GR,1,4500,0,4500,3738,762
8/17/2021 21:31,YP,YUPI,12,250,0,3000,2496,504
8/17/2021 21:32,089686060102,POP MIE PEDE GLEDEEK,1,5000,0,5000,4450,550
8/17/2021 21:36,8998866200325,MIE SEDAAP SOTO,1,2700,0,2700,2331,369
8/17/2021 21:36,8998866202343,MIE SEDAAP KOREAN SPICY,1,2700,0,2700,2413,287
8/17/2021 21:36,8991188943536,SASA SANTAN KELAPA 65ML,2,3000,0,6000,4874,1126
8/17/2021 21:41,8992761166205,FRESTEA GREEN HONEY 350ML,1,4500,0,4500,3000,1500
8/17/2021 21:43,8998866201841,GOLDA DOLCE LATTE 200ML,1,3000,0,3000,2500,500
8/17/2021 21:43,PRG,PARAGO,2,500,0,1000,800,200
8/17/2021 21:57,089686017748,SARIMIE GORENG ISI 2,1,3500,0,3500,3120,380
8/17/2021 21:57,8998866202602,KRISBEE FRENCH FRIES 18GR,1,2000,0,2000,1500,500
8/17/2021 21:58,8992946512223,SHINZUI,1,4000,0,4000,2500,1500
8/17/2021 22:04,8999999049409,REXONA MEN ICE COOL 45 ML,2,15000,0,30000,27100,2900
8/17/2021 22:04,8999999049478,REXONA WMN RO NATURALS BIO 45 ML,1,16500,0,16500,14900,1600
8/17/2021 22:11,8996001600641,TORA CAPPUCINO,1,3500,0,3500,2750,750
8/17/2021 22:11,089686021127,INTER MIE KALDU,3,1000,0,3000,2439,561
8/17/2021 22:12,8997027300089,NOMOS,1,4000,0,4000,2963,1037
8/17/2021 22:19,8999999027056,LIFEBUOY ANTI KETOMBE 9ML,2,5000,0,10000,9000,1000
8/17/2021 22:22,8993072254018,MELROSE COTTON BUDS BSR,2,5000,0,10000,8100,1900
8/17/2021 22:24,8993083929912,BISKITOP ASSORTED WAFER STICK,1,30000,0,30000,28400,1600
8/17/2021 22:26,8991102381024,FULLO VNL PCK,2,10000,0,20000,18000,2000
8/17/2021 22:26,8991188943536,SASA SANTAN KELAPA 65ML,1,3000,0,3000,2437,563
8/17/2021 22:28,8991111101408,JB POWDER 50G,1,3500,0,3500,3000,500
8/17/2021 22:29,8998989110167,SURYA GUDANG GARAM 16 FILTER,1,25000,0,25000,23200,1800
8/17/2021 22:30,BALON,BALON CABUT,4,1000,0,4000,3600,400
8/17/2021 22:31,VTM,VITAMIN CIMIN,3,500,0,1500,1275,225
8/17/2021 22:32,089686010107,INDOMIE KALDU AYAM,2,2500,0,5000,4300,700
8/17/2021 22:35,8998866609029,DAIA PUTIH GUSSWET 565G,1,10000,0,10000,8700,1300
8/17/2021 22:39,8992628020152,BIMOLI POUCH 2L,1,31000,0,31000,29800,1200
8/17/2021 22:39,ARG,ARGUS 220ML,1,14500,0,14500,13300,1200
8/17/2021 22:40,8991102303309,WFR TANGO SBJ 176G,2,10000,0,20000,17388,2612
8/17/2021 22:43,8991102987875,WFR TANGO POUCH CKL 115G,1,8000,0,8000,6786,1214
8/17/2021 22:43,8998009010569,ULTRA CHO 200,2,5000,0,10000,7660,2340
8/17/2021 22:47,8991102320184,TANGO CHOCO JAVAMOCCA,1,5000,0,5000,4330,670
8/17/2021 22:49,8998866202626,Top Kopi Gula Aren 22gr,2,1000,0,2000,1660,340
8/17/2021 22:49,8991102989381,TANGO LONG BUBBLEGUM 130G,1,5000,0,5000,4345,655
8/17/2021 22:52,8992761139018,ADES 600ML,1,3500,0,3500,2292,1208
8/17/2021 22:53,8998898830125,KKB ENER-G ANGGUR,1,5500,0,5500,4824,676
8/17/2021 22:54,RT MNTG,ROTI SISIR MENTEGA,2,2000,0,4000,3200,800
8/17/2021 22:55,GL,GULA 1 LITER,1,11500,0,11500,10500,1000
8/17/2021 22:57,YP,YUPI,20,250,0,5000,4160,840
8/17/2021 22:58,8991002105409,KOPI KAPAL API,1,20000,0,20000,18888,1112
8/17/2021 23:09,8998866500135,HERSPROTEX SOFTCARE WINGS,2,5500,0,11000,9640,1360
8/17/2021 23:10,8998866202770,MIE SEDAAP SALERO PADANG,1,2500,0,2500,2362,138
8/17/2021 23:12,8998866201377,KRISBEE FRIES KENTANG GORENG 68 GR,2,5500,0,11000,9240,1760
8/17/2021 23:15,8999909003439,MARLBORO CRAFTED 12,1,8000,0,8000,7250,750
8/17/2021 23:15,123124,KOREK BIASA,1,2000,0,2000,1300,700
8/17/2021 23:16,8991102714860,MILKIDO STRAW,2,3000,0,6000,4306,1694
8/17/2021 23:19,8994834006128,TICTIC PEDAS,1,2000,0,2000,1700,300
8/17/2021 23:19,ROTI,ROTI 2000,3,2000,0,6000,5400,600
8/17/2021 23:20,8992761002015,COCA COLA PET 390ML,1,5500,0,5500,4333,1167
8/17/2021 23:20,8992761166038,MMP ORANGE 300ML,1,5000,0,5000,3750,1250
8/17/2021 23:21,8998989500166,GUDANG GARAM MERAH BESAR 16KS,1,18000,0,18000,17000,1000
8/17/2021 23:21,123124,KOREK BIASA,1,2000,0,2000,1300,700
8/17/2021 23:23,8991102714860,MILKIDO STRAW,1,3000,0,3000,2153,847
8/17/2021 23:23,8998866202770,MIE SEDAAP SALERO PADANG,1,2500,0,2500,2362,138
8/18/2021 12:09,ARG,ARGUS 220ML,2,14500,0,29000,26600,2400
8/18/2021 12:09,8996001600269,LE MINERAL 600ML,1,3000,0,3000,1688,1312
8/18/2021 12:14,8992959117583,SFX DS REG FLOW WING 20,1,5000,0,5000,4288,712
8/18/2021 12:18,9556001004673,MILO NESTLE MALAYSIA ACTIVE GO,1,85000,0,85000,80000,5000
8/18/2021 12:38,8998866200561,EKOMIE SUPER 600GR,4,10000,0,40000,34460,5540
8/18/2021 12:40,8995333060703,TERIGU KOMPAS 1KG,1,10500,0,10500,9816,684
8/18/2021 12:42,089686060102,POP MIE PEDE GLEDEEK,1,5000,0,5000,4450,550
8/18/2021 12:45,PRG,PARAGO,1,500,0,500,400,100
8/18/2021 12:46,8998989500166,GUDANG GARAM MERAH BESAR 16KS,1,18000,0,18000,17000,1000
8/18/2021 12:48,8998989500166,GUDANG GARAM MERAH BESAR 16KS,1,18000,0,18000,17000,1000
8/18/2021 16:44,8992696404441,BEAR BRAND 189ML,14,9000,0,126000,110418,15582
8/18/2021 17:06,8998866605106,CLING BIRU BTL 440ML,1,8500,0,8500,7600,900
8/18/2021 17:06,8998866601429,POWDET DAIA BUNGA BAG 290GR,1,5000,0,5000,4450,550
8/18/2021 17:06,8998866608459,POWDET DAIA PUTIH BAG 290GR,1,5000,0,5000,4450,550
8/18/2021 17:06,8999999706180,PEPSODENT WHITE 190GR,1,10000,0,10000,9350,650
8/18/2021 18:18,8991002105409,KOPI KAPAL API,1,20000,0,20000,18888,1112
8/18/2021 18:31,8886013213208,FRENCH FREIS 2000,2,5000,0,10000,7500,2500
8/18/2021 18:57,8994420107789,SARDEN SAUS TOMAT,1,7000,0,7000,5833,1167
8/18/2021 18:58,8997028590014,ARGUS 220ML,2,500,0,1000,604,396
8/18/2021 19:09,8998989300261,GUDANG GARAM SURYA 12 FILTER,1,18500,0,18500,17200,1300
8/18/2021 19:13,8996001600375,LE MINERAL 330ML,1,2000,0,2000,1417,583
8/18/2021 19:13,8886013257400,TWISTKO,2,1000,0,2000,1800,200
8/18/2021 19:13,ff,FULLO BLASTO,1,1000,0,1000,995,5
8/18/2021 19:16,8996001600399,LE MINERAL 1500ML,4,5000,0,20000,16168,3832
8/18/2021 19:16,8997018720469,TISSUE SE-KA,1,10000,0,10000,9300,700
8/18/2021 19:16,8998989110167,SURYA GUDANG GARAM 16 FILTER,1,25000,0,25000,23200,1800
8/18/2021 19:19,ff,FULLO BLASTO,1,1000,0,1000,995,5
8/18/2021 19:28,8998989110167,SURYA GUDANG GARAM 16 FILTER,1,25000,0,25000,23200,1800
8/18/2021 19:28,8999999056841,PONDS WB SKIN PERFCTNG CRM NRML 20G,1,20000,0,20000,18185,1815
8/18/2021 19:28,8991111111964,C&C FACIAL WASH 50ML,1,12000,0,12000,10870,1130
8/18/2021 19:28,8998866611220,FRES&NATURAL PUTIH 100ML,1,11500,0,11500,10310,1190
8/18/2021 19:28,8992775000076,GERY SNACK RING CKLT,1,2000,0,2000,1712,288
8/18/2021 19:28,8991002105584,KAPAL API 6.5 G,4,500,0,2000,1560,440
8/18/2021 19:28,TBR,TEPUNG BERAS ROSE BRAND,1,8000,0,8000,5800,2200
8/18/2021 19:31,8998989110167,SURYA GUDANG GARAM 16 FILTER,1,25000,0,25000,23200,1800
8/18/2021 19:47,8992753100101,BKM FULL CREAM GOLD 370,2,15000,0,30000,28000,2000
8/18/2021 19:47,8992696404441,BEAR BRAND 189ML,2,9000,0,18000,15774,2226
8/18/2021 19:47,8993072254018,MELROSE COTTON BUDS BSR,1,5000,0,5000,4050,950
8/18/2021 19:49,8999099920691,SGM 1+ MADU 1000G,1,85000,0,85000,78510,6490
8/18/2021 20:20,8993989311699,CLAS MILD 16 FILTER,1,23000,0,23000,21700,1300
8/18/2021 20:58,8996001600269,LE MINERAL 600ML,4,3000,0,12000,6752,5248
8/18/2021 21:08,089686611878,QTELA TEMPE,1,6000,0,6000,5370,630
8/18/2021 21:08,8994834006128,TICTIC PEDAS,1,2000,0,2000,1700,300
8/18/2021 21:08,8991111101408,JB POWDER 50G,1,3500,0,3500,3000,500
8/18/2021 21:22,8999999024789,VASELINE PERFECT 10 PJ 200ML,1,33500,0,33500,30855,2645
8/18/2021 21:23,8992775214008,Garuda Kacang Atom,2,1000,0,2000,1620,380
8/18/2021 21:25,089686021141,INTER MIE SOTO,3,1000,0,3000,2562,438
8/18/2021 21:26,8999909002821,MARLBORO BLACK 16,1,22000,0,22000,20850,1150
8/18/2021 21:33,ARG,ARGUS 220ML,3,14500,0,43500,39900,3600
8/18/2021 21:58,8997025914059,HATARI SEE HONG,1,6000,0,6000,4911,1089
8/18/2021 21:58,8992775315095,GERY MALKIST SWEET CHEESE,1,6500,0,6500,5516,984
8/18/2021 21:59,8996001318430,BETTER 1000,2,1000,0,2000,1640,360
8/18/2021 21:59,GGK,PLAYGUM PERMEN KARET,1,500,0,500,400,100
8/18/2021 22:11,SFX,SOFTEX DAUN SIRIH 1,10,500,0,5000,4130,870
8/18/2021 22:12,8996001600269,LE MINERAL 600ML,1,3000,0,3000,1688,1312
8/18/2021 22:13,8992761002022,SPRITE PET 390ML,1,5500,0,5500,4300,1200
8/18/2021 22:14,089686386011,BUMBU RACIK NASI GORENG,3,2000,0,6000,4350,1650
8/18/2021 22:18,8992959954034,SWEETY BRONZE NB 24,1,29000,0,29000,26762,2238
8/18/2021 22:28,8996001600399,LE MINERAL 1500ML,2,5000,0,10000,8084,1916
8/18/2021 22:30,089686041705,INDOMIE GORENG JUMBO,1,3500,0,3500,3143,357
8/18/2021 22:33,089686043051,INDOMIE COTO MAKASSAR,2,2800,0,5600,5050,550
8/19/2021 10:24,ARG,ARGUS 220ML,2,14500,0,29000,26600,2400
8/19/2021 10:24,8999999042646,RINSO MOLTO ROSE FRESH LIQ 40ML,2,1000,0,2000,1604,396
8/19/2021 10:53,8992717781001,NATA DE COCO,1,13000,0,13000,12083,917
8/19/2021 10:53,8992933214116,NUTRIJELL MELON,1,6000,0,6000,5041,959
8/19/2021 10:53,8992933216110,NUTRIJELL MANGO,2,6000,0,12000,9900,2100
8/19/2021 10:53,8992933219111,NUTRIJELL CINCAU,1,6000,0,6000,5000,1000
8/19/2021 10:53,8992933215113,NUTRIJELL TANPA RASA,1,6000,0,6000,4950,1050
8/19/2021 10:53,8997018720018,SIRUP DHT,1,23000,0,23000,20958,2042
8/19/2021 10:57,8992761164478,FRESTEA MILK TEA,1,8000,0,8000,6575,1425
8/19/2021 11:07,8997028590014,ARGUS 220ML,2,500,0,1000,604,396
8/19/2021 11:09,8997028590014,ARGUS 220ML,2,500,0,1000,604,396
8/19/2021 11:09,8886030322907,PORSTEX BIRU 500ML,1,15500,0,15500,13000,2500
8/19/2021 11:12,8992696405417,DNCO INSTANT 27G,5,3500,0,17500,15000,2500
8/19/2021 11:37,8998009020186,BUAVITA GUAVA 250ML,1,7000,0,7000,6083,917
8/19/2021 11:37,8996001600375,LE MINERAL 330ML,2,2000,0,4000,2834,1166
8/19/2021 11:45,8992775203422,GARUDA ROSTA OVEN 100G,1,8000,0,8000,7322,678
8/19/2021 11:45,8996001600375,LE MINERAL 330ML,1,2000,0,2000,1417,583
8/19/2021 11:48,8998866202923,FLORIDINA COCO,1,3000,0,3000,2500,500
8/19/2021 11:50,8998866500708,FLORIDINA ORANGE,1,3000,0,3000,2500,500
8/19/2021 11:51,9556001047175,NESCAFE ORI 240ML,1,8500,0,8500,7834,666
8/19/2021 11:51,9556001051509,MILO ACT GO HICAL 240ML,1,8500,0,8500,7437,1063
8/19/2021 12:14,8998866692601,SOKLIN FLOORCLENER HIJAU 450ML,1,7000,0,7000,6385,615
8/19/2021 12:14,8993226112508,GARAM REFINA,1,3000,0,3000,2461,539
8/19/2021 12:14,8991111112206,C&C DEEP ACTION CLEANSER 50G,1,14000,0,14000,12900,1100
8/19/2021 12:15,8992761166038,MMP ORANGE 300ML,1,5000,0,5000,3750,1250
8/19/2021 12:23,8992775610008,TING-TING GARUDA 2.5G,1,7500,0,7500,6296,1204
8/19/2021 12:25,8998866105491,EMERON LOVELY SMOTH&BRIGHT 100ML,1,4300,0,4300,3800,500
8/19/2021 12:25,8992775610008,TING-TING GARUDA 2.5G,1,7500,0,7500,6296,1204
8/19/2021 12:32,8996001600269,LE MINERAL 600ML,1,3000,0,3000,1688,1312
8/19/2021 14:49,8991102714860,MILKIDO STRAW,1,3000,0,3000,2153,847
8/19/2021 19:11,8999999524838,SUNLIGHT MINT POUCH 755ML,1,17000,0,17000,15400,1600
8/19/2021 19:11,8998009020186,BUAVITA GUAVA 250ML,1,7000,0,7000,6083,917
8/19/2021 19:12,8995102703534,TERASI DUO 6 GR,1,4000,0,4000,3720,280
8/19/2021 19:30,8998989300391,SURYA PRO PUTIH,2,20000,0,40000,37200,2800
8/19/2021 19:39,8991004011906,KOPI BORONG,1,10000,0,10000,8333,1667
8/19/2021 19:39,GL,GULA 1 LITER,1,11500,0,11500,10500,1000
8/19/2021 19:39,8999999524807,SUNLIGHT HABBATUSSAUDA POUCH 755ML,1,17000,0,17000,15400,1600
8/19/2021 19:39,089686060102,POP MIE PEDE GLEDEEK,1,5000,0,5000,4450,550
8/19/2021 19:39,089686535242,SUN PISANG SUSU,1,8500,0,8500,7410,1090
8/19/2021 19:55,8998989300261,GUDANG GARAM SURYA 12 FILTER,1,19000,0,19000,17700,1300
8/19/2021 19:59,8994420100018,SARDEN SAUS PEDAS,1,7000,0,7000,5833,1167
8/19/2021 20:01,8991004011906,KOPI BORONG,1,10000,0,10000,8333,1667
8/19/2021 20:01,8998866501026,MINYAK GORENG SEDAAP POUCH 1 L,5,15000,0,75000,70550,4450
8/19/2021 20:02,ARG,ARGUS 220ML,1,14500,0,14500,13300,1200
8/19/2021 20:03,ARG,ARGUS 220ML,3,14500,0,43500,39900,3600
8/19/2021 20:04,8995333032113,TERIGU GATOT KACA 1 KG,1,8500,0,8500,8012,488
8/19/2021 20:04,8995333060772,TERIGU GATOT KACA 500GR,1,4500,0,4500,4065,435
8/19/2021 20:05,8991004011906,KOPI BORONG,1,10000,0,10000,8333,1667
8/19/2021 20:06,089686386127,BUMBU RACIK NASI GORENG SOSIS,1,2000,0,2000,1620,380
8/19/2021 20:06,8992702000063,INDOMILK COKLAT 370G,1,10000,0,10000,9020,980
8/19/2021 20:08,8998989300261,GUDANG GARAM SURYA 12 FILTER,1,19000,0,19000,17700,1300
8/19/2021 20:11,8996001305058,ROMA SANDWICH KACANG,1,7000,0,7000,5000,2000
8/19/2021 20:12,8991188943536,SASA SANTAN KELAPA 65ML,2,3000,0,6000,4874,1126
8/19/2021 20:15,8993226365522,GARAM MEJA GYURI 200GR,2,2000,0,4000,3400,600
8/19/2021 20:18,8992753100101,BKM FULL CREAM GOLD 370,2,15000,0,30000,28000,2000
8/19/2021 20:26,ARG,ARGUS 220ML,1,14500,0,14500,13300,1200
8/19/2021 20:26,LT,LIPSTIK HANASUI,1,27000,0,27000,27000,0
8/19/2021 20:27,089686021141,INTER MIE SOTO,2,1000,0,2000,1708,292
8/19/2021 20:28,8994834006128,TICTIC PEDAS,1,2000,0,2000,1700,300
8/19/2021 20:30,089686067002,POP MIE PDS DOWER RS AYAM,1,5000,0,5000,4450,550
8/19/2021 20:31,8886013213208,FRENCH FREIS 2000,2,5000,0,10000,7500,2500
8/19/2021 20:33,8999999042639,RINSO ANTI NODA CLS LIQ 40ML,2,1000,0,2000,1610,390
8/19/2021 20:35,8998989300261,GUDANG GARAM SURYA 12 FILTER,1,19000,0,19000,17700,1300
8/19/2021 20:36,8997025914059,HATARI SEE HONG,1,6000,0,6000,4911,1089
8/19/2021 20:38,089686048704,SARIMIE GORENG AYAM KCP ISI 2,1,3500,0,3500,3120,380
8/19/2021 20:38,8998989110167,SURYA GUDANG GARAM 16 FILTER,1,25000,0,25000,23700,1300
8/19/2021 20:38,8997018720469,TISSUE SE-KA,1,10000,0,10000,9300,700
8/19/2021 20:40,8996001600269,LE MINERAL 600ML,5,3000,0,15000,8440,6560
8/19/2021 20:43,RB,RED BOLD,1,19000,0,19000,17900,1100
8/19/2021 20:43,CLUB,AIR CLUB 600ML,1,3000,0,3000,1452,1548
8/19/2021 20:44,8886001038011,BENG-BENG SCT,2,1500,0,3000,2900,100
8/19/2021 20:46,8997025911058,HATARI SHP KELAPA,1,6000,0,6000,4911,1089
8/19/2021 20:47,8999909982000,SAMPOERNA 12 FILTER,1,18000,0,18000,16000,2000
8/19/2021 20:47,MBL,MOBIL,1,5000,0,5000,3500,1500
8/19/2021 20:47,8996001600269,LE MINERAL 600ML,1,3000,0,3000,1688,1312
8/19/2021 20:48,8992761166038,MMP ORANGE 300ML,1,5000,0,5000,3750,1250
8/19/2021 20:49,8997013790108,BIMURA KACANG TELUR 25G,2,1000,0,2000,1750,250
8/19/2021 20:54,8998898830125,KKB ENER-G ANGGUR,1,5500,0,5500,4824,676
8/19/2021 20:54,8999999059781,SUNLIGHT LIME NEW POUCH 210ML,1,5000,0,5000,4300,700
8/19/2021 21:03,8999999710873,PEPSODENT ACTION123 HERBAL 120G,1,11400,0,11400,10400,1000
8/19/2021 21:05,8997011700123,BIHUN JAGUNG 300GR,1,6000,0,6000,4979,1021
8/19/2021 21:08,8996001355756,BENG-BENG MAXX SCT,5,2500,0,12500,10205,2295
8/19/2021 21:09,8992959117583,SFX DS REG FLOW WING 20,1,5000,0,5000,4288,712
8/19/2021 21:10,8998989500166,GUDANG GARAM MERAH BESAR 16KS,1,18000,0,18000,17000,1000
8/19/2021 21:13,8994867007161,ROKOK PENA GOLD 20,1,17000,0,17000,15500,1500
8/19/2021 21:13,8998009020186,BUAVITA GUAVA 250ML,1,7000,0,7000,6083,917
8/19/2021 21:15,KPS,KAPAS MEI QIAN,1,5000,0,5000,4750,250
8/19/2021 21:18,8991909101016,URBAN MILD 16,1,17000,0,17000,15800,1200
8/19/2021 21:22,8999999048259,SUNSILK  SOFT&SMOOTH 70+21ML,1,9400,0,9400,8525,875
8/19/2021 21:22,089686043204,INDOMIE MIE ACEH,1,2700,0,2700,2452,248
8/19/2021 21:22,8998866203104,MIE SEDAAP SINGAPORE,1,2500,0,2500,2266,234
8/19/2021 21:22,8998989300261,GUDANG GARAM SURYA 12 FILTER,1,19000,0,19000,17700,1300
8/19/2021 21:28,RT,ROTI,1,9000,0,9000,8000,1000
8/19/2021 21:29,8992761139018,ADES 600ML,2,3500,0,7000,4584,2416
8/19/2021 21:31,LT,LIPSTIK HANASUI,1,27000,0,27000,27000,0
8/19/2021 21:36,089686010107,INDOMIE KALDU AYAM,2,2500,0,5000,4300,700
8/19/2021 21:37,KLOP,KLOP SALUTO,1,16000,0,16000,14545,1455
8/19/2021 21:46,8991102320184,TANGO CHOCO JAVAMOCCA,1,5000,0,5000,4330,670
8/19/2021 21:47,8992775315057,GERY SALUT MALKIST COKLAT,1,6500,0,6500,5516,984
8/19/2021 21:51,8995333060772,TERIGU GATOT KACA 500GR,1,4500,0,4500,4065,435
8/19/2021 22:03,8998866202312,NOODLE SEDAAP TASTY BAKMI AYAM 129 GR,2,5000,0,10000,8334,1666
8/19/2021 22:03,8996001370063,CHOKI-CHOKI,1,18200,0,18200,16500,1700
8/19/2021 22:03,8996001440520,ENERGEN JAGUNG,1,1500,0,1500,1150,350
8/19/2021 22:03,8991002330504,RELAXA MANGO MINT,1,5000,0,5000,4500,500
8/19/2021 22:03,8998866202671,NOODLE SEDAAP MIE KOREAN SPICY SOUP CUP,2,5000,0,10000,8004,1996
8/19/2021 22:03,8994834006128,TICTIC PEDAS,1,2000,0,2000,1700,300
8/19/2021 22:03,8998866202404,NOODLE SEDAAP MIE KOREAN SPICY CHICKEN CUP,1,5000,0,5000,4002,998
8/19/2021 22:03,BB,PASEO SMARTY FACIAL TRAVEL PACK 50S GT,1,3000,0,3000,1980,1020
8/19/2021 22:18,8992959953099,SWEETY BRONZE XL7,1,16000,0,16000,15190,810
8/19/2021 22:21,089686043273,INDOMIE SAMBAL RICA,1,2700,0,2700,2452,248
8/19/2021 22:21,089686010343,INDOMIE SOTO MIE,1,2600,0,2600,2367,233
8/19/2021 22:21,8998989300261,GUDANG GARAM SURYA 12 FILTER,1,19000,0,19000,17700,1300
8/19/2021 22:24,8999999059781,SUNLIGHT LIME NEW POUCH 210ML,1,5000,0,5000,4300,700
8/19/2021 22:31,8999909010567,234 DJI SAM SOE 16,1,22000,0,22000,21500,500
8/19/2021 22:32,8998989110167,SURYA GUDANG GARAM 16 FILTER,1,25000,0,25000,23700,1300
8/20/2021 10:09,8999999516208,ROYCO FDS CHICKEN NEW 230G,1,10000,0,10000,9000,1000
8/20/2021 10:09,8998866501026,MINYAK GORENG SEDAAP POUCH 1 L,5,15000,0,75000,70550,4450
8/20/2021 10:24,8994834006128,TICTIC PEDAS,2,2000,0,4000,3400,600
8/20/2021 10:24,8991102714860,MILKIDO STRAW,1,3000,0,3000,2153,847
8/20/2021 10:34,8991102320184,TANGO CHOCO JAVAMOCCA,2,5000,0,10000,8660,1340
8/20/2021 10:36,8992775610008,TING-TING GARUDA 2.5G,1,7500,0,7500,6296,1204
8/20/2021 10:44,ROTI,ROTI 2000,1,2000,0,2000,1800,200
8/20/2021 10:44,8991102320184,TANGO CHOCO JAVAMOCCA,1,5000,0,5000,4330,670
8/20/2021 10:44,8998866692601,SOKLIN FLOORCLENER HIJAU 450ML,1,7000,0,7000,6385,615
8/20/2021 10:44,8999999059781,SUNLIGHT LIME NEW POUCH 210ML,1,5000,0,5000,4300,700
8/20/2021 10:46,8998009020186,BUAVITA GUAVA 250ML,1,7000,0,7000,6083,917
8/20/2021 10:49,8999909028234,234 DJI SAM SOE 12,1,17000,0,17000,15850,1150
8/20/2021 10:54,8992761164546,NUTRIBOOST STRAWBERRY 300ML,2,6500,0,13000,10600,2400
8/20/2021 10:54,8991001121400,SILVERQUEEN ALMOND 65G,2,15000,0,30000,26400,3600
8/20/2021 11:31,8991102989381,TANGO LONG BUBBLEGUM 130G,2,5000,0,10000,8690,1310
8/20/2021 11:42,8996001600269,LE MINERAL 600ML,1,3000,0,3000,1688,1312
8/20/2021 12:01,8998989300261,GUDANG GARAM SURYA 12 FILTER,1,19000,0,19000,17700,1300
8/20/2021 12:01,6907992824963,JD MILKY CHOCOLATE,1,3000,0,3000,2600,400
8/20/2021 12:02,6907992824963,JD MILKY CHOCOLATE,1,3000,0,3000,2600,400
8/20/2021 12:02,8998989300261,GUDANG GARAM SURYA 12 FILTER,1,19000,0,19000,17700,1300
8/20/2021 12:09,089686043273,INDOMIE SAMBAL RICA,1,2700,0,2700,2452,248
8/20/2021 12:09,8993989311279,CLAS MILD 12,1,17000,0,17000,15700,1300
8/20/2021 12:37,8992775311325,GERY SNACK&SEREAL 100G,1,7000,0,7000,6012,988
8/20/2021 12:37,8996001355756,BENG-BENG MAXX SCT,2,2500,0,5000,4082,918
8/20/2021 12:37,8886001038011,BENG-BENG SCT,4,1500,0,6000,5800,200
8/20/2021 12:37,8992761002022,SPRITE PET 390ML,1,5500,0,5500,4300,1200
8/20/2021 12:37,8992696523067,MILO ACTVGO UHT 180ML,1,4500,0,4500,3515,985
8/20/2021 12:37,8998866202923,FLORIDINA COCO,1,3000,0,3000,2500,500
8/20/2021 13:01,8991002307209,COFFE CANDY,1,5000,0,5000,4500,500
8/20/2021 13:02,8999909982000,SAMPOERNA 12 FILTER,1,18000,0,18000,16000,2000
8/20/2021 18:03,8998009010569,ULTRA CHO 200,2,5000,0,10000,7660,2340
8/20/2021 18:03,8998866202060,POTABEE AYAM BAKAR PEDAS 35 GR,3,5000,0,15000,12450,2550
8/20/2021 18:03,8997218380135,ICHITAN GREEN TEA,3,8000,0,24000,19749,4251
8/20/2021 18:03,8998866202435,JAPOTA UMAMI JAPANESE SEAWEED 35GR,3,5000,0,15000,12450,2550
8/20/2021 18:03,8991102987875,WFR TANGO POUCH CKL 115G,1,8000,0,8000,6786,1214
8/20/2021 18:03,8991102320184,TANGO CHOCO JAVAMOCCA,1,5000,0,5000,4330,670
8/20/2021 18:03,8998009020186,BUAVITA GUAVA 250ML,1,7000,0,7000,6083,917
8/20/2021 18:03,8991102714860,MILKIDO STRAW,1,3000,0,3000,2153,847
8/20/2021 18:03,8998866201865,KRISBEE PILLOW CHOCOLAVA 120 GR,1,8000,0,8000,7250,750
8/20/2021 18:04,8996001338056,TAMARIN,1,6000,0,6000,5100,900
8/20/2021 18:04,8999999034726,PONDS MEN WHITE BOOST 50G,1,18500,0,18500,17160,1340
8/20/2021 19:36,8992959020012,SWEETY SILVER PANTS XL 34,1,78000,0,78000,73637,4363
8/20/2021 20:44,8992761166038,MMP ORANGE 300ML,1,5000,0,5000,3750,1250
8/20/2021 20:45,8996001305003,SARI GANDUM SANDWICH,1,6000,0,6000,5100,900
8/20/2021 20:47,RB,RED BOLD,1,19000,0,19000,17900,1100
8/20/2021 20:56,8999909096004,SAMPOERNA 16 FILTER,1,24000,0,24000,23000,1000
8/20/2021 20:56,8997018250218,JAHE MERAH,3,1000,0,3000,2499,501
8/20/2021 20:56,8998866201865,KRISBEE PILLOW CHOCOLAVA 120 GR,1,8000,0,8000,7250,750
8/20/2021 20:56,8886001038011,BENG-BENG SCT,2,1500,0,3000,2900,100
8/20/2021 20:56,PRG,PARAGO,4,500,0,2000,1600,400
8/20/2021 20:56,8991111109107,JB POWDER BEDTIME 75+25g,1,6000,0,6000,5440,560
8/20/2021 20:58,TEMBAK,TEMBAK SNIPPER,1,3500,0,3500,2500,1000
8/20/2021 21:00,PUL,PULPEN,4,1500,0,6000,3332,2668
8/20/2021 21:04,8998989110167,SURYA GUDANG GARAM 16 FILTER,1,25000,0,25000,23700,1300
8/20/2021 21:04,ROTI,ROTI 2000,10,2000,0,20000,18000,2000
8/20/2021 21:05,8997018720018,SIRUP DHT,1,23000,0,23000,20958,2042
8/20/2021 21:16,ROTI,ROTI 2000,2,2000,0,4000,3600,400
8/20/2021 21:16,8997009510116,LEMON WATER,1,7000,0,7000,5694,1306
8/20/2021 21:16,8992761002039,FANTA STRAWBERRY PET 390 ML,1,5500,0,5500,4300,1200
8/20/2021 21:16,8992761139018,ADES 600ML,1,3500,0,3500,2292,1208
8/20/2021 21:16,8991102714860,MILKIDO STRAW,1,3000,0,3000,2153,847
8/20/2021 21:16,089686611618,QTELA BARBEQUE,4,5000,0,20000,17064,2936
8/20/2021 21:16,8997018720469,TISSUE SE-KA,1,10000,0,10000,9300,700
8/20/2021 21:16,8999909096004,SAMPOERNA 16 FILTER,1,24000,0,24000,23000,1000
8/20/2021 21:16,8997218380135,ICHITAN GREEN TEA,3,8000,0,24000,19749,4251
8/20/2021 21:16,RB,RED BOLD,1,19000,0,19000,17900,1100
8/20/2021 21:20,8993470411433,JOGER CLASSIC,8,1000,0,8000,6800,1200
8/20/2021 21:25,8999999524722,SUNLIGHT LIME NEW PCH 435ML,1,10000,0,10000,9100,900
8/20/2021 21:25,8992775002933,GERY MALKIST DOUBLE ABON,2,6500,0,13000,11032,1968
8/20/2021 21:27,ROTI,ROTI 2000,1,2000,0,2000,1800,200
8/20/2021 21:27,8991909101016,URBAN MILD 16,1,17000,0,17000,15800,1200
8/20/2021 21:27,8992761139018,ADES 600ML,1,3500,0,3500,2292,1208
8/20/2021 21:32,089686044249,SUPERMI NUTRIMI STEAK AYAM,1,3500,0,3500,2800,700
8/20/2021 21:32,089686021141,INTER MIE SOTO,2,1000,0,2000,1708,292
8/20/2021 21:32,TORT,TORTILA,2,1000,0,2000,2000,0
8/20/2021 21:35,8994834001901,SUKI,1,1000,0,1000,761,239
8/20/2021 21:45,8999801700030,SUSU FOYU,1,11500,0,11500,10450,1050
8/20/2021 21:47,ROTI,ROTI 2000,3,2000,0,6000,5400,600
8/20/2021 22:05,8999999195649,SARI WANGI 25X1.86G,1,6000,0,6000,5050,950
8/20/2021 22:05,8997011700123,BIHUN JAGUNG 300GR,2,6000,0,12000,9958,2042
8/20/2021 22:35,8998866501026,MINYAK GORENG SEDAAP POUCH 1 L,1,15000,0,15000,14110,890
8/20/2021 22:35,8993226112508,GARAM REFINA,1,3000,0,3000,2461,539
8/20/2021 22:35,8998866202626,Top Kopi Gula Aren 22gr,10,1000,0,10000,8300,1700
8/20/2021 22:35,8991002105584,KAPAL API 6.5 G,4,500,0,2000,1560,440
8/20/2021 22:51,8998866604512,FRES&NATURAL SOAP VIOLET 65G,3,1800,0,5400,4275,1125
8/20/2021 22:53,8991102300544,WFR TANGO VNL 176G,1,10000,0,10000,8694,1306
8/20/2021 22:57,8993989311279,CLAS MILD 12,1,17000,0,17000,15700,1300
8/20/2021 22:59,8999908204202,MY BABY MINYAK TELON 60ML,1,18000,0,18000,16900,1100
8/20/2021 23:12,GL,GULA 1 LITER,3,11500,0,34500,31500,3000
8/21/2021 10:48,089686021219,INTER MIE GORENG,2,1000,0,2000,1770,230
8/21/2021 10:51,089686011036,INDOMIE GORENG PEDAS,1,2700,0,2700,2452,248
8/21/2021 10:54,ARG,ARGUS 220ML,1,14500,0,14500,13300,1200
8/21/2021 10:54,6907992823935,JD SWEETCORN,1,3500,0,3500,3000,500
8/21/2021 10:56,8998989300261,GUDANG GARAM SURYA 12 FILTER,1,19000,0,19000,17700,1300
8/21/2021 11:08,GL,GULA 1 LITER,1,11500,0,11500,10500,1000
8/21/2021 11:08,ARG,ARGUS 220ML,1,14500,0,14500,13300,1200
8/21/2021 11:24,6907992823843,JD MOCHA CRISPY,1,5000,0,5000,4400,600
8/21/2021 11:24,8992388133017,NU MILK TEA ORI 330ML,1,6000,0,6000,5125,875
8/21/2021 11:24,8998666002525,TB TORA CAFE CAPPUCINO,2,1000,0,2000,1560,440
8/21/2021 11:28,8991102714860,MILKIDO STRAW,8,3000,0,24000,17224,6776
8/21/2021 11:35,ARG,ARGUS 220ML,1,14500,0,14500,13300,1200
8/21/2021 12:41,8998866501026,MINYAK GORENG SEDAAP POUCH 1 L,1,15000,0,15000,14110,890
8/21/2021 13:00,8999999538453,SUNSILK SHP SOFT AND  SMOOTH 55 ML,1,5000,0,5000,3750,1250
8/21/2021 13:02,GL,GULA 1 LITER,1,11500,0,11500,10500,1000
8/21/2021 13:02,8996001305058,ROMA SANDWICH KACANG,2,7000,0,14000,10000,4000
8/21/2021 13:02,8992761002015,COCA COLA PET 390ML,1,5500,0,5500,4333,1167
8/21/2021 13:03,8992979130012,TOTAL LEMON SOFTENER,1,13000,0,13000,11532,1468
8/21/2021 13:12,6901997923072,SILET SEAGULL,1,6000,0,6000,5500,500
8/21/2021 13:15,TORT,TORTILA,2,1000,0,2000,2000,0
8/21/2021 13:31,8997210107877,VORTEX SMART 3,1,5000,0,5000,4750,250
8/21/2021 13:58,8997018460150,MARLBORO ICE BURST 20,1,30000,0,30000,27750,2250
8/21/2021 13:58,8998989300261,GUDANG GARAM SURYA 12 FILTER,1,19000,0,19000,17700,1300
8/21/2021 14:22,GL,GULA 1 LITER,2,11500,0,23000,21000,2000
8/21/2021 15:02,8993989311699,CLAS MILD 16 FILTER,1,23000,0,23000,21700,1300
8/21/2021 15:24,8999999401252,RINSO ANTI NODA CLASSIC 1.8KG,1,44800,0,44800,40726,4074
8/21/2021 15:32,8998989300261,GUDANG GARAM SURYA 12 FILTER,1,19000,0,19000,17700,1300
8/21/2021 16:05,8992775318201,GERY SNACK BANTAL COKLAT,1,2000,0,2000,1712,288
8/21/2021 16:07,8991909101016,URBAN MILD 16,1,17000,0,17000,15800,1200
8/21/2021 16:07,123124,KOREK BIASA,1,2000,0,2000,1300,700
8/21/2021 16:27,8993083929912,BISKITOP ASSORTED WAFER STICK,1,30000,0,30000,28400,1600
8/21/2021 16:27,8997011931107,Ketumbar bubuk,1,1000,0,1000,833,167
8/21/2021 16:29,8999999050009,SUNLIGHT LIME NEW POUCH 95ML,1,2000,0,2000,1600,400
8/21/2021 16:29,8993083929837,BISKITOP BLACK COOKIES,1,27000,0,27000,23700,3300
8/21/2021 16:34,8992775312469,GERY SALUT COKELAT,1,11000,0,11000,9983,1017
8/21/2021 17:11,8992388101085,NU GREEN TEA ORIGINAL 330ML,1,3500,0,3500,2854,646
8/21/2021 17:15,8886020033431,KAPUR AJAIB ANTI KECOA DAN NYAMUK,1,3000,0,3000,2700,300
8/21/2021 17:15,8997018720469,TISSUE SE-KA,2,10000,0,20000,18600,1400
8/21/2021 17:32,8996001600399,LE MINERAL 1500ML,2,5000,0,10000,8084,1916
8/21/2021 17:32,8992959954034,SWEETY BRONZE NB 24,1,29000,0,29000,26762,2238
8/21/2021 17:32,ROTI,ROTI 2000,3,2000,0,6000,5400,600
8/21/2021 17:32,8998009010569,ULTRA CHO 200,1,5000,0,5000,3830,1170
8/21/2021 17:32,8992696422650,NESCAFE FRENCH VANILLA,1,5000,0,5000,4099,901
8/21/2021 17:33,8850007090281,JB BATH MILK 500ML,1,39000,0,39000,37160,1840
8/21/2021 17:34,8999999559557,LUX BW MAGICAL ORCHID 85ML,2,5000,0,10000,8000,2000
8/21/2021 17:34,8991111101408,JB POWDER 50G,1,3500,0,3500,3000,500
8/21/2021 17:34,8998866202923,FLORIDINA COCO,1,3000,0,3000,2500,500
8/21/2021 17:38,8886013213208,FRENCH FREIS 2000,3,5000,0,15000,11250,3750
8/21/2021 17:39,8992628020152,BIMOLI POUCH 2L,1,31000,0,31000,29800,1200
8/21/2021 17:39,089686043051,INDOMIE COTO MAKASSAR,2,2800,0,5600,5050,550
8/21/2021 17:39,089686010107,INDOMIE KALDU AYAM,2,2500,0,5000,4300,700
8/21/2021 17:58,GL,GULA 1 LITER,1,11500,0,11500,10500,1000
8/21/2021 17:58,8997018720469,TISSUE SE-KA,1,10000,0,10000,9300,700
8/21/2021 18:21,089686044249,SUPERMI NUTRIMI STEAK AYAM,1,3500,0,3500,2800,700
8/21/2021 18:21,089686021219,INTER MIE GORENG,3,1000,0,3000,2655,345
8/21/2021 18:21,8994834006128,TICTIC PEDAS,1,2000,0,2000,1700,300
8/21/2021 18:23,8996001600269,LE MINERAL 600ML,1,3000,0,3000,1688,1312
8/21/2021 18:23,089686611618,QTELA BARBEQUE,1,5000,0,5000,4266,734
8/21/2021 18:32,8998989110167,SURYA GUDANG GARAM 16 FILTER,1,25000,0,25000,23700,1300
8/21/2021 19:00,8999909002821,MARLBORO BLACK 16,1,22000,0,22000,20850,1150
8/21/2021 19:00,8994867007161,ROKOK PENA GOLD 20,1,17000,0,17000,15500,1500
8/21/2021 19:01,8991102320184,TANGO CHOCO JAVAMOCCA,1,5000,0,5000,4330,670
8/21/2021 19:01,TG,TEH GELAS,1,1000,0,1000,729,271
8/21/2021 19:51,8998989500166,GUDANG GARAM MERAH BESAR 16KS,1,18000,0,18000,17000,1000
8/21/2021 19:55,ROTI,ROTI 2000,5,2000,0,10000,9000,1000
8/21/2021 19:55,8991102385060,TANGO WAFFLE CHOX,1,9000,0,9000,8498,502
8/21/2021 19:57,8992959953167,SWEETY BRONZE S36+2,1,48000,0,48000,45682,2318
8/21/2021 19:57,8996001600399,LE MINERAL 1500ML,1,5000,0,5000,4042,958
8/21/2021 20:22,8992628020152,BIMOLI POUCH 2L,1,31000,0,31000,29800,1200
8/21/2021 20:24,8992959508855,SWEETY SILVER PANTS XL 18,1,47800,0,47800,43353,4447
8/21/2021 20:36,Gula gula pulpen,gula gula pulpen,3,2000,0,6000,5250,750
8/21/2021 20:38,089686386127,BUMBU RACIK NASI GORENG SOSIS,2,2000,0,4000,3240,760
8/21/2021 20:38,089686386011,BUMBU RACIK NASI GORENG,1,2000,0,2000,1450,550
8/21/2021 20:55,6907992823843,JD MOCHA CRISPY,1,5000,0,5000,4400,600
8/21/2021 20:55,6907992823867,JD CRUNCHY CHOCOLATE MALT,1,5500,0,5500,4700,800
8/21/2021 21:17,8992959117583,SFX DS REG FLOW WING 20,1,5000,0,5000,4288,712
8/21/2021 21:17,8999999533366,VASELINE FRESH&FAIR 100ML,1,13000,0,13000,11805,1195
8/21/2021 21:26,telur,telur,2,2000,0,4000,2468,1532
8/21/2021 21:27,8991102320184,TANGO CHOCO JAVAMOCCA,1,5000,0,5000,4330,670
8/21/2021 21:27,8992761166205,FRESTEA GREEN HONEY 350ML,1,4500,0,4500,3000,1500
8/21/2021 21:43,089686010343,INDOMIE SOTO MIE,1,2600,0,2600,2367,233
8/21/2021 21:43,8998866200578,MIE SEDAAP KARI KENTAL,1,2700,0,2700,2331,369
8/21/2021 21:43,089686043273,INDOMIE SAMBAL RICA,1,2700,0,2700,2452,248
8/21/2021 22:04,ARG,ARGUS 220ML,1,14500,0,14500,13300,1200
8/21/2021 22:09,8999999518998,RINSO MOLTO PERFUME ESSENSE 770GR,1,21300,0,21300,19338,1962
8/21/2021 22:09,8991102023115,Sikat Gigi Formula,1,11000,0,11000,10000,1000
8/21/2021 22:12,8993989311699,CLAS MILD 16 FILTER,1,23000,0,23000,21700,1300
8/21/2021 22:12,8992761164478,FRESTEA MILK TEA,1,8000,0,8000,6575,1425
8/21/2021 22:36,8998866200813,NOODLE SEDAAP MIE GORENG CUP 85 GR,2,5000,0,10000,7834,2166
8/21/2021 22:36,8991102320184,TANGO CHOCO JAVAMOCCA,1,5000,0,5000,4330,670
8/21/2021 22:36,8886013213208,FRENCH FREIS 2000,1,5000,0,5000,3750,1250
8/21/2021 22:36,089686611618,QTELA BARBEQUE,1,5000,0,5000,4266,734
8/21/2021 22:36,8992775311325,GERY SNACK&SEREAL 100G,1,7000,0,7000,6012,988
8/21/2021 22:36,8996001440520,ENERGEN JAGUNG,9,1500,0,13500,10350,3150
8/21/2021 22:36,8996001600269,LE MINERAL 600ML,2,3000,0,6000,3376,2624
8/21/2021 22:36,8991001121400,SILVERQUEEN ALMOND 65G,2,15000,0,30000,26400,3600
8/22/2021 9:07,8998866202343,MIE SEDAAP KOREAN SPICY,1,2700,0,2700,2413,287
8/22/2021 9:16,8997028590014,ARGUS 220ML,1,500,0,500,302,198
8/22/2021 9:19,089686021219,INTER MIE GORENG,2,1000,0,2000,1770,230
8/22/2021 9:19,Gula gula pulpen,gula gula pulpen,1,2000,0,2000,1750,250
8/22/2021 9:31,089686021219,INTER MIE GORENG,1,1000,0,1000,885,115
8/22/2021 11:58,telur,telur,3,2000,0,6000,3702,2298
8/22/2021 12:08,8996001600269,LE MINERAL 600ML,1,3000,0,3000,1688,1312
8/22/2021 12:16,089686611618,QTELA BARBEQUE,2,5000,0,10000,8532,1468
8/22/2021 12:16,8992696521797,MILO 22G,10,2500,0,25000,15720,9280
8/22/2021 12:16,8992775318201,GERY SNACK BANTAL COKLAT,2,2000,0,4000,3424,576
8/22/2021 12:16,8991002121003,GOOD DAY TIRAMISU BLISS,2,6000,0,12000,8590,3410
8/22/2021 12:16,ARG,ARGUS 220ML,1,14500,0,14500,13300,1200
8/22/2021 15:14,ARG,ARGUS 220ML,1,14500,0,14500,13300,1200
8/22/2021 15:18,8999909000711,MAGNUM MILD 16,1,21000,0,21000,19350,1650
8/22/2021 15:19,8886057883665,KRATING DAENG,1,6000,0,6000,4286,1714
8/22/2021 15:19,ROTI,ROTI 2000,1,2000,0,2000,1800,200
8/22/2021 15:23,8994867006997,ROKOK PENA BOLD 20BTG,1,17000,0,17000,15000,2000
8/22/2021 15:33,8998866202060,POTABEE AYAM BAKAR PEDAS 35 GR,1,5000,0,5000,4150,850
8/22/2021 15:33,089686611878,QTELA TEMPE,1,6000,0,6000,5370,630
8/22/2021 15:33,8992761166052,FRESTEA MELATI 350ML,3,4500,0,13500,9000,4500
8/22/2021 15:33,8995150101771,M+SUSU RASA JERUK,1,5000,0,5000,4000,1000
8/22/2021 15:37,8998666001924,TB TORA CAFE CHOCO LATTE,3,1000,0,3000,2340,660
8/22/2021 15:41,8998866202732,MILKU STROBERI 200ML,1,3000,0,3000,2375,625
8/22/2021 15:41,ROTI,ROTI 2000,1,2000,0,2000,1800,200
8/22/2021 15:42,JL,JELLY,10,500,0,5000,4000,1000
8/22/2021 16:30,8993083929912,BISKITOP ASSORTED WAFER STICK,1,30000,0,30000,28400,1600
8/22/2021 16:30,8997025914059,HATARI SEE HONG,2,6000,0,12000,9822,2178
8/22/2021 16:56,9556040040038,SUSU F&N,2,33000,0,66000,60000,6000
8/22/2021 16:56,8992761166038,MMP ORANGE 300ML,1,5000,0,5000,3750,1250
8/22/2021 16:56,8992761166052,FRESTEA MELATI 350ML,1,4500,0,4500,3000,1500
8/22/2021 16:56,6907992823935,JD SWEETCORN,1,3500,0,3500,3000,500
8/22/2021 17:08,8992628020152,BIMOLI POUCH 2L,1,31000,0,31000,29800,1200
8/22/2021 17:08,8992770034175,MASAKO,1,5000,0,5000,4000,1000
8/22/2021 17:12,8992747180126,VIXAL PEMB PORS 470ML,1,15000,0,15000,13420,1580
8/22/2021 17:12,8997025914059,HATARI SEE HONG,1,6000,0,6000,4911,1089
8/22/2021 17:15,8996001355978,BENG-BENG SHARE IT 9.5G,1,10000,0,10000,8700,1300
8/22/2021 17:15,8992761139018,ADES 600ML,1,3500,0,3500,2292,1208
8/22/2021 17:15,8996001600375,LE MINERAL 330ML,1,2000,0,2000,1417,583
8/22/2021 17:15,8994834005923,SPIX 1000,3,1000,0,3000,2550,450
8/22/2021 17:15,YP,YUPI,3,250,0,750,624,126
8/22/2021 17:45,8992628020152,BIMOLI POUCH 2L,1,31000,0,31000,29800,1200
8/22/2021 17:54,JL,JELLY,2,500,0,1000,800,200
8/22/2021 17:56,JL,JELLY,2,500,0,1000,800,200
8/22/2021 18:03,JL,JELLY,10,500,0,5000,4000,1000
8/22/2021 18:37,089686646047,SUNMARIE,1,7000,0,7000,6626,374
8/22/2021 19:12,TORT,TORTILA,4,1000,0,4000,4000,0
8/22/2021 19:15,8997018720469,TISSUE SE-KA,1,10000,0,10000,9300,700
8/22/2021 19:15,8992775001042,PILUS GARUDA MI GORENG,1,5000,0,5000,4810,190
8/22/2021 19:15,8991102020305,FORMULA TRIPLE ACTION,1,3000,0,3000,2500,500
8/22/2021 19:15,8998866106979,CIPTADENT TB CHARCOAL PROTEC,1,6000,0,6000,5250,750
8/22/2021 20:01,8998866501026,MINYAK GORENG SEDAAP POUCH 1 L,1,15000,0,15000,14110,890
8/22/2021 20:01,8999999053291,LIFEBUOY LEMONFRESH 110G,1,15000,0,15000,14245,755
8/22/2021 20:01,8995333060772,TERIGU GATOT KACA 500GR,1,5000,0,5000,4346,654
8/22/2021 20:01,8996001440049,ENERGEN,7,1500,0,10500,8400,2100
8/22/2021 20:03,8999801700054,SUSU FOYU 1 KG,1,22000,0,22000,19791,2209
8/22/2021 20:03,ROTI,ROTI 2000,2,2000,0,4000,3600,400
8/22/2021 20:18,8999909096004,SAMPOERNA 16 FILTER,1,24000,0,24000,23000,1000
8/22/2021 20:18,8998989300261,GUDANG GARAM SURYA 12 FILTER,1,19000,0,19000,17700,1300
8/22/2021 20:26,8995333060703,TERIGU KOMPAS 1KG,2,10500,0,21000,19632,1368
8/22/2021 20:26,8995333000822,TERIGU KOMPAS SOFT 500GR,1,5500,0,5500,4967,533
8/22/2021 20:28,8991102714846,MILKIDO CKLT,1,3000,0,3000,2153,847
8/22/2021 20:28,VTM,VITAMIN CIMIN,4,500,0,2000,1700,300
8/22/2021 20:58,8998866201865,KRISBEE PILLOW CHOCOLAVA 120 GR,1,8000,0,8000,7250,750
8/22/2021 21:20,8993989311279,CLAS MILD 12,1,17000,0,17000,15700,1300
8/22/2021 22:06,8998866202343,MIE SEDAAP KOREAN SPICY,2,2700,0,5400,4826,574
8/22/2021 22:06,RB,RED BOLD,1,19000,0,19000,17900,1100
8/22/2021 22:08,089686049053,SARIMI PUAS,2,3000,0,6000,4800,1200
8/22/2021 22:08,ARG,ARGUS 220ML,1,14500,0,14500,13300,1200
8/22/2021 22:14,8998866202060,POTABEE AYAM BAKAR PEDAS 35 GR,1,5000,0,5000,4150,850
8/22/2021 22:14,WC,WAFER COKELAT MADE,5,1000,0,5000,4000,1000
8/22/2021 22:20,8991001121400,SILVERQUEEN ALMOND 65G,1,15000,0,15000,13200,1800
8/22/2021 22:20,8992775913000,CHOCOLATOS CKLT 28G,6,2000,0,12000,9342,2658
8/22/2021 22:34,089686021219,INTER MIE GORENG,5,1000,0,5000,4425,575
8/22/2021 22:44,8992696405417,DNCO INSTANT 27G,6,3500,0,21000,18000,3000
8/23/2021 7:36,ROTI,ROTI 2000,3,2000,0,6000,5400,600
8/23/2021 7:36,8996001600269,LE MINERAL 600ML,2,3000,0,6000,3376,2624
8/23/2021 7:47,8991102714846,MILKIDO CKLT,1,3000,0,3000,2153,847
8/23/2021 11:04,8992775001691,GARUDA ROSTA WAGYU BEEF,1,8000,0,8000,7322,678
8/23/2021 11:10,8991102714594,TANGO DRINK BLCK VNL,1,5000,0,5000,3818,1182
8/23/2021 11:18,8992775203422,GARUDA ROSTA OVEN 100G,1,8000,0,8000,7322,678
8/23/2021 11:21,8999099920486,SGM 0-6 1000G,1,87000,0,87000,83707,3293
8/23/2021 11:21,8992959954058,SWEETY BRONZE NB 44,1,48000,0,48000,45682,2318
8/23/2021 12:19,8996001600665,COOL TIME,1,3500,0,3500,2750,750
8/23/2021 12:19,8886013213208,FRENCH FREIS 2000,1,5000,0,5000,3750,1250
8/23/2021 12:25,8991002121010,GOOD DAY FANTASTIC MOCACINNO,1,6000,0,6000,4295,1705
8/23/2021 12:25,8999999508609,LIFEBUOY HAND SANITIZER 50ML,1,13000,0,13000,11600,1400
8/23/2021 12:25,8996200900092,HEROCYN 85GR,1,13000,0,13000,11650,1350
8/23/2021 12:32,ROTI,ROTI 2000,3,2000,0,6000,5400,600
8/23/2021 12:33,TG,TEH GELAS,3,1000,0,3000,2187,813
8/23/2021 12:33,8992761139018,ADES 600ML,1,3500,0,3500,2292,1208
8/23/2021 12:34,8996001600269,LE MINERAL 600ML,3,3000,0,9000,5064,3936
8/23/2021 12:36,8998866202695,KOPI MAYOR,1,6000,0,6000,4500,1500
8/23/2021 12:54,8886013213208,FRENCH FREIS 2000,3,5000,0,15000,11250,3750
8/23/2021 12:55,8991102320184,TANGO CHOCO JAVAMOCCA,1,5000,0,5000,4330,670
8/23/2021 13:02,089686611670,QTELA BALADO,1,5000,0,5000,4266,734
8/23/2021 13:02,8991002121003,GOOD DAY TIRAMISU BLISS,1,6000,0,6000,4295,1705
8/23/2021 13:02,8992696523081,MILO UHT 110ML,1,2500,0,2500,1962,538
8/23/2021 13:04,4800888141125,AXE DEO BODYSPRAY DARK 150ML,1,20000,0,20000,10615,9385
8/23/2021 13:11,6949586607033,SILET ALSHABAB,1,8500,0,8500,7500,1000
8/23/2021 13:11,8996001600269,LE MINERAL 600ML,1,3000,0,3000,1688,1312
8/23/2021 13:11,RT,ROTI,1,9000,0,9000,8000,1000
8/23/2021 13:11,8997028590014,ARGUS 220ML,3,500,0,1500,906,594
8/23/2021 13:21,8997028590014,ARGUS 220ML,6,500,0,3000,1812,1188
8/23/2021 13:22,8996001600269,LE MINERAL 600ML,1,3000,0,3000,1688,1312
8/23/2021 13:22,8991002121065,GOOD DAY AVOCADO DELIGHT,1,6000,0,6000,4295,1705
8/23/2021 13:22,8999999534356,MOLTO DETERGEN CARE PINK PCH 700ML,1,20500,0,20500,18570,1930
8/23/2021 13:49,8995333032113,TERIGU GATOT KACA 1 KG,1,10000,0,10000,8572,1428
8/23/2021 13:56,Gula gula pulpen,gula gula pulpen,1,2000,0,2000,1750,250
8/23/2021 14:04,8998989110167,SURYA GUDANG GARAM 16 FILTER,1,25000,0,25000,23700,1300
8/23/2021 15:45,8998866200301,MIE SEDAAP GORENG,3,2700,0,8100,7239,861
8/23/2021 15:45,8998866602563,NUVO FAMILY HIJAU 76G,1,2000,0,2000,1820,180
8/23/2021 15:45,8998866602556,NUVO FAMILY MERAH 76G,2,2000,0,4000,3640,360
8/23/2021 15:46,8996001312582,MALKIST KELAPA KOPYOR SCT,1,1000,0,1000,820,180
8/23/2021 16:16,8991111109138,JB POWDER BLOSSOM 150+50G,1,10000,0,10000,9210,790
8/23/2021 16:16,telur,telur,3,2000,0,6000,3702,2298
8/23/2021 16:54,9999,ISOLASI LAKBAN,1,8000,0,8000,6500,1500
8/23/2021 17:02,8997028590014,ARGUS 220ML,2,500,0,1000,604,396
8/23/2021 17:02,8998989300261,GUDANG GARAM SURYA 12 FILTER,1,19000,0,19000,17700,1300
8/23/2021 17:02,8992933216110,NUTRIJELL MANGO,2,6000,0,12000,9900,2100
8/23/2021 17:02,8995150101696,M+SUSU ORIGINAL,1,5000,0,5000,4000,1000
8/23/2021 17:02,8993007001557,INDOMILK SKM 37G,2,1500,0,3000,2162,838
8/23/2021 17:02,8995333000822,TERIGU KOMPAS SOFT 500GR,2,5500,0,11000,9934,1066
8/23/2021 17:03,8992775211434,PILUS GARUDA SAPI PANGGANG,1,5000,0,5000,4810,190
8/23/2021 17:07,8995333000822,TERIGU KOMPAS SOFT 500GR,4,5500,0,22000,19868,2132
8/23/2021 17:07,8995333060703,TERIGU KOMPAS 1KG,1,10500,0,10500,9816,684
8/23/2021 17:09,8991102308823,KLOP COCONUT ORI,1,6000,0,6000,4969,1031
8/23/2021 17:09,8994834005923,SPIX 1000,6,1000,0,6000,5100,900
8/23/2021 17:09,TS,TISSUE TESSY,1,5000,0,5000,4200,800
8/23/2021 17:10,TBR,TEPUNG BERAS ROSE BRAND,1,8000,0,8000,5800,2200
8/23/2021 18:19,8993989311699,CLAS MILD 16 FILTER,1,23000,0,23000,21700,1300
8/23/2021 18:19,8998866201865,KRISBEE PILLOW CHOCOLAVA 120 GR,1,8000,0,8000,7250,750
8/23/2021 18:31,ff,FULLO BLASTO,2,1000,0,2000,1990,10
8/23/2021 18:31,8998866202619,MIE SEDAAP KOREAN SPICY SOUP,1,2700,0,2700,2322,378
8/23/2021 19:38,8992959117583,SFX DS REG FLOW WING 20,1,5000,0,5000,4288,712
8/23/2021 19:38,8997018720469,TISSUE SE-KA,1,10000,0,10000,9300,700
8/23/2021 19:41,8995333060772,TERIGU GATOT KACA 500GR,1,5000,0,5000,4346,654
8/23/2021 19:41,8995333032113,TERIGU GATOT KACA 1 KG,4,10000,0,40000,34288,5712
8/23/2021 20:03,ARG,ARGUS 220ML,1,14500,0,14500,13300,1200
8/23/2021 20:03,6907992823843,JD MOCHA CRISPY,1,5000,0,5000,4400,600
8/23/2021 20:17,123124,KOREK BIASA,1,2000,0,2000,1300,700
8/23/2021 22:07,GL,GULA 1 LITER,5,11500,0,57500,52500,5000
8/23/2021 22:11,8992959953105,SWEETY BRONZE XXL6,1,16000,0,16000,15230,770
8/23/2021 22:13,PUL,PULPEN,6,1500,0,9000,4998,4002
8/23/2021 22:14,8998989500166,GUDANG GARAM MERAH BESAR 16KS,1,18000,0,18000,17000,1000
8/23/2021 22:14,123124,KOREK BIASA,1,2000,0,2000,1300,700
8/23/2021 22:19,ROTI,ROTI 2000,1,2000,0,2000,1800,200
8/23/2021 22:20,8996001600399,LE MINERAL 1500ML,1,5000,0,5000,4042,958
8/23/2021 22:21,8998989110167,SURYA GUDANG GARAM 16 FILTER,2,25000,0,50000,47400,2600
8/23/2021 22:22,milkita,milkita,4,500,0,2000,1480,520
8/23/2021 22:23,8996001600597,KOPIKO LUCKY DAY,1,5000,0,5000,4283,717
8/23/2021 22:24,8996001600399,LE MINERAL 1500ML,1,5000,0,5000,4042,958
8/23/2021 22:24,ROTI,ROTI 2000,5,2000,0,10000,9000,1000
8/23/2021 22:25,8998898280401,TOLAK ANGIN FLU,6,3500,0,21000,16248,4752
8/23/2021 22:27,KOPIKO,KOPIKO,12,250,0,3000,2100,900
8/23/2021 22:28,ROTI,ROTI 2000,1,2000,0,2000,1800,200
8/23/2021 22:28,8996001600399,LE MINERAL 1500ML,1,5000,0,5000,4042,958
8/23/2021 22:31,089686611519,QTELA SINGKONG,3,5000,0,15000,12798,2202
8/23/2021 22:32,8996001600269,LE MINERAL 600ML,1,3000,0,3000,1688,1312
8/23/2021 22:33,CLUB,AIR CLUB 600ML,2,3000,0,6000,2904,3096
8/23/2021 22:34,8996001600269,LE MINERAL 600ML,3,3000,0,9000,5064,3936
8/23/2021 22:35,8992761139018,ADES 600ML,1,3500,0,3500,2292,1208
8/23/2021 22:37,9556001004673,MILO NESTLE MALAYSIA ACTIVE GO,1,85000,0,85000,80000,5000
8/23/2021 22:37,8996001600269,LE MINERAL 600ML,1,3000,0,3000,1688,1312
8/23/2021 22:39,MILKITA,MILKITA,12,250,0,3000,2400,600
8/23/2021 22:47,JL,JELLY,12,500,0,6000,4800,1200
8/23/2021 22:49,CLUB,AIR CLUB 600ML,4,3000,0,12000,5808,6192
8/23/2021 22:49,896867700494,AIR CLUB 1500ML,1,5000,0,5000,2987,2013
8/24/2021 9:51,8991002103764,GOOD DAY CAPPUCINO 10X25G,5,1500,0,7500,6975,525
8/24/2021 9:51,KPS,KAPAS MEI QIAN,1,5000,0,5000,4750,250
8/24/2021 9:55,8991102230308,BLASTER PINK,1,5000,0,5000,3106,1894
8/24/2021 9:55,8996001600269,LE MINERAL 600ML,1,3000,0,3000,1688,1312
8/24/2021 10:32,11,PASEO SMART FHSTD PERF 6P 12S,1,5000,0,5000,4264,736
8/24/2021 10:55,6907992823829,JD MILKY MILK,3,3000,0,9000,7800,1200
8/24/2021 10:56,8992761166052,FRESTEA MELATI 350ML,1,4500,0,4500,3000,1500
8/24/2021 11:00,8992761002039,FANTA STRAWBERRY PET 390 ML,2,5500,0,11000,8600,2400
8/24/2021 11:03,8998866500708,FLORIDINA ORANGE,1,3000,0,3000,2500,500
8/24/2021 11:03,6907992823829,JD MILKY MILK,1,3000,0,3000,2600,400
8/24/2021 11:03,8991102987875,WFR TANGO POUCH CKL 115G,1,8000,0,8000,6786,1214
8/24/2021 11:12,8992761166205,FRESTEA GREEN HONEY 350ML,1,4500,0,4500,3000,1500
8/24/2021 11:17,8998989121163,SURYA PRO MERAH,1,20000,0,20000,18600,1400
8/24/2021 11:17,8992761002039,FANTA STRAWBERRY PET 390 ML,1,5500,0,5500,4300,1200
8/24/2021 11:34,8991001780492,SELAMAT COKLAT,1,13000,0,13000,11800,1200
8/24/2021 11:34,8996001600269,LE MINERAL 600ML,1,3000,0,3000,1688,1312
8/24/2021 11:36,8996001600269,LE MINERAL 600ML,1,3000,0,3000,1688,1312
8/24/2021 11:36,8991001780492,SELAMAT COKLAT,1,13000,0,13000,11800,1200
8/24/2021 11:41,8998989110167,SURYA GUDANG GARAM 16 FILTER,1,25000,0,25000,23700,1300
8/24/2021 11:42,8993053641042,PASEO BABY WIPES GAZETTE 50S,1,17000,0,17000,15400,1600
8/24/2021 11:46,8992753184002,FF MILKY STRW 115G,1,3000,0,3000,2178,822
8/24/2021 11:49,8992775002933,GERY MALKIST DOUBLE ABON,1,6500,0,6500,5516,984
8/24/2021 11:49,8991102384841,WFR TANGO LONG CKLT 130G,1,5000,0,5000,4345,655
8/24/2021 11:49,8992761164478,FRESTEA MILK TEA,2,8000,0,16000,13150,2850
8/24/2021 11:51,8992761002015,COCA COLA PET 390ML,1,5500,0,5500,4333,1167
8/24/2021 11:51,8991102384841,WFR TANGO LONG CKLT 130G,1,5000,0,5000,4345,655
8/24/2021 11:52,8991102384841,WFR TANGO LONG CKLT 130G,1,5000,0,5000,4345,655
8/24/2021 11:52,8992761002015,COCA COLA PET 390ML,2,5500,0,11000,8666,2334
8/24/2021 11:54,8996001600269,LE MINERAL 600ML,2,3000,0,6000,3376,2624
8/24/2021 12:07,8850507002951,BONCHA EGG SQUISHY,1,12000,0,12000,10841,1159
8/24/2021 12:19,ARG,ARGUS 220ML,1,14500,0,14500,13300,1200
8/24/2021 12:20,8992933216110,NUTRIJELL MANGO,1,6000,0,6000,4950,1050
8/24/2021 12:20,8996001600269,LE MINERAL 600ML,1,3000,0,3000,1688,1312
8/24/2021 12:46,8993989311699,CLAS MILD 16 FILTER,2,23000,0,46000,43400,2600
8/24/2021 13:05,089686010343,INDOMIE SOTO MIE,1,2600,0,2600,2367,233
8/24/2021 13:05,089686010107,INDOMIE KALDU AYAM,1,2500,0,2500,2150,350
8/24/2021 13:05,089686041705,INDOMIE GORENG JUMBO,1,3500,0,3500,3143,357
8/24/2021 13:13,8992761164539,NUTRIBOOST ORANGE 300ML,5,6500,0,32500,26500,6000
8/24/2021 13:14,8996001600269,LE MINERAL 600ML,1,3000,0,3000,1688,1312
8/24/2021 13:19,6907992823911,JD CRUNCHY HONEYDEW MELON,1,8000,0,8000,6800,1200
8/24/2021 13:21,ARG,ARGUS 220ML,1,14500,0,14500,13300,1200
8/24/2021 13:21,8994867007161,ROKOK PENA GOLD 20,1,17000,0,17000,15500,1500
8/24/2021 13:26,8998866501026,MINYAK GORENG SEDAAP POUCH 1 L,4,15000,0,60000,56440,3560
8/24/2021 13:26,ARG,ARGUS 220ML,2,14500,0,29000,26600,2400
8/24/2021 13:27,8992959953082,SWEETY BRONZE L8,1,17000,0,17000,15380,1620
8/24/2021 13:29,8992761111533,SPRITE SLIM CAM250ML,1,5000,0,5000,3750,1250
8/24/2021 13:29,8998009040023,TEH KOTAK,1,5000,0,5000,2827,2173
8/24/2021 13:43,8996001354001,KALPA SCT,1,2000,0,2000,1666,334
8/24/2021 14:05,089686010107,INDOMIE KALDU AYAM,2,2500,0,5000,4300,700
8/24/2021 14:05,089686041705,INDOMIE GORENG JUMBO,1,3500,0,3500,3143,357
8/24/2021 14:09,VCO,VICEE C500 ORANGE,15,1000,0,15000,8625,6375
8/24/2021 14:10,VCO,VICEE C500 ORANGE,1,1000,0,1000,575,425
8/24/2021 14:14,8999999036492,LUX BW PINK SOFT BTL 100ML,1,10000,0,10000,8690,1310
8/24/2021 16:10,8993989311699,CLAS MILD 16 FILTER,1,23000,0,23000,21700,1300
8/24/2021 16:10,8992753182008,FF MILKY CKLT 115ML,1,3000,0,3000,2179,821
8/24/2021 16:10,8991102100823,Formula Acttion Protector 190 gr,1,10000,0,10000,9000,1000
8/24/2021 16:10,8992959107607,SFX COMFORT SLIM 1,1,5000,0,5000,4000,1000
8/24/2021 16:10,8998866202053,POTABEE AYAM BAKAR PEDAS 68GR,1,8000,0,8000,7200,800
8/24/2021 17:42,TORT,TORTILA,2,1000,0,2000,2000,0
8/24/2021 17:42,8998989110129,SURYA KECIL MERAH 12KS,1,19000,0,19000,16450,2550
8/24/2021 17:42,6907992823935,JD SWEETCORN,1,3500,0,3500,3000,500
8/24/2021 17:42,8998989110167,SURYA GUDANG GARAM 16 FILTER,1,25000,0,25000,23700,1300
8/24/2021 18:25,GL,GULA 1 LITER,2,11500,0,23000,21000,2000
8/24/2021 18:25,SMC,BIMURA MAKARONI CINCIN 250G,1,10000,0,10000,9300,700
8/24/2021 19:27,ff,FULLO BLASTO,2,1000,0,2000,1990,10
8/24/2021 19:27,8994867007161,ROKOK PENA GOLD 20,1,17000,0,17000,15500,1500
8/24/2021 19:46,8995333032113,TERIGU GATOT KACA 1 KG,4,10000,0,40000,34288,5712
8/24/2021 19:50,8998866200301,MIE SEDAAP GORENG,2,2700,0,5400,4826,574
8/24/2021 19:54,8995333060772,TERIGU GATOT KACA 500GR,1,5000,0,5000,4346,654
8/24/2021 19:54,8992761002039,FANTA STRAWBERRY PET 390 ML,1,5500,0,5500,4300,1200
8/24/2021 19:55,telur,telur,6,2000,0,12000,7404,4596
8/24/2021 19:56,089686021127,INTER MIE KALDU,2,1000,0,2000,1626,374
8/24/2021 19:57,8993989311699,CLAS MILD 16 FILTER,1,23000,0,23000,21700,1300
8/24/2021 19:59,9999,ISOLASI LAKBAN,2,8000,0,16000,13000,3000
8/24/2021 20:03,8999909010567,234 DJI SAM SOE 16,1,22000,0,22000,21500,500
8/24/2021 20:09,8999999706081,PEPSODENT WHITE 75G,1,5000,0,5000,3850,1150
8/24/2021 20:09,8993379121211,SABUN MEDICARE PUTIH,1,2500,0,2500,2237,263
8/24/2021 20:09,8993379260026,SABUN MEDICARE BLACK,1,2500,0,2500,2237,263
8/24/2021 20:09,8996001440001,TB JAHE SUSU,3,1500,0,4500,2610,1890
8/24/2021 20:09,8998866611152,CREAM EKONOMI VIOLET 455G,1,5500,0,5500,4750,750
8/24/2021 20:11,76164217,MARLBORO MERAH,1,30000,0,30000,27700,2300
8/24/2021 20:13,telur,telur,10,2000,0,20000,12340,7660
8/24/2021 20:14,8886020033431,KAPUR AJAIB ANTI KECOA DAN NYAMUK,1,3000,0,3000,2700,300
8/24/2021 20:16,8997018720469,TISSUE SE-KA,1,10000,0,10000,9300,700
8/24/2021 20:18,8998866888622,GIV MERAH KOTAK 76G,2,2000,0,4000,3640,360
8/24/2021 20:20,MOLTO PINK,MOLTO ALL IN ONE 11 ML,5,500,0,2500,2000,500
8/24/2021 20:21,RB,RED BOLD,1,19000,0,19000,17900,1100
8/24/2021 20:22,RT 1000,ROTI 1000,1,1000,0,1000,800,200
8/24/2021 20:25,8998866608459,POWDET DAIA PUTIH BAG 290GR,1,5000,0,5000,4450,550
8/24/2021 20:27,8998866613002,CREAM EKONOMI PINK 455G,1,5500,0,5500,4750,750
8/24/2021 20:27,8997213203118,INLITE 12W,1,46000,0,46000,42000,4000
8/24/2021 20:32,8998866609036,DAIA BUNGA GUSSET 565G,1,10000,0,10000,8700,1300
8/24/2021 20:33,8998989100120,GUDANG GARAM MINI,1,18000,0,18000,16600,1400
8/24/2021 20:33,123124,KOREK BIASA,1,2000,0,2000,1300,700
8/24/2021 20:39,8991111112206,C&C DEEP ACTION CLEANSER 50G,1,14000,0,14000,12900,1100
8/24/2021 20:42,8992775203415,GARUDA ROSTA 25G,1,8000,0,8000,7322,678
8/24/2021 20:42,8992775211434,PILUS GARUDA SAPI PANGGANG,1,5000,0,5000,4810,190
8/24/2021 20:43,8991102989381,TANGO LONG BUBBLEGUM 130G,1,5000,0,5000,4345,655
8/24/2021 20:43,8992770034175,MASAKO,1,5000,0,5000,4000,1000
8/24/2021 20:44,8997028590014,ARGUS 220ML,1,500,0,500,302,198
8/24/2021 20:45,8995333032113,TERIGU GATOT KACA 1 KG,1,10000,0,10000,8572,1428
8/24/2021 20:47,TORT,TORTILA,2,1000,0,2000,2000,0
8/24/2021 20:49,8999999571887,MOLTO EDP PURPLE 10ML,1,5000,0,5000,4800,200
8/24/2021 20:54,8999999531492,MOLTO GLAMOUR,1,5000,0,5000,4800,200
8/24/2021 20:54,8992761139018,ADES 600ML,1,3500,0,3500,2292,1208
8/24/2021 20:55,8992775001691,GARUDA ROSTA WAGYU BEEF,1,8000,0,8000,7322,678
8/24/2021 20:57,8992775001691,GARUDA ROSTA WAGYU BEEF,1,8000,0,8000,7322,678
8/24/2021 20:57,8996001600269,LE MINERAL 600ML,3,3000,0,9000,5064,3936
8/24/2021 20:58,GL,GULA 1 LITER,2,11500,0,23000,21000,2000
8/24/2021 21:00,8991102303309,WFR TANGO SBJ 176G,1,10000,0,10000,8694,1306
8/24/2021 21:01,8996001305003,SARI GANDUM SANDWICH,1,6000,0,6000,5100,900
8/24/2021 21:01,8997025914042,ATB MARIE SUSU 185G,1,7000,0,7000,4554,2446
8/24/2021 21:02,8992775000663,GERY SNACK KEJU,2,2000,0,4000,3424,576
8/24/2021 21:03,8994867000162,ROKOK PUNDIMAS KRETEK16,1,10000,0,10000,8600,1400
8/24/2021 21:04,8999909982000,SAMPOERNA 12 FILTER,1,18000,0,18000,16000,2000
8/24/2021 21:04,VTM,VITAMIN CIMIN,1,500,0,500,425,75
8/24/2021 21:05,RT 1000,ROTI 1000,2,1000,0,2000,1600,400
8/24/2021 21:05,8992761164478,FRESTEA MILK TEA,1,8000,0,8000,6575,1425
8/24/2021 21:06,8992761166212,FRESTEA APPLE 350ML,1,4500,0,4500,3000,1500
8/24/2021 21:07,PUL,PULPEN,1,1500,0,1500,833,667
8/24/2021 21:07,8996001600269,LE MINERAL 600ML,1,3000,0,3000,1688,1312
8/24/2021 21:10,8997028590014,ARGUS 220ML,6,500,0,3000,1812,1188
8/24/2021 21:10,KOPIKO,KOPIKO,12,250,0,3000,2100,900
8/24/2021 21:11,8998866501026,MINYAK GORENG SEDAAP POUCH 1 L,5,15000,0,75000,70550,4450
8/24/2021 21:11,8995333060703,TERIGU KOMPAS 1KG,1,10500,0,10500,9816,684
8/24/2021 21:12,8991102320184,TANGO CHOCO JAVAMOCCA,1,5000,0,5000,4330,670
8/24/2021 21:13,8999999195656,SARI WANGI 50X1.85,1,10000,0,10000,9500,500
8/24/2021 21:14,8991102320184,TANGO CHOCO JAVAMOCCA,1,5000,0,5000,4330,670
8/24/2021 21:14,8991102320184,TANGO CHOCO JAVAMOCCA,2,5000,0,10000,8660,1340
8/24/2021 21:16,8998989110167,SURYA GUDANG GARAM 16 FILTER,1,25000,0,25000,23700,1300
8/24/2021 21:18,8996001600269,LE MINERAL 600ML,1,3000,0,3000,1688,1312
8/24/2021 21:18,8997028590014,ARGUS 220ML,4,500,0,2000,1208,792
8/24/2021 21:26,8993989311699,CLAS MILD 16 FILTER,1,23000,0,23000,21700,1300
8/24/2021 21:26,8996001600269,LE MINERAL 600ML,5,3000,0,15000,8440,6560
8/24/2021 21:29,8992761166205,FRESTEA GREEN HONEY 350ML,1,4500,0,4500,3000,1500
8/24/2021 21:29,RT BAKPIA,ROTI BAKPIA,10,1000,0,10000,7500,2500
8/24/2021 21:30,8992761139018,ADES 600ML,1,3500,0,3500,2292,1208
8/24/2021 21:33,8992775610008,TING-TING GARUDA 2.5G,1,7500,0,7500,6296,1204
8/24/2021 21:33,089686611670,QTELA BALADO,2,5000,0,10000,8532,1468
8/24/2021 21:34,8998866610377,ISOPLUS,2,3000,0,6000,4700,1300
8/24/2021 21:37,8992959117613,SFX DAUN SIRIH 1 WP,10,500,0,5000,4130,870
8/24/2021 21:42,8992696521797,MILO 22G,4,2500,0,10000,6288,3712
8/24/2021 21:42,8996001600375,LE MINERAL 330ML,1,2000,0,2000,1417,583
8/24/2021 21:47,8995333032113,TERIGU GATOT KACA 1 KG,4,10000,0,40000,34288,5712
8/24/2021 21:49,8998866679596,SOKLIN LANTAI BIRU 780ML,1,12000,0,12000,10020,1980
8/24/2021 21:50,JL,JELLY,5,500,0,2500,2000,500
8/24/2021 21:50,8995333060703,TERIGU KOMPAS 1KG,1,10500,0,10500,9816,684
8/24/2021 21:51,JL,JELLY,4,500,0,2000,1600,400
8/24/2021 21:53,8993379254469,SABUN LERVIA 90G,1,5000,0,5000,3077,1923
8/24/2021 21:53,8998989500166,GUDANG GARAM MERAH BESAR 16KS,1,18000,0,18000,17000,1000
8/24/2021 22:01,8998866202312,NOODLE SEDAAP TASTY BAKMI AYAM 129 GR,2,5000,0,10000,8334,1666
8/24/2021 22:01,089686611670,QTELA BALADO,1,5000,0,5000,4266,734
8/24/2021 22:01,8996001600399,LE MINERAL 1500ML,1,5000,0,5000,4042,958
8/24/2021 22:05,8997009510123,ORANGE WATER,1,7000,0,7000,6089,911
8/24/2021 22:23,VCL,VICEE C500 LEMON,5,1000,0,5000,2875,2125
8/24/2021 22:25,VCO,VICEE C500 ORANGE,5,1000,0,5000,2875,2125
8/24/2021 22:31,TORT,TORTILA,1,1000,0,1000,1000,0
8/24/2021 22:31,8993470671752,JOGER STICK DUO KACANG,1,1000,0,1000,850,150
8/24/2021 22:32,milkita,milkita,1,500,0,500,370,130
8/24/2021 22:34,VCL,VICEE C500 LEMON,5,1000,0,5000,2875,2125
8/24/2021 22:37,PUL,PULPEN,2,1500,0,3000,1666,1334
8/24/2021 22:39,8999909002821,MARLBORO BLACK 16,1,22000,0,22000,20850,1150
8/24/2021 22:40,8992775000663,GERY SNACK KEJU,2,2000,0,4000,3424,576
8/24/2021 22:49,8992775311486,CHOCOLATOS DARK 16G,1,18000,0,18000,15173,2827
8/24/2021 22:50,8998009010231,ULTRA CHO 250,1,6000,0,6000,4784,1216
8/24/2021 23:02,8991102320184,TANGO CHOCO JAVAMOCCA,1,5000,0,5000,4330,670
8/24/2021 23:08,8999999195656,SARI WANGI 50X1.85,1,10000,0,10000,9500,500
8/24/2021 23:08,8994834001901,SUKI,1,1000,0,1000,761,239
8/24/2021 23:08,Gula gula pulpen,gula gula pulpen,1,2000,0,2000,1750,250
8/24/2021 23:09,8992959955024,SWEETY BABY WIPES 36X50,1,17000,0,17000,14293,2707
8/24/2021 23:10,8992959001875,SWEETY SILVER PANTS S RTG,1,10200,0,10200,9168,1032
8/24/2021 23:11,8991002121010,GOOD DAY FANTASTIC MOCACINNO,1,6000,0,6000,4295,1705
8/25/2021 9:46,8991102385091,WFR TANGO CKLT 7G,1,8300,0,8300,7455,845
8/25/2021 10:39,8992696523067,MILO ACTVGO UHT 180ML,1,4500,0,4500,3515,985
8/25/2021 10:39,8998009010569,ULTRA CHO 200,1,5000,0,5000,3830,1170
8/25/2021 10:40,8991102987875,WFR TANGO POUCH CKL 115G,1,8000,0,8000,6786,1214
8/25/2021 10:43,8992696523067,MILO ACTVGO UHT 180ML,2,4500,0,9000,7030,1970
8/25/2021 10:44,8992388133017,NU MILK TEA ORI 330ML,1,6000,0,6000,5125,875
8/25/2021 10:44,8992761145033,FANTA STRAW PET 250ML,2,3500,0,7000,4834,2166
8/25/2021 10:44,8998009040023,TEH KOTAK,1,5000,0,5000,2827,2173
8/25/2021 10:47,8998989500166,GUDANG GARAM MERAH BESAR 16KS,1,18000,0,18000,17000,1000
8/25/2021 10:55,8996001301562,MALKIST TABUR KELAPA,5,1000,0,5000,4100,900
8/25/2021 10:56,8992775000663,GERY SNACK KEJU,1,2000,0,2000,1712,288
8/25/2021 11:06,8993470672858,SAKU-SAKU RASA BALADO,1,2000,0,2000,1530,470
8/25/2021 11:06,8998866201841,GOLDA DOLCE LATTE 200ML,3,3000,0,9000,7500,1500
8/25/2021 11:19,8991102320184,TANGO CHOCO JAVAMOCCA,1,5000,0,5000,4330,670
8/25/2021 11:19,8996001600269,LE MINERAL 600ML,3,3000,0,9000,5064,3936
8/25/2021 11:48,8991102230308,BLASTER PINK,1,5000,0,5000,3106,1894
8/25/2021 11:54,8996001600269,LE MINERAL 600ML,1,3000,0,3000,1688,1312
8/25/2021 12:19,8998989500166,GUDANG GARAM MERAH BESAR 16KS,1,18000,0,18000,17000,1000
8/25/2021 12:21,BPO,BIMURA POTATO ORIGINAL 250G,1,10000,0,10000,9300,700
8/25/2021 12:22,8992775210215,GARUDA ATOM PEDAS,1,17000,0,17000,15363,1637
8/25/2021 12:24,6907992825076,JD WATERMELON APPLE,3,2000,0,6000,5100,900
8/25/2021 12:24,6907992823959,JD HAWTHORN BERRY,2,2000,0,4000,3400,600
8/25/2021 12:24,8994867000162,ROKOK PUNDIMAS KRETEK16,1,10000,0,10000,8600,1400
8/25/2021 12:25,8996001600597,KOPIKO LUCKY DAY,1,5000,0,5000,4283,717
8/25/2021 12:38,TORT,TORTILA,1,1000,0,1000,1000,0
8/25/2021 16:39,8992775002933,GERY MALKIST DOUBLE ABON,1,6500,0,6500,5516,984
8/25/2021 16:39,8991102320184,TANGO CHOCO JAVAMOCCA,1,5000,0,5000,4330,670
8/25/2021 16:43,8993379152017,SABUN CUCI SURYA 200G,1,3000,0,3000,2281,719
8/25/2021 16:43,8999999059309,LIFEBUOY TS TOTAL 10 DG 75G,1,3000,0,3000,2640,360
8/25/2021 16:43,8999999045920,LIFEBUOY TS TOTAL 10 110GR,1,15000,0,15000,14245,755
8/25/2021 16:43,8999999706081,PEPSODENT WHITE 75G,1,5000,0,5000,3850,1150
8/25/2021 16:43,8999999534097,PEPSODENT PGB FCM 75G,1,5000,0,5000,3850,1150
8/25/2021 16:43,8992628020152,BIMOLI POUCH 2L,1,31000,0,31000,29800,1200
8/25/2021 16:43,7118441101378,KECAP ABC 520 ML,1,19000,0,19000,17800,1200
8/25/2021 17:15,8992775002582,DILAN CHOCO,2,2000,0,4000,3006,994
8/25/2021 17:56,8993007003902,Susu Kental Manis Indo milk,1,15000,0,15000,13333,1667
8/25/2021 17:58,8992775311486,CHOCOLATOS DARK 16G,1,18000,0,18000,15173,2827
8/25/2021 17:58,8997028590014,ARGUS 220ML,3,500,0,1500,906,594
8/25/2021 18:16,8997025911058,HATARI SHP KELAPA,1,6000,0,6000,4911,1089
8/25/2021 18:16,GL,GULA 1 LITER,2,11500,0,23000,21000,2000
8/25/2021 18:21,089686043204,INDOMIE MIE ACEH,1,2700,0,2700,2452,248
8/25/2021 18:21,8996001355978,BENG-BENG SHARE IT 9.5G,1,10000,0,10000,8700,1300
8/25/2021 18:21,8996001318911,BETTER ISI 4,1,2000,0,2000,1700,300
8/25/2021 18:21,8996001355756,BENG-BENG MAXX SCT,1,2500,0,2500,2041,459
8/25/2021 18:21,8996001354001,KALPA SCT,1,2000,0,2000,1666,334
8/25/2021 18:21,8998866200301,MIE SEDAAP GORENG,1,2700,0,2700,2413,287
8/25/2021 18:21,ARG,ARGUS 220ML,1,14500,0,14500,13300,1200
8/25/2021 18:38,8992761164546,NUTRIBOOST STRAWBERRY 300ML,2,6500,0,13000,10600,2400
8/25/2021 18:38,8999999049669,REXONA MEN RO INVISIBLE DRY 45 ML,1,15000,0,15000,13550,1450
8/25/2021 18:40,8992761164546,NUTRIBOOST STRAWBERRY 300ML,1,6500,0,6500,5300,1200
8/25/2021 18:47,8992761164546,NUTRIBOOST STRAWBERRY 300ML,1,6500,0,6500,5300,1200
8/25/2021 19:06,ARG,ARGUS 220ML,1,14500,0,14500,13300,1200
8/25/2021 19:06,8995333060772,TERIGU GATOT KACA 500GR,1,5000,0,5000,4346,654
8/25/2021 19:24,8994935000070,MINYAK DUNIA 450 ML,1,7500,0,7500,6779,721
8/25/2021 19:24,8999999559045,SUNLIGHT LIME CREAM 110G,1,2000,0,2000,1800,200
8/25/2021 19:24,8934868015024,REXONA DEO LOTION FREE SPIRIT 9G,1,2500,0,2500,2000,500
8/25/2021 19:26,8999909002821,MARLBORO BLACK 16,1,22000,0,22000,20850,1150
8/25/2021 19:26,8998989110167,SURYA GUDANG GARAM 16 FILTER,2,25000,0,50000,47400,2600
8/25/2021 20:17,8998989500166,GUDANG GARAM MERAH BESAR 16KS,1,18000,0,18000,17000,1000
8/25/2021 20:25,123124,KOREK BIASA,1,2000,0,2000,1300,700
8/25/2021 20:25,089686611618,QTELA BARBEQUE,1,5000,0,5000,4266,734
8/25/2021 20:25,8992775002735,CHOCOLATOS SUSU COKELAT,1,4000,0,4000,3520,480
8/25/2021 20:39,PUL,PULPEN,2,1500,0,3000,1666,1334
8/25/2021 20:58,76239878,MARLBORO GOLD,1,30000,0,30000,27700,2300
8/25/2021 21:08,8998866202602,KRISBEE FRENCH FRIES 18GR,1,2000,0,2000,1500,500
8/25/2021 21:08,KOPIKO,KOPIKO,24,250,0,6000,4200,1800
8/25/2021 21:08,8991002304413,RELAXA GRAPE MINT,1,5000,0,5000,4500,500
8/25/2021 21:09,PUL,PULPEN,2,1500,0,3000,1666,1334
8/25/2021 21:14,TG,TEH GELAS,3,1000,0,3000,2187,813
8/25/2021 21:14,8996001600269,LE MINERAL 600ML,1,3000,0,3000,1688,1312
8/25/2021 21:14,8996001302620,MALKIST COKLAT SCT,2,1000,0,2000,1680,320
8/25/2021 21:14,8992761145033,FANTA STRAW PET 250ML,1,3500,0,3500,2417,1083
8/25/2021 21:14,8999909010567,234 DJI SAM SOE 16,1,22000,0,22000,21500,500
8/25/2021 21:14,123124,KOREK BIASA,1,2000,0,2000,1300,700
8/25/2021 21:19,8992761145026,SPRITE PET 250ML,1,3500,0,3500,2417,1083
8/25/2021 21:19,milkita,milkita,2,500,0,1000,740,260
8/25/2021 21:19,8992761166038,MMP ORANGE 300ML,2,5000,0,10000,7500,2500
8/25/2021 21:19,8998989300261,GUDANG GARAM SURYA 12 FILTER,1,19000,0,19000,17700,1300
8/25/2021 21:25,089686021219,INTER MIE GORENG,1,1000,0,1000,885,115
8/25/2021 21:25,8992761166038,MMP ORANGE 300ML,1,5000,0,5000,3750,1250
8/25/2021 21:25,8992775210215,GARUDA ATOM PEDAS,1,17000,0,17000,15363,1637
8/25/2021 21:29,8999909096004,SAMPOERNA 16 FILTER,1,24000,0,24000,23000,1000
8/25/2021 21:31,8992761166038,MMP ORANGE 300ML,1,5000,0,5000,3750,1250
8/25/2021 21:31,8996001600269,LE MINERAL 600ML,1,3000,0,3000,1688,1312
8/25/2021 21:31,8992761145026,SPRITE PET 250ML,1,3500,0,3500,2417,1083
8/25/2021 21:32,8998989300261,GUDANG GARAM SURYA 12 FILTER,1,19000,0,19000,17700,1300
8/25/2021 21:35,8998866613002,CREAM EKONOMI PINK 455G,1,5500,0,5500,4750,750
8/25/2021 21:35,8991002304413,RELAXA GRAPE MINT,1,5000,0,5000,4500,500
8/25/2021 21:36,8996001600269,LE MINERAL 600ML,1,3000,0,3000,1688,1312
8/25/2021 21:42,GL,GULA 1 LITER,1,11500,0,11500,10500,1000
8/25/2021 21:42,8992761164546,NUTRIBOOST STRAWBERRY 300ML,1,6500,0,6500,5300,1200
8/25/2021 21:42,ARG,ARGUS 220ML,2,14500,0,29000,26600,2400
8/25/2021 21:46,CLUB,AIR CLUB 600ML,1,3000,0,3000,1452,1548
8/25/2021 21:46,8996001600269,LE MINERAL 600ML,2,3000,0,6000,3376,2624
8/25/2021 21:47,8992761166038,MMP ORANGE 300ML,1,5000,0,5000,3750,1250
8/25/2021 21:47,RT 1000,ROTI 1000,5,1000,0,5000,4000,1000
8/25/2021 21:48,8992775110140,GARUDA KACANG KULIT 160G,1,12000,0,12000,10012,1988
8/25/2021 21:50,8994867000162,ROKOK PUNDIMAS KRETEK16,1,10000,0,10000,8600,1400
8/25/2021 21:52,8998989500166,GUDANG GARAM MERAH BESAR 16KS,1,18000,0,18000,17000,1000
8/25/2021 21:52,8999099920486,SGM 0-6 1000G,2,87000,0,174000,167414,6586
8/25/2021 21:52,ARG,ARGUS 220ML,1,14500,0,14500,13300,1200
8/25/2021 21:55,8998866200301,MIE SEDAAP GORENG,2,2700,0,5400,4826,574
8/25/2021 21:55,8998866200325,MIE SEDAAP SOTO,2,2700,0,5400,4662,738
8/25/2021 22:00,8996001600399,LE MINERAL 1500ML,1,5000,0,5000,4042,958
8/25/2021 22:00,8992761002039,FANTA STRAWBERRY PET 390 ML,1,5500,0,5500,4300,1200
8/25/2021 22:00,telur,telur,5,2000,0,10000,6170,3830
8/25/2021 22:00,8998866200325,MIE SEDAAP SOTO,1,2700,0,2700,2331,369
8/25/2021 22:00,YOUTOP,YOUTOP,2,1000,0,2000,1750,250
8/25/2021 22:08,8992388133017,NU MILK TEA ORI 330ML,1,6000,0,6000,5125,875
8/25/2021 22:08,8991001503107,CHACHA PEANUT 35GR,1,5500,0,5500,4900,600
8/25/2021 22:08,8991001242013,Top,2,1000,0,2000,1000,1000
8/25/2021 22:10,8991001503107,CHACHA PEANUT 35GR,1,5500,0,5500,4900,600
8/25/2021 22:20,8997218380074,ICHITAN MILK TEA,1,8000,0,8000,6583,1417
8/25/2021 22:20,8999999552527,ZWITSAL KIDS BB CLN&FRSH BLUE 280 ML,1,21500,0,21500,19855,1645
8/25/2021 22:24,8998866202312,NOODLE SEDAAP TASTY BAKMI AYAM 129 GR,1,5000,0,5000,4167,833
8/25/2021 22:24,8998866200301,MIE SEDAAP GORENG,1,2700,0,2700,2413,287
8/25/2021 22:24,8998866202060,POTABEE AYAM BAKAR PEDAS 35 GR,1,5000,0,5000,4150,850
8/25/2021 22:24,8992742360844,POLYTEX SABUT STENLESS,1,4000,0,4000,2200,1800
8/25/2021 22:24,SKT,SIKAT CUCI,1,6000,0,6000,5000,1000
8/25/2021 22:24,balon air,balon air,1,2000,0,2000,1700,300
8/25/2021 22:26,MENTOS,MENTOS,18,250,0,4500,3150,1350
8/25/2021 22:29,8992775315057,GERY SALUT MALKIST COKLAT,1,6500,0,6500,5516,984
8/25/2021 22:33,8991102320184,TANGO CHOCO JAVAMOCCA,1,5000,0,5000,4330,670
8/25/2021 22:33,balon air,balon air,1,2000,0,2000,1700,300
8/25/2021 22:33,8995333060703,TERIGU KOMPAS 1KG,1,10500,0,10500,9816,684
8/25/2021 22:33,8995333032113,TERIGU GATOT KACA 1 KG,6,10000,0,60000,51432,8568
8/25/2021 22:42,8998866201452,POTABEE REGULER BBQ BEEF 35GR,1,5000,0,5000,4150,850
8/25/2021 22:45,8994935000070,MINYAK DUNIA 450 ML,1,7500,0,7500,6779,721
8/25/2021 22:50,8998866603409,RAPIKA UNGU POUCH 400ML,1,5000,0,5000,4500,500
8/25/2021 22:59,8998866200301,MIE SEDAAP GORENG,2,2700,0,5400,4826,574
8/25/2021 22:59,089686021219,INTER MIE GORENG,6,1000,0,6000,5310,690
8/25/2021 22:59,8998866202244,EKOMIE BUMBU KALDU AYAM,3,1000,0,3000,2394,606
8/25/2021 22:59,8998866200325,MIE SEDAAP SOTO,4,2700,0,10800,9324,1476
8/25/2021 23:01,8992959508992,SWEETY SILVER PANTS L 28,1,56800,0,56800,51819,4981
8/25/2021 23:02,ARG,ARGUS 220ML,1,14500,0,14500,13300,1200
8/25/2021 23:03,8996001600399,LE MINERAL 1500ML,2,5000,0,10000,8084,1916
8/25/2021 23:03,8998989110167,SURYA GUDANG GARAM 16 FILTER,3,25000,0,75000,71100,3900
8/25/2021 23:04,8999909002821,MARLBORO BLACK 16,1,22000,0,22000,20850,1150
8/25/2021 23:04,telur rak,telur rak,1,40000,0,40000,37000,3000
8/26/2021 12:51,8995333060772,TERIGU GATOT KACA 500GR,1,5000,0,5000,4346,654
8/26/2021 12:58,8999909982000,SAMPOERNA 12 FILTER,1,18000,0,18000,16000,2000
8/26/2021 12:59,8992761164539,NUTRIBOOST ORANGE 300ML,2,6500,0,13000,10600,2400
8/26/2021 12:59,8992761164539,NUTRIBOOST ORANGE 300ML,1,6500,0,6500,5300,1200
8/26/2021 13:00,8998009010231,ULTRA CHO 250,2,6000,0,12000,9568,2432
8/26/2021 13:02,8998866202732,MILKU STROBERI 200ML,1,3000,0,3000,2375,625
8/26/2021 13:02,8998989300261,GUDANG GARAM SURYA 12 FILTER,1,19000,0,19000,17700,1300
8/26/2021 13:04,8998866202435,JAPOTA UMAMI JAPANESE SEAWEED 35GR,1,5000,0,5000,4150,850
8/26/2021 13:04,8998866201452,POTABEE REGULER BBQ BEEF 35GR,1,5000,0,5000,4150,850
8/26/2021 13:05,8992775001783,GERY SALUT MALKIST KELAPA,2,6500,0,13000,11032,1968
8/26/2021 13:07,8992775001691,GARUDA ROSTA WAGYU BEEF,1,8000,0,8000,7322,678
8/26/2021 13:08,8996001600399,LE MINERAL 1500ML,1,5000,0,5000,4042,958
8/26/2021 13:11,8998866200301,MIE SEDAAP GORENG,2,2700,0,5400,4826,574
8/26/2021 13:11,089686010343,INDOMIE SOTO MIE,2,2600,0,5200,4734,466
8/26/2021 13:11,8992775211434,PILUS GARUDA SAPI PANGGANG,1,5000,0,5000,4810,190
8/26/2021 13:11,ROTI,ROTI 2000,3,2000,0,6000,5400,600
8/26/2021 13:13,8998989300261,GUDANG GARAM SURYA 12 FILTER,1,19000,0,19000,17700,1300
8/26/2021 13:51,ff,FULLO BLASTO,1,1000,0,1000,995,5
8/26/2021 13:51,TORT,TORTILA,1,1000,0,1000,1000,0
8/26/2021 16:04,8992959508855,SWEETY SILVER PANTS XL 18,1,47800,0,47800,43353,4447
8/26/2021 16:20,8999909096004,SAMPOERNA 16 FILTER,1,24000,0,24000,23000,1000
8/26/2021 16:30,8999909982000,SAMPOERNA 12 FILTER,1,18000,0,18000,16000,2000
8/26/2021 16:49,6907992825076,JD WATERMELON APPLE,2,2000,0,4000,3400,600
8/26/2021 16:50,TORT,TORTILA,1,1000,0,1000,1000,0
8/26/2021 19:13,8998009040023,TEH KOTAK,3,5000,0,15000,8481,6519
8/26/2021 19:15,8992696521797,MILO 22G,1,2500,0,2500,1572,928
8/26/2021 19:17,8992761111533,SPRITE SLIM CAM250ML,1,5000,0,5000,3750,1250
8/26/2021 19:23,8992761164546,NUTRIBOOST STRAWBERRY 300ML,1,6500,0,6500,5300,1200
8/26/2021 19:23,089686611878,QTELA TEMPE,1,6000,0,6000,5370,630
8/26/2021 19:24,8992761139018,ADES 600ML,1,3500,0,3500,2292,1208
8/26/2021 19:24,RB,RED BOLD,1,19000,0,19000,17900,1100
8/26/2021 19:25,RB,RED BOLD,1,19000,0,19000,17900,1100
8/26/2021 19:29,8991102230308,BLASTER PINK,1,5000,0,5000,3106,1894
8/26/2021 19:32,GL,GULA 1 LITER,1,11500,0,11500,10500,1000
8/26/2021 19:34,ROTI,ROTI 2000,2,2000,0,4000,3600,400
8/26/2021 19:35,ROTI,ROTI 2000,2,2000,0,4000,3600,400
8/26/2021 19:36,ROTI,ROTI 2000,1,2000,0,2000,1800,200
8/26/2021 19:38,8994867000162,ROKOK PUNDIMAS KRETEK16,1,10000,0,10000,8600,1400
8/26/2021 19:38,089686611519,QTELA SINGKONG,1,5000,0,5000,4266,734
8/26/2021 19:40,ROTI,ROTI 2000,3,2000,0,6000,5400,600
8/26/2021 19:43,8998989500166,GUDANG GARAM MERAH BESAR 16KS,2,18000,0,36000,34000,2000
8/26/2021 19:48,8998866201841,GOLDA DOLCE LATTE 200ML,1,3000,0,3000,2500,500
8/26/2021 19:50,089686611519,QTELA SINGKONG,1,5000,0,5000,4266,734
8/26/2021 19:50,8993470411433,JOGER CLASSIC,1,1000,0,1000,850,150
8/26/2021 19:52,ROTI,ROTI 2000,3,2000,0,6000,5400,600
8/26/2021 19:54,8997009510116,LEMON WATER,1,7000,0,7000,5694,1306
8/26/2021 19:59,8999909096004,SAMPOERNA 16 FILTER,2,24000,0,48000,46000,2000
8/26/2021 20:04,8998009040023,TEH KOTAK,1,5000,0,5000,2827,2173
8/26/2021 20:05,8998989500128,GUDANG GARAM MERAH KECIL 12KS,1,14000,0,14000,13000,1000
8/26/2021 20:20,telur rak,telur rak,1,40000,0,40000,37000,3000
8/26/2021 20:37,8992761111533,SPRITE SLIM CAM250ML,2,5000,0,10000,7500,2500
8/26/2021 20:40,8995333000822,TERIGU KOMPAS SOFT 500GR,3,5500,0,16500,14901,1599
8/26/2021 20:45,8998866200301,MIE SEDAAP GORENG,3,2700,0,8100,7239,861
8/26/2021 20:45,ARG,ARGUS 220ML,1,14500,0,14500,13300,1200
8/26/2021 21:03,8998866501026,MINYAK GORENG SEDAAP POUCH 1 L,1,15000,0,15000,14110,890
8/26/2021 22:16,8998866200301,MIE SEDAAP GORENG,2,2700,0,5400,4826,574
8/26/2021 22:32,123124,KOREK BIASA,1,2000,0,2000,1300,700
8/26/2021 22:36,8999999195649,SARI WANGI 25X1.86G,1,6000,0,6000,5050,950
8/26/2021 22:36,8999999031602,SARI MURNI 20X1.6G,1,6000,0,6000,5400,600
8/26/2021 22:45,KIKO,KIKO,3,1000,0,3000,1500,1500
8/26/2021 22:45,123124,KOREK BIASA,1,2000,0,2000,1300,700
8/26/2021 22:45,089686043051,INDOMIE COTO MAKASSAR,1,2800,0,2800,2525,275
8/26/2021 22:45,8992761111533,SPRITE SLIM CAM250ML,1,5000,0,5000,3750,1250
8/26/2021 22:45,8998009040023,TEH KOTAK,3,5000,0,15000,8481,6519
8/26/2021 22:45,MTR,MOTOR,1,5000,0,5000,3500,1500
8/26/2021 22:45,Gula gula tusuk,gula gula tusuk,2,500,0,1000,800,200
8/26/2021 22:45,8992696521797,MILO 22G,1,2500,0,2500,1572,928
8/26/2021 22:46,123124,KOREK BIASA,2,2000,0,4000,2600,1400
8/26/2021 22:51,8999909096004,SAMPOERNA 16 FILTER,1,24000,0,24000,23100,900
8/26/2021 22:51,8998989300261,GUDANG GARAM SURYA 12 FILTER,1,19000,0,19000,17700,1300
8/26/2021 22:52,8997028590014,ARGUS 220ML,2,500,0,1000,604,396
8/26/2021 22:54,ICE CREAM 5.000,ICE CREAM 5.000,1,5000,0,5000,4700,300
8/26/2021 22:55,8997028590014,ARGUS 220ML,2,500,0,1000,604,396
8/26/2021 22:58,8992761145019,COCA COLA PET 250ML,1,3500,0,3500,2417,1083
8/26/2021 22:59,8992696521629,DNCO COKLT UHT 180ML,2,5000,0,10000,7066,2934
8/26/2021 23:01,ICE CREAM 5,ICE CREAM 5000,1,5000,0,5000,4400,600
8/26/2021 23:02,8991001242013,Top,2,1000,0,2000,1000,1000
8/26/2021 23:03,8991102320184,TANGO CHOCO JAVAMOCCA,1,5000,0,5000,4330,670
8/26/2021 23:06,8996001355756,BENG-BENG MAXX SCT,1,2500,0,2500,2041,459
8/26/2021 23:08,8996001600597,KOPIKO LUCKY DAY,1,5000,0,5000,4283,717
8/26/2021 23:08,ROTI,ROTI 2000,1,2000,0,2000,1800,200
8/26/2021 23:10,8991001770301,SELAMAT CLACK VANILA,1,13000,0,13000,11800,1200
8/26/2021 23:11,Gula gula tusuk,gula gula tusuk,2,500,0,1000,800,200
8/26/2021 23:12,Beras,Beras Liter,5,8000,0,40000,37500,2500
8/26/2021 23:14,8999909982000,SAMPOERNA 12 FILTER,1,18000,0,18000,16600,1400
8/26/2021 23:14,ROTI,ROTI 2000,6,2000,0,12000,10800,1200
8/26/2021 23:14,8997018720469,TISSUE SE-KA,1,10000,0,10000,9300,700
8/26/2021 23:17,8992775311998,GERY CHOCOLATOS,1,17000,0,17000,15483,1517
8/26/2021 23:19,8992775312452,gery salut,1,500,0,500,400,100
8/26/2021 23:20,KIKO,KIKO,1,1000,0,1000,500,500
8/26/2021 23:21,TORT,TORTILA,3,1000,0,3000,3000,0
8/26/2021 23:21,8992761139018,ADES 600ML,1,3500,0,3500,2292,1208
8/26/2021 23:22,8992761111519,COCA COLA SLIM CAM 250ML,3,5000,0,15000,11250,3750
8/26/2021 23:22,8992761145019,COCA COLA PET 250ML,1,3500,0,3500,2417,1083
8/26/2021 23:23,8998866803694,SOKLIN SOFTERGENT PURPLE BAG 770 & PIRING,1,18000,0,18000,16680,1320
8/26/2021 23:23,Gula gula tusuk,gula gula tusuk,2,500,0,1000,800,200
8/26/2021 23:24,KIKO,KIKO,1,1000,0,1000,500,500
8/27/2021 9:45,8850507001152,MOTU ATV,1,10000,0,10000,8000,2000
8/27/2021 9:45,8991002307209,COFFE CANDY,1,6000,0,6000,5000,1000
8/27/2021 9:45,8991002307209,COFFE CANDY,1,6000,0,6000,5000,1000
8/27/2021 9:45,8997003910684,2CS,2,3000,0,6000,3000,3000
8/27/2021 10:27,9556001004673,MILO NESTLE MALAYSIA ACTIVE GO,1,85000,0,85000,80000,5000
8/27/2021 10:33,8998866601429,POWDET DAIA BUNGA BAG 290GR,1,5000,0,5000,4450,550
8/27/2021 10:38,8998866101998,ZINC REFRESHING COOL 70ML,1,8500,0,8500,7550,950
8/27/2021 11:11,8998866200301,MIE SEDAAP GORENG,1,2700,0,2700,2413,287
8/27/2021 11:11,089686043204,INDOMIE MIE ACEH,1,2700,0,2700,2452,248
8/27/2021 11:11,ROTI,ROTI 2000,1,2000,0,2000,1800,200
8/27/2021 11:11,8997028590014,ARGUS 220ML,5,500,0,2500,1510,990
8/27/2021 11:53,8997027300089,NOMOS,1,4000,0,4000,2963,1037
8/27/2021 11:53,8992761111540,FANTA STRAWBERY SLIM CAM 250ML,1,5000,0,5000,3750,1250
8/27/2021 12:17,8999801700054,SUSU FOYU 1 KG,2,22000,0,44000,39582,4418
8/27/2021 12:55,8991002121065,GOOD DAY AVOCADO DELIGHT,1,6000,0,6000,4295,1705
8/27/2021 12:56,Gula gula kaki,gula gula kaki,2,500,0,1000,800,200
8/27/2021 12:57,089686611519,QTELA SINGKONG,2,5000,0,10000,8532,1468
8/27/2021 12:57,ROTI,ROTI 2000,8,2000,0,16000,14400,1600
8/27/2021 12:58,Gula gula kopiko,gula gula kopiko,6,350,0,2100,1500,600
8/27/2021 13:02,8992761164546,NUTRIBOOST STRAWBERRY 300ML,1,6500,0,6500,5300,1200
8/27/2021 13:03,8999999050009,SUNLIGHT LIME NEW POUCH 95ML,1,2000,0,2000,1600,400
8/27/2021 13:03,8992775312452,gery salut,1,500,0,500,400,100
8/27/2021 13:07,8993989311699,CLAS MILD 16 FILTER,1,23000,0,23000,21700,1300
8/27/2021 13:08,8993989311699,CLAS MILD 16 FILTER,1,23000,0,23000,21700,1300
8/27/2021 13:18,089686611519,QTELA SINGKONG,1,5000,0,5000,4266,734
8/27/2021 13:18,8993470672858,SAKU-SAKU RASA BALADO,1,2000,0,2000,1530,470
8/27/2021 13:19,6907992825076,JD WATERMELON APPLE,1,2000,0,2000,1700,300
8/27/2021 13:25,ROTI,ROTI 2000,2,2000,0,4000,3600,400
8/27/2021 13:25,8992775310212,GERY PASTA COKELAT,1,18000,0,18000,16029,1971
8/27/2021 13:25,8992388101085,NU GREEN TEA ORIGINAL 330ML,1,3500,0,3500,2854,646
8/27/2021 13:25,8992696523067,MILO ACTVGO UHT 180ML,1,4500,0,4500,3515,985
8/27/2021 13:54,8991102300421,WFR TANGO COKLAT 176GR,2,10000,0,20000,17388,2612
8/27/2021 13:54,8992775214008,Garuda Kacang Atom,1,1000,0,1000,810,190
8/27/2021 15:06,8996001410042,TB TORA MOKA,5,1500,0,7500,4350,3150
8/27/2021 16:20,8991102385060,TANGO WAFFLE CHOX,1,9000,0,9000,8498,502
8/27/2021 16:45,ARD,SENDAL ARDILES,1,15000,0,15000,13500,1500
8/27/2021 16:52,089686611878,QTELA TEMPE,1,6000,0,6000,5370,630
8/27/2021 16:52,8998866201452,POTABEE REGULER BBQ BEEF 35GR,1,5000,0,5000,4150,850
8/27/2021 16:52,089686611618,QTELA BARBEQUE,1,5000,0,5000,4266,734
8/27/2021 16:52,8991102714679,TANGO TETRA STRAW,2,5000,0,10000,9090,910
8/27/2021 17:21,8997231980039,O`JELLY KONYAKU (MAXI APPLE STRAWBERRY),1,5500,0,5500,4620,880
8/27/2021 17:21,089686611519,QTELA SINGKONG,1,5000,0,5000,4266,734
8/27/2021 17:23,8992775002582,DILAN CHOCO,2,2000,0,4000,3006,994
8/27/2021 17:26,8992775002582,DILAN CHOCO,3,2000,0,6000,4509,1491
8/27/2021 17:30,8991001242013,Top,1,1000,0,1000,500,500
8/27/2021 17:40,8886013213208,FRENCH FREIS 2000,1,5000,0,5000,3750,1250
8/27/2021 17:40,ROTI,ROTI 2000,2,2000,0,4000,3600,400
8/27/2021 17:40,8992775310212,GERY PASTA COKELAT,1,18000,0,18000,16029,1971
8/27/2021 17:40,8992388101085,NU GREEN TEA ORIGINAL 330ML,1,3500,0,3500,2854,646
8/27/2021 17:40,8992696523067,MILO ACTVGO UHT 180ML,2,4500,0,9000,7030,1970
8/27/2021 17:40,KIKO,KIKO,1,1000,0,1000,500,500
8/27/2021 17:40,8999999519124,LUX MAGICAL ORCHID 3PC 110G,1,11200,0,11200,10160,1040
8/27/2021 17:40,8999999033217,LIFEBUOY SHP ANTI KETEMBE 170ML,1,16500,0,16500,14950,1550
8/27/2021 17:40,8998866202343,MIE SEDAAP KOREAN SPICY,1,2700,0,2700,2413,287
8/27/2021 17:40,8991001503107,CHACHA PEANUT 35GR,1,5500,0,5500,4900,600
8/27/2021 17:40,8991002121065,GOOD DAY AVOCADO DELIGHT,1,6000,0,6000,4295,1705
8/27/2021 17:49,8991004011906,KOPI BORONG,1,10000,0,10000,8333,1667
8/27/2021 17:49,8996001355756,BENG-BENG MAXX SCT,4,2500,0,10000,8164,1836
8/27/2021 17:49,ROTI,ROTI 2000,4,2000,0,8000,7200,800
8/27/2021 17:49,089686060027,POP MIE AYAM JUMBO,1,4500,0,4500,3833,667
8/27/2021 17:49,8991102384841,WFR TANGO LONG CKLT 130G,1,5000,0,5000,4345,655
8/27/2021 17:49,8992761002022,SPRITE PET 390ML,1,5500,0,5500,4300,1200
8/27/2021 17:49,8997028590014,ARGUS 220ML,2,500,0,1000,604,396
8/27/2021 17:49,8992761139018,ADES 600ML,2,3500,0,7000,4584,2416
8/27/2021 17:49,089686611519,QTELA SINGKONG,2,5000,0,10000,8532,1468
8/27/2021 17:49,8998866201841,GOLDA DOLCE LATTE 200ML,1,3000,0,3000,2500,500
8/27/2021 17:50,8995333032113,TERIGU GATOT KACA 1 KG,1,9000,0,9000,8572,428
8/27/2021 18:01,9556001004673,MILO NESTLE MALAYSIA ACTIVE GO,1,85000,0,85000,80000,5000
8/27/2021 18:01,089686611519,QTELA SINGKONG,2,5000,0,10000,8532,1468
8/27/2021 18:01,8998009040023,TEH KOTAK,2,5000,0,10000,5654,4346
8/27/2021 18:01,ROTI,ROTI 2000,5,2000,0,10000,9000,1000
8/27/2021 18:01,8992761164539,NUTRIBOOST ORANGE 300ML,1,6500,0,6500,5300,1200
8/27/2021 18:01,Pulpen,pulpen,1,1000,0,1000,750,250
8/27/2021 18:01,8997003910684,2CS,1,3000,0,3000,1500,1500
8/27/2021 18:01,8992761139018,ADES 600ML,1,3500,0,3500,2292,1208
8/27/2021 18:01,6907992823843,JD MOCHA CRISPY,1,5000,0,5000,4400,600
8/27/2021 18:03,8998866607315,SOKLIN SOFTERGENT SAKURA 770G & PIRING,1,18000,0,18000,16680,1320
8/27/2021 18:03,8992959953181,SWEETY BRONZE L30+2,1,55000,0,55000,53410,1590
8/27/2021 18:03,8993470671752,JOGER STICK DUO KACANG,2,1000,0,2000,1700,300
8/27/2021 18:06,Gula gula pulpen,gula gula pulpen,3,2000,0,6000,5250,750
8/27/2021 18:06,Gula gula tusuk,gula gula tusuk,4,500,0,2000,1600,400
8/27/2021 18:09,GL,GULA 1 LITER,1,11500,0,11500,10500,1000
8/27/2021 18:15,8994834006128,TICTIC PEDAS,2,2000,0,4000,3400,600
8/27/2021 18:15,8991102281416,PERMEN MINTZ PPMINT,1,5000,0,5000,4000,1000
8/27/2021 18:33,MARS,MARSHMELLOW,2,500,0,1000,866,134
8/27/2021 18:51,Gula gula pulpen,gula gula pulpen,1,2000,0,2000,1750,250
8/27/2021 18:55,8996001600399,LE MINERAL 1500ML,1,5000,0,5000,4042,958
8/27/2021 19:11,ff,FULLO BLASTO,3,1000,0,3000,2985,15
8/27/2021 19:45,8991102384841,WFR TANGO LONG CKLT 130G,2,5000,0,10000,8690,1310
8/27/2021 19:49,8992775214008,Garuda Kacang Atom,1,1000,0,1000,810,190
8/27/2021 19:49,089686611878,QTELA TEMPE,1,6000,0,6000,5370,630
8/27/2021 19:49,089686611519,QTELA SINGKONG,1,5000,0,5000,4266,734
8/27/2021 19:49,8991102987639,WFR TANGO LONG VNL 130G,2,5000,0,10000,7546,2454
8/27/2021 19:49,8998866201452,POTABEE REGULER BBQ BEEF 35GR,1,5000,0,5000,4150,850
8/27/2021 20:38,krupuk k,Krupuk Kentang,2,5000,0,10000,9000,1000
8/27/2021 21:11,8997003910684,2CS,1,3000,0,3000,1500,1500
8/27/2021 21:36,8992775001783,GERY SALUT MALKIST KELAPA,1,6500,0,6500,5516,984
8/27/2021 21:36,8992775315095,GERY MALKIST SWEET CHEESE,1,6500,0,6500,5516,984
8/27/2021 21:36,8991102989381,TANGO LONG BUBBLEGUM 130G,1,5000,0,5000,4345,655
8/27/2021 21:55,8998866202343,MIE SEDAAP KOREAN SPICY,5,2700,0,13500,12065,1435
8/27/2021 21:55,8998866612173,SOKLIN SOFTERGENT PINK 770G & PIRING,1,18000,0,18000,16055,1945
8/27/2021 21:55,8999999531515,MOLTO WHITE MUSK SC 10ML,1,5500,0,5500,4800,700
8/27/2021 21:55,gula,GULA,2,11500,0,23000,20000,3000
8/27/2021 21:55,8850507001152,MOTU ATV,1,10000,0,10000,8000,2000
8/27/2021 21:59,8998866202312,NOODLE SEDAAP TASTY BAKMI AYAM 129 GR,1,5000,0,5000,4167,833
8/27/2021 21:59,8992959117583,SFX DS REG FLOW WING 20,1,5000,0,5000,4288,712
8/27/2021 22:18,jagung marning,jagung marning,1,5000,0,5000,4500,500
8/27/2021 22:20,ICE CREAM 3.500,ICE CREAM 3.500,1,3500,0,3500,3000,500
8/27/2021 22:23,8999999514495,RINSO MOLTO ROSE FRESH 215ML,1,5000,0,5000,4250,750
8/27/2021 22:28,8998866201889,KRISBEE PILLOW STRAWBERRY ICE CREAM 120GR,1,8000,0,8000,7250,750
8/27/2021 22:33,8992959930748,CONFI PANTS L10,4,5000,0,20000,17032,2968
8/27/2021 22:34,8997003910684,2CS,2,3000,0,6000,3000,3000
8/27/2021 22:35,jagung marning,jagung marning,2,5000,0,10000,9000,1000
8/27/2021 22:40,8992775312452,gery salut,3,500,0,1500,1200,300
8/27/2021 22:44,silet,silet,1,1000,0,1000,800,200
8/27/2021 22:47,8992775312452,gery salut,2,500,0,1000,800,200
8/27/2021 22:48,YOUTOP,YOUTOP,1,1000,0,1000,875,125
8/27/2021 22:50,KIKO,KIKO,1,1000,0,1000,500,500
8/27/2021 22:52,8999999045616,MOLTO AIO PINK SCH,5,1000,0,5000,4000,1000
8/27/2021 22:54,KRP,KERUPUK BAWANG SINJAI,1,6000,0,6000,5000,1000
8/27/2021 22:55,8998866202244,EKOMIE BUMBU KALDU AYAM,2,1000,0,2000,1596,404
8/27/2021 22:56,TORT,TORTILA,1,1000,0,1000,1000,0
8/27/2021 22:58,8999999195649,SARI WANGI 25X1.86G,1,6000,0,6000,5050,950
8/27/2021 23:09,8993007001557,INDOMILK SKM 37G,1,1500,0,1500,1081,419
8/27/2021 23:30,0105312686040047,yakult,1,2000,0,2000,1500,500
8/27/2021 23:31,0105312686040047,yakult,3,2000,0,6000,4500,1500
8/27/2021 23:32,8992775214008,Garuda Kacang Atom,1,1000,0,1000,810,190
8/27/2021 23:33,8998866500708,FLORIDINA ORANGE,1,3000,0,3000,2500,500
8/27/2021 23:37,8994834006128,TICTIC PEDAS,2,2000,0,4000,3400,600
8/27/2021 23:46,8998989110167,SURYA GUDANG GARAM 16 FILTER,1,25000,0,25000,23700,1300
8/28/2021 12:09,ROTI,ROTI 2000,5,2000,0,10000,9000,1000
8/28/2021 12:09,8998989110167,SURYA GUDANG GARAM 16 FILTER,2,25000,0,50000,47400,2600
8/28/2021 12:12,ROTI,ROTI 2000,4,2000,0,8000,7200,800
8/28/2021 12:39,8999909096004,SAMPOERNA 16 FILTER,2,24000,0,48000,46200,1800
8/28/2021 12:39,8996001355237,SUPER STAR,1,11000,0,11000,9900,1100
8/28/2021 13:01,8993989311699,CLAS MILD 16 FILTER,1,23000,0,23000,21700,1300
8/28/2021 13:01,8994935000070,MINYAK DUNIA 450 ML,1,7500,0,7500,6779,721
8/28/2021 13:19,8996001355978,BENG-BENG SHARE IT 9.5G,1,10000,0,10000,8700,1300
8/28/2021 13:21,8992775214008,Garuda Kacang Atom,1,1000,0,1000,810,190
8/28/2021 13:21,8993274532105,BOLU,1,1000,0,1000,833,167
8/28/2021 13:23,ROTI,ROTI 2000,3,2000,0,6000,5400,600
8/28/2021 13:28,8850507001176,HERO RACING,1,12000,0,12000,10600,1400
8/28/2021 13:28,8998866612173,SOKLIN SOFTERGENT PINK 770G & PIRING,1,18000,0,18000,16055,1945
8/28/2021 14:30,8999909010567,234 DJI SAM SOE 16,1,22000,0,22000,21500,500
8/28/2021 14:31,KIKO,KIKO,1,1000,0,1000,500,500
8/28/2021 15:20,Gula gula pulpen,gula gula pulpen,1,2000,0,2000,1750,250
8/28/2021 15:31,KIKO,KIKO,3,1000,0,3000,1500,1500
8/28/2021 15:31,6907992825076,JD WATERMELON APPLE,1,2000,0,2000,1700,300
8/28/2021 16:19,8991102384841,WFR TANGO LONG CKLT 130G,2,5000,0,10000,8690,1310
8/28/2021 16:19,8999909002821,MARLBORO BLACK 16,1,22000,0,22000,20850,1150
8/28/2021 16:19,8994867007161,ROKOK PENA GOLD 20,1,17000,0,17000,15500,1500
8/28/2021 16:19,TORT,TORTILA,1,1000,0,1000,1000,0
8/28/2021 16:19,8886013213208,FRENCH FREIS 2000,1,5000,0,5000,3750,1250
8/28/2021 16:19,KIKO,KIKO,1,1000,0,1000,500,500
8/28/2021 16:19,8998989300261,GUDANG GARAM SURYA 12 FILTER,1,19000,0,19000,17700,1300
8/28/2021 17:11,8998989500166,GUDANG GARAM MERAH BESAR 16KS,1,18000,0,18000,17000,1000
8/28/2021 17:14,8993007000680,INDOMILK 1L,1,16500,0,16500,14792,1708
8/28/2021 17:14,6907992823874,JD CRUNCHY CHOCO BLUEBERRY,1,5500,0,5500,4700,800
8/28/2021 17:16,8991002103931,GOOD DAY CARREBIAN NUT,10,1300,0,13000,8900,4100
8/28/2021 17:18,6907992823652,JD CHOCOLATE MILKSHAKE,1,6000,0,6000,5200,800
8/28/2021 17:18,6907992824963,JD MILKY CHOCOLATE,1,3000,0,3000,2600,400
8/28/2021 18:04,8991102022460,FORMULA DIAMOND,1,3000,0,3000,2500,500
8/28/2021 18:05,8999999049416,REXONA MEN RO QUANTUM 45 ML,1,15000,0,15000,13550,1450
8/28/2021 18:27,8999099920691,SGM 1+ MADU 1000G,1,85000,0,85000,78510,6490
8/28/2021 18:28,8998866200301,MIE SEDAAP GORENG,1,2700,0,2700,2413,287
8/28/2021 18:28,8998866202732,MILKU STROBERI 200ML,1,3000,0,3000,2375,625
8/29/2021 12:09,8993226365522,GARAM MEJA GYURI 200GR,1,2000,0,2000,1700,300
8/29/2021 12:09,VTM,VITAMIN CIMIN,6,500,0,3000,2550,450
8/29/2021 12:09,8998989110167,SURYA GUDANG GARAM 16 FILTER,1,25000,0,25000,23700,1300
8/29/2021 12:09,8999099920691,SGM 1+ MADU 1000G,1,85000,0,85000,78510,6490
8/29/2021 12:09,ARG,ARGUS 220ML,2,14500,0,29000,26600,2400
8/29/2021 12:09,8886001038011,BENG-BENG SCT,2,4000,0,8000,2900,5100
8/29/2021 12:09,8998989500166,GUDANG GARAM MERAH BESAR 16KS,1,18000,0,18000,17000,1000
8/29/2021 12:09,711844120419,SAMBAL ABC 275 ML,1,12000,0,12000,10800,1200
8/29/2021 12:09,8999909096004,SAMPOERNA 16 FILTER,1,24000,0,24000,23100,900
8/29/2021 12:09,GL,GULA 1 LITER,1,11500,0,11500,10500,1000
8/29/2021 12:09,8998989300261,GUDANG GARAM SURYA 12 FILTER,1,19000,0,19000,17700,1300
8/29/2021 12:09,8996001304020,SLAI OLAI NANAS,1,8500,0,8500,7700,800
8/29/2021 13:04,8998989300261,GUDANG GARAM SURYA 12 FILTER,1,19000,0,19000,17700,1300
8/29/2021 13:04,089686611519,QTELA SINGKONG,1,5000,0,5000,4266,734
8/29/2021 13:04,8992959953105,SWEETY BRONZE XXL6,1,16000,0,16000,15230,770
8/29/2021 13:04,8999999529734,CLEAR IC MTHL 160ML,1,23700,0,23700,21400,2300
8/29/2021 13:04,8999999390198,SUNLIGHT LIME NEW POUCH 755ML,1,17000,0,17000,15400,1600
8/29/2021 13:04,8997027300089,NOMOS,1,4000,0,4000,2963,1037
8/29/2021 13:04,8999999007768,FAIR&LOVELY MULTIVITAMIN  CREAM 9 ML,2,4500,0,9000,6400,2600
8/29/2021 13:04,8998866610278,DAIA VIOLET GUSSET 565G,1,10000,0,10000,8700,1300
8/29/2021 13:04,8998866200301,MIE SEDAAP GORENG,2,2700,0,5400,4826,574
8/29/2021 13:04,8993989311699,CLAS MILD 16 FILTER,2,23000,0,46000,43400,2600
8/29/2021 13:04,8994834006128,TICTIC PEDAS,1,1000,0,1000,1700,-700
8/29/2021 13:04,8886013213208,FRENCH FREIS 2000,1,5000,0,5000,3750,1250
8/29/2021 13:04,GL,GULA 1 LITER,5,11500,0,57500,52500,5000
8/29/2021 13:07,089686041705,INDOMIE GORENG JUMBO,1,3500,0,3500,3143,357
8/29/2021 13:07,8998898830125,KKB ENER-G ANGGUR,1,5500,0,5500,4824,676
8/29/2021 13:07,8992761139018,ADES 600ML,1,3000,0,3000,2292,708
8/29/2021 13:07,8996001355756,BENG-BENG MAXX SCT,1,2500,0,2500,2041,459
8/29/2021 13:07,8994867000162,ROKOK PUNDIMAS KRETEK16,1,10000,0,10000,8600,1400
8/29/2021 13:07,8999909000711,MAGNUM MILD 16,1,21000,0,21000,19350,1650
8/29/2021 13:07,8992761145033,FANTA STRAW PET 250ML,1,3500,0,3500,2417,1083
8/29/2021 13:35,8996001600399,LE MINERAL 1500ML,1,5000,0,5000,4042,958
8/29/2021 13:39,8995333000822,TERIGU KOMPAS SOFT 500GR,3,5500,0,16500,14901,1599
8/29/2021 13:39,8999999524722,SUNLIGHT LIME NEW PCH 435ML,1,10000,0,10000,9100,900
8/29/2021 13:46,089686043051,INDOMIE COTO MAKASSAR,1,2800,0,2800,2525,275
8/29/2021 13:46,8991102384841,WFR TANGO LONG CKLT 130G,1,5000,0,5000,4345,655
8/29/2021 13:49,8998866501026,MINYAK GORENG SEDAAP POUCH 1 L,1,15000,0,15000,14110,890
8/29/2021 13:49,8996001355756,BENG-BENG MAXX SCT,1,2500,0,2500,2041,459
8/29/2021 13:49,8992775312452,gery salut,1,500,0,500,400,100
8/29/2021 13:49,8992775000076,GERY SNACK RING CKLT,1,2000,0,2000,1712,288
8/29/2021 13:57,8998989300261,GUDANG GARAM SURYA 12 FILTER,1,19000,0,19000,17700,1300
8/29/2021 13:57,8998866202671,NOODLE SEDAAP MIE KOREAN SPICY SOUP CUP,1,2700,0,2700,4002,-1302
8/29/2021 15:53,TBR,TEPUNG BERAS ROSE BRAND,1,8000,0,8000,5800,2200
8/29/2021 15:53,8998866200844,NOODLE SEDAAP MIE KARI SPESIAL CUP 81 GR,1,4500,0,4500,3650,850
8/29/2021 15:53,SFX,SOFTEX DAUN SIRIH 1,1,5000,0,5000,413,4587
8/29/2021 15:53,KIKO,KIKO,1,1000,0,1000,500,500
8/29/2021 15:53,MILKITA,MILKITA,4,250,0,1000,800,200
8/29/2021 15:53,8999909010567,234 DJI SAM SOE 16,1,22000,0,22000,21500,500
8/29/2021 15:53,8999909000971,MAGNUM MILD 20,1,24000,0,24000,22750,1250
8/29/2021 16:01,8999999559854,AXE BLACK POCKET FRAG 17ML,1,10000,0,10000,8000,2000
8/29/2021 16:27,8997210107877,VORTEX SMART 3,1,4000,0,4000,4750,-750
8/29/2021 17:19,6907992823850,JD CHOCO CIRLE,1,5500,0,5500,4700,800
8/29/2021 17:19,6907992823652,JD CHOCOLATE MILKSHAKE,2,6000,0,12000,10400,1600
8/29/2021 17:19,8992628022156,BIMOLI KLASIK TOUCH 1 LT,1,16000,0,16000,14350,1650
8/29/2021 17:19,KIKO,KIKO,1,1000,0,1000,500,500
8/29/2021 17:19,ff,FULLO BLASTO,1,1000,0,1000,995,5
8/29/2021 17:19,8886001038011,BENG-BENG SCT,3,1500,0,4500,4350,150
8/29/2021 17:20,COKLAT,COKLAT COIN,2,500,0,1000,850,150
8/29/2021 18:10,8997210107877,VORTEX SMART 3,1,5000,0,5000,4750,250
8/29/2021 18:13,8998989110167,SURYA GUDANG GARAM 16 FILTER,1,25000,0,25000,23700,1300
8/29/2021 18:28,8999909096004,SAMPOERNA 16 FILTER,2,24000,0,48000,46200,1800
8/29/2021 18:33,8999801700054,SUSU FOYU 1 KG,1,22000,0,22000,19791,2209
8/29/2021 18:47,8997011700123,BIHUN JAGUNG 300GR,5,6000,0,30000,24895,5105
8/29/2021 18:51,KP,KERIPIK PISANG,1,5000,0,5000,5000,0
8/29/2021 18:55,8992628022156,BIMOLI KLASIK TOUCH 1 LT,1,16000,0,16000,14350,1650
8/29/2021 18:56,ICE CREAM 6,ICE CREAM 6.000,2,6000,0,12000,10400,1600
8/29/2021 19:12,8998866601429,POWDET DAIA BUNGA BAG 290GR,1,5000,0,5000,4450,550
8/29/2021 19:12,8999999036607,LUX TS SOFT ROSE 75G,1,3500,0,3500,2800,700
8/29/2021 19:12,8999999050009,SUNLIGHT LIME NEW POUCH 95ML,1,2000,0,2000,1600,400
8/29/2021 19:29,KIKO,KIKO,1,1000,0,1000,500,500
8/29/2021 19:32,8993470672858,SAKU-SAKU RASA BALADO,1,2000,0,2000,1530,470
8/29/2021 20:47,8994867007161,ROKOK PENA GOLD 20,1,17000,0,17000,15500,1500
8/29/2021 20:47,8994867006997,ROKOK PENA BOLD 20BTG,1,17000,0,17000,15000,2000
8/29/2021 20:49,8991909101016,URBAN MILD 16,1,17000,0,17000,15800,1200
8/29/2021 21:16,8998989110167,SURYA GUDANG GARAM 16 FILTER,2,25000,0,50000,47400,2600
8/29/2021 21:23,8996001375372,CHOKI CHOKI,1,1000,0,1000,910,90
8/29/2021 22:11,089686014280,SUPERMI AYAM BAWANG,2,2500,0,5000,4624,376
8/30/2021 17:00,8997025911058,HATARI SHP KELAPA,1,6000,0,6000,4911,1089
8/30/2021 17:00,8996001318430,BETTER 1000,10,1000,0,10000,8200,1800
8/30/2021 17:00,8998866202435,JAPOTA UMAMI JAPANESE SEAWEED 35GR,1,5000,0,5000,4150,850
8/30/2021 17:09,8994867000179,ROKOK PENA MILD 16,1,14500,0,14500,13500,1000
8/30/2021 17:25,8998989110167,SURYA GUDANG GARAM 16 FILTER,1,25000,0,25000,23700,1300
8/30/2021 20:06,8993379241858,SABUN HARMONY LEMON 70G,1,2000,0,2000,1652,348
8/30/2021 20:06,8993379200862,harmony,1,2000,0,2000,1700,300
8/30/2021 20:34,8999999006006,RINSO ANTI NODA CLASSISC 750ML,2,15000,0,30000,25014,4986
8/30/2021 20:34,8998866202732,MILKU STROBERI 200ML,2,3000,0,6000,4750,1250
8/30/2021 20:34,8992388133017,NU MILK TEA ORI 330ML,1,6000,0,6000,5125,875
8/30/2021 20:34,8992775002735,CHOCOLATOS SUSU COKELAT,2,4000,0,8000,7040,960
8/30/2021 20:34,8998866609487,SOKLIN SOFTERGEN 280G,1,5000,0,5000,4425,575
8/30/2021 20:34,8995333032113,TERIGU GATOT KACA 1 KG,1,9000,0,9000,8572,428
8/30/2021 20:34,8993093115008,tepun beras,1,8000,0,8000,7000,1000
8/30/2021 20:46,8998866610087,JAVANA ORIGINAL 350ML,1,3000,0,3000,2150,850
8/30/2021 20:46,TORT,TORTILA,3,1000,0,3000,3000,0
8/30/2021 20:51,RT 1000,ROTI 1000,4,1000,0,4000,3200,800
8/30/2021 20:51,8997028590014,ARGUS 220ML,4,500,0,2000,1208,792
8/30/2021 20:51,jagung marning,jagung marning,1,5000,0,5000,4500,500
8/30/2021 20:52,8999909002821,MARLBORO BLACK 16,1,22000,0,22000,20850,1150
8/30/2021 20:52,8994867007161,ROKOK PENA GOLD 20,1,17000,0,17000,15500,1500
8/30/2021 21:00,8992775318201,GERY SNACK BANTAL COKLAT,1,2000,0,2000,1712,288
8/30/2021 21:00,RT 1000,ROTI 1000,2,1000,0,2000,1600,400
8/30/2021 21:00,8997003910684,2CS,1,3000,0,3000,1500,1500
8/30/2021 21:00,jagung marning,jagung marning,2,5000,0,10000,9000,1000
8/30/2021 21:00,RT,ROTI,2,9000,0,18000,16000,2000
8/30/2021 21:00,8997211400038,SANTAN COCONUT CREAM,2,4000,0,8000,6000,2000
8/30/2021 21:00,089686021219,INTER MIE GORENG,4,1000,0,4000,3540,460
8/30/2021 21:00,8997012030748,MADU ENAK,1,1000,0,1000,900,100
8/30/2021 21:02,8998866200301,MIE SEDAAP GORENG,3,2700,0,8100,7239,861
8/30/2021 21:04,089686010107,INDOMIE KALDU AYAM,4,2500,0,10000,8600,1400
8/30/2021 21:05,Gula gula tusuk,gula gula tusuk,2,500,0,1000,800,200
8/30/2021 21:08,8998866201889,KRISBEE PILLOW STRAWBERRY ICE CREAM 120GR,1,8000,0,8000,7250,750
8/30/2021 21:10,8991102714846,MILKIDO CKLT,2,3000,0,6000,4306,1694
8/30/2021 21:10,ICE CREAM 5.000,ICE CREAM 5.000,1,5000,0,5000,4700,300
8/30/2021 21:10,8992761139018,ADES 600ML,1,3500,0,3500,2292,1208
8/30/2021 21:10,089686611519,QTELA SINGKONG,1,5000,0,5000,4266,734
8/30/2021 21:18,8998866200301,MIE SEDAAP GORENG,2,2700,0,5400,4826,574
8/30/2021 21:19,PUL,PULPEN,1,1500,0,1500,833,667
8/30/2021 21:20,PUL,PULPEN,2,1500,0,3000,1666,1334
8/30/2021 21:24,JL,JELLY,4,500,0,2000,1600,400
8/30/2021 21:25,GGK,PLAYGUM PERMEN KARET,4,500,0,2000,1600,400
8/30/2021 21:26,8991001503107,CHACHA PEANUT 35GR,1,5500,0,5500,4900,600
8/30/2021 21:27,Gula gula pulpen,gula gula pulpen,3,2000,0,6000,5250,750
8/30/2021 21:27,Gula gula pulpen,gula gula pulpen,2,2000,0,4000,3500,500
8/30/2021 21:28,Gula gula pulpen,gula gula pulpen,1,2000,0,2000,1750,250
8/30/2021 21:28,8997012030748,MADU ENAK,1,1000,0,1000,900,100
8/30/2021 21:34,8992775311509,gery garuda,1,1000,0,1000,700,300
8/30/2021 21:35,8992775311509,gery garuda,2,1000,0,2000,1400,600
8/30/2021 21:36,8992775110157,GARUDA KACANG KULIT,2,5000,0,10000,7850,2150
8/30/2021 21:38,MARS,MARSHMELLOW,2,500,0,1000,866,134
8/30/2021 21:39,ARG,ARGUS 220ML,2,14500,0,29000,26600,2400
8/30/2021 21:41,8999999059781,SUNLIGHT LIME NEW POUCH 210ML,1,5000,0,5000,4300,700
8/30/2021 21:41,8992775311509,gery garuda,3,1000,0,3000,2100,900
8/30/2021 21:42,krupuk k,Krupuk Kentang,1,5000,0,5000,4500,500
8/30/2021 21:44,711844110113,KECAP ABC 135 ML,1,7000,0,7000,6400,600
8/30/2021 21:45,8994420107789,SARDEN SAUS TOMAT,1,7000,0,7000,5833,1167
8/30/2021 21:46,8993274532105,BOLU,2,1000,0,2000,1666,334
8/30/2021 21:47,RT 1000,ROTI 1000,2,1000,0,2000,1600,400
8/30/2021 21:47,Masako,Masako Gantung,1,6000,0,6000,5000,1000
8/30/2021 21:48,8999909982000,SAMPOERNA 12 FILTER,1,18000,0,18000,16600,1400
8/30/2021 21:52,8998989110167,SURYA GUDANG GARAM 16 FILTER,1,25000,0,25000,23700,1300
8/30/2021 21:52,8992959020012,SWEETY SILVER PANTS XL 34,1,78000,0,78000,73637,4363
8/30/2021 21:56,8992775001783,GERY SALUT MALKIST KELAPA,1,6500,0,6500,5516,984
8/30/2021 21:56,8993274532105,BOLU,5,1000,0,5000,4165,835
8/30/2021 21:57,jagung marning,jagung marning,1,5000,0,5000,4500,500
8/30/2021 21:57,8998989300261,GUDANG GARAM SURYA 12 FILTER,1,19000,0,19000,17700,1300
8/30/2021 22:01,8992959117583,SFX DS REG FLOW WING 20,1,5000,0,5000,4288,712
8/30/2021 22:02,KIKO,KIKO,2,1000,0,2000,1000,1000
8/30/2021 22:02,ICE CREAM 3,ICE CREAM 3000,1,3000,0,3000,2600,400
8/30/2021 22:02,8993989311699,CLAS MILD 16 FILTER,1,23000,0,23000,21700,1300
8/30/2021 22:06,8992628020152,BIMOLI POUCH 2L,1,31000,0,31000,29800,1200
8/30/2021 22:10,8886022830243,BATEREI ABC,1,9000,0,9000,7000,2000
8/30/2021 22:11,8995555121244,SOSIS KIMBO,7,1000,0,7000,4550,2450
8/30/2021 22:17,8993007000024,INDOMILK UHT VANILA,2,5000,0,10000,6940,3060
8/30/2021 22:17,8997012030748,MADU ENAK,2,1000,0,2000,1800,200
8/30/2021 22:18,YP,YUPI,2,250,0,500,416,84
8/30/2021 22:18,MARS,MARSHMELLOW,2,500,0,1000,866,134
8/30/2021 22:19,JL,JELLY,2,500,0,1000,800,200
8/30/2021 22:19,ARG,ARGUS 220ML,4,14500,0,58000,53200,4800
8/30/2021 22:25,8998898337440,TOLAK ANGIN CARE 10ML,1,10000,0,10000,7893,2107
8/30/2021 22:25,8999999706081,PEPSODENT WHITE 75G,1,5000,0,5000,3850,1150
8/30/2021 22:26,8996001375372,CHOKI CHOKI,1,1000,0,1000,910,90
8/30/2021 22:27,telur,telur,2,2000,0,4000,2468,1532
8/30/2021 22:30,8996001370063,CHOKI-CHOKI,1,18200,0,18200,16500,1700
8/30/2021 22:38,8991111101255,JB SHAMPOO GOLD 50ML,1,5000,0,5000,4500,500
8/30/2021 22:39,KIKO,KIKO,3,1000,0,3000,1500,1500
8/30/2021 22:39,KIKO,KIKO,1,1000,0,1000,500,500
8/30/2021 22:40,8998866608305,GIV BENGKOANG KOTAK 76G,3,2000,0,6000,5460,540
8/30/2021 22:42,ROTI,ROTI 2000,1,2000,0,2000,1800,200
8/30/2021 22:42,089686386011,BUMBU RACIK NASI GORENG,1,2000,0,2000,1450,550
8/30/2021 22:49,8993989311699,CLAS MILD 16 FILTER,2,23000,0,46000,43400,2600
8/30/2021 22:49,8998866610278,DAIA VIOLET GUSSET 565G,1,10000,0,10000,8700,1300
8/30/2021 22:50,ICE CREAM 5,ICE CREAM 5000,1,5000,0,5000,4400,600
8/31/2021 14:34,Beras,Beras Liter,5,8000,0,40000,37500,2500
8/31/2021 14:36,123124,KOREK BIASA,1,2000,0,2000,1300,700
8/31/2021 14:44,8993379200886,SABUN HARMONY ORANGE 70G,1,2000,0,2000,1652,348
8/31/2021 14:44,telur,telur,6,2000,0,12000,7404,4596
8/31/2021 14:45,telur,telur,6,2000,0,12000,7404,4596
8/31/2021 14:57,JL,JELLY,1,500,0,500,400,100
8/31/2021 14:59,123124,KOREK BIASA,1,2000,0,2000,1300,700
8/31/2021 15:18,8998989300261,GUDANG GARAM SURYA 12 FILTER,1,19000,0,19000,17700,1300
8/31/2021 15:48,8996001375372,CHOKI CHOKI,1,1000,0,1000,910,90
8/31/2021 15:48,KIKO,KIKO,5,1000,0,5000,2500,2500
8/31/2021 15:51,8998866501026,MINYAK GORENG SEDAAP POUCH 1 L,1,15000,0,15000,14110,890
8/31/2021 15:51,6907992823829,JD MILKY MILK,1,3000,0,3000,2600,400
8/31/2021 16:03,KIKO,KIKO,2,1000,0,2000,1000,1000
8/31/2021 16:03,8996001355756,BENG-BENG MAXX SCT,1,2500,0,2500,2041,459
8/31/2021 16:03,8992775312452,gery salut,1,500,0,500,400,100
8/31/2021 16:05,089686060362,POP MIE SOTO AYAM JUMBO,1,4500,0,4500,3833,667
8/31/2021 16:05,089686060027,POP MIE AYAM JUMBO,1,4500,0,4500,3833,667
8/31/2021 16:05,089686060102,POP MIE PEDE GLEDEEK,1,5000,0,5000,4450,550
8/31/2021 16:08,8992959850015,CONFIDENCE M5+1,1,43000,0,43000,39550,3450
8/31/2021 16:28,089686611670,QTELA BALADO,1,5000,0,5000,4266,734
8/31/2021 16:53,KP,KERIPIK PISANG,2,5000,0,10000,10000,0
8/31/2021 16:53,8886013213208,FRENCH FREIS 2000,1,5000,0,5000,3750,1250
8/31/2021 16:53,milkita,milkita,1,500,0,500,370,130
8/31/2021 16:53,balon air,balon air,1,2000,0,2000,1700,300
8/31/2021 16:53,8992775312452,gery salut,1,500,0,500,400,100
8/31/2021 16:53,8996001355756,BENG-BENG MAXX SCT,1,2500,0,2500,2041,459
8/31/2021 16:53,8996001375372,CHOKI CHOKI,1,1000,0,1000,910,90
8/31/2021 16:53,8996001318911,BETTER ISI 4,1,2000,0,2000,1700,300
8/31/2021 18:29,RT ISI 6,ROTI ISI 6,1,6000,0,6000,5000,1000
8/31/2021 18:29,8992761139018,ADES 600ML,1,3500,0,3500,2292,1208
8/31/2021 18:29,8992959955024,SWEETY BABY WIPES 36X50,1,17000,0,17000,14293,2707
8/31/2021 18:49,ARG,ARGUS 220ML,1,14500,0,14500,13300,1200
8/31/2021 18:49,Gula gula tusuk,gula gula tusuk,1,500,0,500,400,100
8/31/2021 19:06,089686043051,INDOMIE COTO MAKASSAR,1,2800,0,2800,2525,275
8/31/2021 19:06,089686010343,INDOMIE SOTO MIE,2,2600,0,5200,4734,466
8/31/2021 19:06,8992761111533,SPRITE SLIM CAM250ML,3,5000,0,15000,11250,3750
8/31/2021 19:19,8998989300261,GUDANG GARAM SURYA 12 FILTER,1,19000,0,19000,17700,1300
8/31/2021 19:28,8998866610070,SOKLIN SOFTERGEN 280G PURPLE,1,5000,0,5000,4425,575
8/31/2021 19:28,089686010107,INDOMIE KALDU AYAM,2,2500,0,5000,4300,700
8/31/2021 19:28,8998866200301,MIE SEDAAP GORENG,1,2700,0,2700,2413,287
8/31/2021 19:28,8998866202619,MIE SEDAAP KOREAN SPICY SOUP,1,2700,0,2700,2322,378
8/31/2021 19:44,8997218380135,ICHITAN GREEN TEA,1,8000,0,8000,6583,1417
8/31/2021 19:47,896867700494,AIR CLUB 1500ML,2,5000,0,10000,5974,4026
8/31/2021 19:48,8998898853100,SUSU JAHE,2,1500,0,3000,2360,640
8/31/2021 19:48,8993989311699,CLAS MILD 16 FILTER,1,23000,0,23000,21700,1300
8/31/2021 19:50,8996001355756,BENG-BENG MAXX SCT,1,2500,0,2500,2041,459
8/31/2021 19:50,8991001242013,Top,1,1000,0,1000,500,500
8/31/2021 19:50,8996001375372,CHOKI CHOKI,1,1000,0,1000,910,90
8/31/2021 19:54,8992222050609,GATSBY ANTI KETOMBE 28ML,1,5500,0,5500,4000,1500
8/31/2021 20:11,8998866501026,MINYAK GORENG SEDAAP POUCH 1 L,2,15000,0,30000,28220,1780
8/31/2021 20:26,8992959020005,SWEETY SILVER PANTS XXL 5,1,16800,0,16800,15228,1572
8/31/2021 20:36,8992775311486,CHOCOLATOS DARK 16G,1,18000,0,18000,15173,2827
8/31/2021 20:36,089686043273,INDOMIE SAMBAL RICA,2,2700,0,5400,4904,496
8/31/2021 20:36,8992775001691,GARUDA ROSTA WAGYU BEEF,2,8000,0,16000,14644,1356
8/31/2021 20:36,8999909096004,SAMPOERNA 16 FILTER,2,24000,0,48000,46200,1800
8/31/2021 21:10,8993989311699,CLAS MILD 16 FILTER,1,23000,0,23000,21700,1300
8/31/2021 22:19,8995333060703,TERIGU KOMPAS 1KG,1,10500,0,10500,9816,684
8/31/2021 22:19,8995333000822,TERIGU KOMPAS SOFT 500GR,3,5500,0,16500,14901,1599
8/31/2021 22:19,8999999192150,ROYCO FDS CHICKEN 100GR,2,5000,0,10000,8600,1400
8/31/2021 22:25,8994867000179,ROKOK PENA MILD 16,1,14500,0,14500,13500,1000
8/31/2021 23:19,8998866200301,MIE SEDAAP GORENG,2,2700,0,5400,4826,574
8/31/2021 23:23,8997231980039,O`JELLY KONYAKU (MAXI APPLE STRAWBERRY),1,5500,0,5500,4620,880
8/31/2021 23:25,telur,telur,5,2000,0,10000,6170,3830
9/1/2021 9:35,PUL,PULPEN,1,1500,0,1500,833,667
9/1/2021 11:42,8998009040023,TEH KOTAK,2,5000,0,10000,5654,4346
9/1/2021 11:42,8998866202626,Top Kopi Gula Aren 22gr,1,1000,0,1000,830,170
9/1/2021 11:42,8998866200325,MIE SEDAAP SOTO,5,2700,0,13500,11655,1845
9/1/2021 11:42,AMPLOP,AMPLOP,4,250,0,1000,560,440
9/1/2021 11:42,8996001600399,LE MINERAL 1500ML,1,5000,0,5000,4042,958
9/1/2021 11:42,8992775312452,gery salut,2,500,0,1000,800,200
9/1/2021 11:42,8996001318430,BETTER 1000,2,1000,0,2000,1640,360
9/1/2021 11:42,8992775311509,gery garuda,3,1000,0,3000,2100,900
9/1/2021 11:44,8997025914059,HATARI SEE HONG,1,6000,0,6000,4911,1089
9/1/2021 11:44,8992775001998 pcs,Gery Salut sandiwich pcs,4,1000,0,4000,3260,740
9/1/2021 11:56,6907992825045,JD CRUNCHY MATCHA CHEESE,1,8000,0,8000,7000,1000
9/1/2021 11:56,8992388133017,NU MILK TEA ORI 330ML,1,6000,0,6000,5125,875
9/1/2021 11:58,8998866202626,Top Kopi Gula Aren 22gr,10,800,0,8000,8300,-300
9/1/2021 12:05,8998866202237,NOODLE SEDAAP TASTY AYAM GEPREK 124 GR,1,5000,0,5000,4167,833
9/1/2021 12:48,8995102703534,TERASI DUO 6 GR,1,4000,0,4000,3720,280
9/1/2021 12:50,8998989300261,GUDANG GARAM SURYA 12 FILTER,1,19000,0,19000,17700,1300
9/1/2021 12:52,8999999516208,ROYCO FDS CHICKEN NEW 230G,1,10000,0,10000,9000,1000
9/1/2021 14:52,8992696425316,NESCAFE BLACK,1,5000,0,5000,4099,901
9/1/2021 14:52,8996001600610,TORA MILKY LATTE 180ML,1,3500,0,3500,2750,750
9/1/2021 15:06,8998989121163,SURYA PRO MERAH,1,20000,0,20000,18600,1400
9/1/2021 16:31,8999909003439,MARLBORO CRAFTED 12,1,8000,0,8000,7250,750
9/1/2021 16:31,8995555171225,KIMBO SOSIS,1,1000,0,1000,900,100
9/1/2021 16:31,Vita Jelly,Vita Jelly,2,1000,0,2000,1532,468
9/1/2021 16:31,8996001375372,CHOKI CHOKI,2,1000,0,2000,1820,180
9/1/2021 16:33,JL,JELLY,2,500,0,1000,800,200
9/1/2021 16:59,8992753100101,BKM FULL CREAM GOLD 370,2,15000,0,30000,28000,2000
9/1/2021 17:05,8993989311699,CLAS MILD 16 FILTER,2,23000,0,46000,43400,2600
9/1/2021 17:34,8992959953167,SWEETY BRONZE S36+2,1,48000,0,48000,45682,2318
9/1/2021 17:34,8992959508862,SWEETY SILVER PANTS M 8,1,16800,0,16800,15229,1571
9/1/2021 17:34,8999999032128,ZWITSAL BATH NAT HAIR&BODY 100ML,1,12100,0,12100,10835,1265
9/1/2021 17:38,8993989311699,CLAS MILD 16 FILTER,1,23000,0,23000,21700,1300
9/1/2021 17:48,8997028590014,ARGUS 220ML,1,500,0,500,302,198
9/1/2021 18:00,8991002105409,KOPI KAPAL API,1,20000,0,20000,18888,1112
9/1/2021 18:00,8886013213208,FRENCH FREIS 2000,1,5000,0,5000,3750,1250
9/1/2021 18:00,8998866200561,EKOMIE SUPER 600GR,1,10000,0,10000,8615,1385
9/1/2021 18:00,8995555121244,SOSIS KIMBO,2,1000,0,2000,1300,700
9/1/2021 18:24,8999801700054,SUSU FOYU 1 KG,1,22000,0,22000,19791,2209
9/1/2021 18:24,ROYCO,ROYCO RASA AYAM,2,500,0,1000,750,250
9/1/2021 18:24,Pulpen,pulpen,1,1000,0,1000,750,250
9/1/2021 18:28,8999999516208,ROYCO FDS CHICKEN NEW 230G,1,10000,0,10000,9000,1000
9/1/2021 18:48,8999909010567,234 DJI SAM SOE 16,1,22000,0,22000,21500,500
9/1/2021 19:12,8992696523067,MILO ACTVGO UHT 180ML,1,4500,0,4500,3515,985
9/1/2021 19:12,8992775001042,PILUS GARUDA MI GORENG,1,5000,0,5000,4810,190
9/1/2021 19:12,8992775311325,GERY SNACK&SEREAL 100G,1,7000,0,7000,6012,988
9/1/2021 19:12,8850507002197,TOK TAK FRUIT CANDY,2,7500,0,15000,12500,2500
9/1/2021 19:12,Vita Jelly,Vita Jelly,1,1000,0,1000,766,234
9/1/2021 19:12,8999909096004,SAMPOERNA 16 FILTER,1,24000,0,24000,23100,900
9/1/2021 19:13,123124,KOREK BIASA,1,2000,0,2000,1300,700
9/1/2021 19:27,089686043051,INDOMIE COTO MAKASSAR,1,2800,0,2800,2525,275
9/1/2021 19:27,089686043204,INDOMIE MIE ACEH,1,2700,0,2700,2452,248
9/1/2021 19:27,KOPIKO,KOPIKO,2,250,0,500,350,150
9/1/2021 19:33,8997204370126,Siko,5,10000,0,50000,41665,8335
9/1/2021 19:36,8999909002821,MARLBORO BLACK 16,1,22000,0,22000,20850,1150
9/1/2021 19:38,8998989110167,SURYA GUDANG GARAM 16 FILTER,2,25000,0,50000,47400,2600
9/1/2021 19:38,ARG,ARGUS 220ML,1,14500,0,14500,13300,1200
9/1/2021 19:38,8996001600399,LE MINERAL 1500ML,2,5000,0,10000,8084,1916
9/1/2021 19:38,KOPIKO,KOPIKO,2,250,0,500,350,150
9/1/2021 19:58,8998866202237,NOODLE SEDAAP TASTY AYAM GEPREK 124 GR,1,5000,0,5000,4167,833
9/1/2021 19:58,8998866200301,MIE SEDAAP GORENG,2,2700,0,5400,4826,574
9/1/2021 19:58,089686010107,INDOMIE KALDU AYAM,1,2500,0,2500,2150,350
9/1/2021 19:58,8998866202244,EKOMIE BUMBU KALDU AYAM,2,1000,0,2000,1596,404
9/1/2021 20:02,8994867000179,ROKOK PENA MILD 16,2,14500,0,29000,27000,2000
9/1/2021 20:14,8998989110167,SURYA GUDANG GARAM 16 FILTER,1,25000,0,25000,23700,1300
9/1/2021 20:14,123124,KOREK BIASA,1,2000,0,2000,1300,700
9/1/2021 20:16,6907992823942,JD JUJUBE,1,4500,0,4500,3800,700
9/1/2021 20:16,YP,YUPI,4,250,0,1000,832,168
9/1/2021 20:16,JL,JELLY,1,500,0,500,400,100
9/1/2021 20:23,ARG,ARGUS 220ML,1,14500,0,14500,13300,1200
9/1/2021 20:23,8991909101016,URBAN MILD 16,1,17000,0,17000,15800,1200
9/1/2021 20:25,8998989300261,GUDANG GARAM SURYA 12 FILTER,1,19000,0,19000,17700,1300
9/1/2021 20:29,8992761164478,FRESTEA MILK TEA,2,8000,0,16000,13150,2850
9/1/2021 20:29,8991102281430,PERMEN MINTZ DUOMINT,1,5000,0,5000,4000,1000
9/1/2021 20:29,0105312686040047,yakult,5,2000,0,10000,7500,2500
9/1/2021 20:30,9556001025272,NESCAFE LATTE 240ML,1,8500,0,8500,7834,666
9/1/2021 21:20,896867700494,AIR CLUB 1500ML,4,5000,0,20000,11948,8052
9/1/2021 21:20,8992761145033,FANTA STRAW PET 250ML,1,3500,0,3500,2417,1083
9/1/2021 21:20,089686611618,QTELA BARBEQUE,1,5000,0,5000,4266,734
9/1/2021 21:48,089686021219,INTER MIE GORENG,1,1000,0,1000,885,115
9/1/2021 21:48,089686021127,INTER MIE KALDU,1,1000,0,1000,813,187
9/1/2021 21:53,8994867000162,ROKOK PUNDIMAS KRETEK16,1,10000,0,10000,8600,1400
9/1/2021 21:53,8992959508954,SWEETY SILVER PANTS S 66,1,92000,0,92000,88788,3212
9/1/2021 21:53,GL,GULA 1 LITER,2,11500,0,23000,21000,2000
9/1/2021 22:02,8992696422650,NESCAFE FRENCH VANILLA,1,5000,0,5000,4099,901
9/1/2021 22:21,8999999514648,LUX BWSAKURA BLOOM LD REFF 450 ML,1,25000,0,25000,22110,2890
9/1/2021 22:21,8998866618298,DAIA CLEAN&FRESH HJB 320GR,1,5000,0,5000,4450,550
9/1/2021 22:21,8991002105430,KAPAL API 65G,2,5000,0,10000,8290,1710
9/1/2021 22:25,8998866202619,MIE SEDAAP KOREAN SPICY SOUP,3,2700,0,8100,6966,1134
9/1/2021 22:25,8992979120013,TOTAL BUNGA SOFTENER,1,13000,0,13000,11532,1468
9/1/2021 22:25,8998866201377,KRISBEE FRIES KENTANG GORENG 68 GR,2,5500,0,11000,9240,1760
9/1/2021 22:58,8992761145033,FANTA STRAW PET 250ML,1,3500,0,3500,2417,1083
9/1/2021 22:58,8992761145026,SPRITE PET 250ML,1,3500,0,3500,2417,1083
9/1/2021 22:58,8992775610367,Garuda Koro paggang,1,1000,0,1000,828,172
9/1/2021 23:14,8999909004221,SAMPOERNA ULTRAMILD 16,1,22000,0,22000,20350,1650
9/1/2021 23:15,8992388133345,NU MILK TEA TEH TARIK 330ML,1,6000,0,6000,5125,875
9/1/2021 23:33,8995899210185,Mi Boncabe,1,3500,0,3500,3000,500
9/2/2021 8:57,8995102703534,TERASI DUO 6 GR,1,4000,0,4000,3720,280
9/2/2021 8:57,8998866202626,Top Kopi Gula Aren 22gr,11,1000,0,11000,9130,1870
9/2/2021 8:57,8992696419742,NESCAFE COFFE CREAM,1,5000,0,5000,4099,901
9/2/2021 8:57,089686611519,QTELA SINGKONG,1,5000,0,5000,4266,734
9/2/2021 8:57,AMPLOP,AMPLOP,4,250,0,1000,560,440
9/2/2021 8:57,8992775001615,CHOCOLATOS SWEET CHEESE,1,18000,0,18000,15483,2517
9/2/2021 8:57,8992775311615,CHOCOLATOS,1,12000,0,12000,9983,2017
9/2/2021 8:57,8996001600399,LE MINERAL 1500ML,1,5000,0,5000,4042,958
9/2/2021 8:57,8999909982000,SAMPOERNA 12 FILTER,1,18000,0,18000,16600,1400
9/2/2021 8:57,8992761139018,ADES 600ML,2,3500,0,7000,4584,2416
9/2/2021 8:57,JL,JELLY,2,500,0,1000,800,200
9/2/2021 8:57,8992761111533,SPRITE SLIM CAM250ML,1,5000,0,5000,3750,1250
9/2/2021 8:57,8993007000024,INDOMILK UHT VANILA,1,5000,0,5000,3470,1530
9/2/2021 8:57,8992696523067,MILO ACTVGO UHT 180ML,1,4500,0,4500,3515,985
9/2/2021 8:57,8991002105430,KAPAL API 65G,1,5000,0,5000,4145,855
9/2/2021 9:17,8991102022460,FORMULA DIAMOND,1,3000,0,3000,2500,500
9/2/2021 9:17,8999999552473,PEPSODENT ACTION123 SIWAK 65G,1,6200,0,6200,5600,600
9/2/2021 9:17,8992946512223,SHINZUI,1,4000,0,4000,2500,1500
9/2/2021 9:17,8998666001924,TB TORA CAFE CHOCO LATTE,2,1000,0,2000,1560,440
9/2/2021 9:17,8934868015024,REXONA DEO LOTION FREE SPIRIT 9G,1,2500,0,2500,2000,500
9/2/2021 9:17,8991002114067,PIKOPI,2,1000,0,2000,1090,910
9/2/2021 9:17,KOPIKO,KOPIKO,1,250,0,250,175,75
9/2/2021 9:19,8996001600399,LE MINERAL 1500ML,1,5000,0,5000,4042,958
9/2/2021 9:19,8997028590014,ARGUS 220ML,1,500,0,500,302,198
9/2/2021 9:48,8992761164539,NUTRIBOOST ORANGE 300ML,1,6500,0,6500,5300,1200
9/2/2021 10:01,TBR,TEPUNG BERAS ROSE BRAND,1,8000,0,8000,5800,2200
9/2/2021 10:03,8997003910684,2CS,1,3000,0,3000,1500,1500
9/2/2021 10:03,RT 1000,ROTI 1000,1,1000,0,1000,800,200
9/2/2021 10:03,ff,FULLO BLASTO,1,1000,0,1000,995,5
9/2/2021 10:03,8991102320184,TANGO CHOCO JAVAMOCCA,1,5000,0,5000,4330,670
9/2/2021 10:16,8997218380135,ICHITAN GREEN TEA,1,8000,0,8000,6583,1417
9/2/2021 10:16,8992775001660,WAFER CREAM COKLAT TABUR KEJU,1,19000,0,19000,17721,1279
9/2/2021 10:37,PUL,PULPEN,1,1500,0,1500,833,667
9/2/2021 10:37,6907992823669,JD MILKY STRAW,1,3000,0,3000,2600,400
9/2/2021 10:43,ARG,ARGUS 220ML,1,14500,0,14500,13300,1200
9/2/2021 10:43,8991188943536,SASA SANTAN KELAPA 65ML,1,3000,0,3000,2437,563
9/2/2021 10:56,8992696425316,NESCAFE BLACK,1,5000,0,5000,4099,901
9/2/2021 10:56,RT 1000,ROTI 1000,1,1000,0,1000,800,200
9/2/2021 10:56,8991909101016,URBAN MILD 16,2,17000,0,34000,31600,2400
9/2/2021 11:08,8999909000377,SAMPOERNA AVOLUTION,1,31000,0,31000,28450,2550
9/2/2021 11:08,8997218380074,ICHITAN MILK TEA,1,8000,0,8000,6583,1417
9/2/2021 11:08,8992388133017,NU MILK TEA ORI 330ML,1,6000,0,6000,5125,875
9/2/2021 11:14,POTO,KERUPUK PANJANG,1,5000,0,5000,4000,1000
9/2/2021 11:14,8998866202664,POTABEE WAGYU BEEF STEAK 68 GR,1,8000,0,8000,7200,800
9/2/2021 11:14,8992761164539,NUTRIBOOST ORANGE 300ML,1,6500,0,6500,5300,1200
9/2/2021 11:14,6907992823874,JD CRUNCHY CHOCO BLUEBERRY,2,5500,0,11000,9400,1600
9/2/2021 11:15,8997003910684,2CS,1,3000,0,3000,1500,1500
9/2/2021 12:27,8999999526894,RINSO ROYAL GOLD 40ML,6,1000,0,6000,4830,1170
9/2/2021 12:45,8992775305034,Geri Salut Malkist Bungkus,1,18000,0,18000,16250,1750
9/2/2021 13:55,8992993524477,COLATTA FINEZA COMPOUND DARK 250G,1,18500,0,18500,17179,1321
9/2/2021 14:09,8999999542191,LUX BW SANDALWOOD MUSK 250ML,1,22000,0,22000,19800,2200
9/2/2021 14:09,8999999559861,AXE DARK POCKET FRAG 17ML,1,10000,0,10000,8000,2000
9/2/2021 14:09,JD VM,JD VANILLA MILKSHAKE,1,5000,0,5000,4300,700
9/2/2021 14:09,8997009510123,ORANGE WATER,1,7000,0,7000,6089,911
9/2/2021 14:09,LT,LIPSTIK HANASUI,1,27000,0,27000,27000,0
9/2/2021 14:10,8991002121010,GOOD DAY FANTASTIC MOCACINNO,1,6000,0,6000,4295,1705
9/2/2021 14:21,8992775110157,GARUDA KACANG KULIT,1,5000,0,5000,3925,1075
9/2/2021 14:21,8992761145033,FANTA STRAW PET 250ML,1,3500,0,3500,2417,1083
9/2/2021 14:21,KP,KERIPIK PISANG,1,5000,0,5000,5000,0
9/2/2021 14:26,8998866200813,NOODLE SEDAAP MIE GORENG CUP 85 GR,2,5000,0,10000,7834,2166
9/2/2021 14:26,089686060027,POP MIE AYAM JUMBO,1,4500,0,4500,3833,667
9/2/2021 14:26,089686060126,POP MIE BASO JUMBO,1,4500,0,4500,3833,667
9/2/2021 14:26,089686017748,SARIMIE GORENG ISI 2,2,3500,0,7000,6240,760
9/2/2021 14:26,089686048704,SARIMIE GORENG AYAM KCP ISI 2,2,3500,0,7000,6240,760
9/2/2021 16:21,8998989110167,SURYA GUDANG GARAM 16 FILTER,1,25000,0,25000,23700,1300
9/2/2021 16:24,8999909003439,MARLBORO CRAFTED 12,1,8000,0,8000,7250,750
9/2/2021 16:24,8998866610377,ISOPLUS,1,3000,0,3000,2350,650
9/2/2021 17:18,8998866106535,EMERON LOVELY NAT GREEN 200ML,1,6000,0,6000,5075,925
9/2/2021 17:18,8999999534677,REXONA WMN RO GLOWING WHITE 45 ML,1,13500,0,13500,12030,1470
9/2/2021 17:18,KOPIKO,KOPIKO,2,250,0,500,350,150
9/2/2021 17:27,8992702000018,INDOMILK PUTIH 370G,1,10000,0,10000,9020,980
9/2/2021 17:27,8999999048303,SUNSILK HJV RFR HF SOL 170ML,1,22000,0,22000,20020,1980
9/2/2021 18:15,8991111111971,C&C FACIAL WASH 100ML,1,17500,0,17500,16070,1430
9/2/2021 18:42,8995555171225,KIMBO SOSIS,3,1000,0,3000,2700,300
9/2/2021 19:50,8994867000179,ROKOK PENA MILD 16,1,14500,0,14500,13500,1000
9/2/2021 19:50,8998989300261,GUDANG GARAM SURYA 12 FILTER,1,19000,0,19000,18150,850
9/2/2021 20:15,KPS,KAPAS MEI QIAN,1,5000,0,5000,4750,250
9/2/2021 20:15,8999908284907,MY BABY MINYAK TELON 90ML,1,25000,0,25000,22700,2300
9/2/2021 20:33,8997027300089,NOMOS,1,4000,0,4000,2963,1037
9/2/2021 20:33,8998866202244,EKOMIE BUMBU KALDU AYAM,3,1000,0,3000,2394,606
9/2/2021 20:33,HT,HOT-HOT,2,500,0,1000,700,300
9/2/2021 20:33,KIKO,KIKO,2,1000,0,2000,1000,1000
9/2/2021 20:34,8992959508879,SWEETY SILVER PANTS L 7,1,16800,0,16800,15228,1572
9/2/2021 20:34,KOPIKO,KOPIKO,1,250,0,250,175,75
9/2/2021 21:37,6907992823669,JD MILKY STRAW,1,3000,0,3000,2600,400
9/2/2021 21:37,RT 1000,ROTI 1000,2,1000,0,2000,1600,400
9/2/2021 21:46,8992775001691,GARUDA ROSTA WAGYU BEEF,1,8000,0,8000,7322,678
9/2/2021 21:46,8999999707774,PEPSODENT ACTION 123 PLUS WHITENING 75G,1,8000,0,8000,7200,800
9/2/2021 21:46,8991102022460,FORMULA DIAMOND,1,3000,0,3000,2500,500
9/2/2021 21:46,ARG,ARGUS 220ML,1,14500,0,14500,13300,1200
9/2/2021 22:23,8998866200882,SUKSESMIE GORENG AYAM KRMS 133GR,2,3500,0,7000,6094,906
9/2/2021 22:23,8992775110157,GARUDA KACANG KULIT,1,5000,0,5000,3925,1075
9/2/2021 22:23,8997028900837,SABUN PAPAYA,1,10000,0,10000,9375,625
9/2/2021 22:23,8992979120013,TOTAL BUNGA SOFTENER,1,13000,0,13000,11532,1468
9/2/2021 22:23,9556001025272,NESCAFE LATTE 240ML,1,8500,0,8500,7834,666
9/2/2021 22:23,8996001600399,LE MINERAL 1500ML,1,5000,0,5000,4042,958
9/2/2021 22:29,8998989300261,GUDANG GARAM SURYA 12 FILTER,1,19000,0,19000,18150,850
9/2/2021 22:36,8886057883665,KRATING DAENG,2,6000,0,12000,8572,3428
9/2/2021 22:38,8998866202466,JAPOTA HAPPY HONEY BUTTER,1,5000,0,5000,4150,850
9/2/2021 22:38,8998866202619,MIE SEDAAP KOREAN SPICY SOUP,2,2700,0,5400,4644,756
9/2/2021 22:38,089686010107,INDOMIE KALDU AYAM,1,2500,0,2500,2150,350
9/2/2021 22:38,8998866610377,ISOPLUS,1,3000,0,3000,2350,650
9/2/2021 22:48,8998989110167,SURYA GUDANG GARAM 16 FILTER,1,25000,0,25000,23700,1300
9/2/2021 22:48,8996001600399,LE MINERAL 1500ML,1,5000,0,5000,4042,958
9/2/2021 22:51,8998009010569,ULTRA CHO 200,1,5000,0,5000,3830,1170
9/2/2021 22:51,9556001025272,NESCAFE LATTE 240ML,1,8500,0,8500,7834,666
9/2/2021 22:51,6907992823904,JD CRUNCHY CHOCOLATE VAN,1,8000,0,8000,6800,1200
9/3/2021 9:35,8992979190986,TOTAL PUTIH SOFTENER,1,13000,0,13000,11532,1468
9/3/2021 9:35,8998866619035,Royale Sweet Floral 13 ml,1,5000,0,5000,4452,548
9/3/2021 9:35,8996001355756,BENG-BENG MAXX SCT,2,2500,0,5000,4082,918
9/3/2021 9:35,RT 1000,ROTI 1000,2,1000,0,2000,1600,400
9/3/2021 9:35,8992702000063,INDOMILK COKLAT 370G,1,10000,0,10000,9020,980
9/3/2021 9:35,8991102714860,MILKIDO STRAW,1,3000,0,3000,2153,847
9/3/2021 9:35,8997012321204,MAXX BUMBU BALADO,1,5000,0,5000,4100,900
9/3/2021 9:35,8995333060772,TERIGU GATOT KACA 500GR,1,5000,0,5000,4346,654
9/3/2021 9:35,8993989311699,CLAS MILD 16 FILTER,1,23000,0,23000,21700,1300
9/3/2021 9:35,8997025914042,ATB MARIE SUSU 185G,1,7000,0,7000,4554,2446
9/3/2021 9:46,ROTI,ROTI 2000,1,2000,0,2000,1800,200
9/3/2021 9:46,HT,HOT-HOT,2,500,0,1000,700,300
9/3/2021 9:46,8998989300261,GUDANG GARAM SURYA 12 FILTER,1,19000,0,19000,18150,850
9/3/2021 10:32,711844120419,SAMBAL ABC 275 ML,1,12000,0,12000,10800,1200
9/3/2021 10:32,711844110083,KECAP ABC 275 ML,1,15000,0,15000,14000,1000
9/3/2021 10:58,8998866200325,MIE SEDAAP SOTO,4,2700,0,10800,9324,1476
9/3/2021 10:58,8991102714594,TANGO DRINK BLCK VNL,1,5000,0,5000,3818,1182
9/3/2021 10:58,8992775001042,PILUS GARUDA MI GORENG,1,5000,0,5000,4810,190
9/3/2021 11:21,BAYFLAST,BAYPLAST,1,500,0,500,350,150
9/3/2021 11:21,8999999524722,SUNLIGHT LIME NEW PCH 435ML,1,10000,0,10000,9100,900
9/3/2021 11:21,8998866200325,MIE SEDAAP SOTO,2,2700,0,5400,4662,738
9/3/2021 11:23,BAYFLAST,BAYPLAST,1,500,0,500,350,150
9/3/2021 12:47,KIKO,KIKO,4,1000,0,4000,2000,2000
9/3/2021 13:02,8993989311699,CLAS MILD 16 FILTER,1,23000,0,23000,21700,1300
9/3/2021 13:10,8998866200301,MIE SEDAAP GORENG,1,2700,0,2700,2413,287
9/3/2021 13:10,8999999558062,RINSO ANTI NODA CLASSIC PWD 44G,1,5000,0,5000,4830,170
9/3/2021 13:30,8992775000014,CHOCOLATOS HAZELNUT,1,18000,0,18000,15483,2517
9/3/2021 13:30,8996001304136,SLAI OLAI BLUEBERRY,1,12000,0,12000,9900,2100
9/3/2021 13:30,8992761145026,SPRITE PET 250ML,1,3500,0,3500,2417,1083
9/3/2021 13:30,8992761145019,COCA COLA PET 250ML,1,3500,0,3500,2417,1083
9/3/2021 13:30,0105312686040047,yakult,5,2000,0,10000,7500,2500
9/3/2021 14:34,8998989300261,GUDANG GARAM SURYA 12 FILTER,1,19000,0,19000,18150,850
9/3/2021 14:44,9556040040038,SUSU F&N,2,33000,0,66000,60000,6000
9/3/2021 15:32,GL,GULA 1 LITER,1,11500,0,11500,10500,1000
9/3/2021 15:32,8992628022156,BIMOLI KLASIK TOUCH 1 LT,1,16000,0,16000,14350,1650
9/3/2021 15:32,8999999195649,SARI WANGI 25X1.86G,1,6000,0,6000,5050,950
9/3/2021 16:12,8999999539603,ZWITSAL NATURAL BASIC PACK,1,39000,0,39000,35420,3580
9/3/2021 16:52,RB,RED BOLD,1,20000,0,20000,18800,1200
9/3/2021 17:06,8992959954034,SWEETY BRONZE NB 24,1,29000,0,29000,26762,2238
9/3/2021 17:06,8996001600399,LE MINERAL 1500ML,1,5000,0,5000,4042,958
9/3/2021 17:06,8998009010569,ULTRA CHO 200,1,5000,0,5000,3830,1170
9/3/2021 17:21,GL,GULA 1 LITER,1,11500,0,11500,10500,1000
9/3/2021 17:21,8999801700054,SUSU FOYU 1 KG,1,22000,0,22000,19791,2209
9/3/2021 17:21,8998989110167,SURYA GUDANG GARAM 16 FILTER,1,25000,0,25000,23700,1300
9/3/2021 17:27,6907992823645,JD COCONUT BLISS,1,4000,0,4000,3500,500
9/3/2021 17:27,8996001305119,ARDEN 30G,1,2000,0,2000,1650,350
9/3/2021 18:02,ROTI,ROTI 2000,2,2000,0,4000,3600,400
9/3/2021 18:02,8991188943536,SASA SANTAN KELAPA 65ML,1,3000,0,3000,2437,563
9/3/2021 18:02,8996001314005,ROMA KELAPA CREAM CKLT,1,8000,0,8000,6642,1358
9/3/2021 18:11,MARS,MARSHMELLOW,2,500,0,1000,866,134
9/3/2021 18:30,8992761002015,COCA COLA PET 390ML,1,5500,0,5500,4333,1167
9/3/2021 18:30,8996001600610,TORA MILKY LATTE 180ML,1,3500,0,3500,2750,750
9/3/2021 18:53,ROTI,ROTI 2000,2,2000,0,4000,3600,400
9/3/2021 19:08,8999099920714,SGM 1+ VANILA 1000G,1,85000,0,85000,78510,6490
9/3/2021 19:58,8996001600399,LE MINERAL 1500ML,1,5000,0,5000,4042,958
9/3/2021 20:17,8999909002821,MARLBORO BLACK 16,1,22000,0,22000,20850,1150
9/3/2021 20:36,9556001025272,NESCAFE LATTE 240ML,1,8500,0,8500,7834,666
9/3/2021 20:36,JGR SHN,JOGER SHINY SACHET,1,500,0,500,437,63
9/3/2021 21:02,8992696419742,NESCAFE COFFE CREAM,2,5000,0,10000,8198,1802
9/3/2021 21:22,8992761111533,SPRITE SLIM CAM250ML,2,5000,0,10000,7500,2500
9/3/2021 21:31,8996001410042,TB TORA MOKA,3,1500,0,4500,2610,1890
9/3/2021 21:31,8998866202626,Top Kopi Gula Aren 22gr,2,1000,0,2000,1660,340
9/3/2021 21:34,8997011700123,BIHUN JAGUNG 300GR,1,6000,0,6000,4979,1021
9/3/2021 22:01,8996001600597,KOPIKO LUCKY DAY,1,5000,0,5000,4283,717
9/3/2021 22:09,8999909003873,MARLBORO 12,1,17000,0,17000,15750,1250
9/3/2021 22:09,76239878,MARLBORO GOLD,1,30000,0,30000,27700,2300
9/3/2021 22:12,123124,KOREK BIASA,2,2000,0,4000,2600,1400
9/3/2021 22:13,8991111111995,C&C TONER 100ML,1,14000,0,14000,12900,1100
9/3/2021 22:13,8991102320184,TANGO CHOCO JAVAMOCCA,1,5000,0,5000,4330,670
9/3/2021 22:13,8886013213208,FRENCH FREIS 2000,1,5000,0,5000,3750,1250
9/3/2021 22:27,GL,GULA 1 LITER,5,11500,0,57500,52500,5000
9/3/2021 22:27,ARG 330,ARGUS 330ML,1,35000,0,35000,31000,4000
9/3/2021 22:27,ROTI,ROTI 2000,3,2000,0,6000,5400,600
9/4/2021 8:26,8996001305119,ARDEN 30G,1,2000,0,2000,1650,350
9/4/2021 8:26,089686021219,INTER MIE GORENG,2,1000,0,2000,1770,230
9/4/2021 8:30,ROTI,ROTI 2000,1,2000,0,2000,1800,200
9/4/2021 11:32,8993989311699,CLAS MILD 16 FILTER,1,23000,0,23000,21700,1300
9/4/2021 11:37,8998866202244,EKOMIE BUMBU KALDU AYAM,6,1000,0,6000,4788,1212
9/4/2021 11:37,089686021127,INTER MIE KALDU,3,1000,0,3000,2439,561
9/4/2021 11:37,089686043051,INDOMIE COTO MAKASSAR,1,2800,0,2800,2525,275
9/4/2021 11:42,8991909101016,URBAN MILD 16,1,17000,0,17000,15800,1200
9/4/2021 11:42,TUSTEL,TUSUK TELINGA,1,1000,0,1000,833,167
9/4/2021 11:42,ROTI,ROTI 2000,2,2000,0,4000,3600,400
9/4/2021 11:42,8993083140041,BISKITOP CHOCOLATE,1,27000,0,27000,25200,1800
9/4/2021 11:42,8998989500166,GUDANG GARAM MERAH BESAR 16KS,2,18000,0,36000,34000,2000
9/4/2021 11:42,8994867007161,ROKOK PENA GOLD 20,1,18000,0,18000,16800,1200
9/4/2021 11:42,8998866202244,EKOMIE BUMBU KALDU AYAM,6,1000,0,6000,4788,1212
9/4/2021 11:42,089686021127,INTER MIE KALDU,3,1000,0,3000,2439,561
9/4/2021 11:42,089686043051,INDOMIE COTO MAKASSAR,1,2800,0,2800,2525,275
9/4/2021 11:42,8996001375372,CHOKI CHOKI,1,1000,0,1000,910,90
9/4/2021 12:32,ROTI,ROTI 2000,1,2000,0,2000,1800,200
9/4/2021 12:33,8995333060703,TERIGU KOMPAS 1KG,10,10500,0,105000,98160,6840
9/4/2021 12:52,8992770033178,Masako,12,500,0,6000,5400,600
9/4/2021 12:52,8992979190986,TOTAL PUTIH SOFTENER,1,13000,0,13000,11532,1468
9/4/2021 12:52,8996001305119,ARDEN 30G,2,2000,0,4000,3300,700
9/4/2021 12:52,GL,GULA 1 LITER,2,11500,0,23000,21000,2000
9/4/2021 13:05,ROTI,ROTI 2000,3,2000,0,6000,5400,600
9/4/2021 13:05,8998989300261,GUDANG GARAM SURYA 12 FILTER,1,19000,0,19000,18150,850
9/4/2021 13:29,8992775001844,Chocolatos original taste,1,1000,0,1000,829,171
9/4/2021 13:29,ff,FULLO BLASTO,2,1000,0,2000,1990,10
9/4/2021 13:39,8999999528942,CITRA HBL PEARLY WHITE UV 120ML,1,12000,0,12000,10082,1918
9/4/2021 13:40,ARG,ARGUS 220ML,1,14500,0,14500,13300,1200
9/4/2021 13:44,8992628020152,BIMOLI POUCH 2L,1,31000,0,31000,29800,1200
9/4/2021 13:44,089686017748,SARIMIE GORENG ISI 2,1,3500,0,3500,3120,380
9/4/2021 13:57,8992775001844,Chocolatos original taste,2,1000,0,2000,1658,342
9/4/2021 13:57,089686611670,QTELA BALADO,1,5000,0,5000,4266,734
9/4/2021 14:21,8992775913000,CHOCOLATOS CKLT 28G,2,2000,0,4000,3114,886
9/4/2021 14:21,8992696405417,DNCO INSTANT 27G,5,3500,0,17500,15000,2500
9/4/2021 14:21,8994023000050,MEGKEJU SERBAGUNA 165G,1,12000,0,12000,10339,1661
9/4/2021 14:21,TELUR RAK,TELUR RAK,1,38000,0,38000,36000,2000
9/4/2021 14:35,8998866201377,KRISBEE FRIES KENTANG GORENG 68 GR,1,5500,0,5500,4620,880
9/4/2021 14:35,8998866201469,POTABEE REGULER BBQ BEEF 68 GR,1,8000,0,8000,7200,800
9/4/2021 14:35,YP,YUPI,10,250,0,2500,2080,420
9/4/2021 14:40,TELUR RAK,TELUR RAK,1,39000,0,39000,36000,3000
9/4/2021 14:40,8997028590052,ARGUS 600ML,1,3000,0,3000,1458,1542
9/4/2021 14:40,8997009510123,ORANGE WATER,1,7000,0,7000,6089,911
9/4/2021 15:05,8998898337440,TOLAK ANGIN CARE 10ML,1,10000,0,10000,7893,2107
9/4/2021 15:16,8998866501026,MINYAK GORENG SEDAAP POUCH 1 L,1,15000,0,15000,14110,890
9/4/2021 16:05,089686535044,SUN BERAS MERAH,1,8500,0,8500,7410,1090
9/4/2021 16:39,8998898830125,KKB ENER-G ANGGUR,1,5500,0,5500,4824,676
9/4/2021 17:25,8996001305119,ARDEN 30G,1,2000,0,2000,1650,350
9/4/2021 17:25,8993274532105,BOLU,2,1000,0,2000,1666,334
9/4/2021 17:25,8991102308892,BLASTO,1,1000,0,1000,995,5
9/4/2021 17:27,8998989300261,GUDANG GARAM SURYA 12 FILTER,1,19000,0,19000,18150,850
9/4/2021 17:31,8995555121244,SOSIS KIMBO,1,1000,0,1000,650,350
9/4/2021 17:35,8991102303309,WFR TANGO SBJ 176G,1,10000,0,10000,8694,1306
9/4/2021 17:46,8998989110167,SURYA GUDANG GARAM 16 FILTER,1,25000,0,25000,23700,1300
9/4/2021 19:12,8992959509005,SWEETY SILVER PANTS XL26,1,61500,0,61500,55910,5590
9/4/2021 19:49,ARG 330,ARGUS 330ML,1,35000,0,35000,31000,4000
9/4/2021 19:49,ARG,ARGUS 220ML,1,14500,0,14500,13300,1200
9/4/2021 19:49,8999999195649,SARI WANGI 25X1.86G,1,6000,0,6000,5050,950
9/4/2021 19:49,8991002105409,KOPI KAPAL API,1,20000,0,20000,18888,1112
9/4/2021 19:51,8996001600375,LE MINERAL 330ML,24,2000,0,48000,34008,13992
9/4/2021 20:06,8999999049478,REXONA WMN RO NATURALS BIO 45 ML,1,16500,0,16500,14900,1600
9/4/2021 20:06,8999999049669,REXONA MEN RO INVISIBLE DRY 45 ML,1,15000,0,15000,13550,1450
9/4/2021 20:06,8999999033200,LIFEBUOY SHP ANTI KETOMBE 70+21 ML,1,8000,0,8000,7260,740
9/4/2021 20:06,8997009510123,ORANGE WATER,1,7000,0,7000,6089,911
9/4/2021 20:59,8999999534677,REXONA WMN RO GLOWING WHITE 45 ML,2,13500,0,27000,24060,2940
9/4/2021 20:59,8992959971093,SFX COMFORT SLIME 6,1,8500,0,8500,7798,702
9/4/2021 20:59,8998866107457,POSH SUMMER LOVE 150ML,1,19500,0,19500,17500,2000
9/4/2021 20:59,Vita Jelly,Vita Jelly,5,1000,0,5000,3830,1170
9/4/2021 21:11,8996001305119,ARDEN 30G,2,2000,0,4000,3300,700
9/4/2021 21:33,8998866201490,POTABEE REGULER GRILLED SEAWED 68 GR,1,8000,0,8000,7200,800
9/4/2021 21:34,8992761111540,FANTA STRAWBERY SLIM CAM 250ML,2,5000,0,10000,7500,2500
9/4/2021 21:34,8992761111533,SPRITE SLIM CAM250ML,1,5000,0,5000,3750,1250
9/4/2021 21:52,8992761166052,FRESTEA MELATI 350ML,1,4500,0,4500,3000,1500
9/4/2021 22:36,8997013180046,Tissu Tessi B,1,10000,0,10000,9800,200
9/4/2021 22:36,8992775110157,GARUDA KACANG KULIT,1,5000,0,5000,3925,1075
9/4/2021 22:36,8994834005923,SPIX 1000,5,1000,0,5000,4250,750
9/4/2021 22:49,8998989300261,GUDANG GARAM SURYA 12 FILTER,1,19000,0,19000,18150,850
9/4/2021 22:54,8999909000377,SAMPOERNA AVOLUTION,1,31000,0,31000,29450,1550
9/4/2021 22:59,8998989110167,SURYA GUDANG GARAM 16 FILTER,1,25000,0,25000,23700,1300
9/4/2021 23:12,8993007000086,INDOMILK CKLT 1L,1,16500,0,16500,14791,1709
9/4/2021 23:12,8998866200301,MIE SEDAAP GORENG,2,2700,0,5400,4826,574
9/4/2021 23:12,ARG,ARGUS 220ML,1,14500,0,14500,13300,1200
9/4/2021 23:12,8886013213208,FRENCH FREIS 2000,1,5000,0,5000,3750,1250
9/4/2021 23:13,8994834006128,TICTIC PEDAS,1,2000,0,2000,1700,300
9/4/2021 23:13,ROTI,ROTI 2000,2,2000,0,4000,3600,400
9/4/2021 23:15,Garuda pilus pcs,Garuda pilus Rasa Mi Goreng pcs,1,1000,0,1000,808,192
9/4/2021 23:15,8886001038011,BENG-BENG SCT,1,1500,0,1500,1450,50
9/4/2021 23:15,089686043051,INDOMIE COTO MAKASSAR,1,2800,0,2800,2525,275
9/4/2021 23:15,8992775001998 pcs,Gery Salut sandiwich pcs,1,1000,0,1000,815,185
9/4/2021 23:21,8991102100823,Formula Acttion Protector 190 gr,1,10000,0,10000,9000,1000
9/4/2021 23:21,8993379200886,SABUN HARMONY ORANGE 70G,2,2000,0,4000,3304,696
9/4/2021 23:21,8999999525811,MOLTO AIO BLUE PCH 720,1,26800,0,26800,23900,2900
9/4/2021 23:21,8998866200325,MIE SEDAAP SOTO,2,2700,0,5400,4662,738
9/4/2021 23:21,8998866200301,MIE SEDAAP GORENG,3,2700,0,8100,7239,861
9/4/2021 23:21,8999999536244,SUNSILK SHP THICK N LONG170ML,1,20000,0,20000,18150,1850
9/5/2021 9:24,8992628022156,BIMOLI KLASIK TOUCH 1 LT,1,16000,0,16000,14350,1650
9/5/2021 9:24,8992775002582,DILAN CHOCO,1,2000,0,2000,1503,497
9/5/2021 9:24,8998866202602,KRISBEE FRENCH FRIES 18GR,1,2000,0,2000,1500,500
9/5/2021 9:24,GL,GULA 1 LITER,1,11500,0,11500,10500,1000
9/5/2021 9:24,TELUR,TELUR,3,1800,0,5400,3600,1800
9/5/2021 9:26,8992761145033,FANTA STRAW PET 250ML,1,3500,0,3500,2417,1083
9/5/2021 9:34,8997009510123,ORANGE WATER,1,7000,0,7000,6089,911
9/5/2021 9:34,8998866808729,ROYALE SOFT WHITE,1,5000,0,5000,4500,500
9/5/2021 9:34,8998866803694,SOKLIN SOFTERGENT PURPLE BAG 770 & PIRING,1,18000,0,18000,16680,1320
9/5/2021 9:34,8991188943536,SASA SANTAN KELAPA 65ML,1,3000,0,3000,2437,563
9/5/2021 9:34,089686440133,BUMBU KARE,1,5000,0,5000,4500,500
9/5/2021 9:34,8991102385060,TANGO WAFFLE CHOX,1,9000,0,9000,8498,502
9/5/2021 9:34,8992775913000,CHOCOLATOS CKLT 28G,10,2000,0,20000,15570,4430
9/5/2021 9:34,8998866200301,MIE SEDAAP GORENG,1,2700,0,2700,2413,287
9/5/2021 11:37,8992761139018,ADES 600ML,1,3500,0,3500,2166,1334
9/5/2021 11:37,8992761166038,MMP ORANGE 300ML,1,5000,0,5000,3750,1250
9/5/2021 11:43,8991102714846,MILKIDO CKLT,1,3000,0,3000,2153,847
9/5/2021 11:43,8998866202466,JAPOTA HAPPY HONEY BUTTER,1,5000,0,5000,4150,850
9/5/2021 11:43,AMPLOP,AMPLOP,4,250,0,1000,560,440
9/5/2021 11:43,Vita Jelly,Vita Jelly,1,1000,0,1000,766,234
9/5/2021 11:53,8996001305119,ARDEN 30G,1,2000,0,2000,1650,350
9/5/2021 11:53,ROTI,ROTI 2000,1,2000,0,2000,1800,200
9/5/2021 12:59,089686535044,SUN BERAS MERAH,1,8500,0,8500,7410,1090
9/5/2021 12:59,8991102022347,SIKAT GIGI FORMULA RIPPLE,1,5000,0,5000,4583,417
9/5/2021 13:02,8998989110167,SURYA GUDANG GARAM 16 FILTER,3,25000,0,75000,71100,3900
9/5/2021 13:02,089686611618,QTELA BARBEQUE,1,5000,0,5000,4266,734
9/5/2021 13:02,8886013213208,FRENCH FREIS 2000,1,5000,0,5000,3750,1250
9/5/2021 13:02,8991102308823,KLOP COCONUT ORI,1,6000,0,6000,4969,1031
9/5/2021 13:09,8998866608046,KECAP MANIS SEDAAP POUCH 225ML,1,8500,0,8500,7744,756
9/5/2021 16:06,8992959117583,SFX DS REG FLOW WING 20,1,5000,0,5000,4288,712
9/5/2021 16:12,8999909096004,SAMPOERNA 16 FILTER,1,24000,0,24000,23100,900
9/5/2021 16:13,8992959117583,SFX DS REG FLOW WING 20,1,5000,0,5000,4288,712
9/5/2021 16:16,8998866202619,MIE SEDAAP KOREAN SPICY SOUP,2,2700,0,5400,4644,756
9/5/2021 16:18,089686611519,QTELA SINGKONG,1,5000,0,5000,4266,734
9/5/2021 16:18,8992628022156,BIMOLI KLASIK TOUCH 1 LT,1,16000,0,16000,14350,1650
9/5/2021 16:19,8998866605144,CLING KUNING POUCH 425ML,1,4000,0,4000,3250,750
9/5/2021 16:20,089686043051,INDOMIE COTO MAKASSAR,1,2800,0,2800,2525,275
9/5/2021 16:24,Garuda pilus,Garuda Pilus Pedas Pcs,2,500,0,1000,816,184
9/5/2021 16:24,8993470672827,SAKU-SAKU SAPI PANGGANG,1,2000,0,2000,1530,470
9/5/2021 16:25,Garuda pilus pcs,Garuda pilus Rasa Mi Goreng pcs,1,1000,0,1000,808,192
9/5/2021 16:26,KOPIKO,KOPIKO,2,250,0,500,350,150
9/5/2021 16:28,8998866200882,SUKSESMIE GORENG AYAM KRMS 133GR,1,3500,0,3500,3047,453
9/5/2021 16:30,JL,JELLY,3,500,0,1500,1200,300
9/5/2021 16:31,JL,JELLY,4,500,0,2000,1600,400
9/5/2021 16:32,8998866200646,KOPI TOP MURNI,1,11000,0,11000,9600,1400
9/5/2021 16:33,ROTI,ROTI 2000,2,2000,0,4000,3600,400
9/5/2021 16:35,8993989311699,CLAS MILD 16 FILTER,1,23000,0,23000,21700,1300
9/5/2021 16:38,8992775002933,GERY MALKIST DOUBLE ABON,1,6500,0,6500,5516,984
9/5/2021 16:38,8998989300261,GUDANG GARAM SURYA 12 FILTER,1,19000,0,19000,18150,850
9/5/2021 16:40,8998989500166,GUDANG GARAM MERAH BESAR 16KS,1,18000,0,18000,17000,1000
9/5/2021 16:41,ARG,ARGUS 220ML,1,14500,0,14500,13300,1200
9/5/2021 16:42,ROTI,ROTI 2000,1,2000,0,2000,1800,200
9/5/2021 16:43,8995555171225,KIMBO SOSIS,1,1000,0,1000,900,100
9/5/2021 16:43,8995555171225,KIMBO SOSIS,2,1000,0,2000,1800,200
9/5/2021 16:45,8992775305126 pcs,Gery Salut malkist Kelapa pcs,1,1000,0,1000,812,188
9/5/2021 16:45,8992761166052,FRESTEA MELATI 350ML,1,4500,0,4500,3000,1500
9/5/2021 16:46,8998989300261,GUDANG GARAM SURYA 12 FILTER,1,19000,0,19000,18150,850
9/5/2021 16:47,8992775203422,GARUDA ROSTA OVEN 100G,2,8000,0,16000,14644,1356
9/5/2021 16:49,8994834005923,SPIX 1000,2,1000,0,2000,1700,300
9/5/2021 16:50,8992696425316,NESCAFE BLACK,1,5000,0,5000,4099,901
9/5/2021 16:51,8886013257400,TWISTKO,1,1000,0,1000,900,100
9/5/2021 16:52,SURYA,SURYA,2,500,0,1000,1000,0
9/5/2021 16:57,8992979130012,TOTAL LEMON SOFTENER,1,13000,0,13000,11532,1468
9/5/2021 16:59,8992775311509,gery garuda,2,1000,0,2000,1400,600
9/5/2021 19:04,8996001600399,LE MINERAL 1500ML,1,5000,0,5000,4042,958
9/5/2021 19:04,8994834005923,SPIX 1000,3,1000,0,3000,2550,450
9/5/2021 19:06,089686043051,INDOMIE COTO MAKASSAR,1,2800,0,2800,2525,275
9/5/2021 19:08,8992775002933,GERY MALKIST DOUBLE ABON,1,6500,0,6500,5516,984
9/5/2021 19:57,8995555121244,SOSIS KIMBO,1,1000,0,1000,650,350
9/5/2021 19:59,8992775311509,gery garuda,1,1000,0,1000,700,300
9/5/2021 20:00,8992775311509,gery garuda,1,1000,0,1000,700,300
9/5/2021 20:01,8998989300261,GUDANG GARAM SURYA 12 FILTER,1,19000,0,19000,18150,850
9/5/2021 20:16,GGK,PLAYGUM PERMEN KARET,2,500,0,1000,800,200
9/5/2021 21:07,8998866200578,MIE SEDAAP KARI KENTAL,1,2700,0,2700,2331,369
9/5/2021 21:15,8992775211434,PILUS GARUDA SAPI PANGGANG,1,5000,0,5000,4810,190
9/5/2021 21:15,8998866200325,MIE SEDAAP SOTO,3,2700,0,8100,6993,1107
9/5/2021 21:25,8998866200578,MIE SEDAAP KARI KENTAL,1,2700,0,2700,2331,369
9/5/2021 21:25,8992761166052,FRESTEA MELATI 350ML,1,4500,0,4500,3000,1500
9/6/2021 8:19,ROTI,ROTI 2000,1,2000,0,2000,1800,200
9/6/2021 8:55,8995333000822,TERIGU KOMPAS SOFT 500GR,2,5500,0,11000,9934,1066
9/6/2021 8:57,8998866601429,POWDET DAIA BUNGA BAG 290GR,1,5000,0,5000,4450,550
9/6/2021 8:57,8999999059309,LIFEBUOY TS TOTAL 10 DG 75G,2,3000,0,6000,5280,720
9/6/2021 8:57,8998866602556,NUVO FAMILY MERAH 76G,1,2000,0,2000,1820,180
9/6/2021 12:37,ARG,ARGUS 220ML,2,14500,0,29000,26600,2400
9/6/2021 12:37,8998989300391,SURYA PRO PUTIH,1,22000,0,22000,20100,1900
9/6/2021 12:37,8998866601429,POWDET DAIA BUNGA BAG 290GR,1,5000,0,5000,4450,550
9/6/2021 12:37,8998866602549,NUVO FAMILY BIRU 76G,3,2000,0,6000,5460,540
9/6/2021 12:37,8999999529703,CLEAR MEN COOL SPORT MTHL 80ML,1,11000,0,11000,10000,1000
9/6/2021 12:37,8992730002992,HAI CANDY,7,7000,0,49000,42000,7000
9/6/2021 12:37,8991004011906,KOPI BORONG,1,10000,0,10000,8333,1667
9/6/2021 12:37,gula,GULA,1,11500,0,11500,10000,1500
9/6/2021 12:37,8994867007161,ROKOK PENA GOLD 20,1,18000,0,18000,16800,1200
9/6/2021 12:37,GL,GULA 1 LITER,1,11500,0,11500,10500,1000
9/6/2021 12:37,Gula gula pulpen,gula gula pulpen,1,2000,0,2000,1750,250
9/6/2021 12:37,MOBIL,GULA GULA HP,1,2000,0,2000,1700,300
9/6/2021 12:39,ROTI,ROTI 2000,1,2000,0,2000,1800,200
9/6/2021 16:05,8992730002992,HAI CANDY,2,7000,0,14000,12000,2000
9/6/2021 16:05,8991004011906,KOPI BORONG,1,10000,0,10000,8333,1667
9/6/2021 16:05,GL,GULA 1 LITER,1,11500,0,11500,10500,1000
9/6/2021 16:06,8994867007161,ROKOK PENA GOLD 20,1,18000,0,18000,16800,1200
9/6/2021 16:08,8997003910684,2CS,1,3000,0,3000,1500,1500
9/6/2021 16:48,ARG,ARGUS 220ML,1,14500,0,14500,13300,1200
9/6/2021 16:49,8998989300261,GUDANG GARAM SURYA 12 FILTER,1,19000,0,19000,18150,850
9/6/2021 16:50,ABC,BATERAI ABC BIRU,1,9000,0,9000,7712,1288
9/6/2021 16:51,GL,GULA 1 LITER,1,11500,0,11500,10500,1000
9/6/2021 16:52,8995333032113,TERIGU GATOT KACA 1 KG,1,9000,0,9000,8572,428
9/6/2021 16:52,8995333060703,TERIGU KOMPAS 1KG,1,10500,0,10500,9816,684
9/6/2021 16:53,8998866501026,MINYAK GORENG SEDAAP POUCH 1 L,2,15000,0,30000,28220,1780
9/6/2021 16:56,8993083929837,BISKITOP BLACK COOKIES,1,27000,0,27000,23700,3300
9/6/2021 16:57,8997210107877,VORTEX SMART 3,1,5000,0,5000,4750,250
9/6/2021 17:39,8996001305119,ARDEN 30G,1,2000,0,2000,1650,350
9/6/2021 17:54,8999999524807,SUNLIGHT HABBATUSSAUDA POUCH 755ML,1,17000,0,17000,15400,1600
9/6/2021 17:54,8998866106979,CIPTADENT TB CHARCOAL PROTEC,1,6000,0,6000,5250,750
9/6/2021 17:54,8992628020152,BIMOLI POUCH 2L,1,31000,0,31000,29800,1200
9/6/2021 18:53,8992761111533,SPRITE SLIM CAM250ML,2,5000,0,10000,7500,2500
9/6/2021 18:54,8997025911058,HATARI SHP KELAPA,1,6000,0,6000,4911,1089
9/6/2021 18:58,8997003910684,2CS,1,3000,0,3000,1500,1500
9/6/2021 18:59,8886001038011,BENG-BENG SCT,2,1500,0,3000,2900,100
9/6/2021 18:59,8997003910684,2CS,1,3000,0,3000,1500,1500
9/6/2021 19:04,8999999053291,LIFEBUOY LEMONFRESH 110G,2,15000,0,30000,28490,1510
9/6/2021 20:07,8991001121400,SILVERQUEEN ALMOND 65G,1,15000,0,15000,13200,1800
9/6/2021 20:17,089686010343,INDOMIE SOTO MIE,1,2600,0,2600,2367,233
9/6/2021 20:17,8998866609487,SOKLIN SOFTERGEN 280G,1,5000,0,5000,4425,575
9/6/2021 20:44,089686010343,INDOMIE SOTO MIE,3,2600,0,7800,7101,699
9/6/2021 20:47,ARG,ARGUS 220ML,1,14500,0,14500,13300,1200
9/6/2021 20:47,8992761002022,SPRITE PET 390ML,1,5500,0,5500,4333,1167
9/6/2021 20:47,KIKO,KIKO,1,1000,0,1000,500,500
9/6/2021 20:55,8999909982000,SAMPOERNA 12 FILTER,1,18000,0,18000,16600,1400
9/6/2021 21:41,Gula gula tusuk,gula gula tusuk,2,500,0,1000,800,200
9/6/2021 21:42,089686017748,SARIMIE GORENG ISI 2,1,3500,0,3500,3120,380
9/6/2021 21:49,BALON,BALON CABUT,2,1000,0,2000,1800,200
9/6/2021 21:49,GGK,PLAYGUM PERMEN KARET,6,500,0,3000,2400,600
9/6/2021 21:49,8992761139018,ADES 600ML,1,3500,0,3500,2166,1334
9/7/2021 9:11,8993379200886,SABUN HARMONY ORANGE 70G,2,2000,0,4000,3304,696
9/7/2021 9:15,8992775311509,gery garuda,1,1000,0,1000,700,300
9/7/2021 9:16,8996001305119,ARDEN 30G,1,2000,0,2000,1650,350
9/7/2021 9:18,8991001242013,Top,1,1000,0,1000,500,500
9/7/2021 9:19,ROTI,ROTI 2000,1,2000,0,2000,1800,200
9/7/2021 9:19,8998866679596,SOKLIN LANTAI BIRU 780ML,1,12000,0,12000,10020,1980
9/7/2021 9:20,8996001305119,ARDEN 30G,1,2000,0,2000,1650,350
9/7/2021 9:20,RT 1000,ROTI 1000,1,1000,0,1000,800,200
9/7/2021 9:21,ROTI,ROTI 2000,1,2000,0,2000,1800,200
9/7/2021 9:24,8992959953020,SWEETY BRONZE M1,1,3000,0,3000,2671,329
9/7/2021 9:24,gula,GULA,1,11500,0,11500,10000,1500
9/7/2021 9:53,8992957220186,COKLAT RUSA,1,2000,0,2000,1700,300
9/7/2021 9:53,8886001038011,BENG-BENG SCT,1,1500,0,1500,1450,50
9/7/2021 9:53,089686535044,SUN BERAS MERAH,1,8500,0,8500,7410,1090
9/7/2021 11:12,GL,GULA 1 LITER,1,11500,0,11500,10500,1000
9/7/2021 11:40,089686611670,QTELA BALADO,2,5000,0,10000,8532,1468
9/7/2021 11:45,TORT,TORTILA,2,1000,0,2000,2000,0
9/7/2021 12:20,RB,RED BOLD,1,20000,0,20000,18800,1200
9/7/2021 12:20,KIKO,KIKO,2,1000,0,2000,1000,1000
9/7/2021 12:20,TORT,TORTILA,2,1000,0,2000,2000,0
9/7/2021 12:33,8992775310212,GERY PASTA COKELAT,1,18000,0,18000,16029,1971
9/7/2021 12:39,ARG,ARGUS 220ML,2,14500,0,29000,26600,2400
9/7/2021 14:03,8992775001844,Chocolatos original taste,2,1000,0,2000,1658,342
9/7/2021 14:31,8997218380135,ICHITAN GREEN TEA,1,8000,0,8000,6583,1417
9/7/2021 14:37,8994935000049,MINYAK GORENG DAMAI 5L,1,75000,0,75000,73780,1220
9/7/2021 14:37,8998866501026,MINYAK GORENG SEDAAP POUCH 1 L,1,15000,0,15000,14110,890
9/7/2021 15:32,8999999559533,LIFEBUOY BW TOTAL 10 90ML,1,5000,0,5000,4000,1000
9/7/2021 15:32,8997210107877,VORTEX SMART 3,1,5000,0,5000,4750,250
9/7/2021 15:46,ARG,ARGUS 220ML,3,14500,0,43500,39900,3600
9/7/2021 16:25,ICE CREAM 5,ICE CREAM 5000,1,5000,0,5000,4400,600
9/7/2021 16:29,8997009510055,YOU C1000,1,15000,0,15000,13000,2000
9/7/2021 16:31,8997009510055,YOU C1000,3,15000,0,45000,39000,6000
9/7/2021 16:48,8999988778846,LASEGAR,1,6500,0,6500,5700,800
9/7/2021 16:59,8992628020152,BIMOLI POUCH 2L,1,31000,0,31000,29800,1200
9/7/2021 16:59,8995333000822,TERIGU KOMPAS SOFT 500GR,3,5500,0,16500,14901,1599
9/7/2021 16:59,8992775312469,GERY SALUT COKELAT,1,11000,0,11000,9983,1017
9/7/2021 17:00,8999999001124,LIFEBUOY MILD CARE REF 250ML,1,15000,0,15000,13550,1450
9/7/2021 17:02,8992959953136,SWEETY BRONZE L20,1,40000,0,40000,36770,3230
9/7/2021 17:02,8993007003063,ENAAK 500G,1,11000,0,11000,9625,1375
9/7/2021 17:19,8999909002821,MARLBORO BLACK 16,1,22000,0,22000,20850,1150
9/7/2021 17:23,8999909096004,SAMPOERNA 16 FILTER,1,25000,0,25000,23100,1900
9/7/2021 17:27,8993989311699,CLAS MILD 16 FILTER,1,24000,0,24000,21700,2300
9/7/2021 17:28,8998989300261,GUDANG GARAM SURYA 12 FILTER,1,20000,0,20000,18150,1850
9/7/2021 17:30,8999909010567,234 DJI SAM SOE 16,1,22500,0,22500,21500,1000
9/7/2021 17:39,8998866603676,FRES&NATURAL SOAP GREEN 65G,1,1800,0,1800,1425,375
9/7/2021 17:39,8998866604512,FRES&NATURAL SOAP VIOLET 65G,1,1800,0,1800,1425,375
9/7/2021 17:39,089686535242,SUN PISANG SUSU,1,8500,0,8500,7410,1090
9/7/2021 17:39,6907992823874,JD CRUNCHY CHOCO BLUEBERRY,1,5500,0,5500,4700,800
9/7/2021 17:41,Garuda pilus,Garuda Pilus Pedas Pcs,1,500,0,500,408,92
9/7/2021 17:44,8999801700054,SUSU FOYU 1 KG,1,22000,0,22000,19791,2209
9/7/2021 17:51,8996001600146,TEH PUCUK HARUM 350ML,1,3000,0,3000,2314,686
9/7/2021 17:52,RT 1000,ROTI 1000,1,1000,0,1000,800,200
9/7/2021 21:09,8996001305119,ARDEN 30G,1,2000,0,2000,1650,350
9/7/2021 21:09,8997012030748,MADU ENAK,1,1000,0,1000,900,100
9/7/2021 21:17,KIKO,KIKO,1,1000,0,1000,500,500
9/7/2021 21:17,8996001600146,TEH PUCUK HARUM 350ML,2,3000,0,6000,4628,1372
9/7/2021 21:17,YP,YUPI,2,250,0,500,416,84
9/7/2021 21:17,GL,GULA 1 LITER,4,11500,0,46000,42000,4000
9/7/2021 21:17,8996001318980,BETTER 120G,1,6000,0,6000,5100,900
9/7/2021 21:17,8996001305119,ARDEN 30G,1,2000,0,2000,1650,350
9/7/2021 21:17,123124,KOREK BIASA,1,2000,0,2000,1300,700
9/7/2021 21:17,0105312686040047,yakult,1,2000,0,2000,1500,500
9/7/2021 22:18,8998866501033,MINYAK GORENG SEDAAP POUCH 2L,1,32000,0,32000,31414,586
9/7/2021 22:19,8993379152017,SABUN CUCI SURYA 200G,1,3000,0,3000,2281,719
9/7/2021 22:24,8992775001806 pcs,Gery salut malkist chocolate coconut pcs,1,1000,0,1000,812,188
9/7/2021 22:26,8993989311699,CLAS MILD 16 FILTER,1,24000,0,24000,21700,2300
9/7/2021 22:32,8998989300261,GUDANG GARAM SURYA 12 FILTER,1,20000,0,20000,18150,1850
9/7/2021 22:37,kri,kripik pisang,1,5000,0,5000,4000,1000
9/7/2021 22:42,kentang,kripik kentang,4,1000,0,4000,3600,400
9/7/2021 22:43,8996001600146,TEH PUCUK HARUM 350ML,1,3000,0,3000,2314,686
9/7/2021 22:44,Gula gula kaki,gula gula kaki,4,500,0,2000,1600,400
9/7/2021 22:45,TORT,TORTILA,1,1000,0,1000,1000,0
9/7/2021 22:47,8992775001806 pcs,Gery salut malkist chocolate coconut pcs,1,1000,0,1000,812,188
9/7/2021 22:48,8998866201452,POTABEE REGULER BBQ BEEF 35GR,1,5000,0,5000,4150,850
9/7/2021 22:49,ROTI,ROTI 2000,7,2000,0,14000,12600,1400
9/7/2021 22:53,8997027300089,NOMOS,1,4000,0,4000,2963,1037
9/7/2021 23:09,8993072254018,MELROSE COTTON BUDS BSR,1,5000,0,5000,4050,950
9/7/2021 23:38,8993379152017,SABUN CUCI SURYA 200G,1,3000,0,3000,2281,719
9/7/2021 23:41,8992931006256,tessa,2,1000,0,2000,1800,200
9/8/2021 0:01,8992761166205,FRESTEA GREEN HONEY 350ML,1,4500,0,4500,3000,1500
9/8/2021 0:01,8991102320184,TANGO CHOCO JAVAMOCCA,1,5000,0,5000,4330,670
9/8/2021 0:01,089686043273,INDOMIE SAMBAL RICA,1,2700,0,2700,2452,248
9/8/2021 0:01,8992775913000,CHOCOLATOS CKLT 28G,10,2000,0,20000,15570,4430
9/8/2021 0:01,ROTI,ROTI 2000,1,2000,0,2000,1800,200
9/8/2021 9:13,8997003910684,2CS,4,3000,0,12000,6000,6000
9/8/2021 9:13,8992761164539,NUTRIBOOST ORANGE 300ML,1,6500,0,6500,5300,1200
9/8/2021 9:14,8995555171225,KIMBO SOSIS,1,1000,0,1000,900,100
9/8/2021 9:15,6907992823829,JD MILKY MILK,1,3000,0,3000,2600,400
9/8/2021 9:15,8992775311509,gery garuda,1,1000,0,1000,700,300
9/8/2021 9:16,8992696523081,MILO UHT 110ML,1,2500,0,2500,1962,538
9/8/2021 9:16,8992775001998 pcs,Gery Salut sandiwich pcs,1,1000,0,1000,815,185
9/8/2021 9:16,089686535044,SUN BERAS MERAH,1,8500,0,8500,7410,1090
9/8/2021 9:17,8992628020152,BIMOLI POUCH 2L,1,31000,0,31000,29800,1200
9/8/2021 9:17,PRG,PARAGO,2,500,0,1000,800,200
9/8/2021 9:30,8992761139018,ADES 600ML,1,3500,0,3500,2166,1334
9/8/2021 9:30,ROTI,ROTI 2000,1,2000,0,2000,1800,200
9/8/2021 9:31,ROTI,ROTI 2000,2,2000,0,4000,3600,400
9/8/2021 9:46,8992761166038,MMP ORANGE 300ML,1,5000,0,5000,3750,1250
9/8/2021 9:46,8997028590045,ARGUS 330ML,2,2000,0,4000,2582,1418
9/8/2021 9:47,ROTI,ROTI 2000,2,2000,0,4000,3600,400
9/8/2021 9:50,8886013213208,FRENCH FREIS 2000,2,5000,0,10000,7500,2500
9/8/2021 9:50,089686611878,QTELA TEMPE,1,6000,0,6000,5370,630
9/8/2021 9:51,8998898101409,TOLAK ANGIN SIDOMUNCUL,2,3500,0,7000,5416,1584
9/8/2021 9:51,8997028590052,ARGUS 600ML,2,3000,0,6000,2916,3084
9/8/2021 9:51,8997025914059,HATARI SEE HONG,1,6000,0,6000,4911,1089
9/8/2021 9:52,8992724892844,Coklat mede,7,1000,0,7000,5600,1400
9/8/2021 9:53,8997025914059,HATARI SEE HONG,1,6000,0,6000,4911,1089
9/8/2021 9:54,8997028590052,ARGUS 600ML,2,3000,0,6000,2916,3084
9/8/2021 9:59,8998866202664,POTABEE WAGYU BEEF STEAK 68 GR,1,8000,0,8000,7200,800
9/8/2021 10:14,8998866608718,DAIA SOFTENER PINK,1,5000,0,5000,4450,550
9/8/2021 10:28,8997003910684,2CS,1,3000,0,3000,1500,1500
9/8/2021 10:44,ROTI,ROTI 2000,1,2000,0,2000,1800,200
9/8/2021 10:53,PULPEN SNOWMAN,PULPEN SNOWMAN,2,2500,0,5000,4000,1000
9/8/2021 10:55,PULPEN SNOWMAN,PULPEN SNOWMAN,2,2500,0,5000,4000,1000
9/8/2021 10:56,PULPEN SNOWMAN,PULPEN SNOWMAN,1,2500,0,2500,2000,500
9/8/2021 11:01,PULPEN SNOWMAN,PULPEN SNOWMAN,1,2500,0,2500,2000,500
9/8/2021 11:02,8992696521629,DNCO COKLT UHT 180ML,1,5000,0,5000,3533,1467
9/8/2021 11:02,ARG,ARGUS 220ML,1,14500,0,14500,13300,1200
9/8/2021 11:05,PULPEN SNOWMAN,PULPEN SNOWMAN,1,2500,0,2500,2000,500
9/8/2021 11:11,8992761166038,MMP ORANGE 300ML,1,5000,0,5000,3750,1250
9/8/2021 11:11,0105312686040047,yakult,1,2000,0,2000,1500,500
9/8/2021 11:18,8994935000285,MINYAK GORENG DUNIA 4500ML,1,70000,0,70000,66433,3567
9/8/2021 11:18,8995333060703,TERIGU KOMPAS 1KG,1,10500,0,10500,9816,684
9/8/2021 11:18,ROTI,ROTI 2000,1,2000,0,2000,1800,200
9/8/2021 11:18,8997009510055,YOU C1000,1,15000,0,15000,13000,2000
9/8/2021 11:19,8998989300261,GUDANG GARAM SURYA 12 FILTER,1,20000,0,20000,18150,1850
9/8/2021 11:25,ROTI,ROTI 2000,1,2000,0,2000,1800,200
9/8/2021 11:28,8991102320184,TANGO CHOCO JAVAMOCCA,1,5000,0,5000,4330,670
9/8/2021 11:40,8997003910684,2CS,6,3000,0,18000,9000,9000
9/8/2021 11:46,8999999050009,SUNLIGHT LIME NEW POUCH 95ML,1,2000,0,2000,1600,400
9/8/2021 11:46,8999999057640,MOLTO EDP BLK PURPLE 20ML,1,1000,0,1000,800,200
9/8/2021 11:46,8999999042592,RINSO MOLTO PERFUME ESSENSE LIQ 4OML,1,1000,0,1000,802,198
9/8/2021 11:46,8999999534752,PEPSODENT ACTION123 CHARCOAL 65G,1,7400,0,7400,6710,690
9/8/2021 11:46,8996001600399,LE MINERAL 1500ML,1,5000,0,5000,4042,958
9/8/2021 11:53,8992761164539,NUTRIBOOST ORANGE 300ML,1,6500,0,6500,5300,1200
9/8/2021 11:59,8996001600641,TORA CAPPUCINO,1,3500,0,3500,2750,750
9/8/2021 12:22,8997028590052,ARGUS 600ML,1,3000,0,3000,1458,1542
9/8/2021 12:22,711844120419,SAMBAL ABC 275 ML,1,12000,0,12000,10800,1200
9/8/2021 12:23,8998866201469,POTABEE REGULER BBQ BEEF 68 GR,1,8000,0,8000,7200,800
9/8/2021 12:23,8991102300421,WFR TANGO COKLAT 176GR,1,10000,0,10000,8694,1306
9/8/2021 12:23,8886013257400,TWISTKO,4,1000,0,4000,3600,400
9/8/2021 12:24,TBR,TEPUNG BERAS ROSE BRAND,1,8000,0,8000,5800,2200
9/8/2021 12:24,8991102281430,PERMEN MINTZ DUOMINT,2,5000,0,10000,8000,2000
9/8/2021 12:54,ROTI,ROTI 2000,2,2000,0,4000,3600,400
9/8/2021 12:56,8993470411433,JOGER CLASSIC,2,1000,0,2000,1700,300
9/8/2021 13:15,ARG,ARGUS 220ML,2,14500,0,29000,26600,2400
9/8/2021 13:17,8995333060703,TERIGU KOMPAS 1KG,2,10500,0,21000,19632,1368
9/8/2021 13:25,089686010107,INDOMIE KALDU AYAM,2,2500,0,5000,4300,700
9/8/2021 13:31,8999909002821,MARLBORO BLACK 16,1,22000,0,22000,20850,1150
9/8/2021 14:20,089686021141,INTER MIE SOTO,1,1000,0,1000,854,146
9/8/2021 14:59,8992761166212,FRESTEA APPLE 350ML,5,4500,0,22500,15000,7500
9/8/2021 15:01,8992775002933,GERY MALKIST DOUBLE ABON,1,6500,0,6500,5516,984
9/8/2021 15:01,RT 1000,ROTI 1000,6,1000,0,6000,4800,1200
9/8/2021 15:02,8999909002821,MARLBORO BLACK 16,1,22000,0,22000,20850,1150
9/8/2021 16:46,8991002105409,KOPI KAPAL API,1,20000,0,20000,18888,1112
9/8/2021 16:47,089686044249,SUPERMI NUTRIMI STEAK AYAM,2,3500,0,7000,5600,1400
9/8/2021 16:49,089686021141,INTER MIE SOTO,5,1000,0,5000,4270,730
9/8/2021 16:50,8998866202664,POTABEE WAGYU BEEF STEAK 68 GR,1,8000,0,8000,7200,800
9/8/2021 16:52,8998866202060,POTABEE AYAM BAKAR PEDAS 35 GR,1,5000,0,5000,4150,850
9/8/2021 16:53,8999999024475,CITRA BW PEARLY WHITE LD 400ML,1,21000,0,21000,19000,2000
9/8/2021 16:53,8997028590052,ARGUS 600ML,1,3000,0,3000,1458,1542
9/8/2021 16:54,8999909003873,MARLBORO 12,1,17000,0,17000,15750,1250
9/8/2021 16:54,KIKO,KIKO,5,1000,0,5000,2500,2500
9/8/2021 17:01,6907992823942,JD JUJUBE,1,4500,0,4500,3800,700
9/8/2021 17:02,6907992825069,JD FRUITY,1,5000,0,5000,4400,600
9/8/2021 17:03,JD VM,JD VANILLA MILKSHAKE,1,5000,0,5000,4300,700
9/8/2021 17:03,8997028590045,ARGUS 330ML,1,2000,0,2000,1291,709
9/8/2021 17:03,8991909101016,URBAN MILD 16,1,17000,0,17000,15800,1200
9/8/2021 17:04,8994867007161,ROKOK PENA GOLD 20,1,18000,0,18000,16800,1200
9/8/2021 17:04,ARG,ARGUS 220ML,4,14500,0,58000,53200,4800
9/8/2021 17:04,ARG 330,ARGUS 330ML,1,35000,0,35000,31000,4000
9/8/2021 17:05,0105312686040047,yakult,2,2000,0,4000,3000,1000
9/8/2021 17:05,8992628510158,SIMAS PALMIA,1,6000,0,6000,4832,1168
9/8/2021 17:05,0105312686040047,yakult,1,2000,0,2000,1500,500
9/8/2021 17:05,8998989110167,SURYA GUDANG GARAM 16 FILTER,1,26000,0,26000,23700,2300
9/8/2021 17:06,8992761164539,NUTRIBOOST ORANGE 300ML,1,6500,0,6500,5300,1200
9/8/2021 17:07,8991111101415,JB POWDER 100G,1,7000,0,7000,6000,1000
9/8/2021 17:09,8997028590014,ARGUS 220ML,2,500,0,1000,604,396
9/8/2021 17:10,TG,TEH GELAS,3,1000,0,3000,2187,813
9/8/2021 17:11,KOPIKO,KOPIKO,12,250,0,3000,2100,900
9/8/2021 17:51,8992696523067,MILO ACTVGO UHT 180ML,1,4500,0,4500,3515,985
9/8/2021 18:10,8993989311699,CLAS MILD 16 FILTER,2,24000,0,48000,43400,4600
9/8/2021 18:17,TELUR,TELUR,1,1800,0,1800,1200,600
9/8/2021 18:23,8998989300261,GUDANG GARAM SURYA 12 FILTER,1,20000,0,20000,18150,1850
9/8/2021 19:53,089686043051,INDOMIE COTO MAKASSAR,1,2800,0,2800,2525,275
9/8/2021 19:54,ARG,ARGUS 220ML,1,14500,0,14500,13300,1200
9/8/2021 19:55,ARG 330,ARGUS 330ML,1,35000,0,35000,31000,4000
9/8/2021 19:55,8998989300261,GUDANG GARAM SURYA 12 FILTER,1,20000,0,20000,18150,1850
9/8/2021 19:58,Gula gula tusuk,gula gula tusuk,6,500,0,3000,2400,600
9/8/2021 20:03,6907992823645,JD COCONUT BLISS,1,4000,0,4000,3500,500
9/8/2021 20:10,8996001305041,ROMA SANDWICH CKLT,2,7000,0,14000,11856,2144
9/8/2021 20:10,8995333060703,TERIGU KOMPAS 1KG,1,10500,0,10500,9816,684
9/8/2021 20:10,089686043051,INDOMIE COTO MAKASSAR,4,2800,0,11200,10100,1100
9/8/2021 20:10,8992628022156,BIMOLI KLASIK TOUCH 1 LT,1,16000,0,16000,14350,1650
9/8/2021 20:10,8992979190986,TOTAL PUTIH SOFTENER,1,13000,0,13000,11532,1468
9/8/2021 20:10,8992979130012,TOTAL LEMON SOFTENER,1,13000,0,13000,11532,1468
9/8/2021 20:10,8998866671736,CREAM EKONOMI 455G,1,5500,0,5500,4750,750
9/8/2021 20:10,8999999707859,CLOSEUP GREEN 160G,1,15000,0,15000,13600,1400
9/8/2021 20:10,8999999548698,LUXTS VALVET JASMINE 4X60G,1,8500,0,8500,7650,850
9/8/2021 20:10,8992761111519,COCA COLA SLIM CAM 250ML,1,5000,0,5000,3750,1250
9/8/2021 20:10,8999999059903,PONDS AGE MIRACLE DAY CREAM 10G,1,28500,0,28500,25850,2650
9/8/2021 20:13,8996001318980,BETTER 120G,1,6000,0,6000,5100,900
9/8/2021 20:13,8995555121244,SOSIS KIMBO,1,1000,0,1000,650,350
9/8/2021 20:41,8997018250218,JAHE MERAH,9,1000,0,9000,7497,1503
9/8/2021 20:41,9311931024036,COFFEEMIX SCT,1,1500,0,1500,1200,300
9/8/2021 20:41,8996001440001,TB JAHE SUSU,5,1500,0,7500,4350,3150
9/8/2021 20:41,8998666001306,TB CREAMY LATTE,8,1500,0,12000,7920,4080
9/8/2021 20:45,089686021141,INTER MIE SOTO,1,1000,0,1000,854,146
9/8/2021 20:45,089686021219,INTER MIE GORENG,1,1000,0,1000,885,115
9/8/2021 20:45,Vita Jelly,Vita Jelly,1,1000,0,1000,766,234
9/8/2021 20:52,TELUR,TELUR,3,1800,0,5400,3600,1800
9/8/2021 20:53,kentang,kripik kentang,5,1000,0,5000,4500,500
9/8/2021 21:00,TS,TISSUE TESSY,1,5000,0,5000,4200,800
9/8/2021 21:02,8997028590045,ARGUS 330ML,1,2000,0,2000,1291,709
9/8/2021 21:02,8999909010567,234 DJI SAM SOE 16,1,22500,0,22500,21500,1000
9/8/2021 21:12,8992696521797,MILO 22G,2,2500,0,5000,3144,1856
9/8/2021 22:21,8998866202237,NOODLE SEDAAP TASTY AYAM GEPREK 124 GR,1,5000,0,5000,4167,833
9/8/2021 22:52,8991102213189,BLASTER UNGU,1,5000,0,5000,3106,1894
9/8/2021 22:52,8991102281430,PERMEN MINTZ DUOMINT,1,5000,0,5000,4000,1000
9/8/2021 22:56,kentang,kripik kentang,5,1000,0,5000,4500,500
9/8/2021 23:00,Gula gula kaki,gula gula kaki,4,500,0,2000,1600,400
9/8/2021 23:11,gg,gula-gula koin,2,500,0,1000,800,200
9/8/2021 23:15,gula gula,gula-gula karet,2,500,0,1000,800,200
9/8/2021 23:17,gula gula,gula-gula karet,2,500,0,1000,800,200
9/8/2021 23:17,jagung marning,jagung marning,1,5000,0,5000,4500,500
9/8/2021 23:17,gg,gula-gula koin,2,500,0,1000,800,200
9/8/2021 23:19,TORT,TORTILA,1,1000,0,1000,1000,0
9/8/2021 23:20,8996001301562,MALKIST TABUR KELAPA,1,1000,0,1000,820,180
9/8/2021 23:21,8996001305119,ARDEN 30G,1,2000,0,2000,1650,350
9/8/2021 23:22,8996001305119,ARDEN 30G,2,2000,0,4000,3300,700
9/8/2021 23:25,8991001121400,SILVERQUEEN ALMOND 65G,1,15000,0,15000,13200,1800
9/8/2021 23:25,8993470672858,SAKU-SAKU RASA BALADO,1,2000,0,2000,1530,470
9/8/2021 23:28,8996001355978,BENG-BENG SHARE IT 9.5G,1,10000,0,10000,8700,1300
9/8/2021 23:29,8991111112114,C&C ACNE CLEARING CLEANSER 100G,1,21500,0,21500,19900,1600
9/8/2021 23:31,8997013790108,BIMURA KACANG TELUR 25G,3,1000,0,3000,2625,375
9/8/2021 23:36,8998866202343,MIE SEDAAP KOREAN SPICY,2,2700,0,5400,4826,574
9/8/2021 23:37,Telur 7 Biji,Telur 7 Biji,1,10000,0,10000,8400,1600
9/8/2021 23:39,8992628020152,BIMOLI POUCH 2L,1,31000,0,31000,29800,1200
9/8/2021 23:42,8999909096004,SAMPOERNA 16 FILTER,1,25000,0,25000,23100,1900
9/8/2021 23:42,8997028590052,ARGUS 600ML,2,3000,0,6000,2916,3084
9/8/2021 23:49,8999999037765,pepsodent 225 gr,1,12000,0,12000,10500,1500
9/8/2021 23:49,8999999531515,MOLTO WHITE MUSK SC 10ML,1,5500,0,5500,4800,700
9/8/2021 23:49,8998866610278,DAIA VIOLET GUSSET 565G,1,10000,0,10000,8700,1300
9/8/2021 23:52,8999999192198,Royco,1,5000,0,5000,4000,1000
9/9/2021 0:00,MRC,MERICA LADA,1,1000,0,1000,889,111
9/9/2021 9:12,8991002307209,COFFE CANDY,2,6000,0,12000,10000,2000
9/9/2021 9:25,8998866605144,CLING KUNING POUCH 425ML,1,4000,0,4000,3250,750
9/9/2021 9:26,8992959971109,SFX COMFORT SLIM 36CM 12+1,1,17000,0,17000,15152,1848
9/9/2021 9:27,8992696523081,MILO UHT 110ML,1,2500,0,2500,1962,538
9/9/2021 9:28,8999999042639,RINSO ANTI NODA CLS LIQ 40ML,2,1000,0,2000,1610,390
9/9/2021 9:29,8996001301562,MALKIST TABUR KELAPA,2,1000,0,2000,1640,360
9/9/2021 9:30,8999999531508,MOLTO HYGIENE SC 10ML,4,500,0,2000,1920,80
9/9/2021 9:30,8997025914059,HATARI SEE HONG,1,6000,0,6000,4911,1089
9/9/2021 9:30,8996001305041,ROMA SANDWICH CKLT,1,7000,0,7000,5928,1072
9/9/2021 10:45,8998866202244,EKOMIE BUMBU KALDU AYAM,5,1000,0,5000,3990,1010
9/9/2021 10:58,8997013180046,Tissu Tessi B,1,11000,0,11000,9800,1200
9/9/2021 10:59,8998989500166,GUDANG GARAM MERAH BESAR 16KS,1,18000,0,18000,17000,1000
9/9/2021 11:30,8992959117583,SFX DS REG FLOW WING 20,1,5000,0,5000,4288,712
9/9/2021 11:30,8996001375372,CHOKI CHOKI,1,1000,0,1000,910,90
9/9/2021 11:40,8994867007161,ROKOK PENA GOLD 20,1,18000,0,18000,16800,1200
9/9/2021 11:40,8998989110167,SURYA GUDANG GARAM 16 FILTER,1,26000,0,26000,23700,2300
9/9/2021 11:47,089686611670,QTELA BALADO,1,5000,0,5000,4266,734
9/9/2021 11:47,8992775110140,GARUDA KACANG KULIT 160G,1,12000,0,12000,10012,1988
9/9/2021 12:16,089686067002,POP MIE PDS DOWER RS AYAM,2,5000,0,10000,8900,1100
9/9/2021 12:16,089686060126,POP MIE BASO JUMBO,1,4500,0,4500,3833,667
9/9/2021 12:16,8998866200844,NOODLE SEDAAP MIE KARI SPESIAL CUP 81 GR,1,4500,0,4500,3650,850
9/9/2021 12:23,roti,roti 2000,1,2000,0,2000,1800,200
9/9/2021 12:37,8992959107515,SFX NON WING 23CM 8,1,4000,0,4000,3288,712
9/9/2021 12:37,8997013180053,Tissu Tessy,1,5000,0,5000,4000,1000
9/9/2021 12:37,8999999192150,ROYCO FDS CHICKEN 100GR,1,5000,0,5000,4300,700
9/9/2021 12:37,8997021110028,Garam,1,2500,0,2500,1500,1000
9/9/2021 12:37,8993379254469,SABUN LERVIA 90G,1,5000,0,5000,3077,1923
9/9/2021 12:37,6907992823829,JD MILKY MILK,1,3000,0,3000,2600,400
9/9/2021 12:37,089686048704,SARIMIE GORENG AYAM KCP ISI 2,1,3500,0,3500,3120,380
9/9/2021 12:37,8992775001998 pcs,Gery Salut sandiwich pcs,2,1000,0,2000,1630,370
9/9/2021 13:05,8992696523081,MILO UHT 110ML,1,2500,0,2500,1962,538
9/9/2021 13:06,8992696523081,MILO UHT 110ML,1,2500,0,2500,1962,538
9/9/2021 13:08,TUSTEL,TUSUK TELINGA,1,1000,0,1000,833,167
9/9/2021 13:12,8993989311699,CLAS MILD 16 FILTER,1,24000,0,24000,21700,2300
9/9/2021 13:13,8993989311699,CLAS MILD 16 FILTER,2,24000,0,48000,43400,4600
9/9/2021 13:43,Telur 3 Biji,Telur 3 Biji,1,5000,0,5000,3600,1400
9/9/2021 15:43,8998989500166,GUDANG GARAM MERAH BESAR 16KS,1,18000,0,18000,17000,1000
9/9/2021 15:43,8999909002821,MARLBORO BLACK 16,1,22000,0,22000,20850,1150
9/9/2021 16:28,8996001600146,TEH PUCUK HARUM 350ML,1,3000,0,3000,2314,686
9/9/2021 16:28,8992775311509,gery garuda,2,1000,0,2000,1400,600
9/9/2021 16:50,8991102213189,BLASTER UNGU,1,5000,0,5000,3106,1894
9/9/2021 16:50,8993989311699,CLAS MILD 16 FILTER,1,24000,0,24000,21700,2300
9/9/2021 16:50,roti,roti 2000,4,2000,0,8000,7200,800
9/9/2021 17:19,GL,GULA 1 LITER,1,11500,0,11500,10500,1000
9/9/2021 17:20,JL,JELLY,2,500,0,1000,800,200
9/9/2021 17:20,Gula gula tusuk,gula gula tusuk,2,500,0,1000,800,200
9/9/2021 17:21,8999999059781,SUNLIGHT LIME NEW POUCH 210ML,1,5000,0,5000,4300,700
9/9/2021 17:23,8997012030748,MADU ENAK,2,1000,0,2000,1800,200
9/9/2021 18:14,8996001305119,ARDEN 30G,1,2000,0,2000,1650,350
9/9/2021 18:23,8998866200301,MIE SEDAAP GORENG,1,2700,0,2700,2413,287
9/9/2021 19:22,6907992823843,JD MOCHA CRISPY,1,5000,0,5000,4400,600
9/9/2021 19:22,ARG,ARGUS 220ML,1,14500,0,14500,13300,1200
9/9/2021 19:23,TBR,TEPUNG BERAS ROSE BRAND,1,8000,0,8000,5800,2200
9/9/2021 19:24,YP,YUPI,6,250,0,1500,1248,252
9/9/2021 19:24,8998009010231,ULTRA CHO 250,1,6000,0,6000,4784,1216
9/9/2021 19:25,089686067002,POP MIE PDS DOWER RS AYAM,1,5000,0,5000,4450,550
9/9/2021 19:30,8994834006128,TICTIC PEDAS,3,2000,0,6000,5100,900
9/9/2021 19:30,8997028590045,ARGUS 330ML,2,2000,0,4000,2582,1418
9/9/2021 19:46,gula gula,gula-gula karet,8,500,0,4000,3200,800
9/9/2021 19:50,896867700494,AIR CLUB 1500ML,1,5000,0,5000,2987,2013
9/9/2021 19:50,8998866202770,MIE SEDAAP SALERO PADANG,1,2500,0,2500,2362,138
9/9/2021 19:50,089686043617,INDOMIE MIEGHETTI,1,2700,0,2700,2452,248
9/9/2021 19:50,089686043051,INDOMIE COTO MAKASSAR,1,2800,0,2800,2525,275
9/9/2021 19:50,8999999526894,RINSO ROYAL GOLD 40ML,2,1000,0,2000,1610,390
9/9/2021 19:50,8992775211434,PILUS GARUDA SAPI PANGGANG,1,5000,0,5000,4810,190
9/9/2021 19:50,Gula gula tusuk,gula gula tusuk,1,500,0,500,400,100
9/9/2021 19:50,Gula gula kaki,gula gula kaki,1,500,0,500,400,100
9/9/2021 19:53,roti,roti 2000,3,2000,0,6000,5400,600
9/9/2021 19:54,8992775310212,GERY PASTA COKELAT,1,18000,0,18000,16029,1971
9/9/2021 19:56,8999909002876,SAMPOERNA ULTRAMILD 12,1,17000,0,17000,14600,2400
9/9/2021 20:00,089686021219,INTER MIE GORENG,5,1000,0,5000,4425,575
9/9/2021 20:00,8999999059309,LIFEBUOY TS TOTAL 10 DG 75G,1,3000,0,3000,2640,360
9/9/2021 20:00,8998898830125,KKB ENER-G ANGGUR,1,5500,0,5500,4824,676
9/9/2021 20:00,8999909010567,234 DJI SAM SOE 16,1,22500,0,22500,21500,1000
9/9/2021 20:44,8992775001806 pcs,Gery salut malkist chocolate coconut pcs,3,1000,0,3000,2436,564
9/9/2021 20:44,8992775305188 pcs,Gery Salut Grentea pcs,1,1000,0,1000,812,188
9/9/2021 20:45,kentang,kripik kentang,3,1000,0,3000,2700,300
9/9/2021 20:46,jagung marning,jagung marning,1,5000,0,5000,4500,500
9/9/2021 20:49,8998866605137,CLING BIRU POUCH 425ML,1,4000,0,4000,3250,750
9/9/2021 20:49,Gula gula tusuk,gula gula tusuk,2,500,0,1000,800,200
9/9/2021 20:53,roti,roti 2000,3,2000,0,6000,5400,600
9/9/2021 20:53,8992761111540,FANTA STRAWBERY SLIM CAM 250ML,1,5000,0,5000,3750,1250
9/9/2021 20:54,8992696521797,MILO 22G,1,2500,0,2500,1572,928
9/9/2021 20:56,8992724892844,Coklat mede,1,1000,0,1000,800,200
9/9/2021 20:57,8992775305188 pcs,Gery Salut Grentea pcs,1,1000,0,1000,812,188
9/9/2021 21:02,8996001305119,ARDEN 30G,1,2000,0,2000,1650,350
9/9/2021 21:02,8991102380805,FULLO  CKL PCK 8G,1,10000,0,10000,9000,1000
9/9/2021 21:02,711844610095,LARISSA UDANG 500 GR,1,11000,0,11000,9790,1210
9/9/2021 21:02,8991102987875,WFR TANGO POUCH CKL 115G,1,8000,0,8000,6786,1214
9/9/2021 21:02,089686021219,INTER MIE GORENG,5,1000,0,5000,4425,575
9/9/2021 21:07,8994834006128,TICTIC PEDAS,1,2000,0,2000,1700,300
9/9/2021 21:07,8999999001117,Lifebuoy,1,15000,0,15000,14000,1000
9/9/2021 21:07,8992761145033,FANTA STRAW PET 250ML,1,3500,0,3500,2417,1083
9/9/2021 21:10,8995899210185,Mi Boncabe,2,3500,0,7000,6000,1000
9/9/2021 21:14,8993093115008,tepun beras,1,8000,0,8000,7000,1000
9/9/2021 21:16,8998866201377,KRISBEE FRIES KENTANG GORENG 68 GR,1,5500,0,5500,4620,880
9/9/2021 21:16,8992959117583,SFX DS REG FLOW WING 20,4,5000,0,20000,17152,2848
9/9/2021 21:17,kentang,kripik kentang,1,1000,0,1000,900,100
9/9/2021 21:18,8992628020152,BIMOLI POUCH 2L,1,31000,0,31000,29800,1200
9/9/2021 21:18,ARG,ARGUS 220ML,1,14500,0,14500,13300,1200
9/9/2021 21:19,KIKO,KIKO,1,1000,0,1000,500,500
9/9/2021 21:21,8992761111533,SPRITE SLIM CAM250ML,1,5000,0,5000,3750,1250
9/9/2021 21:22,8999999007768,FAIR&LOVELY MULTIVITAMIN  CREAM 9 ML,1,4500,0,4500,3200,1300
9/9/2021 21:24,8999999549480,SUNLIGHT LIME CRM SCH 270G,1,5000,0,5000,4500,500
9/9/2021 21:27,8992959953037,SWEETY BRONZE L1,2,2500,0,5000,3638,1362
9/9/2021 21:36,8997878004327,gula-gula milkita,4,250,0,1000,800,200
9/9/2021 21:37,8997878004327,gula-gula milkita,4,250,0,1000,800,200
9/9/2021 21:41,kentang,kripik kentang,2,1000,0,2000,1800,200
9/9/2021 21:43,8997009510055,YOU C1000,1,15000,0,15000,13000,2000
9/9/2021 21:44,8997009510055,YOU C1000,1,15000,0,15000,13000,2000
9/9/2021 21:45,8997211400038,SANTAN COCONUT CREAM,1,4000,0,4000,3000,1000
9/9/2021 21:46,8992959953037,SWEETY BRONZE L1,2,2500,0,5000,3638,1362
9/9/2021 21:54,8998866601429,POWDET DAIA BUNGA BAG 290GR,2,5000,0,10000,8900,1100
9/9/2021 21:55,MARS,MARSHMELLOW,8,500,0,4000,3464,536
9/9/2021 21:56,Vita Jelly,Vita Jelly,2,1000,0,2000,1532,468
9/9/2021 21:57,8998866201889,KRISBEE PILLOW STRAWBERRY ICE CREAM 120GR,1,8000,0,8000,7250,750
9/9/2021 21:58,Telur 7 Biji,Telur 7 Biji,1,10000,0,10000,8400,1600
9/9/2021 21:58,8997009510055,YOU C1000,1,15000,0,15000,13000,2000
9/9/2021 21:59,kri,kripik pisang,1,5000,0,5000,4000,1000
9/9/2021 22:00,kri,kripik pisang,1,5000,0,5000,4000,1000
9/9/2021 22:01,8998866201889,KRISBEE PILLOW STRAWBERRY ICE CREAM 120GR,1,8000,0,8000,7250,750
9/9/2021 22:02,8997231980039,O`JELLY KONYAKU (MAXI APPLE STRAWBERRY),2,5500,0,11000,9240,1760
9/9/2021 22:05,8998989500166,GUDANG GARAM MERAH BESAR 16KS,2,18000,0,36000,34000,2000
9/9/2021 22:06,8994867007161,ROKOK PENA GOLD 20,1,18000,0,18000,16800,1200
9/9/2021 22:06,ROTI,ROTI 2000,2,2000,0,4000,3600,400
9/9/2021 22:09,8992959953044,SWEETY BRONZE XL1,6,3000,0,18000,13866,4134
9/9/2021 22:09,MARS,MARSHMELLOW,1,500,0,500,433,67
9/9/2021 22:12,8995899210185,Mi Boncabe,2,3500,0,7000,6000,1000
9/9/2021 22:13,8995899210185,Mi Boncabe,1,3500,0,3500,3000,500
9/9/2021 22:22,8997009510055,YOU C1000,1,15000,0,15000,13000,2000
9/9/2021 22:24,8991909101016,URBAN MILD 16,1,17000,0,17000,15800,1200
9/9/2021 22:30,8998989110167,SURYA GUDANG GARAM 16 FILTER,1,26000,0,26000,23700,2300
9/10/2021 9:49,8998989300261,GUDANG GARAM SURYA 12 FILTER,1,20000,0,20000,18150,1850
9/10/2021 9:50,8996001305119,ARDEN 30G,1,2000,0,2000,1650,350
9/10/2021 9:50,8992775311509,gery garuda,1,1000,0,1000,700,300
9/10/2021 9:50,8995555121244,SOSIS KIMBO,1,1000,0,1000,650,350
9/10/2021 9:51,8991001242013,Top,1,1000,0,1000,500,500
9/10/2021 9:52,8992959509005,SWEETY SILVER PANTS XL26,1,61500,0,61500,55910,5590
9/10/2021 9:52,8992717900310,KARA SUN,2,2500,0,5000,4000,1000
9/10/2021 9:53,8998866202244,EKOMIE BUMBU KALDU AYAM,3,1000,0,3000,2394,606
9/10/2021 9:54,089686386127,BUMBU RACIK NASI GORENG SOSIS,2,2000,0,4000,3240,760
9/10/2021 9:54,roti,roti 2000,1,2000,0,2000,1800,200
9/10/2021 9:56,CC,NICE FACIAL KILOAN 900 GR DUO,1,34500,0,34500,31325,3175
9/10/2021 9:57,roti,roti 2000,2,2000,0,4000,3600,400
9/10/2021 9:57,gula,GULA,1,11500,0,11500,10000,1500
9/10/2021 9:58,8998866619035,Royale Sweet Floral 13 ml,1,5000,0,5000,4452,548
9/10/2021 9:59,8992696430860,KOKO KRUNCH 80G,1,9000,0,9000,8063,937
9/10/2021 9:59,089686060102,POP MIE PEDE GLEDEEK,1,5000,0,5000,4450,550
9/10/2021 10:00,8998866200301,MIE SEDAAP GORENG,2,2700,0,5400,4826,574
9/10/2021 11:01,11222,LEM KOREA,1,10000,0,10000,8000,2000
9/10/2021 11:03,089686060102,POP MIE PEDE GLEDEEK,1,5000,0,5000,4450,550
9/10/2021 11:03,8996001312698,MALKIST KOREAN,1,6500,0,6500,5500,1000
9/10/2021 11:52,089686386011,BUMBU RACIK NASI GORENG,1,2000,0,2000,1450,550
9/10/2021 11:52,Telur 7 Biji,Telur 7 Biji,1,10000,0,10000,8400,1600
9/10/2021 11:54,8995555121244,SOSIS KIMBO,1,1000,0,1000,650,350
9/10/2021 13:09,Gula gula tusuk,gula gula tusuk,1,500,0,500,400,100
9/10/2021 13:10,JD VM,JD VANILLA MILKSHAKE,1,5000,0,5000,4300,700
9/10/2021 13:11,6907992823829,JD MILKY MILK,1,3000,0,3000,2600,400
9/10/2021 13:15,8999999045913,LIFEBUOY MILDCARE 110GR,1,15000,0,15000,14245,755
9/10/2021 13:16,8999999195649,SARI WANGI 25X1.86G,1,6000,0,6000,5050,950
9/10/2021 13:16,8997025911058,HATARI SHP KELAPA,1,6000,0,6000,4911,1089
9/10/2021 13:17,8999909010567,234 DJI SAM SOE 16,1,22500,0,22500,21500,1000
9/10/2021 13:17,8998989110167,SURYA GUDANG GARAM 16 FILTER,1,26000,0,26000,23700,2300
9/10/2021 13:18,8997210107877,VORTEX SMART 3,1,5000,0,5000,4750,250
9/10/2021 13:21,8992775110157,GARUDA KACANG KULIT,1,5000,0,5000,3925,1075
9/10/2021 13:23,8995077609985,Tortilla,1,1000,0,1000,900,100
9/10/2021 13:24,roti,roti 2000,1,2000,0,2000,1800,200
9/10/2021 15:36,8998866200882,SUKSESMIE GORENG AYAM KRMS 133GR,2,3500,0,7000,6094,906
9/10/2021 15:37,089686043051,INDOMIE COTO MAKASSAR,1,2800,0,2800,2525,275
9/10/2021 15:37,8999909002821,MARLBORO BLACK 16,1,22000,0,22000,20850,1150
9/10/2021 15:39,8999999706081,PEPSODENT WHITE 75G,1,5000,0,5000,3850,1150
9/10/2021 15:40,8991102022460,FORMULA DIAMOND,1,3000,0,3000,2500,500
9/10/2021 15:40,Garuda pilus,Garuda Pilus Pedas Pcs,1,500,0,500,408,92
9/10/2021 15:42,8994075230870,momogi,1,500,0,500,450,50
9/10/2021 16:14,MATERAI,MATERAI,6,15000,0,90000,60000,30000
9/10/2021 17:00,8999999049669,REXONA MEN RO INVISIBLE DRY 45 ML,1,15000,0,15000,13550,1450
9/10/2021 17:12,roti,roti 2000,5,2000,0,10000,9000,1000
9/10/2021 17:40,8992979130012,TOTAL LEMON SOFTENER,1,13000,0,13000,11532,1468
9/10/2021 17:40,8998866611718,EKONOMI PENCUCI PIRING  LIQ 780ML,1,12000,0,12000,10900,1100
9/10/2021 17:40,8999999059309,LIFEBUOY TS TOTAL 10 DG 75G,3,3000,0,9000,7920,1080
9/10/2021 17:40,8998989500166,GUDANG GARAM MERAH BESAR 16KS,2,18000,0,36000,34000,2000
9/10/2021 17:42,8998866619035,Royale Sweet Floral 13 ml,1,5000,0,5000,4452,548
9/10/2021 17:42,8998866202244,EKOMIE BUMBU KALDU AYAM,5,1000,0,5000,3990,1010
9/10/2021 17:43,8997003910684,2CS,1,3000,0,3000,1500,1500
9/10/2021 17:43,roti,roti 2000,1,2000,0,2000,1800,200
9/10/2021 17:46,089686043204,INDOMIE MIE ACEH,1,2700,0,2700,2452,248
9/10/2021 17:46,Garuda Pilus,Garuda Pilus Rasa Abon Pcs,2,500,0,1000,802,198
9/10/2021 17:46,roti,roti 2000,1,2000,0,2000,1800,200
9/10/2021 17:47,8998866600521,SOKLIN FLOORCLENER KUNING 400ML,1,6000,0,6000,5025,975
9/10/2021 17:58,8996001600641,TORA CAPPUCINO,1,3500,0,3500,2750,750
9/10/2021 17:58,roti,roti 2000,2,2000,0,4000,3600,400
9/10/2021 17:58,8997878004327,gula-gula milkita,2,250,0,500,400,100
9/10/2021 18:01,711844110083,KECAP ABC 275 ML,1,15000,0,15000,14000,1000
9/10/2021 18:09,roti,roti 2000,1,2000,0,2000,1800,200
9/10/2021 19:21,089686043204,INDOMIE MIE ACEH,1,2700,0,2700,2452,248
9/10/2021 19:22,8998866200578,MIE SEDAAP KARI KENTAL,2,2700,0,5400,4662,738
9/10/2021 19:23,8998866200325,MIE SEDAAP SOTO,2,2700,0,5400,4662,738
9/10/2021 19:23,896867700494,AIR CLUB 1500ML,1,5000,0,5000,2987,2013
9/10/2021 19:28,9556001004673,MILO NESTLE MALAYSIA ACTIVE GO,1,85000,0,85000,80000,5000
9/10/2021 21:03,8997218380074,ICHITAN MILK TEA,1,8000,0,8000,6583,1417
9/10/2021 21:05,8998989110167,SURYA GUDANG GARAM 16 FILTER,1,26000,0,26000,23700,2300
9/10/2021 21:06,089686021219,INTER MIE GORENG,5,1000,0,5000,4425,575
9/10/2021 21:10,8995333000822,TERIGU KOMPAS SOFT 500GR,3,5500,0,16500,14901,1599
9/10/2021 21:12,089686021219,INTER MIE GORENG,5,1000,0,5000,4425,575
9/10/2021 21:13,8992761145033,FANTA STRAW PET 250ML,1,3500,0,3500,2417,1083
9/10/2021 21:13,8999999007782,FAIR&LOVELY MULTIVITAMIN CREAM 25 MG,1,16500,0,16500,14905,1595
9/10/2021 21:13,8993470411433,JOGER CLASSIC,1,1000,0,1000,850,150
9/10/2021 21:13,8994834005923,SPIX 1000,1,1000,0,1000,850,150
9/10/2021 21:15,8993470411433,JOGER CLASSIC,1,1000,0,1000,850,150
9/10/2021 21:20,8997025914059,HATARI SEE HONG,1,6000,0,6000,4911,1089
9/10/2021 21:20,8999999520878,WIPOL 240ML,1,5000,0,5000,4250,750
9/10/2021 21:20,8992736925134,SASA TEPUNG BUMBU SERBAGUNA,1,5500,0,5500,4700,800
9/10/2021 21:20,8991002103764,GOOD DAY CAPPUCINO 10X25G,5,1500,0,7500,6975,525
9/10/2021 21:20,8999999192150,ROYCO FDS CHICKEN 100GR,1,5000,0,5000,4300,700
9/10/2021 21:20,8992696521797,MILO 22G,9,2500,0,22500,14148,8352
9/10/2021 21:21,089686043273,INDOMIE SAMBAL RICA,1,2700,0,2700,2452,248
9/10/2021 21:25,8996001318980,BETTER 120G,1,6000,0,6000,5100,900
9/10/2021 21:25,8997028590052,ARGUS 600ML,1,3000,0,3000,1458,1542
9/10/2021 21:25,9556001047175,NESCAFE ORI 240ML,1,8500,0,8500,7834,666
9/10/2021 21:31,8992696521797,MILO 22G,2,2500,0,5000,3144,1856
9/10/2021 21:42,8996001305041,ROMA SANDWICH CKLT,2,7000,0,14000,11856,2144
9/10/2021 22:21,8996001305119,ARDEN 30G,1,2000,0,2000,1650,350
9/11/2021 9:30,089686535044,SUN BERAS MERAH,1,8500,0,8500,7410,1090
9/11/2021 10:11,roti,roti 2000,2,2000,0,4000,3600,400
9/11/2021 10:11,8995555121244,SOSIS KIMBO,1,1000,0,1000,650,350
9/11/2021 10:11,8992775001998 pcs,Gery Salut sandiwich pcs,1,1000,0,1000,815,185
9/11/2021 10:27,roti,roti 2000,2,2000,0,4000,3600,400
9/11/2021 10:30,roti,roti 2000,1,2000,0,2000,1800,200
9/11/2021 10:38,8999909010567,234 DJI SAM SOE 16,4,22500,0,90000,86000,4000
9/11/2021 11:00,8999999023997,CITRA BW FRESH WHITE 220ML,1,12000,0,12000,10700,1300
9/11/2021 11:00,8998866608404,Softener,1,5000,0,5000,4560,440
9/11/2021 11:07,8998866201469,POTABEE REGULER BBQ BEEF 68 GR,1,8000,0,8000,7200,800
9/11/2021 11:07,089686041705,INDOMIE GORENG JUMBO,1,3500,0,3500,3143,357
9/11/2021 11:07,8996001600146,TEH PUCUK HARUM 350ML,1,3000,0,3000,2314,686
9/11/2021 11:08,8991001121615,SILVERQUEEN NUT,1,15000,0,15000,13200,1800
9/11/2021 11:09,8998866605151,CLING HIJAU POUCH 425ML,1,4000,0,4000,3250,750
9/11/2021 11:21,8997878002088,Kiko,1,1000,0,1000,450,550
9/11/2021 11:26,8998989121163,SURYA PRO MERAH,1,22000,0,22000,20100,1900
9/11/2021 11:28,8999909982000,SAMPOERNA 12 FILTER,1,19000,0,19000,16600,2400
9/11/2021 11:54,8999909002821,MARLBORO BLACK 16,1,22000,0,22000,20850,1150
9/11/2021 11:55,MILKITA,MILKITA,4,250,0,1000,800,200
9/11/2021 11:59,8998009040023,TEH KOTAK,1,5000,0,5000,2827,2173
9/11/2021 12:21,8992775311615,CHOCOLATOS,1,12000,0,12000,9983,2017
9/11/2021 12:23,8992775311615,CHOCOLATOS,1,12000,0,12000,9983,2017
9/11/2021 12:23,8998866500517,BABY HAPPY PANTS L PCS,2,2000,0,4000,2860,1140
9/11/2021 12:31,8998866202602,KRISBEE FRENCH FRIES 18GR,4,2000,0,8000,6000,2000
9/11/2021 12:33,8992761139018,ADES 600ML,1,3500,0,3500,2166,1334
9/11/2021 12:33,YP,YUPI,6,250,0,1500,1248,252
9/11/2021 12:50,8998989300261,GUDANG GARAM SURYA 12 FILTER,1,20000,0,20000,18150,1850
9/11/2021 13:00,ARG,ARGUS 220ML,2,14500,0,29000,26600,2400
9/11/2021 13:00,8998989300261,GUDANG GARAM SURYA 12 FILTER,1,20000,0,20000,18150,1850
9/11/2021 13:06,PRG,PARAGO,4,500,0,2000,1600,400
9/11/2021 13:20,8999999030179,PEPSODENT ACTION 123 COMPLETE 75G,1,6700,0,6700,5170,1530
9/11/2021 13:20,8999999045913,LIFEBUOY MILDCARE 110GR,1,15000,0,15000,14245,755
9/11/2021 15:17,8995333000822,TERIGU KOMPAS SOFT 500GR,3,5500,0,16500,14901,1599
9/11/2021 15:18,8999909004221,SAMPOERNA ULTRAMILD 16,1,22000,0,22000,20350,1650
9/11/2021 15:35,8995555121244,SOSIS KIMBO,1,1000,0,1000,650,350
9/11/2021 16:08,8991001242013,Top,2,1000,0,2000,1000,1000
9/11/2021 16:08,8996001375372,CHOKI CHOKI,2,1000,0,2000,1820,180
9/11/2021 16:09,kentang,kripik kentang,1,1000,0,1000,900,100
9/11/2021 16:09,kentang,kripik kentang,1,1000,0,1000,900,100
9/11/2021 16:17,8995555121244,SOSIS KIMBO,1,1000,0,1000,650,350
9/11/2021 16:19,roti,roti 2000,1,2000,0,2000,1800,200
9/11/2021 16:43,8997878004327,gula-gula milkita,2,250,0,500,400,100
9/11/2021 17:24,8997003910684,2CS,1,3000,0,3000,1500,1500
9/11/2021 17:24,kentang,kripik kentang,2,1000,0,2000,1800,200
9/11/2021 17:31,8992775001998 pcs,Gery Salut sandiwich pcs,1,1000,0,1000,815,185
9/11/2021 17:54,8996001305119,ARDEN 30G,2,2000,0,4000,3300,700
9/11/2021 17:54,kentang,kripik kentang,1,1000,0,1000,900,100
9/11/2021 17:54,Vita Jelly,Vita Jelly,1,1000,0,1000,766,234
9/11/2021 17:54,8994834006128,TICTIC PEDAS,1,2000,0,2000,1700,300
9/11/2021 18:04,8998866200646,KOPI TOP MURNI,1,11000,0,11000,9600,1400
9/11/2021 18:06,Vita Jelly,Vita Jelly,1,1000,0,1000,766,234
9/11/2021 18:06,gg,gula-gula koin,2,500,0,1000,800,200
9/11/2021 18:20,089686041705,INDOMIE GORENG JUMBO,1,3500,0,3500,3143,357
9/11/2021 20:19,8999999524807,SUNLIGHT HABBATUSSAUDA POUCH 755ML,1,17000,0,17000,15400,1600
9/11/2021 20:20,8998989110167,SURYA GUDANG GARAM 16 FILTER,1,26000,0,26000,23700,2300
9/11/2021 20:21,8998866200578,MIE SEDAAP KARI KENTAL,2,2700,0,5400,4662,738
9/11/2021 20:21,8998866202343,MIE SEDAAP KOREAN SPICY,2,2700,0,5400,4826,574
9/11/2021 20:22,TBR,TEPUNG BERAS ROSE BRAND,1,8000,0,8000,5800,2200
9/11/2021 20:25,8992959071205,HN PANTS M20,1,32000,0,32000,29091,2909
9/11/2021 20:26,8934868015031,REXONA DEO LOTION ICE COOL,1,4500,0,4500,3900,600
9/11/2021 20:26,8992959117613,SFX DAUN SIRIH 1 WP,3,500,0,1500,1239,261
9/11/2021 20:27,Vita Jelly,Vita Jelly,2,1000,0,2000,1532,468
9/11/2021 20:28,8993470411433,JOGER CLASSIC,2,1000,0,2000,1700,300
9/11/2021 20:30,8998866202602,KRISBEE FRENCH FRIES 18GR,2,2000,0,4000,3000,1000
9/11/2021 20:30,CK,COOKIEZ,1,1000,0,1000,725,275
9/11/2021 20:35,8999908059802,MY BABY POWDER KUNING,1,5000,0,5000,3276,1724
9/11/2021 20:36,8998866105484,EMERON LOVELY MOISTURE&BRIGHT,1,4300,0,4300,3800,500
9/11/2021 20:40,8997240540019,tepun tapioka,1,11000,0,11000,9900,1100
9/11/2021 20:41,8992959953020,SWEETY BRONZE M1,1,3000,0,3000,2671,329
9/11/2021 20:42,gg,gula-gula koin,4,500,0,2000,1600,400
9/11/2021 21:07,8991102281416,PERMEN MINTZ PPMINT,1,5000,0,5000,4000,1000
9/11/2021 21:07,8991002330504,RELAXA MANGO MINT,1,5000,0,5000,4500,500
9/11/2021 21:07,8991102230308,BLASTER PINK,1,5000,0,5000,3106,1894
9/11/2021 21:22,8996001305119,ARDEN 30G,1,2000,0,2000,1650,350
9/12/2021 16:23,8995333060703,TERIGU KOMPAS 1KG,1,10500,0,10500,9816,684
9/12/2021 16:23,8998866501026,MINYAK GORENG SEDAAP POUCH 1 L,1,15000,0,15000,14110,890
9/12/2021 16:49,8998989300261,GUDANG GARAM SURYA 12 FILTER,1,20000,0,20000,18150,1850
9/12/2021 16:49,8991002103337,GOOD DAY VANILLA,2,1500,0,3000,1780,1220
9/12/2021 17:19,8998989110167,SURYA GUDANG GARAM 16 FILTER,1,26000,0,26000,23700,2300
9/12/2021 17:25,8999909096004,SAMPOERNA 16 FILTER,1,25000,0,25000,23100,1900
9/12/2021 17:27,8997009510055,YOU C1000,1,15000,0,15000,13000,2000
9/12/2021 17:39,8999999401238,RINSO ANTI NODA 770G,1,21200,0,21200,19338,1862
9/12/2021 17:43,8993083140041,BISKITOP CHOCOLATE,1,27000,0,27000,25200,1800
9/12/2021 17:43,KLOP,KLOP SALUTO,2,16000,0,32000,29090,2910
9/12/2021 17:44,8991102308823,KLOP COCONUT ORI,2,6000,0,12000,9938,2062
9/12/2021 17:44,8993083140041,BISKITOP CHOCOLATE,2,27000,0,54000,50400,3600
9/12/2021 18:06,8992628020152,BIMOLI POUCH 2L,1,31000,0,31000,29800,1200
9/12/2021 18:06,GL,GULA 1 LITER,1,11500,0,11500,10500,1000
9/12/2021 18:06,ARG,ARGUS 220ML,1,14500,0,14500,13300,1200
9/12/2021 18:06,ROTI,ROTI 2000,1,2000,0,2000,1800,200
9/12/2021 18:06,8886001038011,BENG-BENG SCT,2,1500,0,3000,2900,100
9/12/2021 18:06,JL,JELLY,2,500,0,1000,800,200
9/12/2021 18:06,8993470411433,JOGER CLASSIC,1,1000,0,1000,850,150
9/12/2021 18:06,8996001600146,TEH PUCUK HARUM 350ML,1,3000,0,3000,2314,686
9/12/2021 18:12,8995899210185,Mi Boncabe,1,3000,0,3000,3000,0
9/12/2021 18:12,8992761139018,ADES 600ML,1,3500,0,3500,2166,1334
9/12/2021 18:12,8998866202053,POTABEE AYAM BAKAR PEDAS 68GR,1,8000,0,8000,7200,800
9/12/2021 18:12,8886013213208,FRENCH FREIS 2000,1,5000,0,5000,3750,1250
9/12/2021 18:12,8996001375372,CHOKI CHOKI,2,1000,0,2000,1820,180
9/12/2021 18:12,8998866200325,MIE SEDAAP SOTO,1,2700,0,2700,2331,369
9/12/2021 18:12,8886001038011,BENG-BENG SCT,1,1500,0,1500,1450,50
9/12/2021 18:12,YP,YUPI,3,250,0,750,624,126
9/12/2021 18:12,8996001600146,TEH PUCUK HARUM 350ML,2,3000,0,6000,4628,1372
9/12/2021 18:18,8992696523081,MILO UHT 110ML,1,2500,0,2500,1962,538
9/12/2021 18:18,PRG,PARAGO,1,500,0,500,400,100
9/12/2021 18:18,roti,roti 2000,3,2000,0,6000,5400,600
9/12/2021 18:18,8998866200561,EKOMIE SUPER 600GR,1,10000,0,10000,8615,1385
9/12/2021 18:18,8998866202435,JAPOTA UMAMI JAPANESE SEAWEED 35GR,1,5000,0,5000,4150,850
9/12/2021 18:18,8995899210185,Mi Boncabe,1,3000,0,3000,3000,0
9/12/2021 18:18,jagung marning,jagung marning,1,5000,0,5000,4500,500
9/12/2021 18:18,ARG,ARGUS 220ML,1,14500,0,14500,13300,1200
9/12/2021 18:21,8992761111540,FANTA STRAWBERY SLIM CAM 250ML,1,5000,0,5000,3750,1250
9/12/2021 18:21,roti,roti 2000,1,2000,0,2000,1800,200
9/12/2021 18:48,8994867007161,ROKOK PENA GOLD 20,1,18000,0,18000,16800,1200
9/12/2021 19:04,8991909101016,URBAN MILD 16,1,17000,0,17000,15800,1200
9/12/2021 19:15,krupuk k,Krupuk Kentang,1,5000,0,5000,4500,500
9/12/2021 19:15,kentang,kripik kentang,1,1000,0,1000,900,100
9/12/2021 19:23,Vita Jelly,Vita Jelly,2,1000,0,2000,1532,468
9/12/2021 19:23,8996001305119,ARDEN 30G,2,2000,0,4000,3300,700
9/12/2021 19:31,8993989311699,CLAS MILD 16 FILTER,1,24000,0,24000,21700,2300
9/12/2021 19:31,6907992824963,JD MILKY CHOCOLATE,2,3000,0,6000,5200,800
9/12/2021 19:52,GL,GULA 1 LITER,1,11500,0,11500,10500,1000
9/12/2021 19:52,8997204370126,Siko,1,10000,0,10000,8333,1667
9/12/2021 20:10,GL,GULA 1 LITER,4,11500,0,46000,42000,4000
9/12/2021 20:28,8995150101696,M+SUSU ORIGINAL,1,5000,0,5000,4000,1000
9/12/2021 20:33,GGK,PLAYGUM PERMEN KARET,2,500,0,1000,800,200
9/12/2021 20:33,lolipop,lolipop,4,1000,0,4000,3400,600
9/12/2021 20:40,TELUR,TELUR,7,1428,0,9996,8400,1596
9/12/2021 21:41,8999909010567,234 DJI SAM SOE 16,1,22500,0,22500,21500,1000
9/12/2021 21:41,8997028590052,ARGUS 600ML,1,3000,0,3000,1458,1542
9/12/2021 21:41,089686021219,INTER MIE GORENG,5,1000,0,5000,4425,575
9/12/2021 21:43,ARG,ARGUS 220ML,1,14500,0,14500,13300,1200
9/12/2021 21:43,TELUR,TELUR,7,1428,0,9996,8400,1596
9/12/2021 21:43,8992761002022,SPRITE PET 390ML,1,5500,0,5500,4333,1167
9/12/2021 22:03,8992959953037,SWEETY BRONZE L1,2,2500,0,5000,3638,1362
9/12/2021 22:30,8992696521797,MILO 22G,2,2500,0,5000,3144,1856
9/13/2021 14:24,8992717900310,KARA SUN,2,2500,0,5000,4000,1000
9/13/2021 14:24,6907992823829,JD MILKY MILK,1,3000,0,3000,2600,400
9/13/2021 14:24,8996001600146,TEH PUCUK HARUM 350ML,1,3000,0,3000,2314,686
9/13/2021 14:47,ARG,ARGUS 220ML,2,14500,0,29000,26600,2400
9/13/2021 14:47,8997028590052,ARGUS 600ML,4,3000,0,12000,5832,6168
9/13/2021 14:47,8991102281416,PERMEN MINTZ PPMINT,1,5000,0,5000,4000,1000
9/13/2021 14:47,8996001314005,ROMA KELAPA CREAM CKLT,1,8000,0,8000,6642,1358
9/13/2021 14:47,8992775001844,Chocolatos original taste,3,1000,0,3000,2487,513
9/13/2021 14:47,8991102714846,MILKIDO CKLT,1,3000,0,3000,2153,847
9/13/2021 15:12,8998866605151,CLING HIJAU POUCH 425ML,1,4000,0,4000,3250,750
9/13/2021 15:12,9556001047175,NESCAFE ORI 240ML,1,8500,0,8500,7834,666
9/13/2021 15:12,8995555121244,SOSIS KIMBO,5,1000,0,5000,3250,1750
9/13/2021 15:12,8997027300089,NOMOS,1,4000,0,4000,2963,1037
9/13/2021 15:12,Vita Jelly,Vita Jelly,1,1000,0,1000,766,234
9/13/2021 15:12,8998866610438,SOKLIN SOFTERGENT RED BAG 770G & PIRING,1,18000,0,18000,16680,1320
9/13/2021 15:12,089686386127,BUMBU RACIK NASI GORENG SOSIS,1,2000,0,2000,1620,380
9/13/2021 15:12,8998866108003,EMERON HJB CLEANFRESH 10ML,1,5000,0,5000,4185,815
9/13/2021 15:12,8997003910684,2CS,2,3000,0,6000,3000,3000
9/13/2021 15:12,8992222050609,GATSBY ANTI KETOMBE 28ML,1,5500,0,5500,4000,1500
9/13/2021 15:12,8998866608459,POWDET DAIA PUTIH BAG 290GR,1,5000,0,5000,4450,550
9/13/2021 15:12,8994935000070,MINYAK GORENG DUNIA 450 ML,1,7500,0,7500,6779,721
9/13/2021 15:12,ROTI,ROTI 2000,3,2000,0,6000,5400,600
9/13/2021 15:12,8991002103238,GOOD DAY MOCACINNO,4,1500,0,6000,3560,2440
9/13/2021 15:12,8999999524807,SUNLIGHT HABBATUSSAUDA POUCH 755ML,1,17000,0,17000,15400,1600
9/13/2021 15:12,GL,GULA 1 LITER,1,11500,0,11500,10500,1000
9/13/2021 15:12,8997013790108,BIMURA KACANG TELUR 25G,3,1000,0,3000,2625,375
9/13/2021 15:12,8996001600146,TEH PUCUK HARUM 350ML,9,3000,0,27000,20826,6174
9/13/2021 15:12,8999999049461,REXONA WMN ROINVISIBLE DRY 45 ML,1,15000,0,15000,13550,1450
9/13/2021 15:12,8991909101016,URBAN MILD 16,1,17000,0,17000,15800,1200
9/13/2021 15:12,6907992823867,JD CRUNCHY CHOCOLATE MALT,1,5500,0,5500,4700,800
9/13/2021 15:12,6907992823843,JD MOCHA CRISPY,1,5000,0,5000,4400,600
9/13/2021 15:12,8993989311699,CLAS MILD 16 FILTER,1,24000,0,24000,21700,2300
9/13/2021 15:12,8998989300261,GUDANG GARAM SURYA 12 FILTER,1,20000,0,20000,18150,1850
9/13/2021 15:12,089686041705,INDOMIE GORENG JUMBO,2,3500,0,7000,6286,714
9/13/2021 15:12,8998866200578,MIE SEDAAP KARI KENTAL,2,2700,0,5400,4662,738
9/13/2021 15:57,8996001600146,TEH PUCUK HARUM 350ML,1,3000,0,3000,2314,686
9/13/2021 16:33,8992761166038,MMP ORANGE 300ML,1,5000,0,5000,3750,1250
9/13/2021 17:14,8998866200325,MIE SEDAAP SOTO,3,2700,0,8100,6993,1107
9/13/2021 17:43,BAYFLAST,BAYPLAST,1,500,0,500,350,150
9/13/2021 17:43,KIKO,KIKO,1,1000,0,1000,500,500
9/13/2021 17:43,6907992825076,JD WATERMELON APPLE,1,2000,0,2000,1700,300
9/13/2021 17:43,8996001600146,TEH PUCUK HARUM 350ML,1,3000,0,3000,2314,686
9/13/2021 18:28,ROTI,ROTI 2000,3,2000,0,6000,5400,600
9/13/2021 18:28,8997003910684,2CS,1,3000,0,3000,1500,1500
9/13/2021 20:02,8999999524807,SUNLIGHT HABBATUSSAUDA POUCH 755ML,1,17000,0,17000,15400,1600
9/13/2021 20:02,GL,GULA 1 LITER,1,11500,0,11500,10500,1000
9/13/2021 20:04,8991002121089,GOOD DAY ORI CAPPUCINO,1,6000,0,6000,4295,1705
9/13/2021 20:05,8996001600146,TEH PUCUK HARUM 350ML,2,3000,0,6000,4628,1372
9/13/2021 20:06,8999999047108,REXONA WMN RO ANTIBACTERIAL DEFENSE 45 ML,1,16500,0,16500,14900,1600
9/13/2021 20:07,8991909101016,URBAN MILD 16,1,17000,0,17000,15800,1200
9/13/2021 20:07,8993989311699,CLAS MILD 16 FILTER,1,24000,0,24000,21700,2300
9/13/2021 20:08,ARG,ARGUS 220ML,1,14500,0,14500,13300,1200
9/13/2021 20:10,Gula gula tusuk,gula gula tusuk,3,500,0,1500,1200,300
9/13/2021 20:11,8991102103091,Formula Proteksi,1,3500,0,3500,2650,850
9/13/2021 20:12,gula gula,gula-gula karet,2,500,0,1000,800,200
9/13/2021 20:13,8999999533717,CITRA TS FRESH WHITE 70G,1,2200,0,2200,1900,300
9/13/2021 20:13,8991102103091,Formula Proteksi,1,3500,0,3500,2650,850
9/13/2021 20:16,8997021290348,Teh Gunung Tengah,1,6000,0,6000,5000,1000
9/13/2021 20:27,8998866501026,MINYAK GORENG SEDAAP POUCH 1 L,1,15000,0,15000,14110,890
9/13/2021 20:27,8998866107068,Mama lemon 230 ml,1,4000,0,4000,3500,500
9/13/2021 20:27,8991002105430,KAPAL API 65G,1,5000,0,5000,4145,855
9/13/2021 20:27,8992770154026,SAJIKU SAYUR SOP,1,2500,0,2500,2000,500
9/13/2021 20:27,8994907000428,KECAP SACHET ABC,12,600,0,7200,6000,1200
9/13/2021 20:27,089686021219,INTER MIE GORENG,2,1000,0,2000,1770,230
9/13/2021 20:27,089686021127,INTER MIE KALDU,5,1000,0,5000,4065,935
9/13/2021 20:32,8995899210185,Mi Boncabe,1,3000,0,3000,3000,0
9/13/2021 20:32,089686014280,SUPERMI AYAM BAWANG,1,2500,0,2500,2312,188
9/13/2021 20:38,8998866200325,MIE SEDAAP SOTO,2,2700,0,5400,4662,738
9/13/2021 20:38,089686041705,INDOMIE GORENG JUMBO,2,3500,0,7000,6286,714
9/13/2021 20:38,TG,TEH GELAS,1,1000,0,1000,729,271
9/13/2021 20:42,8998989300261,GUDANG GARAM SURYA 12 FILTER,1,20000,0,20000,18150,1850
9/13/2021 20:52,8991102714846,MILKIDO CKLT,1,3000,0,3000,2153,847
9/13/2021 20:52,ROTI,ROTI 2000,1,2000,0,2000,1800,200
9/13/2021 20:53,8992775000663,GERY SNACK KEJU,1,2000,0,2000,1712,288
9/13/2021 20:54,8998866605144,CLING KUNING POUCH 425ML,1,4000,0,4000,3250,750
9/13/2021 20:55,9556001047175,NESCAFE ORI 240ML,1,8500,0,8500,7834,666
9/13/2021 20:55,8995555121244,SOSIS KIMBO,3,1000,0,3000,1950,1050
9/13/2021 20:56,8997027300089,NOMOS,1,4000,0,4000,2963,1037
9/13/2021 20:57,Vita Jelly,Vita Jelly,1,1000,0,1000,766,234
9/13/2021 20:58,8998866608558,SOKLIN SOFTERGENT BIRU 770G & PIRING,1,18000,0,18000,16055,1945
9/13/2021 20:58,roti,roti 2000,1,2000,0,2000,1800,200
9/13/2021 21:00,TG,TEH GELAS,1,1000,0,1000,729,271
9/13/2021 21:00,Garuda pilus pcs,Garuda pilus Rasa Mi Goreng pcs,1,1000,0,1000,808,192
9/13/2021 21:00,8992959117538,SFX COMFORT SLIM WING 20,1,12000,0,12000,10947,1053
9/13/2021 21:13,8992959508879,SWEETY SILVER PANTS L 7,1,16800,0,16800,15228,1572
9/13/2021 21:14,Telur 7 Biji,Telur 7 Biji,1,10000,0,10000,8400,1600
9/14/2021 10:46,8998866200646,KOPI TOP MURNI,1,11000,0,11000,9600,1400
9/14/2021 10:51,8992628020152,MINYAK GOREG BIMOLI POUCH 2L,2,32000,0,64000,59600,4400
9/14/2021 11:11,089686043204,INDOMIE MIE ACEH,1,2700,0,2700,2452,248
9/14/2021 11:11,8998866202770,MIE SEDAAP SALERO PADANG,1,2500,0,2500,2362,138
9/14/2021 12:00,8886467100017,pringles original,1,9000,0,9000,6333,2667
9/14/2021 12:00,8991002121089,GOOD DAY ORI CAPPUCINO,1,6000,0,6000,4295,1705
9/14/2021 12:00,8991001111883,SILVERQUEEN CHUNKYBAR 33G,1,8000,0,8000,7150,850
9/14/2021 12:15,089686060102,POP MIE PEDE GLEDEEK,1,5000,0,5000,4450,550
9/14/2021 12:15,8998866200844,NOODLE SEDAAP MIE KARI SPESIAL CUP 81 GR,3,4500,0,13500,10950,2550
9/14/2021 12:15,8995555121244,SOSIS KIMBO,4,1000,0,4000,2600,1400
9/14/2021 13:02,8992959953020,SWEETY BRONZE M1,2,3000,0,6000,5342,658
9/14/2021 13:14,8992775311615,CHOCOLATOS,1,12000,0,12000,9983,2017
9/14/2021 13:58,8998009040023,TEH KOTAK,1,5000,0,5000,2827,2173
9/14/2021 13:58,8998989300261,GUDANG GARAM SURYA 12 FILTER,1,20000,0,20000,18150,1850
9/14/2021 13:58,KIKO,KIKO,3,1000,0,3000,1500,1500
9/14/2021 15:32,8999999529840,CLEAR SHP SPR FRSH APPLE 9 AML,1,10500,0,10500,9300,1200
9/14/2021 15:32,8991001111883,SILVERQUEEN CHUNKYBAR 33G,1,8000,0,8000,7150,850
9/14/2021 16:04,8991102281416,PERMEN MINTZ PPMINT,1,5000,0,5000,4000,1000
9/14/2021 16:27,8992696523081,MILO UHT 110ML,4,2500,0,10000,7848,2152
9/14/2021 16:30,ARG,ARGUS 220ML,1,14500,0,14500,13300,1200
9/14/2021 16:30,8997013180053,Tissu Tessy,3,5000,0,15000,12000,3000
9/14/2021 16:30,8999999050009,SUNLIGHT LIME NEW POUCH 95ML,1,2000,0,2000,1600,400
9/14/2021 16:31,8997018250058,SUSU JAHE,8,1000,0,8000,6400,1600
9/14/2021 16:50,8998989500166,GUDANG GARAM MERAH BESAR 16KS,2,18000,0,36000,34000,2000
9/14/2021 16:50,089686010107,INDOMIE KALDU AYAM,4,2700,0,10800,8600,2200
9/14/2021 16:50,123124,KOREK BIASA,1,2000,0,2000,1300,700
9/14/2021 17:10,8993989311699,CLAS MILD 16 FILTER,1,24000,0,24000,21700,2300
9/14/2021 17:17,6907992823850,JD CHOCO CIRLE,1,5500,0,5500,4700,800
9/14/2021 17:17,8999908204202,MY BABY MINYAK TELON 60ML,1,18000,0,18000,16900,1100
9/14/2021 17:29,JGR SHN,JOGER SHINY SACHET,2,500,0,1000,874,126
9/14/2021 17:29,8997009510055,YOU C1000,1,15000,0,15000,13000,2000
9/14/2021 17:33,8999801700054,SUSU FOYU 1 KG,1,22000,0,22000,19791,2209
9/14/2021 17:44,711844110083,KECAP ABC 275 ML,1,15000,0,15000,14000,1000
9/14/2021 18:11,8992761139018,ADES 600ML,3,3500,0,10500,6498,4002
9/14/2021 18:11,8992775001691,GARUDA ROSTA WAGYU BEEF,1,8000,0,8000,7322,678
9/14/2021 18:11,8991102989381,TANGO LONG BUBBLEGUM 130G,1,5000,0,5000,4345,655
9/14/2021 18:11,8886013213208,FRENCH FREIS 2000,2,5000,0,10000,7500,2500
9/14/2021 18:16,ROTI,ROTI 2000,2,2000,0,4000,3600,400
9/14/2021 18:20,8992761166038,MMP ORANGE 300ML,1,5000,0,5000,3750,1250
9/14/2021 18:20,8992761139018,ADES 600ML,1,3500,0,3500,2166,1334
9/14/2021 18:22,8992702000063,INDOMILK COKLAT 370G,1,10000,0,10000,9020,980
9/14/2021 18:51,8994867007161,ROKOK PENA GOLD 20,1,18000,0,18000,16800,1200
9/14/2021 19:13,8995333032113,TERIGU GATOT KACA 1 KG,4,9000,0,36000,34288,1712
9/14/2021 19:21,8998866200578,MIE SEDAAP KARI KENTAL,1,2700,0,2700,2331,369
9/14/2021 19:21,8998866202343,MIE SEDAAP KOREAN SPICY,2,2700,0,5400,4826,574
9/14/2021 19:21,KIKO,KIKO,1,1000,0,1000,500,500
9/14/2021 19:28,089686048704,SARIMIE GORENG AYAM KCP ISI 2,2,3500,0,7000,6240,760
9/14/2021 19:28,089686043273,INDOMIE SAMBAL RICA,2,2700,0,5400,4904,496
9/14/2021 19:28,8992761139018,ADES 600ML,1,3500,0,3500,2166,1334
9/14/2021 19:29,BAYFLAST,BAYPLAST,8,500,0,4000,2800,1200
9/14/2021 21:04,089686010343,INDOMIE SOTO MIE,2,2600,0,5200,4734,466
9/14/2021 21:04,8998866200882,SUKSESMIE GORENG AYAM KRMS 133GR,1,3500,0,3500,3047,453
9/14/2021 22:33,8992761111533,SPRITE SLIM CAM250ML,2,5000,0,10000,7500,2500
9/14/2021 22:33,8998866619004,ROYALE SUNNY DAY,1,5000,0,5000,4560,440
9/14/2021 22:33,089686386127,BUMBU RACIK NASI GORENG SOSIS,1,2000,0,2000,1620,380
9/14/2021 22:33,8995102703138,bumbu sop,1,500,0,500,450,50
9/14/2021 22:33,8997028590052,ARGUS 600ML,1,3000,0,3000,1458,1542
9/14/2021 22:33,ROTI,ROTI 2000,1,2000,0,2000,1800,200
9/14/2021 22:33,8994075230870,momogi,2,500,0,1000,900,100
9/14/2021 22:33,Vita Jelly,Vita Jelly,2,1000,0,2000,1532,468
9/14/2021 22:33,8999999195649,SARI WANGI 25X1.86G,1,6000,0,6000,5050,950
9/14/2021 22:33,SURYA,SURYA,3,500,0,1500,1500,0
9/14/2021 22:33,milkita,milkita,1,500,0,500,370,130
9/14/2021 22:33,8998866604963,POWDET DAIA LEMON 290GR,1,5000,0,5000,4450,550
9/14/2021 22:33,8998989500166,GUDANG GARAM MERAH BESAR 16KS,1,18000,0,18000,17000,1000
9/14/2021 22:33,8995555171225,KIMBO SOSIS,1,1000,0,1000,900,100
9/14/2021 22:33,0105312686040047,yakult,2,2000,0,4000,3000,1000
9/14/2021 22:33,8998866202602,KRISBEE FRENCH FRIES 18GR,2,2000,0,4000,3000,1000
9/14/2021 22:33,6907992825069,JD FRUITY,1,5000,0,5000,4400,600
9/14/2021 22:33,8992959117583,SFX DS REG FLOW WING 20,1,5000,0,5000,4288,712
9/14/2021 22:33,8993989311699,CLAS MILD 16 FILTER,1,24000,0,24000,21700,2300
9/14/2021 22:33,8995102703534,TERASI DUO 6 GR,1,4000,0,4000,3720,280
9/14/2021 22:33,6907992825076,JD WATERMELON APPLE,3,2000,0,6000,5100,900
9/15/2021 9:43,PULPEN SNOWMAN,PULPEN SNOWMAN,1,2500,0,2500,2000,500
9/15/2021 9:43,8999988778846,LASEGAR,1,6500,0,6500,5700,800
9/15/2021 9:43,8996001600146,TEH PUCUK HARUM 350ML,1,3000,0,3000,2314,686
9/15/2021 9:43,6907992823973,JD PINEAPPLE,1,5000,0,5000,4300,700
9/15/2021 9:43,8998866105651,EMERON LOVELY NOUR&BRIGHT 200ML,1,7500,0,7500,6475,1025
9/15/2021 9:44,8997028590014,ARGUS 220ML,2,500,0,1000,604,396
9/15/2021 9:49,PULPEN SNOWMAN,PULPEN SNOWMAN,1,2500,0,2500,2000,500
9/15/2021 9:54,PULPEN SNOWMAN,PULPEN SNOWMAN,1,2500,0,2500,2000,500
9/15/2021 10:00,PULPEN SNOWMAN,PULPEN SNOWMAN,2,2500,0,5000,4000,1000
9/15/2021 10:01,8997028590014,ARGUS 220ML,2,500,0,1000,604,396
9/15/2021 10:01,8992775311325,GERY SNACK&SEREAL 100G,1,7000,0,7000,6012,988
9/15/2021 10:05,BAYFLAST,BAYPLAST,2,500,0,1000,700,300
9/15/2021 10:05,VTM,VITAMIN CIMIN,2,500,0,1000,850,150
9/15/2021 10:06,8998866601429,POWDET DAIA BUNGA BAG 290GR,1,5000,0,5000,4450,550
9/15/2021 10:15,8991102987875,WFR TANGO POUCH CKL 115G,1,8000,0,8000,6786,1214
9/15/2021 10:15,8992761166038,MMP ORANGE 300ML,2,5000,0,10000,7500,2500
9/15/2021 10:31,GL,GULA 1 LITER,4,11500,0,46000,42000,4000
9/15/2021 10:41,8998989300261,GUDANG GARAM SURYA 12 FILTER,1,20000,0,20000,18150,1850
9/15/2021 10:45,8992761166038,MMP ORANGE 300ML,1,5000,0,5000,3750,1250
9/15/2021 11:04,8997028590045,ARGUS 330ML,1,2000,0,2000,1291,709
9/15/2021 11:04,8999909096004,SAMPOERNA 16 FILTER,1,25000,0,25000,23100,1900
9/15/2021 11:29,kri,kripik pisang,1,5000,0,5000,4000,1000
9/15/2021 11:32,8993007000024,INDOMILK UHT VANILA,1,5000,0,5000,3470,1530
9/15/2021 11:32,BALON,BALON CABUT,1,1000,0,1000,900,100
9/15/2021 11:32,Gula gula tusuk,gula gula tusuk,1,500,0,500,400,100
9/15/2021 11:32,KOPIKO,KOPIKO,12,250,0,3000,2100,900
9/15/2021 11:32,YP,YUPI,2,250,0,500,416,84
9/15/2021 12:14,123124,KOREK BIASA,1,2000,0,2000,1300,700
9/15/2021 12:14,8991909101016,URBAN MILD 16,1,17000,0,17000,15800,1200
9/15/2021 12:14,KOPIKO,KOPIKO,4,250,0,1000,700,300
9/15/2021 12:24,8992761002039,FANTA STRAWBERRY PET 390 ML,1,5500,0,5500,4333,1167
9/15/2021 12:28,8991102228053,TEH GELAS BOTOL,1,3000,0,3000,1695,1305
9/15/2021 12:28,ARG,ARGUS 220ML,1,14500,0,14500,13300,1200
9/15/2021 12:38,ARG,ARGUS 220ML,1,14500,0,14500,13300,1200
9/15/2021 12:44,8993989311699,CLAS MILD 16 FILTER,1,24000,0,24000,21700,2300
9/15/2021 12:44,6907992823904,JD CRUNCHY CHOCOLATE VAN,1,8000,0,8000,6800,1200
9/15/2021 12:44,6907992823911,JD CRUNCHY HONEYDEW MELON,1,8000,0,8000,6800,1200
9/15/2021 12:44,8995555121244,SOSIS KIMBO,3,1000,0,3000,1950,1050
9/15/2021 12:51,8991102300544,WFR TANGO VNL 176G,1,10000,0,10000,8694,1306
9/15/2021 12:51,8997028590045,ARGUS 330ML,3,2000,0,6000,3873,2127
9/15/2021 13:10,8997028590014,ARGUS 220ML,1,500,0,500,302,198
9/15/2021 13:25,8997009510055,YOU C1000,2,15000,0,30000,26000,4000
9/15/2021 13:25,8998009010569,ULTRA CHO 200,2,5000,0,10000,7660,2340
9/15/2021 13:25,8997003910684,2CS,2,3000,0,6000,3000,3000
9/15/2021 13:25,8999909096004,SAMPOERNA 16 FILTER,1,25000,0,25000,23100,1900
9/15/2021 13:25,123124,KOREK BIASA,1,2000,0,2000,1300,700
9/15/2021 13:26,8999909001909,MAGNUM REVAMP BLACK 12,1,18000,0,18000,16300,1700
9/15/2021 13:32,8993470672858,SAKU-SAKU RASA BALADO,2,2000,0,4000,3060,940
9/15/2021 13:32,8997028590045,ARGUS 330ML,1,2000,0,2000,1291,709
9/15/2021 13:39,8998866202060,POTABEE AYAM BAKAR PEDAS 35 GR,1,5000,0,5000,4150,850
9/15/2021 13:39,8991001502933,CHACHA TUBE,1,7500,0,7500,6400,1100
9/15/2021 14:46,8997028590052,ARGUS 600ML,2,3000,0,6000,2916,3084
9/15/2021 15:02,8998989300261,GUDANG GARAM SURYA 12 FILTER,1,20000,0,20000,18150,1850
9/15/2021 15:18,8997028590045,ARGUS 330ML,1,2000,0,2000,1291,709
9/15/2021 15:18,8997028590052,ARGUS 600ML,1,3000,0,3000,1458,1542
9/15/2021 15:18,9556001025272,NESCAFE LATTE 240ML,1,8500,0,8500,7834,666
9/15/2021 15:18,8998866200851,NOODLE SEDAAP MIE BAKSO SPESIAL CUP 77 GR,1,4500,0,4500,3738,762
9/15/2021 15:18,8886013213208,FRENCH FREIS 2000,1,5000,0,5000,3750,1250
9/15/2021 15:34,8992761122331,FRESTEA APPEL 500ML,1,6500,0,6500,4791,1709
9/15/2021 17:32,TORT,TORTILA,1,1000,0,1000,1000,0
9/15/2021 19:23,8997028590045,ARGUS 330ML,1,2000,0,2000,1291,709
9/15/2021 19:23,8997028590014,ARGUS 220ML,4,500,0,2000,1208,792
9/15/2021 19:23,8996001318980,BETTER 120G,1,6000,0,6000,5100,900
9/15/2021 19:23,8992957220087,COKLAT SINGA,1,2000,0,2000,1700,300
9/15/2021 19:23,GGK,PLAYGUM PERMEN KARET,4,500,0,2000,1600,400
9/15/2021 19:23,JGR SHN,JOGER SHINY SACHET,4,500,0,2000,1748,252
9/15/2021 19:23,8992957220063,COKLAT BANGO,1,2000,0,2000,1700,300
9/15/2021 19:24,8998898101409,TOLAK ANGIN SIDOMUNCUL,2,3500,0,7000,5416,1584
9/15/2021 19:24,8997009510055,YOU C1000,1,15000,0,15000,13000,2000
9/15/2021 19:24,KP,KERIPIK PISANG,1,5000,0,5000,5000,0
9/15/2021 19:24,ROTI,ROTI 2000,1,2000,0,2000,1800,200
9/15/2021 19:47,8998989300261,GUDANG GARAM SURYA 12 FILTER,1,20000,0,20000,18150,1850
9/15/2021 19:47,8994867000162,ROKOK PUNDIMAS KRETEK16,1,10000,0,10000,8600,1400
9/15/2021 19:53,8992775110157,GARUDA KACANG KULIT,2,5000,0,10000,7850,2150
9/15/2021 19:56,ROTI,ROTI 2000,2,2000,0,4000,3600,400
9/15/2021 20:19,9556001047175,NESCAFE ORI 240ML,1,8500,0,8500,7834,666
9/15/2021 20:19,9556001025272,NESCAFE LATTE 240ML,1,8500,0,8500,7834,666
9/15/2021 20:19,8998009040023,TEH KOTAK,1,5000,0,5000,2827,2173
9/15/2021 20:19,TG,TEH GELAS,4,1000,0,4000,2916,1084
9/15/2021 20:59,8999909001909,MAGNUM REVAMP BLACK 12,1,18000,0,18000,16300,1700
9/15/2021 20:59,Gula gula tusuk,gula gula tusuk,2,500,0,1000,800,200
9/15/2021 20:59,8999909002821,MARLBORO BLACK 16,1,22000,0,22000,20850,1150
9/15/2021 21:00,8998866605779,RAPIKA BIANG BIRU 250MLBTL,1,8500,0,8500,7650,850
9/15/2021 22:03,8992761166205,FRESTEA GREEN HONEY 350ML,1,4500,0,4500,3000,1500
9/15/2021 22:10,8992696521797,MILO 22G,2,2500,0,5000,3144,1856
9/15/2021 22:14,089686021219,INTER MIE GORENG,2,1000,0,2000,1770,230
9/15/2021 22:47,8992775318201,GERY SNACK BANTAL COKLAT,1,2000,0,2000,1712,288
9/15/2021 22:47,8995555171225,KIMBO SOSIS,1,1000,0,1000,900,100
9/15/2021 22:47,8999999706081,PEPSODENT WHITE 75G,1,5000,0,5000,3850,1150
9/15/2021 22:47,8999999533731,CITRA TS NATURE WHITE 70G,1,2200,0,2200,1900,300
9/15/2021 22:47,8998866200325,MIE SEDAAP SOTO,1,2700,0,2700,2331,369
9/15/2021 22:47,ROTI,ROTI 2000,4,2000,0,8000,7200,800
9/15/2021 22:47,8997028590045,ARGUS 330ML,4,2000,0,8000,5164,2836
9/15/2021 22:47,jagung marning,jagung marning,1,5000,0,5000,4500,500
9/15/2021 22:47,8997028590052,ARGUS 600ML,2,3000,0,6000,2916,3084
9/15/2021 22:47,8996001305041,ROMA SANDWICH CKLT,2,7000,0,14000,11856,2144
9/15/2021 22:47,8997025914059,HATARI SEE HONG,1,6000,0,6000,4911,1089
9/15/2021 22:47,8999999037765,pepsodent 225 gr,1,12000,0,12000,10500,1500
9/15/2021 22:47,8999999707859,CLOSEUP GREEN 160G,1,15000,0,15000,13600,1400
9/15/2021 22:47,8999999533717,CITRA TS FRESH WHITE 70G,2,2200,0,4400,3800,600
9/15/2021 22:47,8999999529840,CLEAR SHP SPR FRSH APPLE 9 AML,1,10500,0,10500,9300,1200
9/15/2021 22:47,8992761111533,SPRITE SLIM CAM250ML,2,5000,0,10000,7500,2500
9/15/2021 22:47,8991102281430,PERMEN MINTZ DUOMINT,1,5000,0,5000,4000,1000
9/15/2021 22:47,TUSTEL,TUSUK TELINGA,1,1000,0,1000,833,167
9/15/2021 22:47,8996001440001,TB JAHE SUSU,10,1500,0,15000,8700,6300
9/15/2021 22:47,8992696523067,MILO ACTVGO UHT 180ML,2,5000,0,10000,7030,2970
9/15/2021 22:47,8992775214008,Garuda Kacang Atom,2,1000,0,2000,1620,380
9/15/2021 22:47,8992761166038,MMP ORANGE 300ML,1,5000,0,5000,3750,1250
9/15/2021 22:47,6907992823911,JD CRUNCHY HONEYDEW MELON,1,8000,0,8000,6800,1200
9/15/2021 22:47,6907992823829,JD MILKY MILK,1,3000,0,3000,2600,400
9/15/2021 22:47,8991102320184,TANGO CHOCO JAVAMOCCA,1,5000,0,5000,4330,670
9/15/2021 22:47,8992730002992,HAI CANDY,1,7000,0,7000,6000,1000
9/15/2021 22:47,6907992823652,JD CHOCOLATE MILKSHAKE,1,6000,0,6000,5200,800
9/15/2021 22:47,6907992823669,JD MILKY STRAW,1,3000,0,3000,2600,400
9/15/2021 22:47,8995555121244,SOSIS KIMBO,1,1000,0,1000,650,350
9/15/2021 22:47,ARG,ARGUS 220ML,1,14500,0,14500,13300,1200
9/15/2021 22:47,896867700494,AIR CLUB 1500ML,1,5000,0,5000,2987,2013
9/15/2021 22:47,8991909101016,URBAN MILD 16,1,17000,0,17000,15800,1200
9/15/2021 22:47,123124,KOREK BIASA,1,2000,0,2000,1300,700
9/15/2021 22:47,Gula gula tusuk,gula gula tusuk,2,500,0,1000,800,200
9/16/2021 11:16,8996001305119,ARDEN 30G,1,2000,0,2000,1650,350
9/16/2021 11:16,8995555121244,SOSIS KIMBO,3,1000,0,3000,1950,1050
9/16/2021 11:16,8992775318201,GERY SNACK BANTAL COKLAT,1,2000,0,2000,1712,288
9/16/2021 11:16,ROTI,ROTI 2000,1,2000,0,2000,1800,200
9/16/2021 11:16,8991001503336,chacha minis hat,1,7500,0,7500,6400,1100
9/16/2021 11:16,8992775511206,LEO 10GR,2,1000,0,2000,1696,304
9/16/2021 11:16,089686017748,SARIMIE GORENG ISI 2,1,3500,0,3500,3120,380
9/16/2021 11:16,8997009510123,ORANGE WATER,1,11000,0,11000,10416,584
9/16/2021 11:16,8997028590052,ARGUS 600ML,1,3000,0,3000,1458,1542
9/16/2021 11:16,8999988778846,LASEGAR,1,6500,0,6500,5700,800
9/16/2021 11:16,8997028590045,ARGUS 330ML,1,2000,0,2000,1291,709
9/16/2021 11:16,8993274532105,BOLU,1,1000,0,1000,833,167
9/16/2021 11:16,8995333060703,TERIGU KOMPAS 1KG,1,10500,0,10500,9816,684
9/16/2021 11:16,8999801700054,SUSU FOYU 1 KG,1,22000,0,22000,19791,2209
9/16/2021 11:16,ARG,ARGUS 220ML,1,14500,0,14500,13300,1200
9/16/2021 11:16,0105312686040047,yakult,1,2000,0,2000,1500,500
9/16/2021 11:43,8992716109172,BISKUAT BOLU SCT,1,2000,0,2000,1641,359
9/16/2021 11:43,7622300335809,OREO SOFT CAKE,1,2000,0,2000,1641,359
9/16/2021 11:43,ROTI,ROTI 2000,1,2000,0,2000,1800,200
9/16/2021 11:43,8995077609985,Tortilla,1,1000,0,1000,850,150
9/16/2021 11:43,8997028590052,ARGUS BTL 600ML,1,3000,0,3000,1458,1542
9/16/2021 11:46,8998866606158,NUVO ACTIVE COOL 110G,1,3000,0,3000,2600,400
9/16/2021 11:46,8998866602563,NUVO FAMILY HIJAU 76G,1,2000,0,2000,1820,180
9/16/2021 11:46,8991102020305,FORMULA TRIPLE ACTION,1,3000,0,3000,2500,500
9/16/2021 12:15,8995333000822,TERIGU KOMPAS SOFT 500GR,1,5500,0,5500,4967,533
9/16/2021 12:15,8996001305119,ARDEN 30G,2,2000,0,4000,3300,700
9/16/2021 12:21,8992628020152,MINYAK GOREG BIMOLI POUCH 2L,1,32000,0,32000,29800,2200
9/16/2021 12:21,8999999049447,REXONA WMN RO ADVANCED WHITE 45 ML,1,16500,0,16500,14900,1600
9/16/2021 12:21,8999999053031,PONDS WHITE BEAUTY FACIAL FOAM100G,1,26000,0,26000,23700,2300
9/16/2021 12:22,8995333060703,TERIGU KOMPAS 1KG,2,10500,0,21000,19632,1368
9/16/2021 12:23,8999999003074,VASELINE ALOE SOOTHE,1,13200,0,13200,11805,1395
9/16/2021 12:30,Telur 3 Biji,Telur 3 Biji,1,5000,0,5000,3600,1400
9/16/2021 12:30,089686021141,INTER MIE SOTO,2,1000,0,2000,1708,292
9/16/2021 12:31,BAYFLAST,BAYPLAST,2,500,0,1000,700,300
9/16/2021 13:19,RB,RED BOLD,1,20000,0,20000,18800,1200
9/16/2021 13:23,8998989300261,GUDANG GARAM SURYA 12 FILTER,1,20000,0,20000,18150,1850
9/16/2021 13:50,8991002105430,KAPAL API 65G,1,5000,0,5000,4145,855
9/16/2021 14:08,8992761139018,ADES 600ML,1,3500,0,3500,2166,1334
9/16/2021 14:08,8995555171225,KIMBO SOSIS,1,1000,0,1000,900,100
9/16/2021 14:08,MILKITA,MILKITA,2,250,0,500,400,100
9/16/2021 14:21,8992628020152,MINYAK GOREG BIMOLI POUCH 2L,1,32000,0,32000,29800,2200
9/16/2021 14:21,8999999516208,ROYCO FDS CHICKEN NEW 230G,1,10000,0,10000,9000,1000
9/16/2021 14:21,8992696405417,DNCO INSTANT 27G,4,3500,0,14000,12000,2000
9/16/2021 14:34,8992761139018,ADES 600ML,2,3500,0,7000,4332,2668
9/16/2021 14:34,TG,TEH GELAS,5,1000,0,5000,3645,1355
9/16/2021 14:34,8997028590014,ARGUS 220ML,6,500,0,3000,1812,1188
9/16/2021 16:04,089686727081,DORITOS 55G,1,7000,0,7000,5950,1050
9/16/2021 16:04,8992957220025,GOLDEN CITY MINI,1,3000,0,3000,2500,500
9/16/2021 16:04,8997218380135,ICHITAN GREEN TEA,1,8000,0,8000,6583,1417
9/16/2021 16:05,8992388133017,NU MILK TEA ORI 330ML,1,6000,0,6000,5125,875
9/16/2021 16:05,8992775311325,GERY SNACK&SEREAL 100G,1,7000,0,7000,6012,988
9/16/2021 16:05,YP,YUPI,8,250,0,2000,1664,336
9/16/2021 16:06,089686727081,DORITOS 55G,1,7000,0,7000,5950,1050
9/16/2021 16:06,8992957220025,GOLDEN CITY MINI,1,3000,0,3000,2500,500
9/16/2021 16:06,089686611618,QTELA BARBEQUE,1,5000,0,5000,4266,734
9/16/2021 16:06,8991102714495,TANGO DRINK COKLAT,1,5000,0,5000,3818,1182
9/16/2021 16:06,9556001047175,NESCAFE ORI 240ML,1,8500,0,8500,7834,666
9/16/2021 16:07,8999999559861,AXE DARK POCKET FRAG 17ML,1,10000,0,10000,8000,2000
9/16/2021 16:08,Telur 3 Biji,Telur 3 Biji,1,5000,0,5000,3600,1400
9/16/2021 16:08,089686010343,INDOMIE SOTO MIE,1,2600,0,2600,2367,233
9/16/2021 16:15,8999909096004,SAMPOERNA 16 FILTER,1,25000,0,25000,23100,1900
9/16/2021 16:53,8998989300261,GUDANG GARAM SURYA 12 FILTER,1,20000,0,20000,18150,1850
9/16/2021 16:55,8999999706180,PEPSODENT WHITE 190GR,1,10000,0,10000,9350,650
9/16/2021 16:55,8998866602570,NUVO FAMILY KUNING 76G,1,2000,0,2000,1820,180
9/16/2021 16:55,8998866618144,NUVO FAMILY UNGU 76G,1,2000,0,2000,1880,120
9/16/2021 16:55,8998866618199,NUVO FAMILY TOSKA 76G,1,2000,0,2000,1880,120
9/16/2021 17:24,8998866201728,POTABEE SELECTION SALTED EGG 68G,1,8000,0,8000,7200,800
9/16/2021 17:24,8886013257400,TWISTKO,1,1000,0,1000,900,100
9/16/2021 17:24,Vita Jelly,Vita Jelly,2,1000,0,2000,1532,468
9/16/2021 17:40,8999909010567,234 DJI SAM SOE 16,2,22500,0,45000,43000,2000
9/16/2021 17:46,8995150101696,M+SUSU ORIGINAL,1,5000,0,5000,4000,1000
9/16/2021 17:48,8991102024099,FORMULA CURVE,1,5000,0,5000,3000,2000
9/16/2021 17:48,8999999525590,PEPSODENT TB KIDS,1,12900,0,12900,11700,1200
9/16/2021 17:48,8999999710873,PEPSODENT ACTION123 HERBAL 120G,1,11400,0,11400,10400,1000
9/16/2021 17:48,8997028590052,ARGUS BTL 600ML,2,3000,0,6000,2916,3084
9/16/2021 17:48,ROTI,ROTI 2000,5,2000,0,10000,9000,1000
9/16/2021 18:00,ARG 330,ARGUS DOS 330ML,1,35000,0,35000,31000,4000
9/16/2021 18:36,ARG,ARGUS DOS 220ML,1,14500,0,14500,13300,1200
9/16/2021 18:36,089686611670,QTELA BALADO,1,5000,0,5000,4266,734
9/16/2021 18:36,8992959953310,SWEETY BRONZE M58,1,85000,0,85000,80304,4696
9/16/2021 19:17,896867700494,AIR CLUB 1500ML,3,5000,0,15000,8961,6039
9/16/2021 19:21,KIKO,KIKO,1,1000,0,1000,500,500
9/16/2021 19:23,MARS,MARSHMELLOW,2,500,0,1000,866,134
9/16/2021 19:24,896867700494,AIR CLUB 1500ML,3,5000,0,15000,8961,6039
9/16/2021 19:24,8998989110167,SURYA GUDANG GARAM 16 FILTER,1,26000,0,26000,23700,2300
9/16/2021 19:31,8995333060703,TERIGU KOMPAS 1KG,1,10500,0,10500,9816,684
9/16/2021 19:31,KOPIKO,KOPIKO,2,250,0,500,350,150
9/16/2021 20:33,8994867007161,ROKOK PENA GOLD 20,1,18000,0,18000,16800,1200
9/16/2021 20:40,8992696521797,MILO 22G,1,2500,0,2500,1572,928
9/16/2021 20:40,8997025911058,HATARI SHP KELAPA,1,6000,0,6000,4911,1089
9/16/2021 20:44,SMBL,SAMBAL ABC BLINK 335 ML,1,14000,0,14000,12550,1450
9/16/2021 20:44,0105312686040047,yakult,2,2000,0,4000,3000,1000
9/16/2021 20:44,COKLAT,COKLAT COIN,2,500,0,1000,850,150
9/16/2021 20:59,ROTI,ROTI 2000,1,2000,0,2000,1800,200
9/16/2021 20:59,8998866202602,KRISBEE FRENCH FRIES 18GR,1,2000,0,2000,1500,500
9/16/2021 21:00,MILKITA,MILKITA,2,250,0,500,400,100
9/16/2021 21:00,TELUR RAK,TELUR RAK,1,39000,0,39000,36000,3000
9/16/2021 21:03,8991909101016,URBAN MILD 16,1,17000,0,17000,15800,1200
9/16/2021 21:03,8999909002821,MARLBORO BLACK 16,1,22000,0,22000,20850,1150
9/16/2021 21:10,8996001318980,BETTER 120G,1,6000,0,6000,5100,900
9/16/2021 21:19,ROTI,ROTI 2000,1,2000,0,2000,1800,200
9/16/2021 21:19,8992716109172,BISKUAT BOLU SCT,1,2000,0,2000,1641,359
9/16/2021 21:19,8886001038011,BENG-BENG SCT,1,1500,0,1500,1450,50
9/16/2021 21:47,089686821086,ICHI OCHA MELATI,1,3000,0,3000,2250,750
9/16/2021 22:17,8998989500166,GUDANG GARAM MERAH BESAR 16KS,2,18000,0,36000,34000,2000
9/17/2021 10:15,8995555121244,SOSIS KIMBO,1,1000,0,1000,650,350
9/17/2021 10:15,OJELLY,O'JELLY,4,500,0,2000,1540,460
9/17/2021 10:15,8998989300261,GUDANG GARAM SURYA 12 FILTER,2,20000,0,40000,36300,3700
9/17/2021 10:15,8996001318980,BETTER 120G,1,6000,0,6000,5100,900
9/17/2021 10:15,8997028590045,ARGUS BTL 330ML,1,2000,0,2000,1291,709
9/17/2021 10:15,ROTI,ROTI 2000,1,2000,0,2000,1800,200
9/17/2021 10:15,8992761139018,ADES 600ML,2,3500,0,7000,4332,2668
9/17/2021 10:57,ARG,ARGUS DOS 220ML,1,14500,0,14500,13300,1200
9/17/2021 11:06,8997011700123,BIHUN JAGUNG 300GR,1,6000,0,6000,4979,1021
9/17/2021 11:06,ARG,ARGUS DOS 220ML,1,14500,0,14500,13300,1200
9/17/2021 11:06,Gula gula tusuk,gula gula tusuk,1,500,0,500,400,100
9/17/2021 11:18,8997003910684,2CS,2,3000,0,6000,3000,3000
9/17/2021 11:18,8997028590052,ARGUS BTL 600ML,1,3000,0,3000,1458,1542
9/17/2021 11:18,8997028590045,ARGUS BTL 330ML,1,2000,0,2000,1291,709
9/17/2021 11:18,8998866610087,JAVANA ORIGINAL 350ML,1,3000,0,3000,2150,850
9/17/2021 11:24,8991002121089,GOOD DAY ORI CAPPUCINO,1,6000,0,6000,4295,1705
9/17/2021 11:38,8997009510123,ORANGE WATER,1,11000,0,11000,10416,584
9/17/2021 11:38,8998866200301,MIE SEDAAP GORENG,1,2700,0,2700,2363,337
9/17/2021 11:38,8998866200844,NOODLE SEDAAP MIE KARI SPESIAL CUP 81 GR,2,4500,0,9000,7300,1700
9/17/2021 11:38,8997013790092,BIMURA KERUPUK BAWANG 25G,2,1000,0,2000,1748,252
9/17/2021 11:43,KIKO,KIKO,4,1000,0,4000,2000,2000
9/17/2021 12:14,8998866200578,MIE SEDAAP KARI KENTAL,2,2700,0,5400,4662,738
9/17/2021 12:14,8998866200301,MIE SEDAAP GORENG,2,2700,0,5400,4726,674
9/17/2021 12:14,8991102228053,TEH GELAS BOTOL,1,3000,0,3000,1695,1305
9/17/2021 12:39,ROTI,ROTI 2000,2,2000,0,4000,3600,400
9/17/2021 12:51,8993496107549,MINYAK SIIP 1800 ML,1,28000,0,28000,25399,2601
9/17/2021 12:51,8996001318980,BETTER 120G,1,6000,0,6000,5100,900
9/17/2021 12:51,YP,YUPI,4,250,0,1000,832,168
9/17/2021 13:15,8998866202923,FLORIDINA COCO,1,3000,0,3000,2500,500
9/17/2021 13:15,8992761166038,MMP ORANGE 300ML,1,5000,0,5000,3750,1250
9/17/2021 13:15,8999999519872,DOVE DEO WMN RO POMEGRANATE 40 ML,1,16500,0,16500,15000,1500
9/17/2021 14:01,8992761122331,FRESTEA APPEL 500ML,1,6500,0,6500,4791,1709
9/17/2021 14:12,6907992825076,JD WATERMELON APPLE,2,2000,0,4000,3400,600
9/17/2021 14:28,8998866501026,MINYAK GORENG SEDAAP POUCH 1 L,2,15500,0,31000,28220,2780
9/17/2021 14:28,8998989110167,SURYA GUDANG GARAM 16 FILTER,1,26000,0,26000,23700,2300
9/17/2021 15:16,8999908059802,MY BABY POWDER KUNING,1,5000,0,5000,3276,1724
9/17/2021 16:05,8991102022460,FORMULA DIAMOND,1,3000,0,3000,2500,500
9/17/2021 16:35,8994867000179,ROKOK PENA MILD 16,2,14500,0,29000,27000,2000
9/17/2021 17:15,8998866200578,MIE SEDAAP KARI KENTAL,2,2700,0,5400,4662,738
9/17/2021 17:15,8991102228053,TEH GELAS BOTOL,1,3000,0,3000,1695,1305
9/17/2021 17:15,6907992823843,JD MOCHA CRISPY,1,5000,0,5000,4400,600
9/17/2021 17:15,6907992824963,JD MILKY CHOCOLATE,1,3000,0,3000,2600,400
9/17/2021 17:15,8991001111883,SILVERQUEEN CHUNKYBAR 33G,1,8000,0,8000,7150,850
9/17/2021 17:15,ROTI,ROTI 2000,2,2000,0,4000,3600,400
9/17/2021 17:25,6907992823966,JD BLUEBERRY,2,3500,0,7000,6000,1000
9/17/2021 17:28,KIKO,KIKO,2,1000,0,2000,1000,1000
9/17/2021 17:28,GGK,PLAYGUM PERMEN KARET,4,500,0,2000,1600,400
9/17/2021 17:30,8999999195656,SARIWANGI 50X1.85,1,10000,0,10000,9405,595
9/17/2021 17:34,8999999524838,SUNLIGHT MINT POUCH 755ML,1,18000,0,18000,15950,2050
9/17/2021 17:44,8993989311279,CLAS MILD 12,1,18000,0,18000,15800,2200
9/17/2021 18:06,8992696404441,BEAR BRAND 189ML,1,13000,0,13000,11000,2000
9/17/2021 18:23,8991102022460,FORMULA DIAMOND,1,3000,0,3000,2500,500
9/17/2021 19:20,8992761111540,FANTA STRAWBERY SLIM CAM 250ML,2,5000,0,10000,7500,2500
9/17/2021 19:20,8998989300261,GUDANG GARAM SURYA 12 FILTER,1,20000,0,20000,18150,1850
9/17/2021 19:20,8999909000377,SAMPOERNA AVOLUTION,1,31000,0,31000,29450,1550
9/17/2021 19:20,8997028590052,ARGUS BTL 600ML,1,3000,0,3000,1458,1542
9/17/2021 19:22,896867700494,AIR CLUB 1500ML,1,5000,0,5000,2987,2013
9/17/2021 19:22,8992775318201,GERY SNACK BANTAL COKLAT,1,2000,0,2000,1712,288
9/17/2021 19:22,8991002121003,GOOD DAY TIRAMISU BLISS,1,6000,0,6000,4295,1705
9/17/2021 19:22,7622300405588,KEJUCAKE 16G,1,2000,0,2000,1641,359
9/17/2021 20:37,8992959953037,SWEETY BRONZE L1,2,2500,0,5000,3638,1362
9/17/2021 20:42,8999999516208,ROYCO FDS CHICKEN NEW 230G,2,10000,0,20000,18000,2000
9/17/2021 20:44,ROTI,ROTI 2000,1,2000,0,2000,1800,200
9/17/2021 20:44,089686386127,BUMBU RACIK NASI GORENG SOSIS,1,2000,0,2000,1620,380
9/17/2021 20:45,8997028590052,ARGUS BTL 600ML,1,3000,0,3000,1458,1542
9/17/2021 20:46,8998866202244,EKOMIE BUMBU KALDU AYAM,1,1000,0,1000,798,202
9/17/2021 20:46,ROTI,ROTI 2000,1,2000,0,2000,1800,200
9/17/2021 20:47,8991102026383,AIR CRYSTALINE 1.5 L,1,5000,0,5000,3471,1529
9/17/2021 20:47,8994075230870,momogi,2,500,0,1000,900,100
9/17/2021 20:48,Vita Jelly,Vita Jelly,2,1000,0,2000,1532,468
9/17/2021 20:51,8999999195649,SARIWANGI 25X1.86G,1,6000,0,6000,5202,798
9/17/2021 20:51,SURYA,SURYA,3,500,0,1500,1500,0
9/17/2021 20:52,Gula gula tusuk,gula gula tusuk,1,500,0,500,400,100
9/17/2021 20:53,8998989500166,GUDANG GARAM MERAH BESAR 16KS,1,18000,0,18000,17000,1000
9/17/2021 20:54,8995555171225,KIMBO SOSIS,1,1000,0,1000,900,100
9/17/2021 20:54,8992775305003 pcs,Gery Salut Coklat pcs,1,1000,0,1000,812,188
9/17/2021 20:55,0105312686040047,yakult,2,2000,0,4000,3000,1000
9/17/2021 20:56,8998866202602,KRISBEE FRENCH FRIES 18GR,2,2000,0,4000,3000,1000
9/17/2021 20:56,ICE CREAM 5.000,ICE CREAM 5.000,1,5000,0,5000,4700,300
9/17/2021 20:58,089686021219,INTER MIE GORENG,1,1000,0,1000,885,115
9/17/2021 20:58,Vita Jelly,Vita Jelly,1,1000,0,1000,766,234
9/17/2021 21:15,ICE CREAM 5,ICE CREAM 5000,1,5000,0,5000,4400,600
9/17/2021 21:20,8991102020305,FORMULA TRIPLE ACTION,1,3000,0,3000,2500,500
9/17/2021 21:26,089686535044,SUN BERAS MERAH,1,8500,0,8500,7410,1090
9/17/2021 21:26,8997027300089,NOMOS,1,4000,0,4000,2963,1037
9/17/2021 21:26,JGR SHN,JOGER SHINY SACHET,2,500,0,1000,874,126
9/17/2021 21:26,8999909002821,MARLBORO BLACK 16,1,22000,0,22000,20850,1150
9/17/2021 21:26,8995555121244,SOSIS KIMBO,3,1000,0,3000,1950,1050
9/17/2021 21:42,8998866100717,MAMALIME POUCH 780ML,1,15500,0,15500,13850,1650
9/17/2021 21:42,8992979130012,TOTAL LEMON SOFTENER,1,13000,0,13000,11532,1468
9/17/2021 21:42,8992696404441,BEAR BRAND 189ML,1,13000,0,13000,11000,2000
9/17/2021 21:42,8997009510055,YOU C1000,1,15000,0,15000,13000,2000
9/17/2021 22:02,8992759218046,JOLLY KLNR FCL CR LUNAK EMBOSS 10 ROLL,2,9000,0,18000,16150,1850
9/17/2021 22:02,GL,GULA 1 LITER,4,11500,0,46000,42000,4000
9/17/2021 22:06,8991102026383,AIR CRYSTALINE 1.5 L,1,5000,0,5000,3471,1529
9/17/2021 22:11,JGR SHN,JOGER SHINY SACHET,1,500,0,500,437,63
9/17/2021 22:14,8998989110167,SURYA GUDANG GARAM 16 FILTER,1,26000,0,26000,23700,2300
9/17/2021 22:40,OJELLY,O'JELLY,1,500,0,500,385,115
9/17/2021 22:40,ROTI,ROTI 2000,1,2000,0,2000,1800,200
9/17/2021 22:40,JGR SHN,JOGER SHINY SACHET,2,500,0,1000,874,126
9/17/2021 22:40,8997218380135,ICHITAN GREEN TEA,1,8000,0,8000,6583,1417
9/18/2021 11:22,8991102987875,WFR TANGO POUCH CKL 115G,2,8000,0,16000,13572,2428
9/18/2021 11:22,8991102320184,TANGO CHOCO JAVAMOCCA,3,5000,0,15000,12990,2010
9/18/2021 11:22,8991102994422,TANGO WALUT CHOCOBNN 18G,1,9000,0,9000,8661,339
9/18/2021 11:29,TBR,TEPUNG BERAS ROSE BRAND,1,8000,0,8000,5800,2200
9/18/2021 11:29,089686048704,SARIMIE GORENG AYAM KCP ISI 2,1,3500,0,3500,3120,380
9/18/2021 11:29,8992705025124,AGAR-AGAR SATELIT MERAH,1,3500,0,3500,2604,896
9/18/2021 11:29,8992705035123,AGAR-AGAR SATELIT COKLAT,1,3500,0,3500,2604,896
9/18/2021 11:29,8992705045122,AGAR-AGAR SATELIT HIJAU,2,3500,0,7000,5208,1792
9/18/2021 11:29,RT,ROTI,1,9000,0,9000,8000,1000
9/18/2021 11:29,8997025914042,ATB MARIE SUSU 185G,1,7000,0,7000,4554,2446
9/18/2021 11:29,8997028590052,ARGUS BTL 600ML,3,3000,0,9000,4374,4626
9/18/2021 11:29,8999909096004,SAMPOERNA 16 FILTER,3,25000,0,75000,69300,5700
9/18/2021 11:29,8992775203422,GARUDA ROSTA OVEN BAWANG 100G,1,8000,0,8000,7322,678
9/18/2021 11:29,7622300335809,OREO SOFT CAKE,1,2000,0,2000,1641,359
9/18/2021 11:29,8992761139018,ADES 600ML,1,3500,0,3500,2166,1334
9/18/2021 11:29,8997028590014,ARGUS 220ML,2,500,0,1000,604,396
9/18/2021 11:29,8998866610223,DAIA VIOLET BAG 850G & PIRING,1,18000,0,18000,15627,2373
9/18/2021 11:29,ROTI,ROTI 2000,2,2000,0,4000,3600,400
9/18/2021 11:29,8997009510055,YOU C1000,3,15000,0,45000,39000,6000
9/18/2021 11:29,8992696404441,BEAR BRAND 189ML,1,13000,0,13000,11000,2000
9/18/2021 11:29,8997028590045,ARGUS BTL 330ML,1,2000,0,2000,1291,709
9/18/2021 11:29,8992775318201,GERY SNACK BANTAL COKLAT,1,2000,0,2000,1712,288
9/18/2021 11:29,8991001242013,Top,1,1000,0,1000,500,500
9/18/2021 11:29,8992696523067,MILO ACTVGO UHT 180ML,1,4500,0,4500,3515,985
9/18/2021 11:29,8992959117613,SFX DAUN SIRIH 1 WP,4,500,0,2000,1652,348
9/18/2021 11:29,8991001502926,Chaca Peanut,1,1000,0,1000,800,200
9/18/2021 11:29,KIKO,KIKO,1,1000,0,1000,500,500
9/18/2021 11:34,ABC,BATERAI ABC BIRU,1,9000,0,9000,7712,1288
9/18/2021 11:44,8993989311279,CLAS MILD 12,1,18000,0,18000,15800,2200
9/18/2021 12:02,8998989300261,GUDANG GARAM SURYA 12 FILTER,1,20000,0,20000,18150,1850
9/18/2021 13:41,6907992823942,JD JUJUBE,1,4500,0,4500,3800,700
9/18/2021 13:41,8991001111883,SILVERQUEEN CHUNKYBAR 33G,1,8000,0,8000,7150,850
9/18/2021 13:41,8999999516208,ROYCO FDS CHICKEN NEW 230G,1,10000,0,10000,9000,1000
9/18/2021 13:41,OJELLY,O'JELLY,1,500,0,500,385,115
9/18/2021 13:41,8991001502926,Chaca Peanut,1,1000,0,1000,800,200
9/18/2021 14:04,8850507001152,MOTU ATV,1,10000,0,10000,8000,2000
9/18/2021 14:04,7622201430184,OREO ORIGINAL 38G,2,2000,0,4000,3282,718
9/18/2021 14:18,089686611670,QTELA BALADO,1,5000,0,5000,4266,734
9/18/2021 14:18,8997003910684,2CS,1,3000,0,3000,1500,1500
9/18/2021 14:18,8991102987875,WFR TANGO POUCH CKL 115G,1,8000,0,8000,6786,1214
9/18/2021 14:18,8999988778846,LASEGAR,1,6500,0,6500,5700,800
9/18/2021 14:18,8998866201490,POTABEE REGULER GRILLED SEAWED 68 GR,1,8000,0,8000,7200,800
9/18/2021 14:18,8996001318980,BETTER 120G,1,6000,0,6000,5100,900
9/18/2021 14:53,8992761166212,FRESTEA APPLE 350ML,3,4500,0,13500,9000,4500
9/18/2021 14:53,8992761145026,SPRITE PET 250ML,5,3500,0,17500,12085,5415
9/18/2021 15:23,8992761145026,SPRITE PET 250ML,2,3500,0,7000,4834,2166
9/18/2021 15:39,8991111101507,JB POWDER BLOSSOM 50G,1,3500,0,3500,3000,500
9/18/2021 15:39,8998866603546,SOKLIN FLOORCLENER UNGU 450ML,1,7000,0,7000,6385,615
9/18/2021 15:48,8998989110167,SURYA GUDANG GARAM 16 FILTER,1,26000,0,26000,23700,2300
9/18/2021 15:48,123124,KOREK BIASA,1,2000,0,2000,1300,700
9/18/2021 15:48,Gula gula tusuk,gula gula tusuk,4,500,0,2000,1600,400
9/18/2021 15:56,8992959071205,HN PANTS M20,1,32000,0,32000,29091,2909
9/18/2021 15:59,8998009010569,ULTRA CHO 200,1,5000,0,5000,3830,1170
9/18/2021 16:05,18992628503171,SIMAS 5KG,1,95000,0,95000,89000,6000
9/18/2021 16:05,8995333060703,TERIGU KOMPAS 1KG,20,10500,0,210000,196320,13680
9/18/2021 16:05,GLK,GULATA 50KG,1,620000,0,620000,592000,28000
9/18/2021 16:44,8886022971298,BATERAI ALKALINE 06,1,12000,0,12000,10557,1443
9/18/2021 17:18,8994867007161,ROKOK PENA GOLD 20,1,18000,0,18000,16800,1200
9/18/2021 17:45,8992959953198,SWEETY BRONZE XL 26+2,1,60000,0,60000,54091,5909
9/18/2021 17:45,8998009010569,ULTRA CHO 200,1,5000,0,5000,3830,1170
9/18/2021 17:51,8999999559533,LIFEBUOY BW TOTAL 10 90ML,1,5000,0,5000,4000,1000
9/18/2021 17:57,8999999036546,LUX BW WHITE VELVET 250ML,1,20000,0,20000,17900,2100
9/18/2021 17:57,711844110113,KECAP ABC 135 ML,1,7000,0,7000,6400,600
9/18/2021 17:57,8992870311091,SALONPAS,1,6000,0,6000,4806,1194
9/18/2021 17:57,Pulpen,pulpen,1,1000,0,1000,750,250
9/18/2021 18:35,089686043617,INDOMIE MIEGHETTI,2,2700,0,5400,4904,496
9/18/2021 18:35,089686010343,INDOMIE SOTO MIE,1,2600,0,2600,2367,233
9/18/2021 19:04,8997028590014,ARGUS 220ML,10,500,0,5000,3020,1980
9/18/2021 19:08,6907992825069,JD FRUITY,2,5000,0,10000,8800,1200
9/18/2021 19:35,6907992823942,JD JUJUBE,1,4500,0,4500,3800,700
9/18/2021 19:35,8992775318201,GERY SNACK BANTAL COKLAT,2,2000,0,4000,3424,576
9/18/2021 19:35,KIKO,KIKO,2,1000,0,2000,1000,1000
9/18/2021 19:44,8993226365522,GARAM MEJA GYURI 200GR,1,2000,0,2000,1700,300
9/18/2021 19:44,8997021110028,Garam,1,2500,0,2500,1500,1000
9/18/2021 20:23,0105312686040047,yakult,1,2000,0,2000,1500,500
9/18/2021 20:23,8992957220025,GOLDEN CITY MINI,1,3000,0,3000,2500,500
9/18/2021 20:27,8999909002821,MARLBORO BLACK 16,1,22000,0,22000,20850,1150
9/18/2021 20:47,8999988778846,LASEGAR,1,6500,0,6500,5700,800
9/18/2021 20:47,8998989300261,GUDANG GARAM SURYA 12 FILTER,1,20000,0,20000,18150,1850
9/18/2021 20:48,8991909101016,URBAN MILD 16,1,17000,0,17000,15800,1200
9/18/2021 20:48,8998866202602,KRISBEE FRENCH FRIES 18GR,6,2000,0,12000,9000,3000
9/18/2021 20:50,8999988778846,LASEGAR,1,6500,0,6500,5700,800
9/18/2021 20:50,8993007000024,INDOMILK UHT VANILA,1,5000,0,5000,3470,1530
9/18/2021 20:50,8992388133345,NU MILK TEA TEH TARIK 330ML,1,6000,0,6000,5125,875
9/18/2021 20:50,ROTI,ROTI 2000,1,2000,0,2000,1800,200
9/18/2021 20:50,MARS,MARSHMELLOW,1,500,0,500,433,67
9/18/2021 20:51,8998989500166,GUDANG GARAM MERAH BESAR 16KS,2,18000,0,36000,34000,2000
9/18/2021 20:57,8994867000179,ROKOK PENA MILD 16,1,14500,0,14500,13500,1000
9/18/2021 21:00,8999909028234,234 DJI SAM SOE 12,1,17500,0,17500,15850,1650
9/18/2021 21:06,8992959953037,SWEETY BRONZE L1,2,2500,0,5000,3638,1362
9/18/2021 21:11,OJELLY,O'JELLY,1,500,0,500,385,115
9/18/2021 21:12,8992696523081,MILO UHT 110ML,2,2500,0,5000,3924,1076
9/18/2021 21:18,8998866200646,KOPI TOP MURNI,1,11000,0,11000,9600,1400
9/18/2021 21:20,ARG,ARGUS DOS 220ML,1,14500,0,14500,13300,1200
9/19/2021 11:01,8999999558086,RINSO MOLTO FERFUME ESSENSE PWD 44G,1,1000,0,1000,805,195
9/19/2021 11:01,8999909982000,SAMPOERNA 12 FILTER,1,19000,0,19000,16600,2400
9/19/2021 11:01,8995555121244,SOSIS KIMBO,3,1000,0,3000,1950,1050
9/19/2021 11:01,VTM,VITAMIN CIMIN,7,500,0,3500,2975,525
9/19/2021 11:01,GGK,PLAYGUM PERMEN KARET,1,500,0,500,400,100
9/19/2021 11:01,ROTI,ROTI 2000,2,2000,0,4000,3600,400
9/19/2021 11:01,8997025911058,HATARI SHP KELAPA,1,6000,0,6000,4911,1089
9/19/2021 11:01,8992628020152,MINYAK GOREG BIMOLI POUCH 2L,1,32000,0,32000,29800,2200
9/19/2021 11:01,8993007001359,INDOMILK KM SCT 37G,2,1500,0,3000,2166,834
9/19/2021 11:01,8998866200325,MIE SEDAAP SOTO,2,2700,0,5400,4564,836
9/19/2021 11:01,Telur 3 Biji,Telur 3 Biji,1,5000,0,5000,3600,1400
9/19/2021 11:01,8999999533717,CITRA TS FRESH WHITE 70G,1,2200,0,2200,1900,300
9/19/2021 11:01,8992694247163,ZWITSAL SOAP RICH N HON 70G,1,4000,0,4000,3410,590
9/19/2021 11:01,8998866100717,MAMALIME POUCH 780ML,1,15500,0,15500,13850,1650
9/19/2021 11:01,GL,GULA 1 LITER,1,11500,0,11500,10500,1000
9/19/2021 11:24,KIKO,KIKO,4,1000,0,4000,2000,2000
9/19/2021 12:09,8998989300261,GUDANG GARAM SURYA 12 FILTER,1,20000,0,20000,18150,1850
9/19/2021 12:30,8993007001694,INDOMILK SKM 37G,1,7500,0,7500,6500,1000
9/19/2021 12:30,8998898830125,KKB ENER-G ANGGUR,1,5500,0,5500,4824,676
9/19/2021 12:33,8998866608459,POWDET DAIA PUTIH BAG 290GR,1,5000,0,5000,4450,550
9/19/2021 12:34,8991102022460,FORMULA DIAMOND,1,3000,0,3000,2500,500
9/19/2021 12:34,8998866609043,DAIA SOFTENER GUSSET 565G,1,10000,0,10000,8700,1300
9/19/2021 13:19,089686043273,INDOMIE SAMBAL RICA,1,2700,0,2700,2452,248
9/19/2021 13:19,Telur 3 Biji,Telur 3 Biji,1,5000,0,5000,3600,1400
9/19/2021 13:44,ROTI,ROTI 2000,1,2000,0,2000,1800,200
9/19/2021 14:18,8994867000179,ROKOK PENA MILD 16,2,14500,0,29000,27000,2000
9/19/2021 14:23,8998866200325,MIE SEDAAP SOTO,2,2700,0,5400,4564,836
9/19/2021 14:23,8998866200578,MIE SEDAAP KARI KENTAL,1,2700,0,2700,2331,369
9/19/2021 14:23,8998866200301,MIE SEDAAP GORENG,2,2700,0,5400,4726,674
9/19/2021 14:29,089686021219,INTER MIE GORENG,2,1000,0,2000,1770,230
9/19/2021 14:38,8994867000162,ROKOK PUNDIMAS KRETEK16,2,10000,0,20000,17200,2800
9/19/2021 14:38,6907992823829,JD MILKY MILK,1,3000,0,3000,2600,400
9/19/2021 14:38,6907992825076,JD WATERMELON APPLE,1,2000,0,2000,1700,300
9/19/2021 14:49,8995555171225,KIMBO SOSIS,1,1000,0,1000,900,100
9/19/2021 14:49,OJELLY,O'JELLY,2,500,0,1000,770,230
9/19/2021 14:50,8995555171225,KIMBO SOSIS,3,1000,0,3000,2700,300
9/19/2021 14:50,8997028590014,ARGUS 220ML,2,500,0,1000,604,396
9/19/2021 14:58,8991001503336,chacha minis hat,1,7500,0,7500,6400,1100
9/19/2021 15:03,8994834006128,TICTIC PEDAS,2,2000,0,4000,3400,600
9/19/2021 15:03,8991002103238,GOOD DAY MOCACINNO,4,1500,0,6000,3560,2440
9/19/2021 15:03,089686021127,INTER MIE KALDU,1,1000,0,1000,813,187
9/19/2021 15:03,8992770033178,Masako,2,500,0,1000,900,100
9/19/2021 15:09,8995555121244,SOSIS KIMBO,3,1000,0,3000,1950,1050
9/19/2021 15:09,Gula gula tusuk,gula gula tusuk,2,500,0,1000,800,200
9/19/2021 16:12,8992696404441,BEAR BRAND 189ML,1,15000,0,15000,11000,4000
9/19/2021 16:20,6907992825076,JD WATERMELON APPLE,1,2000,0,2000,1700,300
9/19/2021 16:20,8999909085114,SAMPOERNA KRETEK HIJAU 12,1,13000,0,13000,11650,1350
9/19/2021 16:40,8992696405417,DNCO INSTANT 27G,3,3500,0,10500,9000,1500
9/19/2021 17:36,Vita Jelly,Vita Jelly,1,1000,0,1000,766,234
9/19/2021 17:45,089686060362,POP MIE SOTO AYAM JUMBO,3,4500,0,13500,11499,2001
9/19/2021 17:45,8999999059781,SUNLIGHT LIME NEW POUCH 210ML,1,5000,0,5000,4520,480
9/19/2021 18:13,76164217,MARLBORO MERAH,2,30000,0,60000,55400,4600
9/19/2021 18:13,8992696404441,BEAR BRAND 189ML,2,15000,0,30000,22000,8000
9/19/2021 18:13,8997009510055,YOU C1000,2,15000,0,30000,26000,4000
9/19/2021 18:18,8999909002821,MARLBORO BLACK 16,1,22000,0,22000,20850,1150
9/19/2021 18:33,JGR SHN,JOGER SHINY SACHET,2,500,0,1000,874,126
9/19/2021 18:33,8997009510123,ORANGE WATER,1,11000,0,11000,10416,584
9/19/2021 18:38,8992696404441,BEAR BRAND 189ML,1,15000,0,15000,11000,4000
9/19/2021 18:40,8997028590052,ARGUS BTL 600ML,2,3000,0,6000,2916,3084
9/19/2021 18:40,8992761166212,FRESTEA APPLE 350ML,1,4500,0,4500,3000,1500
9/19/2021 18:40,8992696523067,MILO ACTVGO UHT 180ML,1,4500,0,4500,3515,985
9/19/2021 18:40,8995555121244,SOSIS KIMBO,1,1000,0,1000,650,350
9/19/2021 18:40,8992775000076,GERY SNACK RING CKLT,1,2000,0,2000,1712,288
9/19/2021 19:17,ROTI,ROTI 2000,1,2000,0,2000,1800,200
9/19/2021 19:17,8999909028234,234 DJI SAM SOE 12,1,17500,0,17500,15850,1650
9/19/2021 19:21,8998989110167,SURYA GUDANG GARAM 16 FILTER,1,26000,0,26000,23700,2300
9/19/2021 19:21,089686060027,POP MIE AYAM JUMBO,1,4500,0,4500,3833,667
9/19/2021 19:21,8998009010569,ULTRA CHO 200,1,5000,0,5000,3830,1170
9/19/2021 19:21,KIKO,KIKO,1,1000,0,1000,500,500
9/19/2021 19:21,ARG,ARGUS DOS 220ML,1,14500,0,14500,13300,1200
9/19/2021 19:21,ROTI,ROTI 2000,2,2000,0,4000,3600,400
9/19/2021 19:21,8998866202602,KRISBEE FRENCH FRIES 18GR,1,2000,0,2000,1500,500
9/19/2021 19:34,8992222050418,GATSBY NORMAL 38GR,1,5000,0,5000,3850,1150
9/19/2021 20:03,8999999048174,SUNSILK  BLK SHINE 70+21ML,1,9600,0,9600,8525,1075
9/19/2021 20:04,8998989300261,GUDANG GARAM SURYA 12 FILTER,1,20000,0,20000,18150,1850
9/19/2021 20:04,ROTI,ROTI 2000,2,2000,0,4000,3600,400
9/19/2021 20:30,8997027300089,NOMOS,1,4000,0,4000,2963,1037
9/19/2021 20:32,8998866608718,DAIA SOFTENER PINK,1,5000,0,5000,4450,550
9/19/2021 20:32,SKT,SIKAT CUCI,1,6000,0,6000,5000,1000
9/19/2021 20:32,RB,RED BOLD,1,20000,0,20000,18800,1200
9/19/2021 20:34,ARG,ARGUS DOS 220ML,3,14500,0,43500,39900,3600
9/19/2021 20:42,6907992825076,JD WATERMELON APPLE,1,2000,0,2000,1700,300
9/19/2021 20:42,Vita Jelly,Vita Jelly,1,1000,0,1000,766,234
9/19/2021 20:45,JGR SHN,JOGER SHINY SACHET,6,500,0,3000,2622,378
9/19/2021 20:45,8991909101016,URBAN MILD 16,1,17000,0,17000,15800,1200
9/19/2021 21:16,8998866608725,DAIA SOFTENER BAG 850G,1,18000,0,18000,15627,2373
9/19/2021 21:16,8999999525675,MOLTO HYGIENE 720ML,1,28000,0,28000,25150,2850
9/19/2021 21:45,Vita Jelly,Vita Jelly,1,1000,0,1000,766,234
9/19/2021 22:11,8997027300089,NOMOS,1,4000,0,4000,2963,1037
9/19/2021 22:11,8993470672827,SAKU-SAKU SAPI PANGGANG,1,2000,0,2000,1530,470
9/19/2021 22:11,8997013790108,BIMURA KACANG TELUR 25G,1,1000,0,1000,875,125
9/19/2021 22:25,8999999001162,LIFEBUOY BW MILDCARE BTL 300ML,1,24000,0,24000,21550,2450
9/19/2021 22:25,8999999049669,REXONA MEN RO INVISIBLE DRY 45 ML,1,15000,0,15000,13550,1450
9/19/2021 22:40,8997009510055,YOU C1000,3,15000,0,45000,39000,6000
9/19/2021 22:40,8992696404441,BEAR BRAND 189ML,3,15000,0,45000,33000,12000
9/19/2021 22:40,4902430553636,HEAD & shoulders,1,25000,0,25000,18900,6100
9/19/2021 22:40,TUSTEL,TUSUK TELINGA,1,1000,0,1000,833,167
9/19/2021 22:40,8995555171225,KIMBO SOSIS,1,1000,0,1000,900,100
9/19/2021 22:43,7992912508305,SWEETY SILVER PANTS L1,2,2500,0,5000,3764,1236
9/19/2021 22:43,8992959117613,SFX DAUN SIRIH 1 WP,4,500,0,2000,1652,348
9/19/2021 22:43,8992696521797,MILO 22G,2,2500,0,5000,3144,1856
9/19/2021 22:43,8991102228053,TEH GELAS BOTOL,1,3000,0,3000,1695,1305
9/20/2021 10:39,8998009010569,ULTRA CHO 200,1,5000,0,5000,3830,1170
9/20/2021 10:39,8998866200301,MIE SEDAAP GORENG,3,2700,0,8100,7089,1011
9/20/2021 10:39,8993110071126,SONICE SOSIS SAPI,1,24000,0,24000,23500,500
9/20/2021 10:39,8995555171225,KIMBO SOSIS,2,1000,0,2000,1800,200
9/20/2021 10:39,8997003910684,2CS,2,3000,0,6000,3000,3000
9/20/2021 10:39,8999999059316,LIFEBUOY TS MILDCARE 75G,1,3000,0,3000,2640,360
9/20/2021 10:56,8992696523067,MILO ACTVGO UHT 180ML,2,4500,0,9000,7030,1970
9/20/2021 10:56,8993470279651,JOGER CHOCKY BAR,1,1000,0,1000,867,133
9/20/2021 12:15,8998866107099,WET WIPES KODOMO BABY 50SHT CLSSC,1,20000,0,20000,14150,5850
9/20/2021 15:37,8994867000162,ROKOK PUNDIMAS KRETEK16,1,10000,0,10000,8600,1400
9/20/2021 16:09,8999988778846,LASEGAR,1,6500,0,6500,5700,800
9/20/2021 16:09,8998989300261,GUDANG GARAM SURYA 12 FILTER,1,20000,0,20000,18150,1850
9/20/2021 16:17,8991002103337,GOOD DAY VANILLA,2,1500,0,3000,1780,1220
9/20/2021 16:17,8991102320184,TANGO CHOCO JAVAMOCCA,1,5000,0,5000,4330,670
9/20/2021 16:24,ARG,ARGUS DOS 220ML,1,14500,0,14500,13300,1200
9/20/2021 16:30,8992761145019,COCA COLA PET 250ML,1,3500,0,3500,2417,1083
9/20/2021 16:43,8994867007161,ROKOK PENA GOLD 20,1,18000,0,18000,16800,1200
9/20/2021 17:13,8996001301579,MALKIST CKLT KELAPA PACK,1,6500,0,6500,5400,1100
9/20/2021 17:13,8996001305058,ROMA SANDWICH KACANG,1,7000,0,7000,5928,1072
9/20/2021 17:13,8991102023115,Sikat Gigi Formula,1,11000,0,11000,10000,1000
9/20/2021 17:19,KIKO,KIKO,6,1000,0,6000,3000,3000
9/20/2021 17:19,OJELLY,O'JELLY,2,500,0,1000,770,230
9/20/2021 17:19,8997028590014,ARGUS 220ML,10,500,0,5000,3020,1980
9/20/2021 17:40,8991002103337,GOOD DAY VANILLA,1,1500,0,1500,890,610
9/20/2021 17:40,8991002103832,GOOD DAY CHOCOCINNO,1,1500,0,1500,890,610
9/20/2021 17:40,GL,GULA 1 LITER,1,11500,0,11500,10500,1000
9/20/2021 17:40,OJELLY,O'JELLY,1,500,0,500,385,115
9/20/2021 17:41,8992870311091,SALONPAS,1,6000,0,6000,4806,1194
9/20/2021 17:52,8994935000070,MINYAK GORENG DUNIA 450 ML,1,7500,0,7500,6779,721
9/20/2021 17:52,8996001314005,ROMA KELAPA CREAM CKLT,1,8000,0,8000,6642,1358
9/20/2021 18:20,089686041705,INDOMIE GORENG JUMBO,1,3500,0,3500,3143,357
9/20/2021 18:22,8998866200301,MIE SEDAAP GORENG,2,2700,0,5400,4726,674
9/20/2021 18:22,8995555121244,SOSIS KIMBO,2,1000,0,2000,1300,700
9/20/2021 18:22,8997028590052,ARGUS BTL 600ML,1,3000,0,3000,1458,1542
9/20/2021 18:59,8991102026383,AIR CRYSTALINE 1.5 L,1,5000,0,5000,3471,1529
9/20/2021 19:01,8997009510055,YOU C1000,1,15000,0,15000,13000,2000
9/20/2021 19:01,8992696404441,BEAR BRAND 189ML,1,15000,0,15000,11000,4000
9/20/2021 19:10,8998866604963,POWDET DAIA LEMON 290GR,1,5000,0,5000,4450,550
9/20/2021 19:10,8991002105430,KAPAL API 65G,1,5000,0,5000,4145,855
9/20/2021 19:10,8992775511206,LEO 10GR,1,1000,0,1000,848,152
9/20/2021 19:10,8996001305119,ARDEN 30G,1,2000,0,2000,1650,350
9/20/2021 19:10,8998866202602,KRISBEE FRENCH FRIES 18GR,1,2000,0,2000,1500,500
9/20/2021 19:32,8992696404441,BEAR BRAND 189ML,1,15000,0,15000,11000,4000
9/20/2021 19:35,8998989500166,GUDANG GARAM MERAH BESAR 16KS,1,18000,0,18000,17000,1000
9/20/2021 19:51,8998989300261,GUDANG GARAM SURYA 12 FILTER,1,20000,0,20000,18150,1850
9/20/2021 19:52,Vita Jelly,Vita Jelly,1,1000,0,1000,766,234
9/20/2021 20:21,OJELLY,O'JELLY,3,500,0,1500,1155,345
9/20/2021 20:26,ROTI,ROTI 2000,1,2000,0,2000,1800,200
9/20/2021 20:32,8993989311699,CLAS MILD 16 FILTER,1,24000,0,24000,21700,2300
9/20/2021 20:40,7992912508305,SWEETY SILVER PANTS L1,2,2500,0,5000,3764,1236
9/20/2021 20:43,8999999516208,ROYCO FDS CHICKEN NEW 230G,1,10000,0,10000,9000,1000
9/20/2021 22:20,7622300761349,OREO MINI CKLT,1,7500,0,7500,6500,1000
9/21/2021 10:53,8991001503336,chacha minis hat,1,7500,0,7500,6400,1100
9/21/2021 10:53,8998989300261,GUDANG GARAM SURYA 12 FILTER,1,20000,0,20000,18150,1850
9/21/2021 11:06,8996001305119,ARDEN 30G,1,2000,0,2000,1650,350
9/21/2021 11:06,8992775511206,LEO 10GR,3,1000,0,3000,2544,456
9/21/2021 11:06,8992959850046,CONFI PANTS M10,1,80000,0,80000,75120,4880
9/21/2021 11:06,8999999059781,SUNLIGHT LIME NEW POUCH 210ML,1,5000,0,5000,4520,480
9/21/2021 11:06,8999999571887,MOLTO EDP PURPLE 10ML,1,5000,0,5000,4800,200
9/21/2021 11:06,8992775318201,GERY SNACK BANTAL COKLAT,1,2000,0,2000,1712,288
9/21/2021 11:06,8995555171225,KIMBO SOSIS,1,1000,0,1000,900,100
9/21/2021 11:06,8997204370126,Siko,1,10000,0,10000,8333,1667
9/21/2021 11:06,8997025911058,HATARI SHP KELAPA,1,6000,0,6000,4911,1089
9/21/2021 11:06,GL,GULA 1 LITER,2,11500,0,23000,21000,2000
9/21/2021 11:06,WC,WAFER COKELAT MADE,1,1000,0,1000,800,200
9/21/2021 11:06,8993470279651,JOGER CHOCKY BAR,1,1000,0,1000,867,133
9/21/2021 11:06,8992959508930,SWEETY SILVER PANTS L 54,1,108000,0,108000,99697,8303
9/21/2021 11:06,ROTI,ROTI 2000,2,2000,0,4000,3600,400
9/21/2021 11:06,8991188943062,SASA 250G,1,10000,0,10000,8500,1500
9/21/2021 11:06,jagung marning,jagung marning,1,5000,0,5000,4500,500
9/21/2021 11:06,8997028590052,ARGUS BTL 600ML,1,3000,0,3000,1458,1542
9/21/2021 11:06,8992959117583,SFX DS REG FLOW WING 20,1,5000,0,5000,4288,712
9/21/2021 11:09,Telur 3 Biji,Telur 3 Biji,1,5000,0,5000,3600,1400
9/21/2021 11:09,8998866200301,MIE SEDAAP GORENG,1,2700,0,2700,2363,337
9/21/2021 11:09,KERUPUK 1000,KERUPUK BALADO,2,1000,0,2000,1800,200
9/21/2021 11:09,KOPIKO,KOPIKO,1,250,0,250,175,75
9/21/2021 11:26,8996001301579,MALKIST CKLT KELAPA PACK,1,6500,0,6500,5400,1100
9/21/2021 11:26,ROTI,ROTI 2000,1,2000,0,2000,1800,200
9/21/2021 11:41,8994867007161,ROKOK PENA GOLD 20,1,18000,0,18000,16800,1200
9/21/2021 11:59,8991102300544,WFR TANGO VNL 176G,1,10000,0,10000,8694,1306
9/21/2021 11:59,8991102300421,WFR TANGO COKLAT 176GR,1,10000,0,10000,8694,1306
9/21/2021 14:52,8998866200882,SUKSESMIE GORENG AYAM KRMS 133GR,1,3500,0,3500,3047,453
9/21/2021 14:54,6907992825076,JD WATERMELON APPLE,1,2000,0,2000,1700,300
9/21/2021 14:54,6907992823942,JD JUJUBE,1,4500,0,4500,3800,700
9/21/2021 14:54,lolipop,lolipop,1,1000,0,1000,850,150
9/21/2021 15:05,8995899210185,Mi Boncabe,1,3000,0,3000,3000,0
9/21/2021 15:05,8995555171225,KIMBO SOSIS,1,1000,0,1000,900,100
9/21/2021 15:08,8998989300261,GUDANG GARAM SURYA 12 FILTER,1,20000,0,20000,18150,1850
9/21/2021 15:08,8997218380135,ICHITAN GREEN TEA,2,8000,0,16000,13166,2834
9/21/2021 15:08,8997218380074,ICHITAN MILK TEA,1,8000,0,8000,6583,1417
9/21/2021 15:08,8992761139018,ADES 600ML,1,3500,0,3500,2166,1334
9/21/2021 15:08,8992730002992,HAI CANDY,1,7000,0,7000,6000,1000
9/21/2021 15:08,8991001503336,chacha minis hat,1,7500,0,7500,6400,1100
9/21/2021 16:33,8991102024099,FORMULA CURVE,1,5000,0,5000,3000,2000
9/21/2021 16:33,8998866610711,NOVO ACTIVE CLEAN 110G,2,3000,0,6000,5200,800
9/21/2021 16:33,089686010343,INDOMIE SOTO MIE,2,2600,0,5200,4734,466
9/21/2021 16:33,KERUPUK 5000,KERUPUK BALADO,1,5000,0,5000,4000,1000
9/21/2021 16:33,8991002121089,GOOD DAY ORI CAPPUCINO,1,6000,0,6000,4295,1705
9/21/2021 16:41,8999909096004,SAMPOERNA 16 FILTER,1,25000,0,25000,23100,1900
9/21/2021 17:43,Vita Jelly,Vita Jelly,1,1000,0,1000,766,234
9/21/2021 17:45,8991002105409,KOPI KAPAL API,1,20000,0,20000,18888,1112
9/21/2021 17:45,8998989300261,GUDANG GARAM SURYA 12 FILTER,1,20000,0,20000,18150,1850
9/21/2021 18:25,089686021141,INTER MIE SOTO,2,1000,0,2000,1708,292
9/21/2021 18:31,TG,TEH GELAS,1,1000,0,1000,729,271
9/21/2021 18:31,KERUPUK 5000,KERUPUK BALADO,1,5000,0,5000,4000,1000
9/21/2021 19:13,8998866202664,POTABEE WAGYU BEEF STEAK 68 GR,2,8000,0,16000,14400,1600
9/21/2021 19:13,ROTI,ROTI 2000,5,2000,0,10000,9000,1000
9/21/2021 19:15,8997028590014,ARGUS 220ML,8,500,0,4000,2416,1584
9/21/2021 19:54,JL,JELLY,2,500,0,1000,800,200
9/21/2021 20:55,TG APEL,TEH GELAS APEL,1,2000,0,2000,1178,822
9/21/2021 20:55,TG MARKISA,TEH GELAS MARKISA,2,2000,0,4000,2356,1644
9/21/2021 20:55,TG,TEH GELAS,2,1000,0,2000,1458,542
9/21/2021 20:55,Vita Jelly,Vita Jelly,5,1000,0,5000,3830,1170
9/21/2021 20:55,8997028590014,ARGUS 220ML,2,500,0,1000,604,396
9/21/2021 21:18,8997027300089,NOMOS,1,4000,0,4000,2963,1037
9/21/2021 21:53,089686041705,INDOMIE GORENG JUMBO,1,3500,0,3500,3143,357
9/21/2021 21:53,8997028590045,ARGUS BTL 330ML,1,2000,0,2000,1291,709
9/21/2021 21:58,GL,GULA 1 LITER,4,11500,0,46000,42000,4000
9/21/2021 22:06,8992979130012,TOTAL LEMON SOFTENER,1,15000,0,15000,13524,1476
9/21/2021 22:06,8998866200646,KOPI TOP MURNI,1,11000,0,11000,9600,1400
9/21/2021 22:09,7992912508305,SWEETY SILVER PANTS L1,2,2500,0,5000,3764,1236
9/22/2021 8:52,8999999525590,PEPSODENT TB KIDS,1,12900,0,12900,11700,1200
9/22/2021 9:00,8998866605113,CLING KUNING BTL 440ML,1,8500,0,8500,7600,900
9/22/2021 9:02,RB,RED BOLD,1,20000,0,20000,18800,1200
9/22/2021 9:14,8998989300261,GUDANG GARAM SURYA 12 FILTER,1,20000,0,20000,18150,1850
9/22/2021 9:14,8991102320184,TANGO CHOCO JAVAMOCCA,1,5000,0,5000,4330,670
9/22/2021 10:21,PULPEN SNOWMAN,PULPEN SNOWMAN,3,2500,0,7500,6000,1500
9/22/2021 10:21,Pulpen,pulpen,1,1000,0,1000,750,250
9/22/2021 10:23,8994834006128,TICTIC PEDAS,2,2000,0,4000,3400,600
9/22/2021 10:23,8991102714594,TANGO DRINK BLCK VNL,1,5000,0,5000,3818,1182
9/22/2021 10:23,8996001600641,TORA CAPPUCINO,1,3500,0,3500,2750,750
9/22/2021 10:23,JGR SHN,JOGER SHINY SACHET,1,500,0,500,437,63
9/22/2021 10:34,089686611618,QTELA BARBEQUE,1,5000,0,5000,4266,734
9/22/2021 10:38,8998866201490,POTABEE REGULER GRILLED SEAWED 68 GR,1,8000,0,8000,7200,800
9/22/2021 10:40,8991102714860,MILKIDO STRAW,2,3000,0,6000,4306,1694
9/22/2021 10:40,089686727074,DORITOS 160G,1,12000,0,12000,10700,1300
9/22/2021 10:47,089686611670,QTELA BALADO,1,5000,0,5000,4266,734
9/22/2021 10:47,ROTI,ROTI 2000,1,2000,0,2000,1800,200
9/22/2021 10:56,8992761166212,FRESTEA APPLE 350ML,4,4500,0,18000,12000,6000
9/22/2021 10:56,8999999033170,LIFEBUOY SHP  KUAT&BERKILAU 170ML,1,16500,0,16500,14950,1550
9/22/2021 10:57,PRG,PARAGO,1,500,0,500,400,100
9/22/2021 10:58,8992761145026,SPRITE PET 250ML,1,3500,0,3500,2417,1083
9/22/2021 11:13,JGR SHN,JOGER SHINY SACHET,2,500,0,1000,874,126
9/22/2021 11:13,8997028590045,ARGUS BTL 330ML,1,2000,0,2000,1291,709
9/22/2021 11:17,ROTI,ROTI 2000,3,2000,0,6000,5400,600
9/22/2021 11:20,ROTI,ROTI 2000,1,2000,0,2000,1800,200
9/22/2021 11:36,8997028590014,ARGUS 220ML,6,500,0,3000,1812,1188
9/22/2021 11:36,OJELLY,O'JELLY,5,500,0,2500,1925,575
9/22/2021 12:30,8998866608725,DAIA SOFTENER BAG 850G,1,18000,0,18000,15627,2373
9/22/2021 12:50,8997028590014,ARGUS 220ML,6,500,0,3000,1812,1188
9/22/2021 13:09,8991102026383,AIR CRYSTALINE 1.5 L,1,5000,0,5000,3471,1529
9/22/2021 13:12,Vita Jelly,Vita Jelly,2,1000,0,2000,1532,468
9/22/2021 13:15,ARG,ARGUS DOS 220ML,3,14500,0,43500,39900,3600
9/22/2021 13:44,8996001305119,ARDEN 30G,1,2000,0,2000,1650,350
9/22/2021 13:50,8998866201377,KRISBEE FRIES KENTANG GORENG 68 GR,1,5500,0,5500,4620,880
9/22/2021 13:50,8997028590045,ARGUS BTL 330ML,1,2000,0,2000,1291,709
9/22/2021 13:50,8992759120264,LARISST 220,1,10000,0,10000,9200,800
9/22/2021 13:50,6901668053121,OREO ORIGINAL 66.5 G,1,4000,0,4000,3200,800
9/22/2021 13:50,8992775318201,GERY SNACK BANTAL COKLAT,1,2000,0,2000,1712,288
9/22/2021 13:54,8992775318201,GERY SNACK BANTAL COKLAT,2,2000,0,4000,3424,576
9/22/2021 14:15,8991102308861,FULLO BLASTO,1,16000,0,16000,14545,1455
9/22/2021 14:40,8998989300261,GUDANG GARAM SURYA 12 FILTER,1,20000,0,20000,18150,1850
9/22/2021 15:47,GL,GULA 1 LITER,4,11500,0,46000,42000,4000
9/22/2021 16:24,ROTI,ROTI 2000,2,2000,0,4000,3600,400
9/22/2021 16:24,6901668053121,OREO ORIGINAL 66.5 G,1,4000,0,4000,3200,800
9/22/2021 16:24,KIKO,KIKO,2,1000,0,2000,1000,1000
9/22/2021 17:50,8998866202312,NOODLE SEDAAP TASTY BAKMI AYAM 129 GR,1,5000,0,5000,4167,833
9/22/2021 17:50,8998866200325,MIE SEDAAP SOTO,1,2700,0,2700,2282,418
9/22/2021 22:06,8999999195656,SARIWANGI 50X1.85,1,10000,0,10000,9405,595
9/22/2021 22:06,8998989500166,GUDANG GARAM MERAH BESAR 16KS,1,18000,0,18000,17000,1000
9/22/2021 22:06,8991102026383,AIR CRYSTALINE 1.5 L,1,5000,0,5000,3471,1529
9/22/2021 22:10,8998989110167,SURYA GUDANG GARAM 16 FILTER,1,26000,0,26000,23700,2300
9/22/2021 22:18,JGR SHN,JOGER SHINY SACHET,2,500,0,1000,874,126
9/22/2021 22:26,MTR,MOTOR,1,5000,0,5000,3500,1500
9/23/2021 21:19,ICE CREAM 3,ICE CREAM 3000,5,3000,0,15000,13000,2000
9/23/2021 21:20,8998009010569,ULTRA CHO 200,1,5000,0,5000,3830,1170
9/23/2021 21:28,8998009010231,ULTRA CHO 250,1,6000,0,6000,4784,1216
9/23/2021 21:30,8998989110167,SURYA GUDANG GARAM 16 FILTER,1,26000,0,26000,23700,2300
9/23/2021 21:32,AMPLOP,AMPLOP,2,250,0,500,280,220
9/23/2021 21:37,8992775511206,LEO 10GR,3,1000,0,3000,2544,456
9/23/2021 21:38,8997028590052,ARGUS BTL 600ML,1,3000,0,3000,1458,1542
9/23/2021 21:39,7992912508305,SWEETY SILVER PANTS L1,2,2500,0,5000,3764,1236
9/23/2021 21:41,8991111112213,C&C DEEP ACTION CLEANSER 100G,1,22000,0,22000,19900,2100
9/23/2021 21:44,8991102281430,PERMEN MINTZ DUOMINT,1,5000,0,5000,4000,1000
9/23/2021 21:44,8997028590052,ARGUS BTL 600ML,1,3000,0,3000,1458,1542
9/23/2021 21:44,8997218380074,ICHITAN MILK TEA,1,8000,0,8000,6583,1417
9/23/2021 21:44,8997028590052,ARGUS BTL 600ML,1,3000,0,3000,1458,1542
9/23/2021 21:59,8991102989381,TANGO LONG BUBBLEGUM 130G,1,5000,0,5000,4345,655
9/23/2021 22:02,KOPIKO,KOPIKO,4,250,0,1000,700,300
9/23/2021 22:02,8998989500166,GUDANG GARAM MERAH BESAR 16KS,1,18000,0,18000,17000,1000
9/24/2021 10:13,8999999027056,LIFEBUOY ANTI KETOMBE 9ML,2,5000,0,10000,9000,1000
9/24/2021 10:13,8997231980022,O'JELLY MINI STRAWBERRY,1,3000,0,3000,2250,750
9/24/2021 10:13,8997009510055,YOU C1000,3,15000,0,45000,39000,6000
9/24/2021 10:13,8998989110167,SURYA GUDANG GARAM 16 FILTER,1,26000,0,26000,23700,2300
9/24/2021 10:14,8998866202626,Top Kopi Gula Aren 22gr,3,666,0,1998,1659,339
9/24/2021 10:50,8994935000070,MINYAK GORENG DUNIA 450 ML,1,7500,0,7500,6779,721
9/24/2021 10:50,089686021219,INTER MIE GORENG,1,1000,0,1000,885,115
9/24/2021 10:50,089686021141,INTER MIE SOTO,1,1000,0,1000,854,146
9/24/2021 10:50,YP,YUPI,2,250,0,500,416,84
9/24/2021 12:18,8992761145026,SPRITE PET 250ML,4,3500,0,14000,9668,4332
9/24/2021 12:18,8991102385091,WFR TANGO CKLT 7G,1,8300,0,8300,7455,845
9/24/2021 12:18,8992775203422,GARUDA ROSTA OVEN BAWANG 100G,1,8000,0,8000,7322,678
9/24/2021 12:18,8992959953150,SWEETY BRONZE XXL 18,1,45000,0,45000,42330,2670
9/24/2021 12:18,4902430400947,PANTENE ANTI DANDRUFF 130ML,1,20000,0,20000,17860,2140
9/24/2021 12:24,8992775001691,GARUDA ROSTA WAGYU BEEF 100G,2,8000,0,16000,14644,1356
9/24/2021 12:24,089686727081,DORITOS 55G,1,7000,0,7000,5950,1050
9/24/2021 12:24,8886013213208,FRENCH FREIS 2000,1,5000,0,5000,3750,1250
9/24/2021 12:24,8886467100048,pringles bbq,1,9000,0,9000,6333,2667
9/24/2021 12:25,8886467100017,pringles original,1,9000,0,9000,6333,2667
9/24/2021 12:25,8886013213208,FRENCH FREIS 2000,1,5000,0,5000,3750,1250
9/24/2021 12:25,8992775001691,GARUDA ROSTA WAGYU BEEF 100G,1,8000,0,8000,7322,678
9/24/2021 12:25,8992775110157,GARUDA KACANG KULIT,1,5000,0,5000,3925,1075
9/24/2021 12:41,8998898337440,TOLAK ANGIN CARE 10ML,1,10000,0,10000,7893,2107
9/24/2021 12:58,8998989300261,GUDANG GARAM SURYA 12 FILTER,1,20000,0,20000,18150,1850
9/24/2021 12:58,8991909101016,URBAN MILD 16,1,17000,0,17000,15800,1200
9/24/2021 12:58,123124,KOREK BIASA,1,2000,0,2000,1300,700
9/24/2021 12:58,Gula gula tusuk,gula gula tusuk,4,500,0,2000,1600,400
9/24/2021 13:00,8998866201483,POTABEE REGULER GRILLED SEAWEED 35GR,1,5000,0,5000,4150,850
9/24/2021 13:00,TG,TEH GELAS,2,1000,0,2000,1458,542
9/24/2021 13:03,8998866200578,MIE SEDAAP KARI KENTAL,2,2700,0,5400,4662,738
9/24/2021 13:03,8998866200301,MIE SEDAAP GORENG,2,2700,0,5400,4726,674
9/24/2021 13:03,ROTI,ROTI 2000,2,2000,0,4000,3600,400
9/24/2021 13:03,KOPIKO,KOPIKO,1,250,0,250,175,75
9/24/2021 13:10,8998866202770,MIE SEDAAP SALERO PADANG,2,2500,0,5000,4724,276
9/24/2021 13:12,8886001038011,BENG-BENG SCT,1,1500,0,1500,1450,50
9/24/2021 13:12,COKLAT,COKLAT COIN,1,500,0,500,425,75
9/24/2021 14:14,6907992823843,JD MOCHA CRISPY,1,5000,0,5000,4400,600
9/24/2021 14:16,RB,RED BOLD,1,20000,0,20000,18800,1200
9/24/2021 15:12,8999909000773,MARLBORO FILTER BLACK 12,1,17000,0,17000,15950,1050
9/24/2021 15:31,8998866501026,MINYAK GORENG SEDAAP POUCH 1 L,1,15000,0,15000,14110,890
9/24/2021 15:31,089686535044,SUN BERAS MERAH,1,8500,0,8500,7410,1090
9/24/2021 15:34,8998989300261,GUDANG GARAM SURYA 12 FILTER,1,20000,0,20000,18150,1850
9/24/2021 15:34,8850507001152,MOTU ATV,1,10000,0,10000,8000,2000
9/24/2021 15:34,6907992823652,JD CHOCOLATE MILKSHAKE,1,6000,0,6000,5200,800
9/24/2021 16:13,8992761164539,NUTRIBOOST ORANGE 300ML,1,6500,0,6500,5300,1200
9/24/2021 16:13,8991001111883,SILVERQUEEN CHUNKYBAR 33G,1,8000,0,8000,7150,850
9/24/2021 16:44,GGK,PLAYGUM PERMEN KARET,4,500,0,2000,1600,400
9/24/2021 16:45,8992775214008,Garuda Kacang Atom,6,1000,0,6000,4860,1140
9/24/2021 17:01,Gula gula tusuk,gula gula tusuk,2,500,0,1000,800,200
9/24/2021 17:01,lolipop,lolipop,2,1000,0,2000,1700,300
9/24/2021 17:01,8995555121244,SOSIS KIMBO,2,1000,0,2000,1300,700
9/24/2021 17:05,8992761166212,FRESTEA APPLE 350ML,1,4500,0,4500,3000,1500
9/24/2021 17:05,PD,PENDEKAR,3,500,0,1500,1050,450
9/24/2021 17:36,8997218380074,ICHITAN MILK TEA,1,8000,0,8000,6583,1417
9/24/2021 17:36,8998009010231,ULTRA CHO 250,1,6000,0,6000,4784,1216
9/24/2021 17:36,7622201430184,OREO ORIGINAL 38G,1,2000,0,2000,1641,359
9/24/2021 17:36,7622201430153,OREO CHOCOLATE 38G,1,2000,0,2000,1641,359
9/24/2021 17:43,8998989500166,GUDANG GARAM MERAH BESAR 16KS,1,18000,0,18000,17000,1000
9/24/2021 17:49,8992761145026,SPRITE PET 250ML,1,3500,0,3500,2417,1083
9/24/2021 17:49,8997009510055,YOU C1000,1,15000,0,15000,13000,2000
9/24/2021 17:49,8992761164539,NUTRIBOOST ORANGE 300ML,1,6500,0,6500,5300,1200
9/24/2021 17:49,8992775318201,GERY SNACK BANTAL COKLAT,1,2000,0,2000,1712,288
9/24/2021 17:49,8992696523067,MILO ACTVGO UHT 180ML,1,4500,0,4500,3515,985
9/24/2021 18:23,8998989110167,SURYA GUDANG GARAM 16 FILTER,1,26000,0,26000,23700,2300
9/24/2021 19:10,JD VM,JD VANILLA MILKSHAKE,1,5000,0,5000,4300,700
9/24/2021 19:31,8992694242502,ZWITZAL SOAP CALSSIC 70G,1,3800,0,3800,3410,390
9/24/2021 19:31,8999999053307,LIFEBUOY LEMONFRESH 60G,4,2500,0,10000,7644,2356
9/24/2021 19:31,8999999529833,CLEAR SHP ICM UNISEX 9 ML,1,10000,0,10000,9300,700
9/24/2021 19:31,8999999524722,SUNLIGHT LIME NEW PCH 435ML,1,10000,0,10000,9100,900
9/24/2021 19:31,8998866607315,SOKLIN SOFTERGENT SAKURA 770G & PIRING,1,18000,0,18000,16680,1320
9/24/2021 19:31,8991102385091,WFR TANGO CKLT 7G,1,8300,0,8300,7455,845
9/24/2021 19:31,8992959953334,SWEETY BRONZE XL42,1,80000,0,80000,75455,4545
9/24/2021 19:31,8992959020012,SWEETY SILVER PANTS XL34,1,78000,0,78000,73637,4363
9/24/2021 19:31,8992761111533,SPRITE SLIM CAM250ML,1,5000,0,5000,3750,1250
9/24/2021 19:48,8992775318201,GERY SNACK BANTAL COKLAT,1,2000,0,2000,1712,288
9/24/2021 19:48,TG,TEH GELAS,2,1000,0,2000,1458,542
9/24/2021 19:48,8992775315095,GERY MALKIST SWEET CHEESE,1,6500,0,6500,5516,984
9/24/2021 19:49,Gula gula kaki,gula gula kaki,2,500,0,1000,800,200
9/24/2021 19:49,ICE CREAM 3,ICE CREAM 3000,1,3000,0,3000,2600,400
9/24/2021 19:54,8994867000162,ROKOK PUNDIMAS KRETEK16,1,10000,0,10000,8600,1400
9/24/2021 20:03,8998866609494,SOKLIN SOFTERGEN 280G BIRU,1,5000,0,5000,4425,575
9/24/2021 20:03,8999999046996,LIFEBUOY TOTAL10 60G,1,3000,0,3000,1800,1200
9/24/2021 20:03,8992761166052,FRESTEA MELATI 350ML,1,4500,0,4500,3000,1500
9/24/2021 20:10,7992912508305,SWEETY SILVER PANTS L1,1,2500,0,2500,1882,618
9/24/2021 20:18,8992959971109,SFX COMFORT SLIM 36CM 12+1,1,17000,0,17000,15152,1848
9/24/2021 20:19,TUSTEL,TUSUK TELINGA,1,1000,0,1000,833,167
9/24/2021 20:26,Gula gula tusuk,gula gula tusuk,4,500,0,2000,1600,400
9/24/2021 20:40,8998866610087,JAVANA ORIGINAL 350ML,1,3000,0,3000,2150,850
9/24/2021 20:52,8994867007161,ROKOK PENA GOLD 20,1,18000,0,18000,16800,1200
9/24/2021 21:09,8992775001998 pcs,Gery Salut sandiwich pcs,1,1000,0,1000,815,185
9/24/2021 21:09,Vita Jelly,Vita Jelly,2,1000,0,2000,1532,468
9/24/2021 21:33,6907992825069,JD FRUITY,2,5000,0,10000,8800,1200
9/24/2021 22:03,8991102320184,TANGO CHOCO JAVAMOCCA,1,5000,0,5000,4330,670
9/24/2021 22:03,COKLAT,COKLAT COIN,5,500,0,2500,2125,375
9/24/2021 22:03,8992724892844,Coklat mede,3,1000,0,3000,2400,600
9/24/2021 22:11,8992959020005,SWEETY SILVER PANTS XXL5,1,16800,0,16800,15228,1572
9/24/2021 22:11,8992957220025,GOLDEN CITY MINI,1,3000,0,3000,2500,500
9/24/2021 22:20,ARG 330,ARGUS DOS 330ML,1,35000,0,35000,31000,4000
9/25/2021 11:57,6907992823935,JD SWEETCORN,1,3500,0,3500,3000,500
9/25/2021 11:57,6907992825069,JD FRUITY,1,5000,0,5000,4400,600
9/25/2021 11:57,8991102385091,WFR TANGO CKLT 7G,1,8300,0,8300,7455,845
9/25/2021 15:46,8998866610087,JAVANA ORIGINAL 350ML,1,3000,0,3000,2150,850
9/25/2021 15:48,089686535242,SUN PISANG SUSU,1,8500,0,8500,7410,1090
9/25/2021 15:48,COKLAT,COKLAT COIN,1,500,0,500,425,75
9/25/2021 15:51,COKLAT,COKLAT COIN,1,500,0,500,425,75
9/25/2021 15:51,MILKITA,MILKITA,2,250,0,500,400,100
9/25/2021 15:51,8991909101016,URBAN MILD 16,1,17000,0,17000,15800,1200
9/25/2021 16:13,KERUPUK 1000,KERUPUK BALADO,2,1000,0,2000,1800,200
9/25/2021 16:13,ABC,BATERAI ABC BIRU,2,2500,0,5000,3856,1144
9/25/2021 16:17,8998989110129,SURYA KECIL MERAH 12KS,1,20000,0,20000,18450,1550
9/25/2021 16:18,8998989300261,GUDANG GARAM SURYA 12 FILTER,1,20000,0,20000,18150,1850
9/25/2021 16:18,8998989500166,GUDANG GARAM MERAH BESAR 16KS,1,18000,0,18000,17000,1000
9/25/2021 16:19,8991909101016,URBAN MILD 16,1,17000,0,17000,15800,1200
9/25/2021 16:19,GL,GULA 1 LITER,4,11500,0,46000,42000,4000
9/25/2021 16:20,GGK,PLAYGUM PERMEN KARET,6,500,0,3000,2400,600
9/25/2021 16:41,7622300335809,OREO SOFT CAKE,2,2000,0,4000,3282,718
9/25/2021 17:27,8997028590014,ARGUS 220ML,3,500,0,1500,906,594
9/25/2021 17:27,PD,PENDEKAR,2,500,0,1000,700,300
9/25/2021 17:27,KERUPUK,KERUPUK BALADO,1,1000,0,1000,900,100
9/25/2021 18:44,KIKO,KIKO,3,1000,0,3000,1500,1500
9/25/2021 18:44,8992959117613,SFX DAUN SIRIH 1 WP,2,500,0,1000,826,174
9/25/2021 19:04,RB,RED BOLD,1,20000,0,20000,18800,1200
9/25/2021 19:36,8998898337440,TOLAK ANGIN CARE 10ML,1,10000,0,10000,7893,2107
9/25/2021 19:36,8992775913000,CHOCOLATOS CKLT 28G,2,2000,0,4000,3114,886
9/25/2021 19:47,8991002103832,GOOD DAY CHOCOCINNO,1,1500,0,1500,890,610
9/25/2021 19:47,JGR SHN,JOGER SHINY SACHET,1,500,0,500,437,63
9/25/2021 20:20,8996001375372,CHOKI CHOKI,1,1000,0,1000,910,90
9/25/2021 20:20,YP,YUPI,12,250,0,3000,2496,504
9/25/2021 20:26,8992775305102,GERY MALKIST COCONUT,2,6500,0,13000,11032,1968
9/25/2021 20:26,8999999049669,REXONA MEN RO INVISIBLE DRY 45 ML,1,15000,0,15000,13550,1450
9/25/2021 20:57,8993989311699,CLAS MILD 16 FILTER,1,24000,0,24000,21700,2300
9/25/2021 20:57,8999909085114,SAMPOERNA KRETEK HIJAU 12,1,13000,0,13000,11650,1350
9/25/2021 20:57,8998009010231,ULTRA CHO 250,1,6000,0,6000,4784,1216
9/25/2021 20:57,8992696404441,BEAR BRAND 189ML,1,15000,0,15000,11000,4000
9/25/2021 20:57,123124,KOREK BIASA,1,2000,0,2000,1300,700
9/25/2021 20:57,8991102300544,WFR TANGO VNL 176G,1,10000,0,10000,8694,1306
9/25/2021 21:22,8994867007161,ROKOK PENA GOLD 20,1,18000,0,18000,16800,1200
9/25/2021 21:22,8999999031930,PEPSODENT TB TRIPLE CLEAN,1,3500,0,3500,2850,650
9/25/2021 22:14,089686021219,INTER MIE GORENG,4,1000,0,4000,3540,460
9/25/2021 22:14,Telur 3 Biji,Telur 3 Biji,1,5000,0,5000,3600,1400
9/25/2021 22:14,8992959508305,SWEETY,2,2500,0,5000,4000,1000
9/25/2021 22:14,kentang,kripik kentang,1,1000,0,1000,900,100
9/25/2021 22:17,BMO,BERAS MERAH ORGANIK,1,25000,0,25000,23500,1500
9/25/2021 22:42,8992979190986,TOTAL PUTIH SOFTENER,1,15000,0,15000,13524,1476
9/25/2021 22:50,8992761166052,FRESTEA MELATI 350ML,1,4500,0,4500,3000,1500
9/25/2021 22:50,7622300405588,KEJUCAKE 16G,1,2000,0,2000,1641,359
9/25/2021 22:51,8996001314005,ROMA KELAPA CREAM CKLT,1,8000,0,8000,6642,1358
9/25/2021 22:51,089686727081,DORITOS 55G,1,7000,0,7000,5950,1050
9/25/2021 22:51,8998898337440,TOLAK ANGIN CARE 10ML,1,10000,0,10000,7893,2107
9/25/2021 22:51,8992696404441,BEAR BRAND 189ML,1,15000,0,15000,11000,4000
9/26/2021 13:45,8998989110167,SURYA GUDANG GARAM 16 FILTER,1,26000,0,26000,23700,2300
9/26/2021 14:02,Vita Jelly,Vita Jelly,3,1000,0,3000,2298,702
9/26/2021 14:02,8992775001806 pcs,Gery salut malkist chocolate coconut pcs,3,1000,0,3000,2436,564
9/26/2021 15:09,ICE CREAM 3,ICE CREAM 3000,3,3000,0,9000,7800,1200
9/26/2021 15:16,PULPEN SNOWMAN,PULPEN SNOWMAN,1,2500,0,2500,2000,500
9/26/2021 15:16,PUL,PULPEN,1,1500,0,1500,833,667
9/26/2021 16:31,ARG 330,ARGUS DOS 330ML,1,35000,0,35000,31000,4000
9/26/2021 17:04,8999908284907,MY BABY MINYAK TELON 90ML,1,25000,0,25000,22700,2300
9/26/2021 17:04,8998866200325,MIE SEDAAP SOTO,1,2700,0,2700,2282,418
9/26/2021 17:04,8998866200882,SUKSESMIE GORENG AYAM KRMS 133GR,1,3500,0,3500,3047,453
9/26/2021 17:22,8999999059781,SUNLIGHT LIME NEW POUCH 210ML,1,5000,0,5000,4520,480
9/26/2021 17:24,6907992825045,JD CRUNCHY MATCHA CHEESE,1,8000,0,8000,7000,1000
9/26/2021 17:24,8999999024475,CITRA BW PEARLY WHITE LD 400ML,1,21000,0,21000,19000,2000
9/26/2021 17:24,8997218380074,ICHITAN MILK TEA,1,8000,0,8000,6583,1417
9/26/2021 17:24,8999999036607,LUX TS SOFT ROSE 75G,1,3500,0,3500,2800,700
9/26/2021 17:24,8992702000018,INDOMILK PUTIH 370G,1,10000,0,10000,9020,980
9/26/2021 17:35,8997009510055,YOU C1000,2,15000,0,30000,26000,4000
9/26/2021 17:35,8886013213208,FRENCH FREIS 2000,1,5000,0,5000,3750,1250
9/26/2021 17:41,8934868015024,REXONA DEO LOTION FREE SPIRIT 9G,2,2500,0,5000,4000,1000
9/26/2021 17:43,8992761111533,SPRITE SLIM CAM250ML,1,5000,0,5000,3750,1250
9/26/2021 18:16,8991102714860,MILKIDO STRAW,1,3000,0,3000,2153,847
9/26/2021 18:42,8991102026383,AIR CRYSTALINE 1.5 L,1,5000,0,5000,3471,1529
9/26/2021 18:42,8998866603676,FRES&NATURAL SOAP GREEN 65G,1,1800,0,1800,1425,375
9/26/2021 18:42,8998866603669,FRES&NATURAL SOAP WHITE 65G,1,1800,0,1800,1425,375
9/26/2021 18:50,Gula gula tusuk,gula gula tusuk,2,500,0,1000,800,200
9/26/2021 19:06,089686044249,SUPERMI NUTRIMI STEAK AYAM,2,3500,0,7000,5600,1400
9/26/2021 19:27,8993989311279,CLAS MILD 12,1,18000,0,18000,15800,2200
9/26/2021 19:28,8997009510017,YOU C1000 LEMON,1,10000,0,10000,9166,834
9/26/2021 19:34,ARG,ARGUS DOS 220ML,1,14500,0,14500,13300,1200
9/26/2021 19:34,8997027300089,NOMOS,1,4000,0,4000,2963,1037
9/26/2021 19:34,6907992823645,JD COCONUT BLISS,1,4000,0,4000,3500,500
9/26/2021 19:51,Vita Jelly,Vita Jelly,2,1000,0,2000,1532,468
9/26/2021 19:51,KIKO,KIKO,1,1000,0,1000,500,500
9/26/2021 20:03,8992959930748,CONFI PANTS L10,2,5000,0,10000,8516,1484
9/26/2021 20:03,8992959930762,CONFI CLASS DAY XL1,4,6500,0,26000,22728,3272
9/26/2021 20:03,ICE CREAM 3,ICE CREAM 3000,1,3000,0,3000,2600,400
9/26/2021 20:04,8991909101016,URBAN MILD 16,1,17000,0,17000,15800,1200
9/26/2021 20:25,8999801700054,SUSU FOYU 1 KG,1,22000,0,22000,19791,2209
9/26/2021 20:28,8997028590014,ARGUS 220ML,2,500,0,1000,604,396
9/26/2021 20:28,8995555171225,KIMBO SOSIS,2,1000,0,2000,1800,200
9/26/2021 20:36,8991102989381,TANGO LONG BUBBLEGUM 130G,1,5000,0,5000,4345,655
9/26/2021 20:36,8992696521797,MILO 22G,1,2500,0,2500,1572,928
9/26/2021 20:36,COKLAT,COKLAT COIN,5,500,0,2500,2125,375
9/26/2021 20:42,8997013180046,Tissu Tessi B,1,11000,0,11000,9800,1200
9/26/2021 21:06,MOBIL,GULA GULA HP,1,2000,0,2000,1700,300
9/26/2021 21:06,8995555171225,KIMBO SOSIS,1,1000,0,1000,900,100
9/26/2021 21:15,8998866202244,EKOMIE BUMBU KALDU AYAM,2,1000,0,2000,1596,404
9/26/2021 21:15,8992775315057,GERY SALUT MALKIST COKLAT,1,6500,0,6500,5516,984
9/26/2021 21:15,8998866202602,KRISBEE FRENCH FRIES 18GR,2,2000,0,4000,3000,1000
9/26/2021 22:11,089686611670,QTELA BALADO,1,5000,0,5000,4266,734
9/26/2021 22:11,089686727074,DORITOS 160G,1,12000,0,12000,10700,1300
9/26/2021 22:11,8992761166205,FRESTEA GREEN HONEY 350ML,1,4500,0,4500,3000,1500
9/26/2021 22:11,8998866201490,POTABEE REGULER GRILLED SEAWED 68 GR,1,8000,0,8000,7200,800
9/26/2021 22:11,8992760221028,OREO ORIGINAL 133G,1,8000,0,8000,6300,1700
9/26/2021 22:12,089686727074,DORITOS 160G,2,12000,0,24000,21400,2600
9/26/2021 22:13,8992761122331,FRESTEA APPEL 500ML,1,6500,0,6500,4791,1709
9/26/2021 22:14,8991001503336,chacha minis hat,1,7500,0,7500,6400,1100
9/26/2021 22:18,8991102026383,AIR CRYSTALINE 1.5 L,2,5000,0,10000,6942,3058
9/26/2021 22:18,COKLAT,COKLAT COIN,2,500,0,1000,850,150
9/26/2021 22:19,9556001025272,NESCAFE LATTE 240ML,1,8500,0,8500,7834,666
9/26/2021 22:19,8997009510055,YOU C1000,1,15000,0,15000,13000,2000
9/26/2021 22:19,8992696404441,BEAR BRAND 189ML,1,15000,0,15000,11000,4000
9/26/2021 22:19,8998866610377,ISOPLUS,1,3000,0,3000,2350,650
9/26/2021 22:19,6907992823904,JD CRUNCHY CHOCOLATE VAN,1,8000,0,8000,6800,1200
9/27/2021 8:44,8998866608558,SOKLIN SOFTERGENT BIRU 770G & PIRING,2,18000,0,36000,32110,3890
9/27/2021 8:44,8998866619004,ROYALE SUNNY DAY,2,5000,0,10000,9120,880
9/27/2021 8:44,8992696523067,MILO ACTVGO UHT 180ML,2,4500,0,9000,7030,1970
9/27/2021 8:44,8995555121244,SOSIS KIMBO,5,1000,0,5000,3250,1750
9/27/2021 8:44,8992388133345,NU MILK TEA TEH TARIK 330ML,1,6000,0,6000,5125,875
9/27/2021 8:44,089686611670,QTELA BALADO,1,5000,0,5000,4266,734
9/27/2021 8:44,8996001312278,MALKIST KEJU MANIS,1,6500,0,6500,5400,1100
9/27/2021 8:48,8996001355237,SUPER STAR,1,11000,0,11000,9900,1100
9/27/2021 8:48,8991002307209,COFFE CANDY,1,6000,0,6000,5000,1000
9/27/2021 8:48,8998866200325,MIE SEDAAP SOTO,1,2700,0,2700,2282,418
9/27/2021 8:58,8998866612173,SOKLIN SOFTERGENT PINK 770G & PIRING,1,18000,0,18000,16055,1945
9/27/2021 8:58,8992959117583,SFX DS REG FLOW WING 20,1,5000,0,5000,4288,712
9/27/2021 8:58,089686386127,BUMBU RACIK NASI GORENG SOSIS,2,2000,0,4000,3240,760
9/27/2021 8:58,TUSTEL,TUSUK TELINGA,1,1000,0,1000,833,167
9/27/2021 8:58,8886001038011,BENG-BENG SCT,1,1500,0,1500,1450,50
9/27/2021 8:58,COKLAT,COKLAT COIN,4,500,0,2000,1700,300
9/27/2021 8:58,8993072254018,MELROSE COTTON BUDS BSR,1,5000,0,5000,4050,950
9/27/2021 8:58,8998898847109,KOPI JAHE,1,1500,0,1500,1180,320
9/27/2021 8:58,Telur 3 Biji,Telur 3 Biji,1,5000,0,5000,3600,1400
9/27/2021 8:58,KERUPUK 1000,KERUPUK BALADO,2,1000,0,2000,1800,200
9/27/2021 8:58,089686021141,INTER MIE SOTO,1,1000,0,1000,854,146
9/27/2021 8:58,8991002103535,GOOD DAY ORIGINAL,2,1500,0,3000,1780,1220
9/27/2021 8:58,8991102987875,WFR TANGO POUCH CKL 115G,1,8000,0,8000,6786,1214
9/27/2021 8:58,8992775001783,GERY SALUT MALKIST KELAPA,1,6500,0,6500,5516,984
9/27/2021 8:58,8991102387286,TANGO LONG CKLT 47G,1,2000,0,2000,1551,449
9/27/2021 8:58,8998866610087,JAVANA ORIGINAL 350ML,1,3000,0,3000,2150,850
9/27/2021 8:58,4902430745703,DOWNY SUNRISE FRESH 10ML,4,500,0,2000,1572,428
9/27/2021 8:58,8997003910684,2CS,1,3000,0,3000,1500,1500
9/27/2021 8:58,Vita Jelly,Vita Jelly,1,1000,0,1000,766,234
9/27/2021 8:58,7622201430153,OREO CHOCOLATE 38G,1,2000,0,2000,1641,359
9/27/2021 8:58,8998866202602,KRISBEE FRENCH FRIES 18GR,1,2000,0,2000,1500,500
9/27/2021 8:58,8992696521797,MILO 22G,1,2500,0,2500,1572,928
9/27/2021 8:58,8999909982000,SAMPOERNA 12 FILTER,1,19000,0,19000,16600,2400
9/27/2021 8:58,8992759120264,LARISST 220,1,10000,0,10000,9200,800
9/27/2021 8:58,YP,YUPI,6,250,0,1500,1248,252
9/27/2021 9:37,8993072254018,MELROSE COTTON BUDS BSR,1,5000,0,5000,4050,950
9/27/2021 9:37,8992806145417,SCOTCH BRITE,1,3500,0,3500,2407,1093
9/27/2021 9:37,JGR SHN,JOGER SHINY SACHET,1,500,0,500,437,63
9/27/2021 9:38,8992957220025,GOLDEN CITY MINI,1,3000,0,3000,2500,500
9/27/2021 9:38,SURYA,SURYA,2,500,0,1000,1000,0
9/27/2021 9:38,Garuda Pilus,Garuda Pilus Rasa Abon Pcs,2,500,0,1000,802,198
9/27/2021 9:57,8998866605113,CLING KUNING BTL 440ML,1,8500,0,8500,7600,900
9/27/2021 9:57,089686043273,INDOMIE SAMBAL RICA,1,2700,0,2700,2452,248
9/27/2021 9:57,8992957220025,GOLDEN CITY MINI,1,3000,0,3000,2500,500
9/27/2021 10:30,8998866619035,Royale Sweet Floral 13 ml,1,5000,0,5000,4452,548
9/27/2021 10:30,8999999520885,WIPOL 500 ML,1,10000,0,10000,8600,1400
9/27/2021 10:30,8998866808248,SOKLIN LAVENDER 490 GRAM,1,18000,0,18000,17000,1000
9/27/2021 10:30,9556001004673,MILO NESTLE MALAYSIA ACTIVE GO,1,85000,0,85000,80000,5000
9/27/2021 10:30,089686611618,QTELA BARBEQUE,3,5000,0,15000,12798,2202
9/27/2021 10:30,089686611878,QTELA TEMPE,1,6000,0,6000,5370,630
9/27/2021 10:30,8999999706180,PEPSODENT WHITE 190GR,1,10000,0,10000,9350,650
9/27/2021 10:30,8998866606158,NUVO ACTIVE COOL 110G,1,3000,0,3000,2600,400
9/27/2021 10:30,8999999525590,PEPSODENT TB KIDS,1,12900,0,12900,11700,1200
9/27/2021 10:30,8999999390198,SUNLIGHT LIME NEW POUCH 755ML,3,18000,0,54000,47850,6150
9/27/2021 10:30,8992696405417,DNCO INSTANT 27G,3,3500,0,10500,9000,1500
9/27/2021 10:30,8992696523067,MILO ACTVGO UHT 180ML,2,4500,0,9000,7030,1970
9/27/2021 10:30,8997011700123,BIHUN JAGUNG 300GR,1,6000,0,6000,4979,1021
9/27/2021 10:30,8886020033431,KAPUR AJAIB ANTI KECOA DAN NYAMUK,1,3000,0,3000,2700,300
9/27/2021 10:30,TBR,TEPUNG BERAS ROSE BRAND,2,8000,0,16000,11600,4400
9/27/2021 10:30,8992702000018,INDOMILK PUTIH 370G,1,10000,0,10000,9020,980
9/27/2021 10:30,8994023000050,MEGKEJU SERBAGUNA 165G,1,13000,0,13000,12000,1000
9/27/2021 10:30,8992628510158,SIMAS PALMIA,1,6000,0,6000,4832,1168
9/27/2021 10:30,8997213204900,INLITE 30W,2,110000,0,220000,210000,10000
9/27/2021 10:30,8997213204887,INLITE 20W,1,68000,0,68000,65000,3000
9/27/2021 10:30,711844110113,KECAP ABC 135 ML,1,7000,0,7000,6400,600
9/27/2021 10:30,8991689668006,SWALLOW,6,3500,0,21000,21000,0
9/27/2021 10:30,8991002105409,KOPI KAPAL API,1,20000,0,20000,18888,1112
9/27/2021 10:30,8998866107112,WET WIPES KODOMO  BABY 50SHT,1,20000,0,20000,14150,5850
9/27/2021 10:30,TELUR RAK,TELUR RAK,1,38000,0,38000,35000,3000
9/27/2021 10:30,8992696404441,BEAR BRAND 189ML,1,15000,0,15000,11000,4000
9/27/2021 10:31,089686611670,QTELA BALADO,1,5000,0,5000,4266,734
9/27/2021 11:19,089686021127,INTER MIE KALDU,1,1000,0,1000,813,187
9/27/2021 11:19,8999999046996,LIFEBUOY TOTAL10 60G,1,3000,0,3000,1800,1200
9/27/2021 13:08,8991102022460,FORMULA DIAMOND,1,3000,0,3000,2500,500
9/27/2021 13:08,8997028590045,ARGUS BTL 330ML,1,2000,0,2000,1291,709
9/27/2021 13:08,8998989300261,GUDANG GARAM SURYA 12 FILTER,1,20000,0,20000,18150,1850
9/27/2021 13:08,RB,RED BOLD,1,20000,0,20000,18800,1200
9/27/2021 14:18,8994867000179,ROKOK PENA MILD 16,1,14500,0,14500,13500,1000
9/27/2021 15:30,8992775311509,gery garuda,2,1000,0,2000,1400,600
9/27/2021 15:30,8992775001844,Chocolatos original taste,3,1000,0,3000,2487,513
9/27/2021 16:26,089686386127,BUMBU RACIK NASI GORENG SOSIS,1,2000,0,2000,1620,380
9/27/2021 16:38,8999909000971,MAGNUM MILD 20,1,24000,0,24000,22750,1250
9/27/2021 16:46,6907992823867,JD CRUNCHY CHOCOLATE MALT,1,5500,0,5500,4700,800
9/27/2021 16:46,8999999037765,pepsodent 225 gr,1,12000,0,12000,10500,1500
9/27/2021 16:46,8991909101016,URBAN MILD 16,1,17000,0,17000,15800,1200
9/27/2021 17:04,8991102026383,AIR CRYSTALINE 1.5 L,1,5000,0,5000,3471,1529
9/27/2021 17:32,GL,GULA 1 LITER,3,11500,0,34500,31500,3000
9/27/2021 17:32,8997231980022,O'JELLY MINI STRAWBERRY,1,3000,0,3000,2250,750
9/27/2021 17:32,JGR SHN,JOGER SHINY SACHET,5,500,0,2500,2185,315
9/27/2021 18:10,8991001503107,CHACHA PEANUT 35GR,1,5500,0,5500,4900,600
9/27/2021 18:10,OJELLY,O'JELLY,1,500,0,500,385,115
9/27/2021 18:10,8999909002821,MARLBORO BLACK 16,1,22000,0,22000,20850,1150
9/27/2021 18:20,8992806145417,SCOTCH BRITE,2,3500,0,7000,4814,2186
9/27/2021 18:20,8999999524722,SUNLIGHT LIME NEW PCH 435ML,1,10000,0,10000,9100,900
9/27/2021 18:21,KOPIKO,KOPIKO,12,250,0,3000,2100,900
9/27/2021 18:21,8997028590014,ARGUS 220ML,1,500,0,500,302,198
9/27/2021 18:21,OJELLY,O'JELLY,1,500,0,500,385,115
9/27/2021 19:25,8997222130016,Lemonilo Mie Goreng,2,7500,0,15000,12000,3000
9/27/2021 19:26,8998866501033,MINYAK GORENG SEDAAP POUCH 2L,1,32000,0,32000,29683,2317
9/27/2021 19:26,8997011700123,BIHUN JAGUNG 300GR,1,6000,0,6000,4979,1021
9/27/2021 19:32,8994834003752,TICTIC,2,2000,0,4000,3400,600
9/27/2021 20:03,8998009010231,ULTRA CHO 250,1,6000,0,6000,4784,1216
9/27/2021 20:03,8997009510055,YOU C1000,1,15000,0,15000,13000,2000
9/27/2021 20:05,089686611618,QTELA BARBEQUE,1,5000,0,5000,4266,734
9/27/2021 20:05,8997218380074,ICHITAN MILK TEA,1,8000,0,8000,6583,1417
9/27/2021 20:06,8992959953037,SWEETY BRONZE L1,2,2500,0,5000,3638,1362
9/27/2021 20:07,7992912508305,SWEETY SILVER PANTS L1,2,2500,0,5000,3764,1236
9/27/2021 20:43,8998989300261,GUDANG GARAM SURYA 12 FILTER,1,20000,0,20000,18150,1850
9/27/2021 21:26,8998866200301,MIE SEDAAP GORENG,2,2700,0,5400,4726,674
9/27/2021 21:26,8998866200325,MIE SEDAAP SOTO,1,2700,0,2700,2282,418
9/27/2021 21:29,8997222130191,Lemonilo Ayam Bawang,1,7500,0,7500,6000,1500
9/27/2021 21:29,MILKITA,MILKITA,2,250,0,500,400,100
9/28/2021 10:27,8998866202671,NOODLE SEDAAP MIE KOREAN SPICY SOUP CUP,2,5000,0,10000,8004,1996
9/28/2021 10:31,8998989500166,GUDANG GARAM MERAH BESAR 16KS,2,18000,0,36000,34000,2000
9/28/2021 10:31,8993379200879,SABUN HARMONY MELON 70G,1,2000,0,2000,1652,348
9/28/2021 10:31,8998866200301,MIE SEDAAP GORENG,1,2700,0,2700,2363,337
9/28/2021 10:31,8998866202626,Top Kopi Gula Aren 22gr,2,1000,0,2000,1106,894
9/28/2021 11:29,8998866601436,PODET DAIA BUNGA BAG 850GR & PIRING,1,18000,0,18000,15627,2373
9/28/2021 11:31,GL,GULA 1 LITER,1,11500,0,11500,10500,1000
9/28/2021 11:31,8992628024143,MINYAK GORENG BIMOLI 620ML,1,15000,0,15000,13900,1100
9/28/2021 11:31,8999999195649,SARIWANGI 25X1.86G,1,6000,0,6000,5202,798
9/28/2021 12:31,Telur 3 Biji,Telur 3 Biji,1,5000,0,5000,3600,1400
9/28/2021 12:33,8998866603676,FRES&NATURAL SOAP GREEN 65G,1,1800,0,1800,1425,375
9/28/2021 12:33,8998866613729,EMERON LOVELY NTRL 100ML,1,3500,0,3500,2900,600
9/28/2021 12:34,MILKITA,MILKITA,8,250,0,2000,1600,400
9/28/2021 12:34,8994867007161,ROKOK PENA GOLD 20,1,18000,0,18000,16800,1200
9/28/2021 13:38,8886001038011,BENG-BENG SCT,2,1500,0,3000,2900,100
9/28/2021 13:40,6907992825076,JD WATERMELON APPLE,1,2000,0,2000,1700,300
9/28/2021 13:40,8998866200301,MIE SEDAAP GORENG,1,2700,0,2700,2363,337
9/28/2021 13:40,MILKITA,MILKITA,1,250,0,250,200,50
9/28/2021 14:04,8991102026383,AIR CRYSTALINE 1.5 L,2,5000,0,10000,6942,3058
9/28/2021 14:15,6907992823867,JD CRUNCHY CHOCOLATE MALT,3,5500,0,16500,14100,2400
9/28/2021 16:37,8995555171225,KIMBO SOSIS,1,1000,0,1000,900,100
9/28/2021 16:37,TG,TEH GELAS,1,1000,0,1000,729,271
9/28/2021 16:37,MILKITA,MILKITA,2,250,0,500,400,100
9/28/2021 16:42,8999909001909,MAGNUM REVAMP BLACK 12,1,18000,0,18000,16300,1700
9/28/2021 16:42,7622300335755,OREO SOFT CAKE BOX,1,22000,0,22000,19700,2300
9/28/2021 16:55,TG,TEH GELAS,2,1000,0,2000,1458,542
9/28/2021 16:55,8998866610087,JAVANA ORIGINAL 350ML,3,3000,0,9000,6450,2550
9/28/2021 16:55,8992761166205,FRESTEA GREEN HONEY 350ML,1,4500,0,4500,3000,1500
9/28/2021 16:55,8992761166052,FRESTEA MELATI 350ML,1,4500,0,4500,3000,1500
9/28/2021 16:55,8998866610377,ISOPLUS,1,3000,0,3000,2350,650
9/28/2021 16:55,8994834006128,TICTIC PEDAS,1,2000,0,2000,1700,300
9/28/2021 17:46,8991102303309,WFR TANGO SBJ 176G,1,10000,0,10000,8694,1306
9/28/2021 18:36,8992775110157,GARUDA KACANG KULIT,1,5000,0,5000,3925,1075
9/28/2021 18:36,8996001314005,ROMA KELAPA CREAM CKLT,1,8000,0,8000,6642,1358
9/28/2021 18:42,8992959076200,HN PANTS M34,1,50000,0,50000,45455,4545
9/28/2021 18:42,8992959107515,SFX NON WING 23CM 8,1,4000,0,4000,3288,712
9/28/2021 18:42,8996001305058,ROMA SANDWICH KACANG,1,7000,0,7000,5928,1072
9/28/2021 18:42,7622210580276,OREO CHOCOLATE CREAM 66.5 G,1,4000,0,4000,3200,800
9/28/2021 18:42,8997231980022,O'JELLY MINI STRAWBERRY,1,3000,0,3000,2250,750
9/28/2021 18:42,8991102026383,AIR CRYSTALINE 1.5 L,1,5000,0,5000,3471,1529
9/28/2021 18:42,8992388133345,NU MILK TEA TEH TARIK 330ML,1,6000,0,6000,5125,875
9/28/2021 18:42,6907992823645,JD COCONUT BLISS,2,4000,0,8000,7000,1000
9/28/2021 18:42,8992716109172,BISKUAT BOLU SCT,1,2000,0,2000,1641,359
9/28/2021 18:42,7622300335809,OREO SOFT CAKE,1,2000,0,2000,1641,359
9/28/2021 18:42,8997018720018,SIRUP DHT,1,23000,0,23000,20958,2042
9/28/2021 18:46,OJELLY,O'JELLY,3,500,0,1500,1155,345
9/28/2021 18:46,8991102714846,MILKIDO CKLT,1,3000,0,3000,2153,847
9/28/2021 18:59,8992388133017,NU MILK TEA ORI 330ML,1,6000,0,6000,5125,875
9/28/2021 19:13,8998866202626,Top Kopi Gula Aren 22gr,15,866,0,12990,8295,4695
9/28/2021 19:13,8992761122331,FRESTEA APPEL 500ML,1,6500,0,6500,4791,1709
9/28/2021 19:22,8991002103436,GOOD DAY COOLIN,1,1500,0,1500,890,610
9/28/2021 19:24,6907992825076,JD WATERMELON APPLE,1,2000,0,2000,1700,300
9/28/2021 19:32,6907992824963,JD MILKY CHOCOLATE,1,3000,0,3000,2600,400
9/28/2021 19:32,OJELLY,O'JELLY,10,500,0,5000,3850,1150
9/28/2021 20:37,ARG,ARGUS DOS 220ML,3,14500,0,43500,39900,3600
9/28/2021 20:37,GGK,PLAYGUM PERMEN KARET,3,500,0,1500,1200,300
9/28/2021 20:49,8999999030186,PEPSODENT ACTION 123 COMPLETE 190G,1,14000,0,14000,13200,800
9/28/2021 20:49,GL,GULA 1 LITER,1,11500,0,11500,10500,1000
9/28/2021 20:49,MILKITA,MILKITA,2,250,0,500,400,100
9/28/2021 20:59,8998989110167,SURYA GUDANG GARAM 16 FILTER,1,26000,0,26000,23700,2300
9/28/2021 21:02,8999909002821,MARLBORO BLACK 16,1,22000,0,22000,20850,1150
9/28/2021 21:50,kri,kripik pisang,1,5000,0,5000,4000,1000
9/28/2021 22:03,089686021127,INTER MIE KALDU,2,1000,0,2000,1626,374
9/28/2021 22:19,8992696521797,MILO 22G,2,2500,0,5000,3144,1856
9/28/2021 22:33,8992761139018,ADES 600ML,1,3500,0,3500,2166,1334
9/28/2021 22:33,ARGUS,ARGUS,1,2000,0,2000,1500,500
9/28/2021 22:47,8995333060703,TERIGU KOMPAS 1KG,2,10500,0,21000,19632,1368
9/28/2021 22:47,8993001003908,INDOMILK KENTAL MANIS 545G,3,15000,0,45000,39999,5001
9/28/2021 22:47,8992775000076,GERY SNACK RING CKLT,1,2000,0,2000,1712,288
9/28/2021 22:47,8997028590052,ARGUS BTL 600ML,1,3000,0,3000,1458,1542
9/29/2021 10:03,8999999009601,LIFEBUOY TOTAL10 500ML,1,38500,0,38500,36080,2420
9/29/2021 10:06,711844110083,KECAP ABC 275 ML,1,15000,0,15000,14000,1000
9/29/2021 10:06,8995333060772,TERIGU GATOT KACA 500GR,1,5000,0,5000,4346,654
9/29/2021 10:07,8992775315057,GERY SALUT MALKIST COKLAT,1,6500,0,6500,5516,984
9/29/2021 10:07,8997009510123,ORANGE WATER,2,11000,0,22000,20832,1168
9/29/2021 10:08,8997028590052,ARGUS BTL 600ML,1,3000,0,3000,1458,1542
9/29/2021 10:08,8991102714594,TANGO DRINK BLCK VNL,1,5000,0,5000,3818,1182
9/29/2021 10:10,8992388133017,NU MILK TEA ORI 330ML,1,6000,0,6000,5125,875
9/29/2021 10:10,PRG,PARAGO,8,500,0,4000,3200,800
9/29/2021 10:11,8997028590052,ARGUS BTL 600ML,2,3000,0,6000,2916,3084
9/29/2021 10:12,8992775305102,GERY MALKIST COCONUT,1,6500,0,6500,5516,984
9/29/2021 10:12,8992775315095,GERY MALKIST SWEET CHEESE,1,6500,0,6500,5516,984
9/29/2021 10:40,8992761139018,ADES 600ML,3,3500,0,10500,6498,4002
9/29/2021 10:40,8992388133345,NU MILK TEA TEH TARIK 330ML,1,6000,0,6000,5125,875
9/29/2021 10:40,8992775305102,GERY MALKIST COCONUT,1,6500,0,6500,5516,984
9/29/2021 10:40,8991102714846,MILKIDO CKLT,1,3000,0,3000,2153,847
9/29/2021 10:40,7622201430153,OREO CHOCOLATE 38G,1,2000,0,2000,1641,359
9/29/2021 10:40,PRG,PARAGO,2,500,0,1000,800,200
9/29/2021 10:40,MILKITA,MILKITA,12,250,0,3000,2400,600
9/29/2021 10:40,8997003910684,2CS,2,3000,0,6000,3000,3000
9/29/2021 10:40,8993989311279,CLAS MILD 12,1,18000,0,18000,15800,2200
9/29/2021 10:40,8998866618144,NUVO FAMILY UNGU 76G,2,2000,0,4000,3760,240
9/29/2021 10:40,8997028590014,ARGUS 220ML,2,500,0,1000,604,396
9/29/2021 10:40,8998866202626,Top Kopi Gula Aren 22gr,2,1000,0,2000,1106,894
9/29/2021 10:40,6907992823843,JD MOCHA CRISPY,1,5000,0,5000,4400,600
9/29/2021 10:40,Vita Jelly,Vita Jelly,1,1000,0,1000,766,234
9/29/2021 10:40,8995555171225,KIMBO SOSIS,1,1000,0,1000,900,100
9/29/2021 10:40,Pulpen,pulpen,5,1000,0,5000,3750,1250
9/29/2021 10:40,8994834003752,TICTIC,1,2000,0,2000,1700,300
9/29/2021 10:40,8991102228053,TEH GELAS BOTOL,1,3000,0,3000,1695,1305
9/29/2021 10:40,KOPIKO,KOPIKO,16,250,0,4000,2800,1200
9/29/2021 10:40,8992775002933,GERY MALKIST DOUBLE ABON,1,6500,0,6500,5516,984
9/29/2021 10:40,8991102308861,FULLO BLASTO,2,16000,0,32000,29090,2910
9/29/2021 10:40,8992742360844,POLYTEX SABUT STENLESS,1,4000,0,4000,2200,1800
9/29/2021 10:40,8998866202053,POTABEE AYAM BAKAR PEDAS 68GR,1,8000,0,8000,7200,800
9/29/2021 10:40,ARGUS,ARGUS,4,2000,0,8000,6000,2000
9/29/2021 10:40,8992775305164,GERY MALKIST GREEN TEA,1,6500,0,6500,5500,1000
9/29/2021 10:40,8994867000179,ROKOK PENA MILD 16,1,14500,0,14500,13500,1000
9/29/2021 11:14,8997028590052,ARGUS BTL 600ML,1,3000,0,3000,1458,1542
9/29/2021 11:19,8997028590052,ARGUS BTL 600ML,1,3000,0,3000,1458,1542
9/29/2021 11:31,8992761166052,FRESTEA MELATI 350ML,1,4500,0,4500,3000,1500
9/29/2021 11:38,8991102308892,BLASTO,2,1000,0,2000,1990,10
9/29/2021 11:38,8991001502926,Chaca Peanut,2,1000,0,2000,1600,400
9/29/2021 11:38,Gula gula tusuk,gula gula tusuk,2,500,0,1000,800,200
9/29/2021 11:38,MILKITA,MILKITA,4,250,0,1000,800,200
9/29/2021 11:49,8998866201865,KRISBEE PILLOW CHOCOLAVA 120 GR,1,8000,0,8000,7250,750
9/29/2021 11:49,8997028590052,ARGUS BTL 600ML,1,3000,0,3000,1458,1542
9/29/2021 12:16,8997028590052,ARGUS BTL 600ML,1,3000,0,3000,1458,1542
9/29/2021 12:16,8997028590014,ARGUS 220ML,4,500,0,2000,1208,792
9/29/2021 12:48,8992775002582,DILAN CHOCO,1,2000,0,2000,1503,497
9/29/2021 12:48,8994867007161,ROKOK PENA GOLD 20,1,18000,0,18000,16800,1200
9/29/2021 12:53,8992761122331,FRESTEA APPEL 500ML,1,6500,0,6500,4791,1709
9/29/2021 12:53,8992761002039,FANTA STRAWBERRY PET 390 ML,1,5500,0,5500,4333,1167
9/29/2021 12:53,8991102300421,WFR TANGO COKLAT 176GR,1,10000,0,10000,8694,1306
9/29/2021 12:53,8996001305119,ARDEN 30G,1,2000,0,2000,1650,350
9/29/2021 13:03,KPS,KAPAS MEI QIAN,1,5000,0,5000,4750,250
9/29/2021 13:03,8992696520103,DNCO INSTANT CKLT 39G,3,3500,0,10500,9000,1500
9/29/2021 14:07,8998866610377,ISOPLUS,1,3000,0,3000,2350,650
9/29/2021 14:13,8998866619004,ROYALE SUNNY DAY,1,5000,0,5000,4560,440
9/29/2021 14:22,MATERAI,MATERAI,1,15000,0,15000,10000,5000
9/29/2021 14:22,8992761122331,FRESTEA APPEL 500ML,1,6500,0,6500,4791,1709
9/29/2021 14:22,8997231980022,O'JELLY MINI STRAWBERRY,1,3000,0,3000,2250,750
9/29/2021 14:22,8992730002992,HAI CANDY,1,7000,0,7000,6000,1000
9/29/2021 14:24,KOPIKO,KOPIKO,2,250,0,500,350,150
9/29/2021 14:44,Gula gula tusuk,gula gula tusuk,6,500,0,3000,2400,600
9/29/2021 14:44,8991909101016,URBAN MILD 16,1,17000,0,17000,15800,1200
9/29/2021 14:44,MATERAI,MATERAI,3,15000,0,45000,30000,15000
9/29/2021 15:19,8998866203227,MIE SEDAAP AYAM BAKAR LIMAU,1,2700,0,2700,2163,537
9/29/2021 15:19,8998866200325,MIE SEDAAP SOTO,2,2700,0,5400,4564,836
9/29/2021 15:19,8998989300261,GUDANG GARAM SURYA 12 FILTER,1,20000,0,20000,18150,1850
9/29/2021 15:41,Telur 3 Biji,Telur 3 Biji,1,5000,0,5000,3600,1400
9/29/2021 15:41,8991102387286,TANGO LONG CKLT 47G,1,2000,0,2000,1551,449
9/29/2021 15:41,089686021141,INTER MIE SOTO,3,1000,0,3000,2562,438
9/29/2021 15:41,8992775311509,gery garuda,1,1000,0,1000,700,300
9/29/2021 15:59,Vita Jelly,Vita Jelly,1,1000,0,1000,766,234
9/29/2021 15:59,HT,HOT-HOT,1,500,0,500,350,150
9/29/2021 16:15,8994834003752,TICTIC,2,2000,0,4000,3400,600
9/29/2021 16:15,KRZ,KREZZ COKELAT,1,1000,0,1000,715,285
9/29/2021 16:15,8992761002022,SPRITE PET 390ML,1,5500,0,5500,4333,1167
9/29/2021 16:50,7622300335809,OREO SOFT CAKE,1,2000,0,2000,1641,359
9/29/2021 17:01,Garuda Pilus,Garuda Pilus Rasa Abon Pcs,1,500,0,500,401,99
9/29/2021 17:01,8992775511206,LEO 10GR,1,1000,0,1000,848,152
9/29/2021 17:01,8886013257400,TWISTKO,1,1000,0,1000,900,100
9/29/2021 17:01,MILKITA,MILKITA,2,250,0,500,400,100
9/29/2021 17:01,7622201430184,OREO ORIGINAL 38G,1,2000,0,2000,1641,359
9/29/2021 17:01,8994867000162,ROKOK PUNDIMAS KRETEK16,1,10000,0,10000,8600,1400
9/29/2021 17:30,8992959117583,SFX DS REG FLOW WING 20,1,5000,0,5000,4288,712
9/29/2021 17:48,711844110113,KECAP ABC 135 ML,1,7000,0,7000,6400,600
9/29/2021 17:48,8998866609487,SOKLIN SOFTERGEN 280G,1,5000,0,5000,4425,575
9/29/2021 18:05,8992775001653,GERY SALUT CHOCOLATE COCONUT,2,2000,0,4000,2952,1048
9/29/2021 18:05,8886001038011,BENG-BENG SCT,1,1500,0,1500,1450,50
9/29/2021 18:05,8992716109172,BISKUAT BOLU SCT,1,2000,0,2000,1641,359
9/29/2021 18:05,7622300335809,OREO SOFT CAKE,1,2000,0,2000,1641,359
9/29/2021 18:05,7622300405588,KEJUCAKE 16G,1,2000,0,2000,1641,359
9/29/2021 18:42,8995333060703,TERIGU KOMPAS 1KG,1,10500,0,10500,9816,684
9/29/2021 19:16,8998866202770,MIE SEDAAP SALERO PADANG,1,2500,0,2500,2362,138
9/29/2021 19:55,8992959117613,SFX DAUN SIRIH 1 WP,10,500,0,5000,4130,870
9/29/2021 20:28,8998866500579,BABY HAPPY PANTS XL 7P,1,17000,0,17000,14827,2173
9/29/2021 21:09,8998866202619,MIE SEDAAP KOREAN SPICY SOUP,1,2700,0,2700,2322,378
9/29/2021 21:09,8998866608046,KECAP MANIS SEDAAP POUCH 225ML,1,8500,0,8500,7744,756
9/29/2021 21:09,8992702000063,INDOMILK COKLAT 370G,1,10000,0,10000,9020,980
9/29/2021 21:09,8992775000076,GERY SNACK RING CKLT,2,2000,0,4000,3424,576
9/29/2021 21:09,8992628020152,MINYAK GOREG BIMOLI POUCH 2L,1,32000,0,32000,29800,2200
9/29/2021 21:09,9556006012093,JB BATH TOPTOETOE 200ML,1,16000,0,16000,14820,1180
9/29/2021 21:36,9556001025272,NESCAFE LATTE 240ML,1,8500,0,8500,7834,666
9/29/2021 21:36,ARG,ARGUS DOS 220ML,1,14500,0,14500,13300,1200
9/29/2021 22:14,8999909982000,SAMPOERNA 12 FILTER,1,19000,0,19000,16600,2400
9/29/2021 22:14,8997021110028,Garam Kasar,25,2500,0,62500,37500,25000
9/29/2021 22:23,9556001025272,NESCAFE LATTE 240ML,1,8500,0,8500,7834,666
9/29/2021 22:23,8997028590052,ARGUS BTL 600ML,1,3000,0,3000,1458,1542
9/30/2021 9:53,8993989311699,CLAS MILD 16 FILTER,1,24000,0,24000,21700,2300
9/30/2021 9:59,8991102281430,PERMEN MINTZ DUOMINT,2,5000,0,10000,8000,2000
9/30/2021 10:18,8998866202770,MIE SEDAAP SALERO PADANG,1,2500,0,2500,2362,138
9/30/2021 10:18,8992775211410,PILUS GARUDA PEDAS,1,5000,0,5000,4886,114
9/30/2021 10:18,8998866202626,Top Kopi Gula Aren 22gr,3,688,0,2064,1659,405
9/30/2021 10:18,JGR SHN,JOGER SHINY SACHET,1,500,0,500,437,63
9/30/2021 11:32,8992959953310,SWEETY BRONZE M58,1,85000,0,85000,80304,4696
9/30/2021 11:32,8998866609487,SOKLIN SOFTERGEN 280G,1,5000,0,5000,4425,575
9/30/2021 11:54,GL,GULA 1 LITER,4,11500,0,46000,42000,4000
9/30/2021 12:29,8998989500166,GUDANG GARAM MERAH BESAR 16KS,1,18000,0,18000,17000,1000
9/30/2021 12:31,8992959020005,SWEETY SILVER PANTS XXL5,1,16800,0,16800,15228,1572
9/30/2021 12:31,8992388133345,NU MILK TEA TEH TARIK 330ML,1,6000,0,6000,5125,875
9/30/2021 12:34,Telur 3 Biji,Telur 3 Biji,1,5000,0,5000,3600,1400
9/30/2021 12:34,089686021141,INTER MIE SOTO,1,1000,0,1000,854,146
9/30/2021 12:34,8998866202619,MIE SEDAAP KOREAN SPICY SOUP,1,2700,0,2700,2322,378
9/30/2021 12:34,KERUPUK,KERUPUK BALADO,1,1000,0,1000,900,100
9/30/2021 12:51,Telur 3 Biji,Telur 3 Biji,1,5000,0,5000,3600,1400
9/30/2021 12:51,8992959953037,SWEETY BRONZE L1,1,2500,0,2500,1819,681
9/30/2021 14:09,7622201430153,OREO CHOCOLATE 38G,1,2000,0,2000,1641,359
9/30/2021 14:09,8991102308892,BLASTO,1,1000,0,1000,995,5
9/30/2021 14:09,8992775002582,DILAN CHOCO,1,2000,0,2000,1503,497
9/30/2021 14:09,8994867007161,ROKOK PENA GOLD 20,1,18000,0,18000,16800,1200
9/30/2021 14:09,8998989300261,GUDANG GARAM SURYA 12 FILTER,1,20000,0,20000,18150,1850
9/30/2021 14:09,8992761164546,NUTRIBOOST STRAWBERRY 300ML,2,6500,0,13000,10600,2400
9/30/2021 14:09,COKLAT,COKLAT COIN,2,500,0,1000,850,150
9/30/2021 14:09,8992388133345,NU MILK TEA TEH TARIK 330ML,1,6000,0,6000,5125,875
9/30/2021 14:09,8998866202664,POTABEE WAGYU BEEF STEAK 68 GR,1,8000,0,8000,7200,800
9/30/2021 15:47,8992759120264,LARISST 220,1,10000,0,10000,9200,800
9/30/2021 15:48,8999801700054,SUSU FOYU 1 KG,1,22000,0,22000,19791,2209
9/30/2021 17:43,8991102987875,WFR TANGO POUCH CKL 115G,1,8000,0,8000,6786,1214
9/30/2021 17:43,8995555121244,SOSIS KIMBO,3,1000,0,3000,1950,1050
9/30/2021 17:59,8999909096004,SAMPOERNA 16 FILTER,1,25000,0,25000,23100,1900
9/30/2021 18:29,8999801700054,SUSU FOYU 1 KG,1,22000,0,22000,19791,2209
9/30/2021 18:29,8998866200301,MIE SEDAAP GORENG,1,2700,0,2700,2363,337
9/30/2021 18:29,089686021219,INTER MIE GORENG,3,1000,0,3000,2655,345
9/30/2021 18:29,089686021141,INTER MIE SOTO,2,1000,0,2000,1708,292
9/30/2021 19:09,8993335529419,Sabun Total de Parfumee Floral Vibes,1,24500,0,24500,22000,2500
9/30/2021 19:09,8999999001209,LIFEBUOY BW MILDCARE LD REFF 450 ML,1,25000,0,25000,22110,2890
9/30/2021 19:09,8999999401238,RINSO ANTI NODA 770G,2,21200,0,42400,38676,3724
9/30/2021 19:09,8999999706180,PEPSODENT WHITE 190GR,3,10000,0,30000,28050,1950
9/30/2021 19:09,8999999055769,FAIR&LOVELY MVIT FC FOAM 50 G,1,12500,0,12500,11715,785
9/30/2021 19:14,8999999552343,LUX BW BIRD OF PARADISE 250ML,1,20000,0,20000,17900,2100
9/30/2021 19:19,8993989311699,CLAS MILD 16 FILTER,1,24000,0,24000,21700,2300
9/30/2021 20:10,8992775001998,Gery Salut sandwich,1,1000,0,1000,815,185
9/30/2021 20:27,8997011700123,BIHUN JAGUNG 300GR,4,6000,0,24000,19916,4084
9/30/2021 21:14,8998989300261,GUDANG GARAM SURYA 12 FILTER,2,20000,0,40000,36300,3700
9/30/2021 21:32,8996001314005,ROMA KELAPA CREAM CKLT,1,8000,0,8000,6642,1358
9/30/2021 21:32,ROTI,ROTI 2000,1,2000,0,2000,1800,200
9/30/2021 21:32,8994867006997,ROKOK PENA BOLD 20BTG,1,17000,0,17000,15000,2000
9/30/2021 21:32,123124,KOREK BIASA,1,2000,0,2000,1300,700
9/30/2021 21:32,MILKITA,MILKITA,4,250,0,1000,800,200
9/30/2021 21:36,8991102228053,TEH GELAS BOTOL,1,3000,0,3000,1695,1305
9/30/2021 21:43,8999909096004,SAMPOERNA 16 FILTER,1,25000,0,25000,23100,1900
9/30/2021 21:45,6907992823904,JD CRUNCHY CHOCOLATE VAN,1,8000,0,8000,6800,1200
9/30/2021 21:45,6907992823652,JD CHOCOLATE MILKSHAKE,1,6000,0,6000,5200,800
9/30/2021 21:52,8998866200578,MIE SEDAAP KARI KENTAL,2,2700,0,5400,4662,738
9/30/2021 21:52,8998866200325,MIE SEDAAP SOTO,2,2700,0,5400,4564,836
9/30/2021 21:58,8997027300089,NOMOS,1,4000,0,4000,2963,1037
9/30/2021 21:58,WC,WAFER COKELAT MADE,1,1000,0,1000,800,200
10/1/2021 10:58,8997210107877,VORTEX SMART 3,1,5000,0,5000,4750,250
10/1/2021 10:58,TORT,TORTILA,5,1000,0,5000,5000,0
10/1/2021 10:58,089686021219,INTER MIE GORENG,2,1000,0,2000,1770,230
10/1/2021 10:58,8991002103832,GOOD DAY CHOCOCINNO,3,1500,0,4500,2670,1830
10/1/2021 10:58,KOPIKO,KOPIKO,2,250,0,500,350,150
10/1/2021 10:58,8998898830125,KKB ENER-G ANGGUR,1,5500,0,5500,4824,676
10/1/2021 10:58,ARG,ARGUS DOS 220ML,1,14500,0,14500,13300,1200
10/1/2021 10:58,8999999516208,ROYCO FDS CHICKEN NEW 230G,1,10000,0,10000,9000,1000
10/1/2021 10:58,8998866202626,Top Kopi Gula Aren 22gr,2,1000,0,2000,1106,894
10/1/2021 10:58,8998866202770,MIE SEDAAP SALERO PADANG,1,2500,0,2500,2362,138
10/1/2021 10:58,YOUTOP,YOUTOP,1,1000,0,1000,875,125
10/1/2021 10:58,Vita Jelly,Vita Jelly,1,1000,0,1000,766,234
10/1/2021 10:58,8991102714846,MILKIDO CKLT,1,3000,0,3000,2153,847
10/1/2021 10:58,8997028590014,ARGUS 220ML,3,500,0,1500,906,594
10/1/2021 10:58,8886001038011,BENG-BENG SCT,1,1500,0,1500,1450,50
10/1/2021 10:58,8991102320184,TANGO CHOCO JAVAMOCCA,1,5000,0,5000,4330,670
10/1/2021 10:58,8992775318201,GERY SNACK BANTAL COKLAT,1,2000,0,2000,1712,288
10/1/2021 10:58,7622201430184,OREO ORIGINAL 38G,1,2000,0,2000,1641,359
10/1/2021 10:58,8995555121244,SOSIS KIMBO,1,1000,0,1000,650,350
10/1/2021 10:58,8992775001998,Gery Salut sandwich,1,1000,0,1000,815,185
10/1/2021 11:06,8996001305119,ARDEN 30G,1,2000,0,2000,1650,350
10/1/2021 11:06,8997028590052,ARGUS BTL 600ML,2,3000,0,6000,2916,3084
10/1/2021 11:23,8998989500166,GUDANG GARAM MERAH BESAR 16KS,1,18000,0,18000,17000,1000
10/1/2021 11:26,8999999046996,LIFEBUOY TOTAL10 60G,1,3000,0,3000,1800,1200
10/1/2021 11:57,8995333060703,TERIGU KOMPAS 1KG,1,10500,0,10500,9816,684
10/1/2021 11:57,8998866604963,POWDET DAIA LEMON 290GR,2,5000,0,10000,8900,1100
10/1/2021 11:57,8998866107068,Mama lemon 230 ml,1,4000,0,4000,3500,500
10/1/2021 11:57,8998866602549,NUVO FAMILY BIRU 76G,1,2000,0,2000,1820,180
10/1/2021 11:57,8999999030179,PEPSODENT ACTION 123 COMPLETE 75G,1,6700,0,6700,5170,1530
10/1/2021 11:57,8991002105430,KAPAL API 65G,2,5000,0,10000,8290,1710
10/1/2021 11:57,ROYCO,ROYCO RASA AYAM,2,500,0,1000,750,250
10/1/2021 11:58,8992984920110,CUKA DAPUR DUA BELIBIS,3,4500,0,13500,9750,3750
10/1/2021 11:58,8999999524838,SUNLIGHT MINT POUCH 755ML,2,18000,0,36000,31900,4100
10/1/2021 11:58,8991909101016,URBAN MILD 16,1,17000,0,17000,15800,1200
10/1/2021 12:32,8997028590014,ARGUS 220ML,2,500,0,1000,604,396
10/1/2021 12:32,Vita Jelly,Vita Jelly,1,1000,0,1000,766,234
10/1/2021 12:32,8992957220025,GOLDEN CITY MINI,1,3000,0,3000,2500,500
10/1/2021 13:15,8999909010567,234 DJI SAM SOE 16,1,22500,0,22500,21500,1000
10/1/2021 13:16,8991001502926,Chaca Peanut,1,1000,0,1000,800,200
10/1/2021 13:16,6907992825076,JD WATERMELON APPLE,1,2000,0,2000,1700,300
10/1/2021 13:47,BALON,BALON CABUT,1,1000,0,1000,900,100
10/1/2021 14:04,8998866610377,ISOPLUS,1,3000,0,3000,2350,650
10/1/2021 14:07,BAYFLAST,BAYPLAST,2,500,0,1000,700,300
10/1/2021 14:07,KOPIKO,KOPIKO,4,250,0,1000,700,300
10/1/2021 14:30,8998989300261,GUDANG GARAM SURYA 12 FILTER,1,20000,0,20000,18150,1850
10/1/2021 14:30,KIKO,KIKO,2,1000,0,2000,1000,1000
10/1/2021 14:37,8994867000179,ROKOK PENA MILD 16,2,14500,0,29000,27000,2000
10/1/2021 14:37,MILKITA,MILKITA,12,250,0,3000,2400,600
10/1/2021 14:39,8992761166052,FRESTEA MELATI 350ML,1,4500,0,4500,3000,1500
10/1/2021 14:39,JGR SHN,JOGER SHINY SACHET,1,500,0,500,437,63
10/1/2021 14:53,ROTI,ROTI 2000,2,2000,0,4000,3600,400
10/1/2021 14:53,COKLAT,COKLAT COIN,4,500,0,2000,1700,300
10/1/2021 14:56,6907992825076,JD WATERMELON APPLE,1,2000,0,2000,1700,300
10/1/2021 14:56,COKLAT,COKLAT COIN,2,500,0,1000,850,150
10/1/2021 15:52,8992222050418,GATSBY NORMAL 38GR,1,5000,0,5000,3850,1150
10/1/2021 16:07,OJELLY,O'JELLY,4,500,0,2000,1540,460
10/1/2021 16:07,TG,TEH GELAS,1,1000,0,1000,729,271
10/1/2021 16:24,8992775002582,DILAN CHOCO,1,2000,0,2000,1503,497
10/1/2021 16:24,YOUTOP,YOUTOP,1,1000,0,1000,875,125
10/1/2021 16:24,8992775511206,LEO 10GR,2,1000,0,2000,1696,304
10/1/2021 16:24,8994834005923,SPIX 1000,1,1000,0,1000,850,150
10/1/2021 16:24,8995555171225,KIMBO SOSIS,2,1000,0,2000,1800,200
10/1/2021 16:44,8993989311699,CLAS MILD 16 FILTER,1,24000,0,24000,21700,2300
10/1/2021 16:48,TBR,TEPUNG BERAS ROSE BRAND,1,8000,0,8000,5800,2200
10/1/2021 16:48,8993379210854,SABUN HARMONY APPLE 70G,1,2000,0,2000,1652,348
10/1/2021 16:48,8993379241858,SABUN HARMONY LEMON 70G,1,2000,0,2000,1652,348
10/1/2021 16:48,089686060461,POP MIE RASA KARI AYAM,1,4500,0,4500,3833,667
10/1/2021 17:31,ARGUS,ARGUS,1,2000,0,2000,1500,500
10/1/2021 17:50,ARG,ARGUS DOS 220ML,1,14500,0,14500,13300,1200
10/1/2021 17:50,8994867007161,ROKOK PENA GOLD 20,1,18000,0,18000,16800,1200
10/1/2021 17:50,GGK,PLAYGUM PERMEN KARET,2,500,0,1000,800,200
10/1/2021 17:50,KIKO,KIKO,1,1000,0,1000,500,500
10/1/2021 18:04,7622201430184,OREO ORIGINAL 38G,1,2000,0,2000,1641,359
10/1/2021 18:07,8995333032113,TERIGU GATOT KACA 1 KG,1,9000,0,9000,8572,428
10/1/2021 18:07,8999999400958,MOLTO PEWANGI BLUE 820ML,1,12500,0,12500,11275,1225
10/1/2021 18:07,8992979190986,TOTAL PUTIH SOFTENER,2,15000,0,30000,27048,2952
10/1/2021 18:07,KPS,KAPAS MEI QIAN,1,5000,0,5000,4750,250
10/1/2021 18:07,8998866600538,SOKLIN FLOORCLENER PINK 400ML,1,6000,0,6000,5025,975
10/1/2021 18:07,8999999707859,CLOSEUP GREEN 160G,1,15000,0,15000,13600,1400
10/1/2021 18:07,8999999500399,LUX TS CAMELLIA WHITE,4,3500,0,14000,11200,2800
10/1/2021 18:07,8998866600101,CREAM EKONOMI LEMON 455G,1,5500,0,5500,4750,750
10/1/2021 18:07,8998866108102,POSH GREEN BLOSSOM 150,1,19500,0,19500,17500,2000
10/1/2021 18:07,GL,GULA 1 LITER,1,11500,0,11500,10500,1000
10/1/2021 18:28,8994867000094,ROKOK PUNDIMAS FIL16,1,15000,0,15000,13500,1500
10/1/2021 18:41,8992222050418,GATSBY NORMAL 38GR,1,5000,0,5000,3850,1150
10/1/2021 18:41,8999999524722,SUNLIGHT LIME NEW PCH 435ML,1,10000,0,10000,9100,900
10/1/2021 18:50,ROTI,ROTI 2000,1,2000,0,2000,1800,200
10/1/2021 18:50,8995555171225,KIMBO SOSIS,2,1000,0,2000,1800,200
10/1/2021 18:50,8992775511206,LEO 10GR,2,1000,0,2000,1696,304
10/1/2021 18:50,8994834003752,TICTIC,1,2000,0,2000,1700,300
10/1/2021 18:52,OJELLY,O'JELLY,2,500,0,1000,770,230
10/1/2021 18:52,6907992823645,JD COCONUT BLISS,2,4000,0,8000,7000,1000
10/1/2021 18:52,8998989110167,SURYA GUDANG GARAM 16 FILTER,1,26000,0,26000,23700,2300
10/1/2021 18:52,KIKO,KIKO,2,1000,0,2000,1000,1000
10/1/2021 18:52,8995555171225,KIMBO SOSIS,2,1000,0,2000,1800,200
10/1/2021 19:16,8995555171225,KIMBO SOSIS,2,1000,0,2000,1800,200
10/1/2021 19:16,OJELLY,O'JELLY,2,500,0,1000,770,230
10/1/2021 19:16,ARGUS,ARGUS,1,2000,0,2000,1500,500
10/1/2021 19:21,8992628020152,MINYAK GOREG BIMOLI POUCH 2L,1,32000,0,32000,29800,2200
10/1/2021 19:21,8998866200301,MIE SEDAAP GORENG,3,2700,0,8100,7089,1011
10/1/2021 19:21,8998866200325,MIE SEDAAP SOTO,2,2700,0,5400,4564,836
10/1/2021 19:44,8886001038011,BENG-BENG SCT,3,1500,0,4500,4350,150
10/1/2021 19:44,TORT,TORTILA,1,1000,0,1000,1000,0
10/1/2021 19:44,8991002103337,GOOD DAY VANILLA,1,1500,0,1500,890,610
10/1/2021 19:44,8991102308892,BLASTO,1,1000,0,1000,995,5
10/1/2021 19:44,7622201430184,OREO ORIGINAL 38G,1,2000,0,2000,1641,359
10/1/2021 20:01,8992702000018,INDOMILK PUTIH 370G,1,10000,0,10000,9020,980
10/1/2021 20:05,Vita Jelly,Vita Jelly,1,1000,0,1000,766,234
10/1/2021 20:05,8992775511206,LEO 10GR,2,1000,0,2000,1696,304
10/1/2021 20:05,COKLAT,COKLAT COIN,4,500,0,2000,1700,300
10/1/2021 20:05,8992761122331,FRESTEA APPEL 500ML,1,6500,0,6500,4791,1709
10/1/2021 20:14,ROTI,ROTI 2000,1,2000,0,2000,1800,200
10/1/2021 20:16,8996001600610,TORA MILKY LATTE 180ML,1,3500,0,3500,2750,750
10/1/2021 20:36,8997027300089,NOMOS,1,4000,0,4000,2963,1037
10/1/2021 20:49,8999909002821,MARLBORO BLACK 16,1,22000,0,22000,20850,1150
10/1/2021 21:08,ARGUS,ARGUS,2,2000,0,4000,3000,1000
10/1/2021 21:08,8997028590052,ARGUS BTL 600ML,1,3000,0,3000,1458,1542
10/1/2021 21:08,Garuda Pilus,Garuda Pilus Rasa Abon Pcs,2,500,0,1000,802,198
10/1/2021 21:08,8992775001998,Gery Salut sandwich,1,1000,0,1000,815,185
10/1/2021 21:13,ROTI,ROTI 2000,2,2000,0,4000,3600,400
10/1/2021 21:13,8994834003752,TICTIC,2,2000,0,4000,3400,600
10/1/2021 21:13,8998866202602,KRISBEE FRENCH FRIES 18GR,2,2000,0,4000,3000,1000
10/1/2021 21:59,Telur 3 Biji,Telur 3 Biji,1,5000,0,5000,3600,1400
10/1/2021 22:13,GL,GULA 1 LITER,2,11500,0,23000,21000,2000
10/1/2021 22:13,8991002105409,KOPI KAPAL API,1,20000,0,20000,18888,1112
10/1/2021 22:13,8999999524807,SUNLIGHT HABBATUSSAUDA POUCH 755ML,1,18000,0,18000,15950,2050
10/1/2021 22:13,8999999016128,RINSO MOLTO ROSE FRESH 750ML,1,15000,0,15000,12507,2493
10/1/2021 22:13,8994834003752,TICTIC,1,2000,0,2000,1700,300
10/1/2021 22:13,8997003910684,2CS,1,3000,0,3000,1500,1500
10/1/2021 22:13,6907992825076,JD WATERMELON APPLE,1,2000,0,2000,1700,300
10/1/2021 22:13,Vita Jelly,Vita Jelly,1,1000,0,1000,766,234
10/2/2021 13:24,8991102989381,TANGO LONG BUBBLEGUM 130G,1,5000,0,5000,4345,655
10/2/2021 16:23,6907992823874,JD CRUNCHY CHOCO BLUEBERRY,1,5500,0,5500,4700,800
10/2/2021 16:23,6907992825076,JD WATERMELON APPLE,2,2000,0,4000,3400,600
10/2/2021 16:23,6907992823904,JD CRUNCHY CHOCOLATE VAN,1,8000,0,8000,6800,1200
10/2/2021 16:23,GGK,PLAYGUM PERMEN KARET,4,500,0,2000,1600,400
10/2/2021 16:23,6907992823904,JD CRUNCHY CHOCOLATE VAN,1,8000,0,8000,6800,1200
10/2/2021 17:37,8992696405233,DNCO FORT CKLT 200G,1,19500,0,19500,17667,1833
10/2/2021 17:37,8992696405431,DNCO INSTAN  400G,1,41000,0,41000,38165,2835
10/2/2021 17:39,8996001600641,TORA CAPPUCINO,1,3500,0,3500,2750,750
10/2/2021 17:43,8999099922985,SGM 0-6 600G,1,55000,0,55000,51951,3049
10/2/2021 17:43,8998866500708,FLORIDINA ORANGE,2,3000,0,6000,5000,1000
10/2/2021 17:43,8992959508930,SWEETY SILVER PANTS L 54,1,108000,0,108000,99697,8303
10/2/2021 17:49,8998866200301,MIE SEDAAP GORENG,1,2700,0,2700,2363,337
10/2/2021 17:49,8998866203227,MIE SEDAAP AYAM BAKAR LIMAU,1,2700,0,2700,2163,537
10/2/2021 17:49,8998866500708,FLORIDINA ORANGE,1,3000,0,3000,2500,500
10/2/2021 17:49,8992694242717,ZWITSAL NAT ALOE VERA PWD 100G,1,8400,0,8400,7590,810
10/2/2021 17:49,8994867007161,ROKOK PENA GOLD 20,1,18000,0,18000,16800,1200
10/2/2021 17:49,8991102714846,MILKIDO CKLT,3,3000,0,9000,6459,2541
10/2/2021 17:51,8992761145026,SPRITE PET 250ML,1,3500,0,3500,2417,1083
10/2/2021 17:51,8994867000094,ROKOK PUNDIMAS FIL16,1,15000,0,15000,13500,1500
10/2/2021 17:51,8994834003752,TICTIC,1,2000,0,2000,1700,300
10/2/2021 18:44,ARG,ARGUS DOS 220ML,1,14500,0,14500,13300,1200
10/2/2021 18:44,8991102228053,TEH GELAS BOTOL,1,3000,0,3000,1695,1305
10/2/2021 18:44,KIKO,KIKO,1,1000,0,1000,500,500
10/2/2021 18:44,8998866202602,KRISBEE FRENCH FRIES 18GR,1,2000,0,2000,1500,500
10/2/2021 18:46,8992979120013,TOTAL BUNGA SOFTENER,1,15000,0,15000,13524,1476
10/2/2021 20:35,0105312686040047,yakult,1,2000,0,2000,1500,500
10/2/2021 20:51,8993571002196,CAP 19 OBAT KURAP AIR 10ML,1,5000,0,5000,3637,1363
10/3/2021 9:08,089686021127,INTER MIE KALDU,4,1000,0,4000,3252,748
10/3/2021 9:08,8995899210185,Mi Boncabe,1,3000,0,3000,3000,0
10/3/2021 9:19,8999999524722,SUNLIGHT LIME NEW PCH 435ML,1,10000,0,10000,9100,900
10/3/2021 9:32,8999999519735,PEPSODENT TB BAMBOO SALT,1,13200,0,13200,11990,1210
10/3/2021 9:32,8999999525590,PEPSODENT TB KIDS,1,12900,0,12900,11700,1200
10/3/2021 9:32,8999999005795,DOVE DEO WMN RO SILK DRY 40 ML,1,17800,0,17800,16050,1750
10/3/2021 9:34,8999999524807,SUNLIGHT HABBATUSSAUDA POUCH 755ML,1,18000,0,18000,15950,2050
10/3/2021 9:37,8997218380135,ICHITAN GREEN TEA,1,8000,0,8000,6583,1417
10/3/2021 9:37,8998866500708,FLORIDINA ORANGE,1,3000,0,3000,2500,500
10/3/2021 9:41,8992717781001,NATA DE COCO,1,13000,0,13000,12083,917
10/3/2021 9:54,8992775511206,LEO 10GR,1,1000,0,1000,848,152
10/3/2021 9:56,8994834003752,TICTIC,2,2000,0,4000,3400,600
10/3/2021 9:56,ROTI,ROTI 2000,1,2000,0,2000,1800,200
10/3/2021 9:56,8998866200301,MIE SEDAAP GORENG,2,2700,0,5400,4726,674
10/3/2021 10:02,8992979190986,TOTAL PUTIH SOFTENER,1,15000,0,15000,13524,1476
10/3/2021 10:15,8991102714860,MILKIDO STRAW,1,3000,0,3000,2153,847
10/3/2021 10:46,8996001355008,BENG-BENG SP20G,2,29000,0,58000,40000,18000
10/3/2021 10:49,8998866500708,FLORIDINA ORANGE,1,3000,0,3000,2500,500
10/3/2021 10:49,8992761111533,SPRITE SLIM CAM250ML,1,5000,0,5000,3750,1250
10/3/2021 10:52,6907992825076,JD WATERMELON APPLE,3,2000,0,6000,5100,900
10/3/2021 10:52,TG,TEH GELAS,2,1000,0,2000,1458,542
10/3/2021 10:52,KERUPUK 1000,KERUPUK BALADO,2,1000,0,2000,1800,200
10/3/2021 10:52,8995555121244,SOSIS KIMBO,2,1000,0,2000,1300,700
10/3/2021 10:52,Vita Jelly,Vita Jelly,1,1000,0,1000,766,234
10/3/2021 10:52,8995899210185,Mi Boncabe,1,3000,0,3000,3000,0
10/3/2021 19:02,GL,GULA 1 LITER,4,11500,0,46000,42000,4000
10/3/2021 19:29,TK,TEPUNG KETAN,1,13000,0,13000,13000,0
10/3/2021 19:29,8991002105409,KOPI KAPAL API,1,20000,0,20000,18888,1112
10/3/2021 19:29,GL,GULA 1 LITER,2,11500,0,23000,21000,2000
10/3/2021 19:29,BG,BERAS GURIH PASAR RAME,1,60000,0,60000,56000,4000
10/3/2021 19:29,8999999195649,SARIWANGI 25X1.86G,1,6000,0,6000,5202,798
10/3/2021 19:29,8992705035123,AGAR-AGAR SATELIT COKLAT,6,3500,0,21000,15624,5376
10/3/2021 19:29,8999801700030,SUSU FOYU,1,11500,0,11500,10450,1050
10/3/2021 19:29,8992993250048,BENDICO COCOA POWDER 90G,1,18000,0,18000,16203,1797
10/3/2021 19:29,8992957352153,CHOCO CHIPS 45G,1,4500,0,4500,2850,1650
10/3/2021 19:29,Telur 7 Biji,Telur 7 Biji,1,10000,0,10000,8400,1600
10/3/2021 19:29,Telur 3 Biji,Telur 3 Biji,1,5000,0,5000,3600,1400
10/3/2021 19:29,8992959076200,HN PANTS M34,1,50000,0,50000,45455,4545
10/3/2021 19:29,8991102026383,AIR CRYSTALINE 1.5 L,1,5000,0,5000,3471,1529
10/3/2021 19:29,JD VM,JD VANILLA MILKSHAKE,1,5000,0,5000,4300,700
10/3/2021 19:29,CHYK,CAHAYA MINYAK TERAPI,1,60000,0,60000,50000,10000
10/3/2021 19:29,ARG,ARGUS DOS 220ML,1,14500,0,14500,13300,1200
10/3/2021 19:29,Gula gula tusuk,gula gula tusuk,1,500,0,500,400,100
10/3/2021 19:34,8994867000094,ROKOK PUNDIMAS FIL16,1,15000,0,15000,13500,1500
10/3/2021 19:34,8998989300261,GUDANG GARAM SURYA 12 FILTER,2,20000,0,40000,36300,3700
10/3/2021 19:34,8999909002821,MARLBORO BLACK 16,1,22000,0,22000,20850,1150
10/3/2021 19:34,8995077609985,Tortilla,3,1000,0,3000,2550,450
10/3/2021 19:34,KERUPUK 1000,KERUPUK BALADO,2,1000,0,2000,1800,200
10/3/2021 19:34,089686021219,INTER MIE GORENG,1,1000,0,1000,885,115
10/3/2021 19:34,089686021141,INTER MIE SOTO,1,1000,0,1000,854,146
10/3/2021 19:34,8997028590045,ARGUS BTL 330ML,1,2000,0,2000,1291,709
10/3/2021 19:34,8997028590014,ARGUS 220ML,2,500,0,1000,604,396
10/3/2021 19:34,8997027300089,NOMOS,1,4000,0,4000,2963,1037
10/3/2021 19:34,8992696523067,MILO ACTVGO UHT 180ML,1,4500,0,4500,3515,985
10/3/2021 19:34,Telur 7 Biji,Telur 7 Biji,1,10000,0,10000,8400,1600
10/3/2021 19:34,Telur 3 Biji,Telur 3 Biji,1,5000,0,5000,3600,1400
10/3/2021 19:34,8992775318201,GERY SNACK BANTAL COKLAT,1,2000,0,2000,1712,288
10/3/2021 19:34,8886013257400,TWISTKO,1,1000,0,1000,900,100
10/3/2021 19:34,8997009510055,YOU C1000,1,15000,0,15000,13000,2000
10/3/2021 19:44,8999909010567,234 DJI SAM SOE 16,2,22500,0,45000,43000,2000
10/3/2021 20:02,8999999706180,PEPSODENT WHITE 190GR,1,10000,0,10000,9350,650
10/3/2021 20:02,8992388101085,NU GREEN TEA ORIGINAL 330ML,1,3500,0,3500,2768,732
10/3/2021 20:02,8994867007161,ROKOK PENA GOLD 20,1,18000,0,18000,16800,1200
10/3/2021 20:02,8999909002821,MARLBORO BLACK 16,1,22000,0,22000,20850,1150
10/3/2021 20:19,ARG,ARGUS DOS 220ML,1,14500,0,14500,13300,1200
10/3/2021 20:23,8998989300261,GUDANG GARAM SURYA 12 FILTER,1,20000,0,20000,18150,1850
10/3/2021 20:40,8997028590045,ARGUS BTL 330ML,1,2000,0,2000,1291,709
10/3/2021 20:43,8991111101507,JB POWDER BLOSSOM 50G,1,3500,0,3500,3000,500
10/3/2021 20:43,Vita Jelly,Vita Jelly,1,1000,0,1000,766,234
10/3/2021 20:43,YP,YUPI,2,250,0,500,416,84
10/3/2021 21:11,8998989300261,GUDANG GARAM SURYA 12 FILTER,1,20000,0,20000,18150,1850
10/3/2021 21:11,8997218380074,ICHITAN MILK TEA,1,8000,0,8000,6500,1500
10/3/2021 21:22,8998866202619,MIE SEDAAP KOREAN SPICY SOUP,1,2700,0,2700,2322,378
10/3/2021 21:34,8997009510123,ORANGE WATER,1,11000,0,11000,10416,584
10/3/2021 21:49,ROTI,ROTI 2000,2,2000,0,4000,3600,400
10/3/2021 21:58,8991102023115,Sikat Gigi Formula,1,11000,0,11000,10000,1000
10/3/2021 22:07,GL,GULA 1 LITER,1,11500,0,11500,10500,1000
10/4/2021 13:05,8993989311699,CLAS MILD 16 FILTER,1,24000,0,24000,21700,2300
10/4/2021 13:05,6907992823874,JD CRUNCHY CHOCO BLUEBERRY,1,5500,0,5500,4700,800
10/4/2021 13:05,6907992823867,JD CRUNCHY CHOCOLATE MALT,1,5500,0,5500,4700,800
10/4/2021 13:14,8992761111533,SPRITE SLIM CAM250ML,1,5000,0,5000,3750,1250
10/4/2021 13:14,8992696404441,BEAR BRAND 189ML,1,15000,0,15000,11000,4000
10/4/2021 13:14,8999999529697,CLEAR DEEP CLEANSE MEN 160ML,1,24700,0,24700,22700,2000
10/4/2021 13:14,089686535044,SUN BERAS MERAH,2,8500,0,17000,14820,2180
10/4/2021 13:14,GL,GULA 1 LITER,3,11500,0,34500,31500,3000
10/4/2021 13:14,KERUPUK 1000,KERUPUK BALADO,3,1000,0,3000,2700,300
10/4/2021 13:14,8997028590014,ARGUS 220ML,4,500,0,2000,1208,792
10/4/2021 13:14,ROTI,ROTI 2000,3,2000,0,6000,5400,600
10/4/2021 13:14,8993989311279,CLAS MILD 12,1,18000,0,18000,15800,2200
10/4/2021 13:14,8992761122430,FRESTEA GREEN HONEY 500ML,1,6500,0,6500,4708,1792
10/4/2021 13:14,8992775001783,GERY SALUT MALKIST KELAPA,1,6500,0,6500,5516,984
10/4/2021 13:14,ABC,BATERAI ABC BIRU,4,2250,0,9000,7712,1288
10/4/2021 13:14,8998989300261,GUDANG GARAM SURYA 12 FILTER,1,20000,0,20000,18150,1850
10/4/2021 13:14,6907992825076,JD WATERMELON APPLE,2,2000,0,4000,3400,600
10/4/2021 13:14,8992931006256,tessa,1,1000,0,1000,900,100
10/4/2021 13:14,8999999050009,SUNLIGHT LIME NEW POUCH 95ML,1,2000,0,2000,1600,400
10/4/2021 13:14,8999999030179,PEPSODENT ACTION 123 COMPLETE 75G,1,6700,0,6700,5170,1530
10/4/2021 13:14,8994867000162,ROKOK PUNDIMAS KRETEK16,1,10000,0,10000,8600,1400
10/4/2021 13:14,8998866202619,MIE SEDAAP KOREAN SPICY SOUP,1,2700,0,2700,2322,378
10/4/2021 13:14,089686021219,INTER MIE GORENG,1,1000,0,1000,885,115
10/4/2021 13:14,8991002105430,KAPAL API 65G,1,5000,0,5000,4145,855
10/4/2021 13:57,8992696404441,BEAR BRAND 189ML,1,15000,0,15000,11000,4000
10/4/2021 13:57,8997009510055,YOU C1000,1,15000,0,15000,13000,2000
10/4/2021 15:03,8999999049416,REXONA MEN RO QUANTUM 45 ML,1,15000,0,15000,13550,1450
10/4/2021 15:03,8998866608305,GIV BENGKOANG KOTAK 76G,1,2000,0,2000,1820,180
10/4/2021 15:03,8997210107877,VORTEX SMART 3,1,5000,0,5000,4750,250
10/4/2021 15:03,8998866107471,ZINC ACTIVE SCT,1,5000,0,5000,4500,500
10/4/2021 16:45,8992761166052,FRESTEA MELATI 350ML,2,4500,0,9000,6000,3000
10/4/2021 16:45,8992761166205,FRESTEA GREEN HONEY 350ML,2,4500,0,9000,6000,3000
10/4/2021 16:45,jagung marning,jagung marning,1,5000,0,5000,4500,500
10/4/2021 17:13,8997003910684,2CS,2,3000,0,6000,3000,3000
10/4/2021 17:13,8997028590014,ARGUS 220ML,2,500,0,1000,604,396
10/4/2021 17:13,8991001502926,Chaca Peanut,1,1000,0,1000,800,200
10/4/2021 17:13,Vita Jelly,Vita Jelly,1,1000,0,1000,766,234
10/4/2021 17:13,ROTI,ROTI 2000,1,2000,0,2000,1800,200
10/4/2021 17:30,8999909010567,234 DJI SAM SOE 16,1,22500,0,22500,21500,1000
10/4/2021 17:30,8992388133345,NU MILK TEA TEH TARIK 330ML,1,6000,0,6000,5125,875
10/4/2021 17:33,8992775001998,Gery Salut sandwich,1,1000,0,1000,815,185
10/4/2021 17:33,8992959508312,SWEETY SILVER PANTS XL1,5,3000,0,15000,11620,3380
10/4/2021 17:43,8997009510055,YOU C1000,1,15000,0,15000,13000,2000
10/4/2021 17:43,8992959508930,SWEETY SILVER PANTS L 54,1,108000,0,108000,99697,8303
10/4/2021 17:43,8992775001844,Chocolatos original taste,2,1000,0,2000,1658,342
10/4/2021 18:12,ARG,ARGUS DOS 220ML,1,14500,0,14500,13300,1200
10/4/2021 18:18,8992959117583,SFX DS REG FLOW WING 20,1,5000,0,5000,4288,712
10/4/2021 18:18,8998866107099,WET WIPES KODOMO BABY 50SHT CLSSC,1,20000,0,20000,14150,5850
10/4/2021 18:18,8992759120264,LARISST 220,1,10000,0,10000,9200,800
10/4/2021 18:18,8991002103337,GOOD DAY VANILLA,10,1300,0,13000,8900,4100
10/4/2021 18:18,8998866619004,ROYALE SUNNY DAY,1,5000,0,5000,4560,440
10/4/2021 18:18,TUSTEL,TUSUK TELINGA,1,1000,0,1000,833,167
10/4/2021 18:18,8999999055769,FAIR&LOVELY MVIT FC FOAM 50 G,1,12500,0,12500,11715,785
10/4/2021 18:18,4902430553629,H&S LEMON 70ML,1,11000,0,11000,9501,1499
10/4/2021 18:18,8991102020305,FORMULA TRIPLE ACTION,1,3000,0,3000,2500,500
10/4/2021 18:18,8999999710880,PEPSODENT ACTION123 HERBAL 75G,1,7500,0,7500,6650,850
10/4/2021 18:18,8999999036492,LUX BW PINK SOFT BTL 100ML,1,10000,0,10000,8690,1310
10/4/2021 18:18,8997009510123,ORANGE WATER,1,11000,0,11000,10416,584
10/4/2021 18:18,8997028590052,ARGUS BTL 600ML,1,3000,0,3000,1458,1542
10/4/2021 18:18,ROTI,ROTI 2000,1,2000,0,2000,1800,200
10/4/2021 18:19,8999999508609,LIFEBUOY HAND SANITIZER 50ML,1,13000,0,13000,11600,1400
10/4/2021 18:19,089686727081,DORITOS 55G,1,7000,0,7000,5950,1050
10/5/2021 20:15,Telur 7 Biji,Telur 7 Biji,1,10000,0,10000,8400,1600
10/5/2021 20:19,8999999053291,LIFEBUOY LEMONFRESH 110G,1,15000,0,15000,14245,755
10/5/2021 20:20,8998866107068,Mama lemon 230 ml,1,4000,0,4000,3500,500
10/5/2021 20:21,8999999027056,LIFEBUOY ANTI KETOMBE 9ML,1,5000,0,5000,4500,500
10/5/2021 20:22,8999999048242,SUNSILK SHP SOFT&SMOOTH 9ML,1,11000,0,11000,9300,1700
10/5/2021 20:23,8997028900837,SABUN PAPAYA,1,10000,0,10000,9375,625
10/5/2021 20:26,ICE CREAM,ICE CREAM 2000,2,2000,0,4000,3400,600
10/5/2021 20:27,8997028590052,ARGUS BTL 600ML,4,3000,0,12000,5832,6168
10/5/2021 20:27,8997878002088,Kiko,1,1000,0,1000,450,550
10/5/2021 20:28,8991102714846,MILKIDO CKLT,1,3000,0,3000,2153,847
10/5/2021 20:28,8998866500708,FLORIDINA ORANGE,1,3000,0,3000,2500,500
10/5/2021 20:28,kentang,kripik kentang,1,1000,0,1000,900,100
10/5/2021 20:30,8998989300261,GUDANG GARAM SURYA 12 FILTER,1,20000,0,20000,18150,1850
10/5/2021 20:30,8992702000018,INDOMILK PUTIH 370G,1,10000,0,10000,9020,980
10/5/2021 20:31,8995555121244,SOSIS KIMBO,1,1000,0,1000,650,350
10/5/2021 20:31,8999999195656,SARIWANGI 50X1.85,1,10000,0,10000,9405,595
10/5/2021 20:32,ROTI,ROTI 2000,1,2000,0,2000,1800,200
10/5/2021 20:32,8997028590014,ARGUS 220ML,4,500,0,2000,1208,792
10/5/2021 20:33,ROTI,ROTI 2000,2,2000,0,4000,3600,400
10/5/2021 20:34,GL,GULA 1 LITER,4,11500,0,46000,42000,4000
10/5/2021 20:37,8998866601429,POWDET DAIA BUNGA BAG 290GR,1,5000,0,5000,4450,550
10/5/2021 20:38,8999999706081,PEPSODENT WHITE 75G,1,5000,0,5000,3850,1150
10/5/2021 20:46,8998866202619,MIE SEDAAP KOREAN SPICY SOUP,1,2700,0,2700,2322,378
10/5/2021 20:48,8997028590014,ARGUS 220ML,10,500,0,5000,3020,1980
10/5/2021 20:49,8998866107068,Mama lemon 230 ml,2,4000,0,8000,7000,1000
10/5/2021 20:49,8999999556341,MOLTO EDP PINK ROSE 20ML,2,1000,0,2000,1600,400
10/5/2021 20:50,8995555121244,SOSIS KIMBO,1,1000,0,1000,650,350
10/5/2021 20:51,8999909096004,SAMPOERNA 16 FILTER,1,25000,0,25000,23100,1900
10/5/2021 20:54,8992717781025,SANTAN KELAPA,1,4000,0,4000,3000,1000
10/5/2021 21:07,8998989110167,SURYA GUDANG GARAM 16 FILTER,1,26000,0,26000,23700,2300
10/5/2021 21:07,8998989300261,GUDANG GARAM SURYA 12 FILTER,1,20000,0,20000,18150,1850
10/5/2021 21:07,8991102026383,AIR CRYSTALINE 1.5 L,1,5000,0,5000,3471,1529
10/5/2021 21:10,8991102026383,AIR CRYSTALINE 1.5 L,4,5000,0,20000,13884,6116
10/5/2021 21:11,TG,TEH GELAS,1,1000,0,1000,729,271
10/5/2021 21:11,8993470411433,JOGER CLASSIC,1,1000,0,1000,850,150
10/5/2021 21:11,YP,YUPI,2,250,0,500,416,84
10/5/2021 21:12,8992957220186,COKLAT RUSA,1,2000,0,2000,1700,300
10/5/2021 21:13,7622201430153,OREO CHOCOLATE 38G,1,2000,0,2000,1641,359
10/5/2021 21:14,8998666002525,TB TORA CAFE CAPPUCINO,3,1000,0,3000,2340,660
10/5/2021 21:15,8999909002821,MARLBORO BLACK 16,1,22000,0,22000,20850,1150
10/5/2021 21:16,8992775305188 pcs,Gery Salut Grentea pcs,4,1000,0,4000,3248,752
10/5/2021 21:23,8996001600641,TORA CAPPUCINO,1,3500,0,3500,2750,750
10/5/2021 21:23,8992775002735,CHOCOLATOS SUSU COKELAT,1,4000,0,4000,3520,480
10/5/2021 21:24,8994867000162,ROKOK PUNDIMAS KRETEK16,1,10000,0,10000,8600,1400
10/5/2021 21:24,8991111109107,JB POWDER BEDTIME 75+25g,1,6000,0,6000,5440,560
10/5/2021 21:46,8998866200882,SUKSESMIE GORENG AYAM KRMS 133GR,1,3500,0,3500,3047,453
10/5/2021 21:49,8998866500517,BABY HAPPY PANTS L PCS,2,2000,0,4000,2860,1140
10/5/2021 21:49,8993274534079,PARAGO CHOCO,2,500,0,1000,800,200
10/5/2021 21:52,8993989311279,CLAS MILD 12,1,18000,0,18000,15800,2200
10/5/2021 21:54,8997028590045,ARGUS BTL 330ML,1,2000,0,2000,1291,709
10/5/2021 21:54,8997028590014,ARGUS 220ML,2,500,0,1000,604,396
10/5/2021 21:55,ARG,ARGUS DOS 220ML,2,14500,0,29000,26600,2400
10/5/2021 21:56,089686021141,INTER MIE SOTO,2,1000,0,2000,1708,292
10/5/2021 21:57,kentang,kripik kentang,1,1000,0,1000,900,100
10/5/2021 21:57,8998866107068,Mama lemon 230 ml,1,4000,0,4000,3500,500
10/5/2021 21:58,8992696521797,MILO 22G,2,2500,0,5000,3144,1856
10/5/2021 21:59,8998989300261,GUDANG GARAM SURYA 12 FILTER,1,20000,0,20000,18150,1850
10/5/2021 21:59,Telur 7 Biji,Telur 7 Biji,1,10000,0,10000,8400,1600
10/5/2021 22:02,8992959508312,SWEETY SILVER PANTS XL1,6,3000,0,18000,13944,4056
10/5/2021 22:02,Telur 3 Biji,Telur 3 Biji,1,5000,0,5000,3600,1400
10/5/2021 22:03,8992775318201,GERY SNACK BANTAL COKLAT,2,2000,0,4000,3424,576
10/5/2021 22:05,8991909101016,URBAN MILD 16,1,17000,0,17000,15800,1200
10/5/2021 22:07,8997009510055,YOU C1000,2,15000,0,30000,26000,4000
10/5/2021 22:08,8992931006256,tessa,1,1000,0,1000,900,100
10/5/2021 22:10,kentang,kripik kentang,1,1000,0,1000,900,100
10/5/2021 22:11,0105312686040047,yakult,1,2000,0,2000,1500,500
10/5/2021 22:14,8886013257400,TWISTKO,1,1000,0,1000,900,100
10/5/2021 22:15,8999999529703,CLEAR MEN COOL SPORT MTHL 80ML,2,11000,0,22000,20000,2000
10/5/2021 22:16,GL,GULA 1 LITER,2,11500,0,23000,21000,2000
10/5/2021 22:17,kentang,kripik kentang,3,1000,0,3000,2700,300
10/5/2021 22:18,8997028590014,ARGUS 220ML,4,500,0,2000,1208,792
10/6/2021 11:06,8998866200646,KOPI TOP MURNI,1,11000,0,11000,9600,1400
10/6/2021 11:23,AIR,ARGUS,2,500,0,1000,800,200
10/6/2021 11:36,8997218380135,ICHITAN GREEN TEA,2,8000,0,16000,13000,3000
10/6/2021 11:36,8998009040023,TEH KOTAK,2,5000,0,10000,5416,4584
10/6/2021 11:36,8992761166038,MMP ORANGE 300ML,1,5000,0,5000,3750,1250
10/6/2021 11:36,8992761139018,ADES 600ML,1,3500,0,3500,2166,1334
10/6/2021 11:36,8991102714846,MILKIDO CKLT,1,3000,0,3000,2153,847
10/6/2021 11:36,8995555121244,SOSIS KIMBO,2,1000,0,2000,1300,700
10/6/2021 11:47,MATERAI,MATERAI,10,15000,0,150000,100000,50000
10/6/2021 12:24,8998866202626,Top Kopi Gula Aren 22gr,3,1000,0,3000,1659,1341
10/6/2021 12:41,6907992825076,JD WATERMELON APPLE,2,2000,0,4000,3400,600
10/6/2021 12:41,8997878002088,Kiko,1,1000,0,1000,450,550
10/6/2021 12:48,8992775203422,GARUDA ROSTA OVEN BAWANG 100G,1,8000,0,8000,7322,678
10/6/2021 12:49,8997231980022,O'JELLY MINI STRAWBERRY,1,3000,0,3000,2250,750
10/6/2021 13:10,8992388101085,NU GREEN TEA ORIGINAL 330ML,1,3500,0,3500,2768,732
10/6/2021 13:10,AIR,ARGUS,1,500,0,500,400,100
10/6/2021 13:11,8997878002088,Kiko,2,1000,0,2000,900,1100
10/6/2021 13:13,8991909101016,URBAN MILD 16,1,17000,0,17000,15800,1200
10/6/2021 13:17,8997018720469,TISSUE SE-KA,1,10000,0,10000,9300,700
10/6/2021 16:58,8991914101513,VIPER KRETEK 12,1,6000,0,6000,5000,1000
10/6/2021 16:58,ROTI,ROTI 2000,2,2000,0,4000,3600,400
10/6/2021 17:15,34678,SENDAL MOLLY,1,15000,0,15000,13500,1500
10/6/2021 17:20,8994867007161,ROKOK PENA GOLD 20,1,18000,0,18000,16800,1200
10/6/2021 18:06,9556001025272,NESCAFE LATTE 240ML,1,8500,0,8500,7834,666
10/6/2021 18:30,8996001305119,ARDEN 30G,1,2000,0,2000,1650,350
10/6/2021 18:30,8991102228053,TEH GELAS BOTOL,1,3000,0,3000,1695,1305
10/6/2021 18:30,KIKO,KIKO,3,1000,0,3000,1500,1500
10/6/2021 18:31,8992628024143,MINYAK GORENG BIMOLI 620ML,1,15000,0,15000,13900,1100
10/6/2021 18:58,Vita Jelly,Vita Jelly,2,1000,0,2000,1532,468
10/6/2021 19:06,8999999533731,CITRA TS NATURE WHITE 70G,1,2200,0,2200,1900,300
10/6/2021 19:09,8992761139018,ADES 600ML,1,3500,0,3500,2166,1334
10/6/2021 19:09,8992761122331,FRESTEA APPEL 500ML,1,6500,0,6500,4791,1709
10/6/2021 19:09,Gula gula tusuk,gula gula tusuk,3,500,0,1500,1200,300
10/6/2021 19:09,Gula gula kopiko,gula gula kopiko,10,350,0,3500,2500,1000
10/6/2021 19:44,8998989300261,GUDANG GARAM SURYA 12 FILTER,1,20000,0,20000,18150,1850
10/6/2021 19:44,8999909002821,MARLBORO BLACK 16,1,22000,0,22000,20850,1150
10/6/2021 19:44,TORT,TORTILA,3,1000,0,3000,3000,0
10/6/2021 19:48,Garuda pilus,Garuda Pilus Pedas Pcs,6,500,0,3000,2448,552
10/6/2021 19:48,8997028590014,ARGUS 220ML,4,500,0,2000,1208,792
10/6/2021 19:51,JIPAH,JIPAN,1,5000,0,5000,4000,1000
10/6/2021 19:52,8998866202244,EKOMIE BUMBU KALDU AYAM,2,1000,0,2000,1596,404
10/6/2021 19:53,8998866202244,EKOMIE BUMBU KALDU AYAM,6,1000,0,6000,4788,1212
10/6/2021 19:54,8997009510055,YOU C1000,1,15000,0,15000,13000,2000
10/6/2021 19:55,TG,TEH GELAS,2,1000,0,2000,1458,542
10/6/2021 19:56,TG MARKISA,TEH GELAS MARKISA,2,2000,0,4000,2356,1644
10/6/2021 19:57,8992716109172,BISKUAT BOLU SCT,4,2000,0,8000,6564,1436
10/6/2021 19:58,ARG,ARGUS DOS 220ML,1,14500,0,14500,13300,1200
10/6/2021 20:00,8997028590014,ARGUS 220ML,2,500,0,1000,604,396
10/6/2021 20:01,8993274532105,BOLU,1,1000,0,1000,833,167
10/6/2021 20:01,8995555121244,SOSIS KIMBO,1,1000,0,1000,650,350
10/6/2021 20:16,0105312686040047,yakult,1,2000,0,2000,1500,500
10/6/2021 20:19,ARG,ARGUS DOS 220ML,1,14500,0,14500,13300,1200
10/6/2021 20:23,8998989300261,GUDANG GARAM SURYA 12 FILTER,1,20000,0,20000,18150,1850
10/6/2021 20:52,8992959953044,SWEETY BRONZE XL1,2,3000,0,6000,4622,1378
10/6/2021 21:14,PULPEN SNOWMAN,PULPEN SNOWMAN,1,2500,0,2500,2000,500
10/6/2021 21:16,8993989311279,CLAS MILD 12,1,18000,0,18000,15800,2200
10/6/2021 21:16,8997028590014,ARGUS 220ML,4,500,0,2000,1208,792
10/6/2021 21:17,8999999706081,PEPSODENT WHITE 75G,1,5000,0,5000,3850,1150
10/6/2021 21:18,8992761145026,SPRITE PET 250ML,1,3500,0,3500,2417,1083
10/6/2021 21:19,8992761145033,FANTA STRAW PET 250ML,1,3500,0,3500,2417,1083
10/6/2021 21:20,Gula gula kaki,gula gula kaki,1,500,0,500,400,100
10/6/2021 21:21,8999999001193,LIFEBUOY BW TOTAL10 LD REFF 450 ML,1,25000,0,25000,22110,2890
10/6/2021 21:22,8991102714846,MILKIDO CKLT,1,3000,0,3000,2153,847
10/6/2021 21:23,8998989300261,GUDANG GARAM SURYA 12 FILTER,1,20000,0,20000,18150,1850
10/6/2021 21:24,RT TWR,ROTI TAWAR JUMBO,1,7000,0,7000,6200,800
10/6/2021 21:25,8991102228053,TEH GELAS BOTOL,1,3000,0,3000,1695,1305
10/6/2021 21:26,8991102026383,AIR CRYSTALINE 1.5 L,1,5000,0,5000,3471,1529
10/6/2021 21:27,8992775001783,GERY SALUT MALKIST KELAPA,1,6500,0,6500,5516,984
10/6/2021 21:29,RT,ROTI,1,9000,0,9000,8000,1000
10/6/2021 21:30,8998989300261,GUDANG GARAM SURYA 12 FILTER,1,20000,0,20000,18150,1850
10/6/2021 21:32,Vita Jelly,Vita Jelly,2,1000,0,2000,1532,468
10/6/2021 21:33,8992696521629,DNCO COKLT UHT 180ML,3,5000,0,15000,10599,4401
10/6/2021 21:33,8992388101085,NU GREEN TEA ORIGINAL 330ML,3,3500,0,10500,8304,2196
10/6/2021 21:34,8999999043674,LUX BW CAMELLIA WHITE LD REFF 450 ML,1,25000,0,25000,22330,2670
10/6/2021 21:34,ARG,ARGUS DOS 220ML,1,14500,0,14500,13300,1200
10/6/2021 21:35,GL,GULA 1 LITER,2,11500,0,23000,21000,2000
10/6/2021 21:36,kentang,kripik kentang,1,1000,0,1000,900,100
10/6/2021 21:38,089686535044,SUN BERAS MERAH,2,8500,0,17000,14820,2180
10/6/2021 21:38,8997028590014,ARGUS 220ML,4,500,0,2000,1208,792
10/6/2021 21:39,ROTI,ROTI 2000,3,2000,0,6000,5400,600
10/6/2021 21:40,8993989311279,CLAS MILD 12,1,18000,0,18000,15800,2200
10/6/2021 21:40,8998866500517,BABY HAPPY PANTS L PCS,5,2000,0,10000,7150,2850
10/6/2021 21:45,8992775305102,GERY MALKIST COCONUT,1,6500,0,6500,5516,984
10/6/2021 21:47,8886022830243,BATEREI ABC,4,2500,0,10000,7712,2288
10/6/2021 21:48,8998989300261,GUDANG GARAM SURYA 12 FILTER,1,20000,0,20000,18150,1850
10/6/2021 21:49,ICE CREAM,ICE CREAM 2000,2,2000,0,4000,3400,600
10/6/2021 21:51,8994935000070,MINYAK GORENG DUNIA 450 ML,1,7500,0,7500,6779,721
10/6/2021 21:52,8992931006256,tessa,1,1000,0,1000,900,100
10/6/2021 21:53,GL,GULA 1 LITER,1,11500,0,11500,10500,1000
10/6/2021 21:53,8999999030179,PEPSODENT ACTION 123 COMPLETE 75G,1,6700,0,6700,5170,1530
10/6/2021 21:54,8999999559045,SUNLIGHT LIME CREAM 110G,1,2000,0,2000,1800,200
10/6/2021 21:54,8994867000162,ROKOK PUNDIMAS KRETEK16,1,10000,0,10000,8600,1400
10/6/2021 21:55,8998866200578,MIE SEDAAP KARI KENTAL,1,2700,0,2700,2331,369
10/6/2021 21:56,089686021219,INTER MIE GORENG,2,1000,0,2000,1770,230
10/6/2021 22:00,8991002105430,KAPAL API 65G,1,5000,0,5000,4145,855
10/6/2021 22:04,8992388133345,NU MILK TEA TEH TARIK 330ML,1,6000,0,6000,5125,875
10/6/2021 22:04,8992761122430,FRESTEA GREEN HONEY 500ML,1,6500,0,6500,4708,1792
10/6/2021 22:05,8998989300261,GUDANG GARAM SURYA 12 FILTER,1,20000,0,20000,18150,1850
10/6/2021 22:06,8992761002039,FANTA STRAWBERRY PET 390 ML,1,5500,0,5500,4333,1167
10/6/2021 22:06,8996001600610,TORA MILKY LATTE 180ML,1,3500,0,3500,2750,750
10/6/2021 22:06,kentang,kripik kentang,3,1000,0,3000,2700,300
10/6/2021 22:07,kri,kripik pisang,1,5000,0,5000,4000,1000
10/6/2021 22:08,YP,YUPI,2,250,0,500,416,84
10/6/2021 22:09,8998866200578,MIE SEDAAP KARI KENTAL,1,2700,0,2700,2331,369
10/6/2021 22:10,8998866203227,MIE SEDAAP AYAM BAKAR LIMAU,1,2700,0,2700,2163,537
10/6/2021 22:10,8998866200882,SUKSESMIE GORENG AYAM KRMS 133GR,1,3500,0,3500,3047,453
10/6/2021 22:11,8998989300261,GUDANG GARAM SURYA 12 FILTER,1,20000,0,20000,18150,1850
10/6/2021 22:11,7622300335809,OREO SOFT CAKE,2,2000,0,4000,3282,718
10/6/2021 22:12,7622300335809,OREO SOFT CAKE,1,2000,0,2000,1641,359
10/6/2021 22:13,8992775001653,GERY SALUT CHOCOLATE COCONUT,1,2000,0,2000,1476,524
10/6/2021 22:14,ROTI,ROTI 2000,1,2000,0,2000,1800,200
10/6/2021 22:14,8999909002821,MARLBORO BLACK 16,1,22000,0,22000,20850,1150
10/6/2021 22:17,8999909982000,SAMPOERNA 12 FILTER,1,19000,0,19000,16600,2400
10/6/2021 22:17,TG,TEH GELAS,1,1000,0,1000,729,271
10/6/2021 22:17,8997878002088,Kiko,2,1000,0,2000,900,1100
10/6/2021 22:18,Vita Jelly,Vita Jelly,1,1000,0,1000,766,234
10/6/2021 22:18,8997028590014,ARGUS 220ML,2,500,0,1000,604,396
10/6/2021 22:19,711844110113,KECAP ABC 135 ML,1,7000,0,7000,6400,600
10/6/2021 22:19,ROTI,ROTI 2000,1,2000,0,2000,1800,200
10/6/2021 22:20,8998989500166,GUDANG GARAM MERAH BESAR 16KS,1,18000,0,18000,17000,1000
10/6/2021 22:20,kri,kripik pisang,1,5000,0,5000,4000,1000
10/6/2021 22:21,kentang,kripik kentang,2,1000,0,2000,1800,200
10/6/2021 22:22,8997222130207,Lemonilo Kari Ayam,1,7500,0,7500,6000,1500
10/6/2021 22:23,8998866200578,MIE SEDAAP KARI KENTAL,1,2700,0,2700,2331,369
10/6/2021 22:23,ARG,ARGUS DOS 220ML,1,14500,0,14500,13300,1200
10/6/2021 22:24,8998989300261,GUDANG GARAM SURYA 12 FILTER,1,20000,0,20000,18150,1850
10/6/2021 22:24,8991909101016,URBAN MILD 16,1,17000,0,17000,15800,1200
10/6/2021 22:25,8994834006128,TICTIC PEDAS,1,2000,0,2000,1700,300
10/6/2021 22:25,123124,KOREK BIASA,1,2000,0,2000,1300,700
10/6/2021 22:25,8997878002088,Kiko,2,1000,0,2000,900,1100
10/6/2021 22:26,ICE CREAM,ICE CREAM 2000,1,2000,0,2000,1700,300
10/6/2021 22:27,Vita Jelly,Vita Jelly,1,1000,0,1000,766,234
10/6/2021 22:27,8998989300261,GUDANG GARAM SURYA 12 FILTER,1,20000,0,20000,18150,1850
10/6/2021 22:28,ARG,ARGUS DOS 220ML,4,14500,0,58000,53200,4800
10/6/2021 22:29,kentang,kripik kentang,1,1000,0,1000,900,100
10/6/2021 22:32,ARG,ARGUS DOS 220ML,6,14500,0,87000,79800,7200
10/6/2021 22:35,8719200177314,BLUE BAND 15G,2,2000,0,4000,3000,1000
10/7/2021 20:26,Telur 3 Biji,Telur 3 Biji,1,5000,0,5000,3600,1400
10/7/2021 20:28,0105312686040047,yakult,1,2000,0,2000,1500,500
10/7/2021 20:35,8992696404441,BEAR BRAND 189ML,1,15000,0,15000,11000,4000
10/7/2021 20:35,8992761166038,MMP ORANGE 300ML,1,5000,0,5000,3750,1250
10/7/2021 20:35,Telur 3 Biji,Telur 3 Biji,1,5000,0,5000,3600,1400
10/7/2021 20:35,089686021219,INTER MIE GORENG,3,1000,0,3000,2655,345
10/7/2021 20:35,0105312686040047,yakult,1,2000,0,2000,1500,500
10/7/2021 20:39,kri,kripik pisang,1,5000,0,5000,4000,1000
10/7/2021 20:39,8997028590014,ARGUS 220ML,4,500,0,2000,1208,792
10/7/2021 20:39,8992761166052,FRESTEA MELATI 350ML,1,4500,0,4500,3000,1500
10/7/2021 20:39,kentang,kripik kentang,2,1000,0,2000,1800,200
10/7/2021 20:45,8998866200851,NOODLE SEDAAP MIE BAKSO SPESIAL CUP 77 GR,1,4500,0,4500,3738,762
10/7/2021 20:45,8999999529703,CLEAR MEN COOL SPORT MTHL 80ML,1,11000,0,11000,10000,1000
10/7/2021 20:48,8998866202244,EKOMIE BUMBU KALDU AYAM,2,1000,0,2000,1596,404
10/7/2021 21:04,8999801700054,SUSU FOYU 1 KG,1,22000,0,22000,19791,2209
10/7/2021 21:21,8992759120264,LARISST 220,1,10000,0,10000,9200,800
10/7/2021 22:00,kentang,kripik kentang,1,1000,0,1000,900,100
10/7/2021 22:02,BALON,BALON CABUT,5,1000,0,5000,4500,500
10/7/2021 22:02,ICE CREAM 5.000,ICE CREAM 5.000,1,5000,0,5000,4700,300
10/7/2021 22:03,8992959117583,SFX DS REG FLOW WING 20,1,5000,0,5000,4288,712
10/7/2021 22:04,8995102703534,TERASI DUO 6 GR,1,4000,0,4000,3720,280
10/7/2021 22:04,8995555121244,SOSIS KIMBO,1,1000,0,1000,650,350
10/7/2021 22:05,8992759120264,LARISST 220,1,10000,0,10000,9200,800
10/7/2021 22:06,ICE CREAM,ICE CREAM 2000,1,2000,0,2000,1700,300
10/7/2021 22:07,089686021219,INTER MIE GORENG,2,1000,0,2000,1770,230
10/7/2021 22:08,ICE CREAM 5.000,ICE CREAM 5.000,2,5000,0,10000,9400,600
10/7/2021 22:08,8994867007161,ROKOK PENA GOLD 20,1,18000,0,18000,16800,1200
10/7/2021 22:09,kentang,kripik kentang,1,1000,0,1000,900,100
10/7/2021 22:09,089686021127,INTER MIE KALDU,5,1000,0,5000,4065,935
10/7/2021 22:10,Telur 3 Biji,Telur 3 Biji,1,5000,0,5000,3600,1400
10/7/2021 22:13,089686611670,QTELA BALADO,1,5000,0,5000,4266,734
10/7/2021 22:13,6907992825076,JD WATERMELON APPLE,1,2000,0,2000,1700,300
10/7/2021 22:13,6907992823874,JD CRUNCHY CHOCO BLUEBERRY,1,5500,0,5500,4700,800
10/7/2021 22:16,8996001600610,TORA MILKY LATTE 180ML,1,3500,0,3500,2750,750
10/7/2021 22:16,7622201430153,OREO CHOCOLATE 38G,1,2000,0,2000,1641,359
10/7/2021 22:16,PRG,PARAGO,2,500,0,1000,800,200
10/7/2021 22:16,8992775318201,GERY SNACK BANTAL COKLAT,1,2000,0,2000,1712,288
10/7/2021 22:16,8995555121244,SOSIS KIMBO,1,1000,0,1000,650,350
10/7/2021 22:16,ROTI,ROTI 2000,2,2000,0,4000,3600,400
10/7/2021 22:17,8992388133345,NU MILK TEA TEH TARIK 330ML,1,6000,0,6000,5125,875
10/7/2021 22:17,8991914101513,VIPER KRETEK 12,1,6000,0,6000,5000,1000
10/7/2021 22:18,8997009510116,LEMON WATER,1,7000,0,7000,5694,1306
10/7/2021 22:19,8994867000162,ROKOK PUNDIMAS KRETEK16,1,10000,0,10000,8600,1400
10/7/2021 22:19,8998989300261,GUDANG GARAM SURYA 12 FILTER,1,20000,0,20000,18150,1850
10/7/2021 22:19,8992979130012,TOTAL LEMON SOFTENER,1,15000,0,15000,13524,1476
10/7/2021 22:19,ARG,ARGUS DOS 220ML,1,14500,0,14500,13300,1200
10/7/2021 22:20,8998866200325,MIE SEDAAP SOTO,1,2700,0,2700,2282,418
10/7/2021 22:24,8991102026383,AIR CRYSTALINE 1.5 L,1,5000,0,5000,3471,1529
10/7/2021 22:24,8998866200301,MIE SEDAAP GORENG,2,2700,0,5400,4726,674
10/7/2021 22:24,8991102228053,TEH GELAS BOTOL,1,3000,0,3000,1695,1305
10/7/2021 22:24,8998989110167,SURYA GUDANG GARAM 16 FILTER,1,26000,0,26000,23700,2300
10/7/2021 22:24,8998989300261,GUDANG GARAM SURYA 12 FILTER,1,20000,0,20000,18150,1850
10/7/2021 22:25,8998866202619,MIE SEDAAP KOREAN SPICY SOUP,2,2700,0,5400,4644,756
10/7/2021 22:27,9556040040038,SUSU F&N,2,33000,0,66000,60000,6000
10/7/2021 22:27,8998866202268,KECAP MANIS SEDAAP SPC REFILL 550ML,1,20000,0,20000,17850,2150
10/7/2021 22:27,8998989300261,GUDANG GARAM SURYA 12 FILTER,1,20000,0,20000,18150,1850
10/7/2021 22:28,123124,KOREK BIASA,1,2000,0,2000,1300,700
10/7/2021 22:28,8997878002088,Kiko,3,1000,0,3000,1350,1650
10/7/2021 22:29,8992628020152,MINYAK GOREG BIMOLI POUCH 2L,1,32000,0,32000,29800,2200
10/7/2021 22:30,8991102100823,Formula Acttion Protector 190 gr,1,10000,0,10000,9000,1000
10/7/2021 22:31,8992775110157,GARUDA KACANG KULIT,1,5000,0,5000,3925,1075
10/7/2021 22:32,ICE CREAM 3,ICE CREAM 3000,2,3000,0,6000,5200,800
10/7/2021 22:32,8991102103091,Formula Proteksi,1,3500,0,3500,2650,850
10/7/2021 22:34,8999999534752,PEPSODENT ACTION123 CHARCOAL 65G,1,7400,0,7400,6710,690
10/7/2021 22:34,8999999048174,SUNSILK  BLK SHINE 70+21ML,1,9600,0,9600,8525,1075
10/7/2021 22:37,8999999045913,LIFEBUOY MILDCARE 110GR,1,15000,0,15000,14245,755
10/7/2021 22:37,8991102022460,FORMULA DIAMOND,1,3000,0,3000,2500,500
10/7/2021 22:38,8993093115008,tepun beras,1,8000,0,8000,7000,1000
10/7/2021 22:38,8992761002022,SPRITE PET 390ML,1,5500,0,5500,4333,1167
10/7/2021 22:39,8998989300261,GUDANG GARAM SURYA 12 FILTER,1,20000,0,20000,18150,1850
10/7/2021 22:39,GL,GULA 1 LITER,1,11500,0,11500,10500,1000
10/7/2021 22:45,8998989110167,SURYA GUDANG GARAM 16 FILTER,1,26000,0,26000,23700,2300
10/8/2021 18:51,089686060461,POP MIE RASA KARI AYAM,2,4500,0,9000,7666,1334
10/8/2021 18:51,8991002105430,KAPAL API 65G,1,5000,0,5000,4145,855
10/8/2021 18:51,8998866200301,MIE SEDAAP GORENG,2,2700,0,5400,4726,674
10/8/2021 18:51,8991102228053,TEH GELAS BOTOL,1,3000,0,3000,1695,1305
10/8/2021 18:51,8997878002088,Kiko,2,1000,0,2000,900,1100
10/8/2021 18:52,ROTI,ROTI 2000,1,2000,0,2000,1800,200
10/8/2021 18:52,8995555121244,SOSIS KIMBO,1,1000,0,1000,650,350
10/8/2021 18:52,7622201430153,OREO CHOCOLATE 38G,1,2000,0,2000,1641,359
10/8/2021 18:53,8886001038011,BENG-BENG SCT,1,1500,0,1500,1000,500
10/8/2021 18:54,8998866202244,EKOMIE BUMBU KALDU AYAM,4,1000,0,4000,3192,808
10/8/2021 18:57,8997018920081,RED BULD,1,20000,0,20000,18000,2000
10/8/2021 18:57,8999909002821,MARLBORO BLACK 16,1,22000,0,22000,20850,1150
10/8/2021 18:58,8998866201490,POTABEE REGULER GRILLED SEAWED 68 GR,1,8000,0,8000,7200,800
10/8/2021 19:00,8997028590052,ARGUS BTL 600ML,2,3000,0,6000,2916,3084
10/8/2021 19:00,8997009460343,NEXI NET,2,1000,0,2000,1800,200
10/8/2021 19:01,kentang,kripik kentang,1,1000,0,1000,900,100
10/8/2021 19:03,8991914101513,VIPER KRETEK 12,1,6000,0,6000,5000,1000
10/8/2021 19:03,8886001038011,BENG-BENG SCT,1,1500,0,1500,1000,500
10/8/2021 19:08,8991102387286,TANGO LONG CKLT 47G,1,2000,0,2000,1551,449
10/8/2021 19:09,8992931006256,tessa,1,1000,0,1000,900,100
10/8/2021 19:09,4901730070010,C&C OIL CONTROL FILM PINK 50,1,24000,0,24000,21250,2750
10/8/2021 19:11,8998866202343,MIE SEDAAP KOREAN SPICY,7,2700,0,18900,16891,2009
10/8/2021 19:13,8991102026383,AIR CRYSTALINE 1.5 L,3,5000,0,15000,10413,4587
10/8/2021 19:13,8991909101016,URBAN MILD 16,1,17000,0,17000,15800,1200
10/8/2021 19:13,8993379210854,SABUN HARMONY APPLE 70G,2,2000,0,4000,3304,696
10/8/2021 19:15,8998989110167,SURYA GUDANG GARAM 16 FILTER,1,26000,0,26000,23700,2300
10/8/2021 19:15,123124,KOREK BIASA,1,2000,0,2000,1300,700
10/8/2021 19:15,GGK,PLAYGUM PERMEN KARET,4,500,0,2000,1600,400
10/8/2021 19:19,8992959020012,SWEETY SILVER PANTS XL34,1,78000,0,78000,73637,4363
10/8/2021 19:19,8992959953303,SWEETY BRONZE S64,1,80000,0,80000,76364,3636
10/8/2021 19:21,8999999053048,PONDS FACIAL FOAM 100G,1,27000,0,27000,24900,2100
10/8/2021 19:21,8996001305119,ARDEN 30G,1,2000,0,2000,1650,350
10/8/2021 19:23,8992959508985,SWEETY SILVER PANTS M30,1,56800,0,56800,51819,4981
10/8/2021 19:25,8886022971298,BATERAI ALKALINE 06,1,12000,0,12000,10557,1443
10/8/2021 19:25,8999999560423,DOVE SUPER SHAMPOO 125ML,1,18500,0,18500,17000,1500
10/8/2021 19:26,8998866107464,POSH FRESH SPIRIT 150ML,1,19500,0,19500,17500,2000
10/8/2021 19:28,Gula gula tusuk,gula gula tusuk,4,500,0,2000,1600,400
10/8/2021 19:29,ROTI,ROTI 2000,1,2000,0,2000,1800,200
10/8/2021 19:45,8993007000024,INDOMILK UHT VANILA,1,5000,0,5000,3470,1530
10/8/2021 19:45,6907992823645,JD COCONUT BLISS,1,4000,0,4000,3500,500
10/8/2021 19:45,OJELLY,O'JELLY,3,500,0,1500,1155,345
10/8/2021 19:45,7622300335809,OREO SOFT CAKE,1,2000,0,2000,1641,359
10/8/2021 20:07,8997009510123,ORANGE WATER,1,11000,0,11000,10416,584
10/8/2021 20:24,ROTI,ROTI 2000,1,2000,0,2000,1800,200
10/8/2021 20:24,8998866500708,FLORIDINA ORANGE,1,3000,0,3000,2500,500
10/10/2021 19:23,8999999031602,SARI MURNI 20X1.6G,1,6000,0,6000,5400,600
10/10/2021 19:24,ARG,ARGUS DOS 220ML,1,14500,0,14500,13300,1200
10/10/2021 19:46,8996001312445,MALKIST CAPPUCINO,1,6500,0,6500,5400,1100
10/10/2021 19:46,ROTI,ROTI 2000,2,2000,0,4000,3600,400
10/10/2021 19:46,8992696523067,MILO ACTVGO UHT 180ML,1,4500,0,4500,3515,985
10/10/2021 19:46,Vita Jelly,Vita Jelly,3,1000,0,3000,2298,702
10/10/2021 19:49,MK,MASKER,1,5000,0,5000,4000,1000
10/10/2021 20:01,8998866600538,SOKLIN FLOORCLENER PINK 400ML,1,6000,0,6000,5025,975
10/10/2021 20:01,8999908204202,MY BABY MINYAK TELON 60ML,1,18000,0,18000,16900,1100
10/10/2021 20:08,8886022971298,BATERAI ALKALINE 06,1,12000,0,12000,10557,1443
10/10/2021 20:10,8993989311699,CLAS MILD 16 FILTER,1,24000,0,24000,21700,2300
10/10/2021 20:10,8999999534752,PEPSODENT ACTION123 CHARCOAL 65G,1,7400,0,7400,6710,690
10/10/2021 20:10,7622300335809,OREO SOFT CAKE,1,2000,0,2000,1641,359
10/10/2021 20:11,8993379260026,SABUN MEDICARE BLACK,2,2500,0,5000,4474,526
10/10/2021 20:13,KIKO,KIKO,2,1000,0,2000,1000,1000
10/10/2021 20:13,8992696404441,BEAR BRAND 189ML,1,15000,0,15000,11000,4000
10/10/2021 20:13,8993007003063,ENAAK 500G,1,11000,0,11000,9625,1375
10/10/2021 20:14,8997027300089,NOMOS,1,4000,0,4000,2963,1037
10/10/2021 20:16,Gula gula tusuk,gula gula tusuk,5,500,0,2500,2000,500
10/10/2021 20:16,123124,KOREK BIASA,1,2000,0,2000,1300,700
10/10/2021 20:16,8998009010231,ULTRA CHO 250,1,6000,0,6000,4784,1216
10/10/2021 20:17,8998989300261,GUDANG GARAM SURYA 12 FILTER,1,20000,0,20000,18150,1850
10/10/2021 20:17,ICE CREAM 5,ICE CREAM 5000,1,5000,0,5000,4400,600
10/10/2021 20:18,ICE CREAM 3,ICE CREAM 3000,1,3000,0,3000,2600,400
10/10/2021 20:20,8994867007161,ROKOK PENA GOLD 20,1,18000,0,18000,16800,1200
10/10/2021 20:20,8997218380074,ICHITAN MILK TEA,1,8000,0,8000,6500,1500
10/10/2021 20:20,8997009510123,ORANGE WATER,1,11000,0,11000,10416,584
10/10/2021 20:22,8992761122331,FRESTEA APPEL 500ML,1,6500,0,6500,4791,1709
10/10/2021 20:22,8997218380074,ICHITAN MILK TEA,2,8000,0,16000,13000,3000
10/10/2021 20:24,8992761164539,NUTRIBOOST ORANGE 300ML,1,6500,0,6500,5300,1200
10/10/2021 20:24,8991102987639,WFR TANGO LONG VNL 130G,1,5000,0,5000,3773,1227
10/10/2021 20:24,8992761111533,SPRITE SLIM CAM250ML,1,5000,0,5000,3750,1250
10/10/2021 20:26,8998989300261,GUDANG GARAM SURYA 12 FILTER,2,20000,0,40000,36300,3700
10/10/2021 20:26,8999999031930,PEPSODENT TB TRIPLE CLEAN,1,3500,0,3500,2850,650
10/10/2021 20:26,8998989110167,SURYA GUDANG GARAM 16 FILTER,1,26000,0,26000,23700,2300
10/10/2021 20:27,8998989300261,GUDANG GARAM SURYA 12 FILTER,1,20000,0,20000,18150,1850
10/10/2021 20:27,MK,MASKER,1,5000,0,5000,4000,1000
10/10/2021 20:28,8998866500487,BABY HAPPY PANTS M 20P,1,37000,0,37000,33520,3480
10/10/2021 20:29,8999801700054,SUSU FOYU 1 KG,1,22000,0,22000,19791,2209
10/10/2021 20:29,GL,GULA 1 LITER,10,11500,0,115000,105000,10000
10/10/2021 20:31,8998866201469,POTABEE REGULER BBQ BEEF 68 GR,1,8000,0,8000,7200,800
10/10/2021 20:31,MK,MASKER,1,5000,0,5000,4000,1000
10/10/2021 20:31,8998009010231,ULTRA CHO 250,2,6000,0,12000,9568,2432
10/10/2021 20:35,8998866202053,POTABEE AYAM BAKAR PEDAS 68GR,1,8000,0,8000,7200,800
10/10/2021 20:35,Gula gula kopiko,gula gula kopiko,3,350,0,1050,750,300
10/10/2021 20:35,KOPIKO,KOPIKO,5,250,0,1250,875,375
10/10/2021 20:37,7622300405588,KEJUCAKE 16G,2,2000,0,4000,3282,718
10/10/2021 20:40,8999909002821,MARLBORO BLACK 16,1,22000,0,22000,20850,1150
10/10/2021 20:40,MK,MASKER,1,5000,0,5000,4000,1000
10/10/2021 20:40,8998989500166,GUDANG GARAM MERAH BESAR 16KS,1,18000,0,18000,17000,1000
10/10/2021 20:40,123124,KOREK BIASA,1,2000,0,2000,1300,700
10/10/2021 20:40,8992696523067,MILO ACTVGO UHT 180ML,2,4500,0,9000,7030,1970
10/10/2021 20:40,8997028590052,ARGUS BTL 600ML,1,3000,0,3000,1458,1542
10/10/2021 20:40,8991909101016,URBAN MILD 16,1,17000,0,17000,15800,1200
10/10/2021 20:41,8992761145026,SPRITE PET 250ML,1,3500,0,3500,2417,1083
10/10/2021 20:42,8992761166038,MMP ORANGE 300ML,1,5000,0,5000,3750,1250
10/10/2021 20:44,7622201430153,OREO CHOCOLATE 38G,2,2000,0,4000,3282,718
10/10/2021 20:46,8996001305119,ARDEN 30G,1,2000,0,2000,1650,350
10/10/2021 20:46,8992717781025,SANTAN KELAPA,1,4000,0,4000,3000,1000
10/10/2021 20:46,8997028590045,ARGUS BTL 330ML,1,2000,0,2000,1291,709
10/10/2021 20:51,8886001038011,BENG-BENG SCT,1,1500,0,1500,1000,500
10/10/2021 20:51,GL,GULA 1 LITER,1,11500,0,11500,10500,1000
10/10/2021 20:51,MK BIASA,MASKERBIASA,1,2000,0,2000,15000,-13000
10/10/2021 20:51,JGRP,JOGER PASTA STICK MOBIL,1,13000,0,13000,11750,1250
10/10/2021 20:51,8998866201490,POTABEE REGULER GRILLED SEAWED 68 GR,1,8000,0,8000,7200,800
10/10/2021 20:52,8997027300089,NOMOS,1,4000,0,4000,2963,1037
10/10/2021 20:52,8992388133345,NU MILK TEA TEH TARIK 330ML,1,6000,0,6000,5125,875
10/10/2021 20:55,8992716109172,BISKUAT BOLU SCT,2,2000,0,4000,3282,718
10/10/2021 20:55,GGK,PLAYGUM PERMEN KARET,2,500,0,1000,800,200
10/10/2021 21:03,8998989110167,SURYA GUDANG GARAM 16 FILTER,3,26000,0,78000,71100,6900
10/10/2021 21:03,123124,KOREK BIASA,1,2000,0,2000,1300,700
10/10/2021 21:11,8998989300261,GUDANG GARAM SURYA 12 FILTER,1,20000,0,20000,18150,1850
10/10/2021 21:24,8886013213208,FRENCH FREIS 2000,2,5000,0,10000,7500,2500
10/10/2021 21:48,8999999008475,SUNLIGHT LIME NEW REF 1600ML,1,35000,0,35000,31955,3045
10/10/2021 21:59,8998866200844,NOODLE SEDAAP MIE KARI SPESIAL CUP 81 GR,1,4500,0,4500,3650,850
10/10/2021 21:59,TELUR,TELUR,1,2000,0,2000,1200,800
10/10/2021 21:59,089686043273,INDOMIE SAMBAL RICA,1,2700,0,2700,2452,248
10/10/2021 22:01,8998989300261,GUDANG GARAM SURYA 12 FILTER,2,20000,0,40000,36300,3700
10/11/2021 20:48,8991002114067,PIKOPI,3,1000,0,3000,1635,1365
10/11/2021 20:49,8993226365522,GARAM MEJA GYURI 200GR,2,2000,0,4000,3400,600
10/11/2021 20:57,089686043273,INDOMIE SAMBAL RICA,4,2700,0,10800,9808,992
10/11/2021 20:57,8991102100823,Formula Acttion Protector 190 gr,1,10000,0,10000,9000,1000
10/11/2021 20:57,089686044249,SUPERMI NUTRIMI STEAK AYAM,2,3500,0,7000,5600,1400
10/11/2021 20:57,8998866611152,CREAM EKONOMI VIOLET 455G,1,5500,0,5500,4750,750
10/11/2021 20:57,8998866600101,CREAM EKONOMI LEMON 455G,1,5500,0,5500,4750,750
10/11/2021 20:57,6907992823645,JD COCONUT BLISS,1,4000,0,4000,3500,500
10/11/2021 20:57,6907992823829,JD MILKY MILK,4,3000,0,12000,10400,1600
10/11/2021 20:57,6907992823669,JD MILKY STRAW,1,3000,0,3000,2600,400
10/11/2021 20:57,JD VM,JD VANILLA MILKSHAKE,1,5000,0,5000,4300,700
10/11/2021 21:05,ARG,ARGUS DOS 220ML,3,14500,0,43500,39900,3600
10/11/2021 22:00,8993989311699,CLAS MILD 16 FILTER,1,24000,0,24000,21700,2300
10/11/2021 22:00,8996001600610,TORA MILKY LATTE 180ML,2,3500,0,7000,5500,1500
10/11/2021 22:01,8999999531508,MOLTO HYGIENE SC 10ML,2,500,0,1000,960,40
10/11/2021 22:01,8996001600610,TORA MILKY LATTE 180ML,1,3500,0,3500,2750,750
10/11/2021 22:07,8997028590014,ARGUS 220ML,3,500,0,1500,906,594
10/11/2021 22:07,8992388111145,MIE ABC SELERA PEDAS- SUP TOMAT PEDAS,1,2500,0,2500,2023,477
10/11/2021 22:07,8992775211410,PILUS GARUDA PEDAS,1,5000,0,5000,4886,114
10/11/2021 22:07,8997878002088,Kiko,2,1000,0,2000,900,1100
10/11/2021 22:07,8993274532105,BOLU,2,1000,0,2000,1666,334
10/11/2021 22:10,0105312686040047,yakult,1,2000,0,2000,1500,500
10/11/2021 22:10,8992388101092,NU GREEN TE HONEY 330ML,1,3500,0,3500,2854,646
10/11/2021 22:17,8997025914059,HATARI SEE HONG,1,6000,0,6000,4911,1089
10/11/2021 22:17,8886001038011,BENG-BENG SCT,2,1500,0,3000,2000,1000
10/11/2021 22:17,8995555121244,SOSIS KIMBO,3,1000,0,3000,1950,1050
10/11/2021 22:17,8992775000663,GERY SNACK KEJU,2,2000,0,4000,3424,576
10/11/2021 22:17,8998866500708,FLORIDINA ORANGE,1,3000,0,3000,2500,500
10/11/2021 22:17,ROTI,ROTI 2000,1,2000,0,2000,1800,200
10/11/2021 22:17,123124,KOREK BIASA,1,2000,0,2000,1300,700
10/11/2021 22:17,kentang,kripik kentang,2,1000,0,2000,1800,200
10/11/2021 22:17,8998866500463,BABY HAPPY PANTS M PCS,5,2000,0,10000,7150,2850
10/11/2021 22:17,8992736424293,SASA BUMBU NASI GORENG 20G,1,2000,0,2000,1136,864
10/11/2021 22:19,089686535044,SUN BERAS MERAH,1,8500,0,8500,7410,1090
10/11/2021 22:19,8994867000094,ROKOK PUNDIMAS FIL16,1,15000,0,15000,13500,1500
10/11/2021 22:19,8998989300261,GUDANG GARAM SURYA 12 FILTER,2,20000,0,40000,36300,3700
10/11/2021 22:20,8994867007161,ROKOK PENA GOLD 20,1,18000,0,18000,16800,1200
10/11/2021 22:20,8998866202060,POTABEE AYAM BAKAR PEDAS 35 GR,1,5000,0,5000,4150,850
10/11/2021 22:21,8998866500463,BABY HAPPY PANTS M PCS,2,2000,0,4000,2860,1140
10/11/2021 22:23,8995150101771,M+SUSU RASA JERUK,1,5000,0,5000,4000,1000
10/11/2021 22:23,8995150109418,M+SUSU RASA MANGGA,1,5000,0,5000,4000,1000
10/11/2021 22:23,4902430563895,PANTENE HALUS DAN LEMBUT 10ML,2,1000,0,2000,1572,428
10/11/2021 22:23,Gula gula tusuk,gula gula tusuk,2,500,0,1000,800,200
10/11/2021 22:25,8997210107877,VORTEX SMART 3,1,5000,0,5000,4750,250
10/11/2021 22:25,silet,silet,2,1000,0,2000,1600,400
10/11/2021 22:28,7622300335809,OREO SOFT CAKE,3,2000,0,6000,4923,1077
10/11/2021 22:28,8992761166038,MMP ORANGE 300ML,1,5000,0,5000,3750,1250
10/11/2021 22:29,8992959508312,SWEETY SILVER PANTS XL1,1,3000,0,3000,2324,676
10/11/2021 22:29,Telur 3 Biji,Telur 3 Biji,1,5000,0,5000,3600,1400
10/11/2021 22:29,TELUR,TELUR,2,2000,0,4000,2400,1600
10/11/2021 22:30,8997028590014,ARGUS 220ML,4,500,0,2000,1208,792
10/11/2021 22:32,8993496107549,MINYAK SIIP 1800 ML,1,28000,0,28000,25399,2601
10/12/2021 20:10,8992946521416,SABUN SHINZUI,1,5000,0,5000,4000,1000
10/12/2021 20:10,ARGUS,ARGUS,1,2000,0,2000,1500,500
10/12/2021 20:10,8997878004327,gula-gula milkita,8,250,0,2000,1600,400
10/12/2021 20:12,ARG,ARGUS DOS 220ML,2,14500,0,29000,26600,2400
10/12/2021 20:24,18992628020152,MINYAK GORENG 2 LT,1,34000,0,34000,32000,2000
10/12/2021 20:24,8994834003752,TICTIC,1,2000,0,2000,1700,300
10/12/2021 20:24,7622201430153,OREO CHOCOLATE 38G,1,2000,0,2000,1641,359
10/12/2021 20:24,8998866108317,EMERON HJB ANTDNDF 10ML,2,5000,0,10000,9000,1000
10/12/2021 20:24,8992696521797,MILO 22G,1,2500,0,2500,1572,928
10/12/2021 20:24,8993989311699,CLAS MILD 16 FILTER,1,24000,0,24000,21700,2300
10/12/2021 20:30,8998866610377,ISOPLUS,1,3000,0,3000,2350,650
10/12/2021 20:30,8998866200301,MIE SEDAAP GORENG,3,2700,0,8100,7089,1011
10/12/2021 20:30,8997028590014,ARGUS 220ML,4,500,0,2000,1208,792
10/12/2021 20:30,8999801700054,SUSU FOYU 1 KG,1,22000,0,22000,19791,2209
10/12/2021 20:33,8992702000063,INDOMILK COKLAT 370G,1,10000,0,10000,9020,980
10/12/2021 20:33,8992759120264,LARISST 220,1,10000,0,10000,9200,800
10/12/2021 20:33,8993007003902,Susu Kental Manis Indo milk,1,15000,0,15000,13333,1667
10/12/2021 20:33,8997028590052,ARGUS BTL 600ML,1,3000,0,3000,1458,1542
10/12/2021 20:34,8997028590052,ARGUS BTL 600ML,1,3000,0,3000,1458,1542
10/12/2021 20:36,8999909002821,MARLBORO BLACK 16,1,22000,0,22000,20850,1150
10/12/2021 20:36,8991102026383,AIR CRYSTALINE 1.5 L,1,5000,0,5000,3471,1529
10/12/2021 20:36,krupuk k,Krupuk Kentang,1,5000,0,5000,4500,500
10/12/2021 20:37,8999909096004,SAMPOERNA 16 FILTER,1,25000,0,25000,23100,1900
10/12/2021 20:37,MBL,MOBIL,1,5000,0,5000,3500,1500
10/12/2021 20:39,8992959508312,SWEETY SILVER PANTS XL1,1,3000,0,3000,2324,676
10/12/2021 20:39,8992761166038,MMP ORANGE 300ML,1,5000,0,5000,3750,1250
10/12/2021 20:47,8992959508312,SWEETY SILVER PANTS XL1,1,3000,0,3000,2324,676
10/12/2021 20:47,8993571003988,CAP 19 BEDAK TALK 100G,1,5500,0,5500,4250,1250
10/12/2021 20:49,8999999007782,FAIR&LOVELY MULTIVITAMIN CREAM 25 MG,1,16500,0,16500,14905,1595
10/12/2021 20:49,8992761145033,FANTA STRAW PET 250ML,1,3500,0,3500,2417,1083
10/12/2021 20:51,ARG,ARGUS DOS 220ML,3,14500,0,43500,39900,3600
10/12/2021 20:51,8998009010569,ULTRA CHO 200,1,5000,0,5000,3958,1042
10/12/2021 20:52,8998009010231,ULTRA CHO 250,1,6000,0,6000,4784,1216
10/12/2021 20:55,8999999007782,FAIR&LOVELY MULTIVITAMIN CREAM 25 MG,1,16500,0,16500,14905,1595
10/12/2021 20:55,1212060005003,IMPLORA,1,20000,0,20000,1900,18100
10/12/2021 20:57,8998866201889,KRISBEE PILLOW STRAWBERRY ICE CREAM 120GR,1,8000,0,8000,7250,750
10/12/2021 21:01,8998898830125,KKB ENER-G ANGGUR,2,5500,0,11000,9648,1352
10/12/2021 21:01,8998866203227,MIE SEDAAP AYAM BAKAR LIMAU,1,2700,0,2700,2163,537
10/12/2021 21:02,8997002060168,KRP SINGKOG PDS PANDA DUO,1,8000,0,8000,7300,700
10/12/2021 21:03,8995333060772,TERIGU GATOT KACA 500GR,1,5000,0,5000,4346,654
10/12/2021 21:03,8992775000663,GERY SNACK KEJU,2,2000,0,4000,3424,576
10/12/2021 21:03,8995555171225,KIMBO SOSIS,1,1000,0,1000,900,100
10/12/2021 21:05,8998866500708,FLORIDINA ORANGE,2,3000,0,6000,5000,1000
10/12/2021 21:05,GL,GULA 1 LITER,2,11500,0,23000,21000,2000
10/12/2021 21:05,Garuda pilus,Garuda Pilus Pedas Pcs,1,500,0,500,408,92
10/12/2021 21:05,8997028590014,ARGUS 220ML,2,500,0,1000,604,396
10/12/2021 21:07,6921101219235,YAKUAT JELLY,1,2000,0,2000,1750,250
10/12/2021 21:07,8992761111533,SPRITE SLIM CAM250ML,1,5000,0,5000,3750,1250
10/12/2021 21:07,8997009510123,ORANGE WATER,1,11000,0,11000,10416,584
10/12/2021 21:08,8999999555450,VIXAL PEMB PORS BIRU 190ML,1,5000,0,5000,4200,800
10/12/2021 21:11,8999999016128,RINSO MOLTO ROSE FRESH 750ML,2,15000,0,30000,25014,4986
10/12/2021 21:13,8991111101316,JB OIL 50ML,1,9500,0,9500,8700,800
10/12/2021 21:13,8991102002363,SABUN PRIMA PROTECT 110GR,1,5000,0,5000,3900,1100
10/12/2021 21:14,8994834003752,TICTIC,2,2000,0,4000,3400,600
10/12/2021 21:14,ARG,ARGUS DOS 220ML,1,14500,0,14500,13300,1200
10/12/2021 21:15,TBR,TEPUNG BERAS ROSE BRAND,1,8000,0,8000,6150,1850
10/12/2021 21:15,8991102228053,TEH GELAS BOTOL,1,3000,0,3000,1695,1305
10/12/2021 21:15,8997878002088,Kiko,1,1000,0,1000,450,550
10/12/2021 21:20,089686010824,INDOMIE GORENG SPESIAL,1,2700,0,2700,2452,248
10/12/2021 21:20,8998866202343,MIE SEDAAP KOREAN SPICY,2,2700,0,5400,4826,574
10/12/2021 21:20,ARG,ARGUS DOS 220ML,1,14500,0,14500,13300,1200
10/12/2021 21:20,8997028590014,ARGUS 220ML,4,500,0,2000,1208,792
10/12/2021 21:20,8998989100120,GUDANG GARAM MINI,1,19000,0,19000,16600,2400
10/12/2021 21:20,8992761139018,ADES 600ML,1,3500,0,3500,2166,1334
10/12/2021 21:21,Gula gula kaki,gula gula kaki,2,500,0,1000,800,200
10/12/2021 21:21,8999999049454,REXONA WMN RO FREE SPIRIT 45 ML,1,15000,0,15000,13550,1450
10/12/2021 21:22,7992912508305,SWEETY SILVER PANTS L1,1,2500,0,2500,1882,618
10/12/2021 21:23,4801010531234,JB BATH BLUE 200 (REFILL),1,14000,0,14000,13530,470
10/12/2021 21:25,8998989300261,GUDANG GARAM SURYA 12 FILTER,1,20000,0,20000,18150,1850
10/12/2021 21:28,8997878002088,Kiko,2,1000,0,2000,900,1100
10/12/2021 21:28,ICE CREAM,ICE CREAM 2000,1,2000,0,2000,1700,300
10/12/2021 21:29,8992760223015,OREO CHOCOLATE CREAM 133G,1,8000,0,8000,6300,1700
10/12/2021 21:32,8998866202244,EKOMIE BUMBU KALDU AYAM,3,1000,0,3000,2394,606
10/12/2021 21:38,8998899001166,BAYGON CITRUS FRESH 600ML,1,37000,0,37000,35000,2000
10/12/2021 21:39,8998009010569,ULTRA CHO 200,1,5000,0,5000,3958,1042
10/12/2021 21:40,8991111101316,JB OIL 50ML,1,9500,0,9500,8700,800
10/12/2021 21:42,089686010824,INDOMIE GORENG SPESIAL,2,2700,0,5400,4904,496
10/12/2021 21:43,gg,gula-gula koin,2,500,0,1000,800,200
10/12/2021 21:44,8997028590014,ARGUS 220ML,4,500,0,2000,1208,792
10/12/2021 21:44,Telur 3 Biji,Telur 3 Biji,1,5000,0,5000,3600,1400
10/12/2021 21:45,8993470671752,JOGER STICK DUO KACANG,2,1000,0,2000,1700,300
10/12/2021 21:45,ICE CREAM 3,ICE CREAM 3000,1,3000,0,3000,2600,400
10/12/2021 21:46,Gula gula kaki,gula gula kaki,2,500,0,1000,800,200
10/12/2021 21:47,Gula gula tusuk,gula gula tusuk,2,500,0,1000,800,200
10/12/2021 21:47,Gula gula tusuk,gula gula tusuk,6,500,0,3000,2400,600
10/12/2021 21:49,8997028590014,ARGUS 220ML,2,500,0,1000,604,396
10/12/2021 21:49,8993470411433,JOGER CLASSIC,1,1000,0,1000,850,150
10/12/2021 21:49,8998989300261,GUDANG GARAM SURYA 12 FILTER,2,20000,0,40000,36300,3700
10/12/2021 21:56,TUSTEL,TUSUK TELINGA,2,1000,0,2000,1666,334
10/12/2021 22:06,8992761166038,MMP ORANGE 300ML,1,5000,0,5000,3750,1250
10/12/2021 22:11,8998866200325,MIE SEDAAP SOTO,2,2700,0,5400,4564,836
10/13/2021 20:19,7622201430153,OREO CHOCOLATE 38G,1,2000,0,2000,1641,359
10/13/2021 20:19,8993274534079,PARAGO CHOCO,2,500,0,1000,800,200
10/13/2021 20:19,ROTI,ROTI 2000,1,2000,0,2000,1800,200
10/13/2021 20:19,8997028590045,ARGUS BTL 330ML,4,2000,0,8000,5164,2836
10/13/2021 20:19,MK,MASKER,3,5000,0,15000,12000,3000
10/13/2021 20:26,8992775000076,GERY SNACK RING CKLT,1,2000,0,2000,1712,288
10/13/2021 20:26,8996001314005,ROMA KELAPA CREAM CKLT,1,8000,0,8000,6642,1358
10/13/2021 20:26,8993274534079,PARAGO CHOCO,4,500,0,2000,1600,400
10/13/2021 20:26,gg,gula-gula koin,6,500,0,3000,2400,600
10/13/2021 20:26,ROTI,ROTI 2000,5,2000,0,10000,9000,1000
10/13/2021 20:26,8996001305126,ARDEN BOX,1,18000,0,18000,16500,1500
10/13/2021 20:26,8998898280401,TOLAK ANGIN FLU,1,3500,0,3500,2708,792
10/13/2021 20:31,8991102385060,TANGO WAFFLE CHOX,1,9000,0,9000,8498,502
10/13/2021 20:31,8991102987875,WFR TANGO POUCH CKL 115G,1,8000,0,8000,6786,1214
10/13/2021 20:31,8992761166205,FRESTEA GREEN HONEY 350ML,1,4500,0,4500,3000,1500
10/13/2021 20:31,8994834005923,SPIX 1000,3,1000,0,3000,2550,450
10/13/2021 20:34,8998866500708,FLORIDINA ORANGE,1,3000,0,3000,2500,500
10/13/2021 20:34,8998866500463,BABY HAPPY PANTS M PCS,2,2000,0,4000,2860,1140
10/13/2021 20:38,8992761166038,MMP ORANGE 300ML,5,5000,0,25000,18750,6250
10/13/2021 20:38,8991909101016,URBAN MILD 16,1,17000,0,17000,15800,1200
10/13/2021 20:38,8992388133345,NU MILK TEA TEH TARIK 330ML,1,6000,0,6000,5125,875
10/13/2021 20:42,8996001301579,MALKIST CKLT KELAPA PACK,2,6500,0,13000,10800,2200
10/13/2021 20:42,kri,kripik pisang,1,5000,0,5000,4000,1000
10/13/2021 20:42,8992775610367,Garuda Koro paggang,2,1000,0,2000,1656,344
10/13/2021 20:42,8992775312469,GERY SALUT COKELAT,1,11000,0,11000,9983,1017
10/13/2021 20:42,8997028590045,ARGUS BTL 330ML,1,2000,0,2000,1291,709
10/13/2021 20:42,8992775001042,PILUS GARUDA MI GORENG,1,5000,0,5000,4810,190
10/13/2021 20:42,8997028590014,ARGUS 220ML,2,500,0,1000,604,396
10/13/2021 20:46,8997028590014,ARGUS 220ML,1,500,0,500,302,198
10/13/2021 20:47,8999909002821,MARLBORO BLACK 16,1,22000,0,22000,20850,1150
10/13/2021 20:50,8991102387286,TANGO LONG CKLT 47G,1,2000,0,2000,1551,449
10/13/2021 20:50,8997028590052,ARGUS BTL 600ML,1,3000,0,3000,1458,1542
10/13/2021 20:50,8991102228053,TEH GELAS BOTOL,4,3000,0,12000,6780,5220
10/13/2021 20:50,8996001301142,ROMA KELAPA,1,8000,0,8000,6628,1372
10/13/2021 20:50,MK BIASA,MASKERBIASA,3,2000,0,6000,45000,-39000
10/13/2021 20:51,MK BIASA,MASKERBIASA,3,2000,0,6000,45000,-39000
10/13/2021 20:58,8997028380165,BISKUIT,1,10000,0,10000,9000,1000
10/13/2021 20:58,MK BIASA,MASKERBIASA,2,2000,0,4000,30000,-26000
10/13/2021 20:58,8997013180046,Tissu Tessi B,1,11000,0,11000,9800,1200
10/13/2021 20:59,8992761166205,FRESTEA GREEN HONEY 350ML,1,4500,0,4500,3000,1500
10/13/2021 20:59,8998866202619,MIE SEDAAP KOREAN SPICY SOUP,1,2700,0,2700,2322,378
10/13/2021 21:00,8997028590014,ARGUS 220ML,4,500,0,2000,1208,792
10/13/2021 21:06,ARG,ARGUS DOS 220ML,2,14500,0,29000,26600,2400
10/13/2021 21:06,8992759120264,LARISST 220,3,10000,0,30000,27600,2400
10/13/2021 21:06,8994867007161,ROKOK PENA GOLD 20,1,18000,0,18000,16800,1200
10/13/2021 21:08,8992775110157,GARUDA KACANG KULIT,1,5000,0,5000,3925,1075
10/13/2021 21:08,8998866202060,POTABEE AYAM BAKAR PEDAS 35 GR,1,5000,0,5000,4150,850
10/13/2021 21:08,8991002103764,GOOD DAY CAPPUCINO 10X25G,3,1500,0,4500,4185,315
10/13/2021 21:08,MTR,MOTOR,2,5000,0,10000,7000,3000
10/13/2021 21:10,8998866202244,EKOMIE BUMBU KALDU AYAM,1,1000,0,1000,798,202
10/13/2021 21:12,8998989110167,SURYA GUDANG GARAM 16 FILTER,1,26000,0,26000,23700,2300
10/13/2021 21:17,8992775110157,GARUDA KACANG KULIT,1,5000,0,5000,3925,1075
10/13/2021 21:17,8995333032113,TERIGU GATOT KACA 1 KG,1,9000,0,9000,8572,428
10/13/2021 21:17,Vita Jelly,Vita Jelly,1,1000,0,1000,766,234
10/13/2021 21:39,089686010824,INDOMIE GORENG SPESIAL,2,2700,0,5400,4904,496
10/13/2021 21:44,8999999706180,PEPSODENT WHITE 190GR,1,10000,0,10000,9350,650
10/13/2021 21:44,8992753100101,BKM FULL CREAM GOLD 370,1,15000,0,15000,14000,1000
10/13/2021 21:53,8886013213208,FRENCH FREIS 2000,1,5000,0,5000,3750,1250
10/13/2021 21:53,8997231980015,O'JELLY MINI APPLE,1,3000,0,3000,2250,750
10/13/2021 21:53,8997028590052,ARGUS BTL 600ML,1,3000,0,3000,1458,1542
10/13/2021 21:53,8993007000024,INDOMILK UHT VANILA,1,5000,0,5000,3470,1530
10/13/2021 21:53,7622201430184,OREO ORIGINAL 38G,1,2000,0,2000,1641,359
10/13/2021 21:53,8994907000428,KECAP SACHET ABC,6,600,0,3600,3000,600
10/13/2021 21:53,Gula gula tusuk,gula gula tusuk,2,500,0,1000,800,200
10/13/2021 21:54,8993989311699,CLAS MILD 16 FILTER,1,24000,0,24000,21700,2300
10/13/2021 21:56,8997028590045,ARGUS BTL 330ML,4,2000,0,8000,5164,2836
10/13/2021 21:56,8992957220117,COKLAT BERUANG,2,2000,0,4000,3400,600
10/13/2021 21:56,8995555121244,SOSIS KIMBO,1,1000,0,1000,650,350
10/13/2021 21:57,8998866610377,ISOPLUS,2,3000,0,6000,4700,1300
10/13/2021 21:59,8886001038011,BENG-BENG SCT,1,1500,0,1500,1000,500
10/13/2021 21:59,8991102300544,WFR TANGO VNL 176G,1,10000,0,10000,8694,1306
10/13/2021 21:59,8997218380159,ICHITAN BROWN SUGAR,1,8000,0,8000,6500,1500
10/13/2021 21:59,kri,kripik pisang,1,5000,0,5000,4000,1000
10/13/2021 21:59,KOPIKO,KOPIKO,4,250,0,1000,700,300
10/13/2021 22:01,8998866201889,KRISBEE PILLOW STRAWBERRY ICE CREAM 120GR,1,8000,0,8000,7250,750
10/13/2021 22:01,8997028590045,ARGUS BTL 330ML,1,2000,0,2000,1291,709
10/13/2021 22:02,8998866201889,KRISBEE PILLOW STRAWBERRY ICE CREAM 120GR,1,8000,0,8000,7250,750
10/13/2021 22:06,MK,MASKER,1,5000,0,5000,4000,1000
10/13/2021 22:06,8994867000162,ROKOK PUNDIMAS KRETEK16,1,10000,0,10000,8600,1400
10/13/2021 22:06,ICE CREAM,ICE CREAM 2000,1,2000,0,2000,1700,300
10/13/2021 22:06,8997028590014,ARGUS 220ML,6,500,0,3000,1812,1188
10/13/2021 22:06,GL,GULA 1 LITER,1,11500,0,11500,10500,1000
10/13/2021 22:06,8992775110157,GARUDA KACANG KULIT,1,5000,0,5000,3925,1075
10/13/2021 22:06,8994935000070,MINYAK GORENG DUNIA 450 ML,1,7500,0,7500,6779,721
10/13/2021 22:06,8992946521416,SABUN SHINZUI,1,5000,0,5000,4000,1000
10/13/2021 22:06,ICE CREAM 3,ICE CREAM 3000,1,3000,0,3000,2600,400
10/13/2021 22:11,ICE CREAM 3,ICE CREAM 3000,1,3000,0,3000,2600,400
10/13/2021 22:12,8991102228053,TEH GELAS BOTOL,2,3000,0,6000,3390,2610
10/13/2021 22:18,8996001600641,TORA CAPPUCINO,1,3500,0,3500,2750,750
10/13/2021 22:18,8996001301142,ROMA KELAPA,1,8000,0,8000,6628,1372
10/13/2021 22:18,8991102300544,WFR TANGO VNL 176G,1,10000,0,10000,8694,1306
10/13/2021 22:18,8997028590052,ARGUS BTL 600ML,4,3000,0,12000,5832,6168
10/13/2021 22:18,8998009040023,TEH KOTAK,1,5000,0,5000,2708,2292
10/13/2021 22:18,8991102026383,AIR CRYSTALINE 1.5 L,1,5000,0,5000,3471,1529
10/13/2021 22:18,8992696523067,MILO ACTVGO UHT 180ML,2,4500,0,9000,7030,1970
10/13/2021 22:18,8992931006256,tessa,1,1000,0,1000,900,100
10/13/2021 22:18,ARG,ARGUS DOS 220ML,2,14500,0,29000,26600,2400
10/13/2021 22:24,8997018720469,TISSUE SE-KA,1,10000,0,10000,9300,700
10/13/2021 22:24,ICE CREAM,ICE CREAM 2000,1,2000,0,2000,1700,300
10/13/2021 22:24,8997028590052,ARGUS BTL 600ML,1,3000,0,3000,1458,1542
10/13/2021 22:24,8992724892844,Coklat mede,1,1000,0,1000,800,200
10/13/2021 22:24,MK,MASKER,1,5000,0,5000,4000,1000
10/13/2021 22:24,Telur 3 Biji,Telur 3 Biji,1,5000,0,5000,3600,1400
10/13/2021 22:24,8995333032113,TERIGU GATOT KACA 1 KG,1,9000,0,9000,8572,428
10/13/2021 22:24,8998866201964,MINYAK GORENG SABRINA 2L POUCH,1,28000,0,28000,26753,1247
10/13/2021 22:24,8993379152017,SABUN CUCI SURYA 200G,1,3000,0,3000,2281,719
10/13/2021 22:24,8994907000428,KECAP SACHET ABC,4,600,0,2400,2000,400
10/13/2021 22:24,8995555121244,SOSIS KIMBO,3,1000,0,3000,1950,1050
10/13/2021 22:25,8999999049447,REXONA WMN RO ADVANCED WHITE 45 ML,1,16500,0,16500,14900,1600
10/13/2021 22:27,ICE CREAM 5.500,ICE CREAM 5.500,1,5500,0,5500,4700,800
10/13/2021 22:27,ICE CREAM 6,ICE CREAM 6.000,1,6000,0,6000,5200,800
10/13/2021 22:27,8997028590052,ARGUS BTL 600ML,1,3000,0,3000,1458,1542
10/13/2021 22:28,8992959953334,SWEETY BRONZE XL42,1,80000,0,80000,75455,4545
10/13/2021 22:31,8992959953174,SWEETY BRONZE M34+2,1,58000,0,58000,53182,4818
10/13/2021 22:31,8998866200578,MIE SEDAAP KARI KENTAL,3,2700,0,8100,6993,1107
10/14/2021 19:31,8992702000018,INDOMILK PUTIH 370G,1,10000,0,10000,9020,980
10/14/2021 19:34,8994834003752,TICTIC,2,2000,0,4000,3400,600
10/14/2021 19:34,8991102387286,TANGO LONG CKLT 47G,2,2000,0,4000,3102,898
10/14/2021 19:34,ICE CREAM,ICE CREAM 2000,1,2000,0,2000,1700,300
10/14/2021 19:34,089686021219,INTER MIE GORENG,2,1000,0,2000,1770,230
10/14/2021 19:37,ICE CREAM,ICE CREAM 2000,6,2000,0,12000,10200,1800
10/14/2021 19:37,KIKO,KIKO,3,1000,0,3000,1500,1500
10/14/2021 19:37,gg,gula-gula koin,6,500,0,3000,2400,600
10/14/2021 19:39,ICE CREAM 3,ICE CREAM 3000,1,3000,0,3000,2600,400
10/14/2021 19:39,8997028590014,ARGUS 220ML,4,500,0,2000,1208,792
10/14/2021 19:39,8997009460343,NEXI NET,2,1000,0,2000,1800,200
10/14/2021 19:39,kentang,kripik kentang,2,1000,0,2000,1800,200
10/14/2021 19:42,8992959002032,SWEETY SILVER PANTS L36,1,72000,0,72000,68182,3818
10/14/2021 19:42,8992775311615,CHOCOLATOS,1,12000,0,12000,9983,2017
10/14/2021 19:42,kri,kripik pisang,1,5000,0,5000,4000,1000
10/14/2021 19:49,MK BIASA,MASKERBIASA,2,2000,0,4000,3000,1000
10/14/2021 20:05,8993989311699,CLAS MILD 16 FILTER,1,24000,0,24000,21700,2300
10/14/2021 20:12,8992775001691,GARUDA ROSTA WAGYU BEEF 100G,1,8000,0,8000,7322,678
10/14/2021 20:12,KIKO,KIKO,1,1000,0,1000,500,500
10/14/2021 20:12,Gula gula kopiko,gula gula kopiko,3,350,0,1050,750,300
10/14/2021 20:22,kentang,kripik kentang,1,1000,0,1000,900,100
10/14/2021 20:22,MK,MASKER,2,5000,0,10000,8000,2000
10/14/2021 20:22,8999999049454,REXONA WMN RO FREE SPIRIT 45 ML,1,15000,0,15000,13550,1450
10/14/2021 20:22,8997013180046,Tissu Tessi B,1,11000,0,11000,9800,1200
10/14/2021 20:23,8998866500463,BABY HAPPY PANTS M PCS,5,2000,0,10000,7150,2850
10/14/2021 20:25,8992775110157,GARUDA KACANG KULIT,1,5000,0,5000,3925,1075
10/14/2021 20:25,8991102281430,PERMEN MINTZ DUOMINT,1,5000,0,5000,4000,1000
10/14/2021 20:26,8997009510055,YOU C1000,1,15000,0,15000,13000,2000
10/14/2021 20:30,8992761111533,SPRITE SLIM CAM250ML,1,5000,0,5000,3750,1250
10/14/2021 20:32,0105312686040047,yakult,2,2000,0,4000,3000,1000
10/14/2021 20:43,8998866107112,WET WIPES KODOMO  BABY 50SHT,1,20000,0,20000,14150,5850
10/14/2021 20:43,LEM,LEM TIKUS,1,27000,0,27000,24000,3000
10/14/2021 20:43,8886013213208,FRENCH FREIS 2000,1,5000,0,5000,3750,1250
10/14/2021 20:43,8992696521629,DNCO COKLT UHT 180ML,1,5000,0,5000,3533,1467
10/14/2021 20:43,8992957220186,COKLAT RUSA,2,2000,0,4000,3400,600
10/14/2021 20:43,8999909003439,MARLBORO CRAFTED 12,2,8000,0,16000,14500,1500
10/14/2021 20:43,8998866201469,POTABEE REGULER BBQ BEEF 68 GR,2,8000,0,16000,14400,1600
10/14/2021 20:43,8993324850395,GENTLE CUTTON BUDS 50,1,3000,0,3000,2000,1000
10/14/2021 20:43,8997240540019,tepun tapioka,1,11000,0,11000,9900,1100
10/14/2021 20:45,8998866200882,SUKSESMIE GORENG AYAM KRMS 133GR,1,3500,0,3500,3047,453
10/14/2021 20:45,8998866202244,EKOMIE BUMBU KALDU AYAM,1,1000,0,1000,798,202
10/14/2021 20:49,8991188943062,SASA 250G,1,10000,0,10000,8500,1500
10/14/2021 20:49,8999909096004,SAMPOERNA 16 FILTER,2,25000,0,50000,46200,3800
10/14/2021 20:49,8991002342118,gula-gula kapal api,1,5000,0,5000,4000,1000
10/14/2021 20:49,8997218380074,ICHITAN MILK TEA,1,8000,0,8000,6500,1500
10/14/2021 20:49,TEMBAK,TEMBAK SNIPPER,1,3500,0,3500,2500,1000
10/14/2021 20:49,ARG,ARGUS DOS 220ML,1,14500,0,14500,13300,1200
10/14/2021 20:51,8999909010567,234 DJI SAM SOE 16,2,22500,0,45000,43000,2000
10/14/2021 20:51,8998866202343,MIE SEDAAP KOREAN SPICY,1,2700,0,2700,2413,287
10/14/2021 20:51,8997028590014,ARGUS 220ML,4,500,0,2000,1208,792
10/14/2021 20:51,TG,TEH GELAS,3,1000,0,3000,2187,813
10/14/2021 20:52,kentang,kripik kentang,1,1000,0,1000,900,100
10/14/2021 20:54,MK,MASKER,1,5000,0,5000,4000,1000
10/14/2021 20:54,8995555121244,SOSIS KIMBO,3,1000,0,3000,1950,1050
10/14/2021 20:54,8992775001783,GERY SALUT MALKIST KELAPA,1,6500,0,6500,5516,984
10/14/2021 20:57,ARG,ARGUS DOS 220ML,2,14500,0,29000,26600,2400
10/14/2021 20:57,MK,MASKER,1,5000,0,5000,4000,1000
10/14/2021 21:02,8992775311615,CHOCOLATOS,1,12000,0,12000,9983,2017
10/14/2021 21:02,8992388101085,NU GREEN TEA ORIGINAL 330ML,1,3500,0,3500,2768,732
10/14/2021 21:02,8992717781025,SANTAN KELAPA,2,4000,0,8000,6000,2000
10/14/2021 21:02,8997009510055,YOU C1000,1,15000,0,15000,13000,2000
10/14/2021 21:02,8997028590052,ARGUS BTL 600ML,1,3000,0,3000,1458,1542
10/14/2021 21:02,8997878004327,gula-gula milkita,8,250,0,2000,1600,400
10/14/2021 21:04,8993379200879,SABUN HARMONY MELON 70G,1,2000,0,2000,1652,348
10/14/2021 21:04,8997013180046,Tissu Tessi B,1,11000,0,11000,9800,1200
10/14/2021 21:04,8991102387286,TANGO LONG CKLT 47G,1,2000,0,2000,1551,449
10/14/2021 21:04,8993274534079,PARAGO CHOCO,2,500,0,1000,800,200
10/14/2021 21:09,8996001600641,TORA CAPPUCINO,1,3500,0,3500,2750,750
10/14/2021 21:09,8999908284907,MY BABY MINYAK TELON 90ML,1,25000,0,25000,22700,2300
10/14/2021 21:09,TEMBAK,TEMBAK SNIPPER,1,3500,0,3500,2500,1000
10/14/2021 21:09,8998866608459,POWDET DAIA PUTIH BAG 290GR,1,5000,0,5000,4450,550
10/14/2021 21:09,8998866200578,MIE SEDAAP KARI KENTAL,1,2700,0,2700,2331,369
10/14/2021 21:09,8999999192150,ROYCO FDS CHICKEN 100GR,1,5000,0,5000,4300,700
10/14/2021 21:09,8992717781025,SANTAN KELAPA,1,4000,0,4000,3000,1000
10/14/2021 21:09,8997013180046,Tissu Tessi B,1,11000,0,11000,9800,1200
10/14/2021 21:09,Telur 3 Biji,Telur 3 Biji,1,5000,0,5000,3600,1400
10/14/2021 21:11,AMPLOP,AMPLOP,2,250,0,500,350,150
10/14/2021 21:11,ICE CREAM,ICE CREAM 2000,1,2000,0,2000,1700,300
10/14/2021 21:11,8997878004327,gula-gula milkita,4,250,0,1000,800,200
10/14/2021 21:11,YP,YUPI,6,250,0,1500,1248,252
10/14/2021 21:19,TEMBAK,TEMBAK SNIPPER,1,3500,0,3500,2500,1000
10/14/2021 21:19,gg,gula-gula koin,4,500,0,2000,1600,400
10/14/2021 21:19,Gula gula kaki,gula gula kaki,5,500,0,2500,2000,500
10/14/2021 21:19,089686061024,POP MIE MINI SOTO RL,1,3000,0,3000,2702,298
10/14/2021 21:19,kentang,kripik kentang,1,1000,0,1000,900,100
10/14/2021 21:19,8998989300261,GUDANG GARAM SURYA 12 FILTER,2,20000,0,40000,36300,3700
10/14/2021 21:19,8886467100048,pringles bbq,1,9000,0,9000,6333,2667
10/14/2021 21:19,8999909002821,MARLBORO BLACK 16,1,22000,0,22000,20850,1150
10/14/2021 21:19,8994867007161,ROKOK PENA GOLD 20,1,18000,0,18000,16800,1200
10/14/2021 21:19,8992775913000,CHOCOLATOS CKLT 28G,1,2000,0,2000,1557,443
10/14/2021 21:19,8992959508312,SWEETY SILVER PANTS XL1,1,3000,0,3000,2324,676
10/14/2021 21:19,8991002103764,GOOD DAY CAPPUCINO 10X25G,1,1500,0,1500,1395,105
10/14/2021 21:19,8998989500166,GUDANG GARAM MERAH BESAR 16KS,2,18000,0,36000,34000,2000
10/14/2021 21:21,ARG,ARGUS DOS 220ML,3,14500,0,43500,39900,3600
10/14/2021 21:21,8998989110167,SURYA GUDANG GARAM 16 FILTER,1,26000,0,26000,23700,2300
10/14/2021 21:21,KIKO,KIKO,1,1000,0,1000,500,500
10/14/2021 21:21,8992775001844,Chocolatos original taste,1,1000,0,1000,829,171
10/14/2021 21:21,8991001242013,Top,1,1000,0,1000,500,500
10/14/2021 21:24,8998866202268,KECAP MANIS SEDAAP SPC REFILL 550ML,1,20000,0,20000,17850,2150
10/14/2021 21:24,Telur 7 Biji,Telur 7 Biji,1,10000,0,10000,8400,1600
10/14/2021 21:24,089686021141,INTER MIE SOTO,4,1000,0,4000,3416,584
10/14/2021 21:24,8999999502409,ROYCO FDS BEEF 9G,2,500,0,1000,750,250
10/14/2021 21:24,8997028590014,ARGUS 220ML,2,500,0,1000,604,396
10/14/2021 21:24,Vita Jelly,Vita Jelly,1,1000,0,1000,766,234
10/14/2021 21:24,GL,GULA 1 LITER,1,11500,0,11500,10500,1000
10/14/2021 21:52,8991914101513,VIPER KRETEK 12,1,6000,0,6000,5000,1000
10/14/2021 22:32,8999909002821,MARLBORO BLACK 16,1,22000,0,22000,20850,1150
10/14/2021 22:32,8998989300261,GUDANG GARAM SURYA 12 FILTER,1,20000,0,20000,18150,1850
10/14/2021 22:32,8998989110167,SURYA GUDANG GARAM 16 FILTER,1,26000,0,26000,23700,2300
10/15/2021 20:52,8999999059781,SUNLIGHT LIME NEW POUCH 210ML,1,5000,0,5000,4520,480
10/15/2021 20:52,ROTI,ROTI 2000,1,2000,0,2000,1800,200
10/15/2021 20:52,8998989300261,GUDANG GARAM SURYA 12 FILTER,1,20000,0,20000,18150,1850
10/15/2021 20:52,123124,KOREK BIASA,1,2000,0,2000,1300,700
10/15/2021 20:52,8992717781025,SANTAN KELAPA,1,4000,0,4000,3000,1000
10/15/2021 20:54,ICE CREAM,ICE CREAM 2000,5,2000,0,10000,8500,1500
10/15/2021 20:54,ROTI,ROTI 2000,2,2000,0,4000,3600,400
10/15/2021 20:55,8999999516208,ROYCO FDS CHICKEN NEW 230G,1,10000,0,10000,9000,1000
10/15/2021 20:58,8999909096004,SAMPOERNA 16 FILTER,1,25000,0,25000,23100,1900
10/15/2021 20:58,8998989110167,SURYA GUDANG GARAM 16 FILTER,1,26000,0,26000,23700,2300
10/15/2021 20:58,8995555121244,SOSIS KIMBO,2,1000,0,2000,1300,700
10/15/2021 20:58,8998866611725,EKONOMI PENCUCI PIRING  LIQ 290ML,1,5000,0,5000,4200,800
10/15/2021 20:58,ARG,ARGUS DOS 220ML,2,14500,0,29000,26600,2400
10/15/2021 21:00,MK,MASKER,2,5000,0,10000,8000,2000
10/15/2021 21:00,8992388133345,NU MILK TEA TEH TARIK 330ML,1,6000,0,6000,5125,875
10/15/2021 21:00,ARG,ARGUS DOS 220ML,2,14500,0,29000,26600,2400
10/15/2021 21:02,8999999524722,SUNLIGHT LIME NEW PCH 435ML,1,10000,0,10000,9100,900
10/15/2021 21:02,jagung marning,jagung marning,1,5000,0,5000,4500,500
10/15/2021 21:02,8992761002039,FANTA STRAWBERRY PET 390 ML,1,5500,0,5500,4333,1167
10/15/2021 21:17,9556040040038,SUSU F&N,3,35000,0,105000,90000,15000
10/15/2021 21:17,8992775211410,PILUS GARUDA PEDAS,1,5000,0,5000,4886,114
10/15/2021 21:17,8998866202619,MIE SEDAAP KOREAN SPICY SOUP,1,2700,0,2700,2322,378
10/15/2021 21:22,8997028590045,ARGUS BTL 330ML,1,2000,0,2000,1291,709
10/15/2021 21:22,8995333060772,TERIGU GATOT KACA 500GR,1,5000,0,5000,4346,654
10/15/2021 21:22,8999999502409,ROYCO FDS BEEF 9G,2,500,0,1000,750,250
10/15/2021 21:22,8996001410042,TB TORA MOKA,1,1500,0,1500,870,630
10/15/2021 21:22,ICE CREAM,ICE CREAM 2000,1,2000,0,2000,1700,300
10/15/2021 21:22,8991002103764,GOOD DAY CAPPUCINO 10X25G,1,1500,0,1500,1395,105
10/15/2021 21:22,Gula gula kaki,gula gula kaki,2,500,0,1000,800,200
10/15/2021 21:28,8992388101085,NU GREEN TEA ORIGINAL 330ML,1,3500,0,3500,2768,732
10/15/2021 21:28,8997878004327,gula-gula milkita,2,250,0,500,400,100
10/15/2021 21:28,8992761166205,FRESTEA GREEN HONEY 350ML,1,4500,0,4500,3000,1500
10/15/2021 21:28,8997218380159,ICHITAN BROWN SUGAR,1,8000,0,8000,6500,1500
10/15/2021 21:31,8991102714846,MILKIDO CKLT,1,3000,0,3000,2153,847
10/15/2021 21:31,ROTI,ROTI 2000,2,2000,0,4000,3600,400
10/15/2021 21:31,8994867007161,ROKOK PENA GOLD 20,1,18000,0,18000,16800,1200
10/15/2021 21:31,ICE CREAM 5.500,ICE CREAM 5.500,2,5500,0,11000,9400,1600
10/15/2021 21:31,8998989300261,GUDANG GARAM SURYA 12 FILTER,1,20000,0,20000,18150,1850
10/15/2021 21:31,GL,GULA 1 LITER,2,11500,0,23000,21000,2000
10/15/2021 21:34,8996001302347,SARI GANDUM FAM,2,8500,0,17000,15400,1600
10/15/2021 21:40,8999999049492,REXONA WMN RO POWDER DRY 45 ML,1,15000,0,15000,13500,1500
10/15/2021 21:40,8998866610278,DAIA VIOLET GUSSET 565G,3,10000,0,30000,26100,3900
10/15/2021 21:40,8999999528942,CITRA HBL PEARLY WHITE UV 120ML,1,12000,0,12000,10082,1918
10/15/2021 21:40,8999999528225,CITRA PEARLY WHITE BTL 220ML,1,17200,0,17200,15450,1750
10/15/2021 21:40,8999999007782,FAIR&LOVELY MULTIVITAMIN CREAM 25 MG,1,16500,0,16500,14905,1595
10/15/2021 21:40,kentang,kripik kentang,1,1000,0,1000,900,100
10/15/2021 21:40,TEMBAK,TEMBAK SNIPPER,1,3500,0,3500,2500,1000
10/15/2021 21:40,8998866202664,POTABEE WAGYU BEEF STEAK 68 GR,1,8000,0,8000,7200,800
10/15/2021 21:40,8993274532105,BOLU,1,1000,0,1000,833,167
10/15/2021 21:40,8998989300261,GUDANG GARAM SURYA 12 FILTER,1,20000,0,20000,18150,1850
10/15/2021 21:43,8991001780232,twister choco 80g,1,8000,0,8000,6700,1300
10/15/2021 21:43,8991909101016,URBAN MILD 16,2,17000,0,34000,31600,2400
10/15/2021 21:43,8886013213208,FRENCH FREIS 2000,2,5000,0,10000,7500,2500
10/15/2021 21:43,8993989311699,CLAS MILD 16 FILTER,2,24000,0,48000,43400,4600
10/15/2021 21:43,089686727081,DORITOS 55G,1,7000,0,7000,5950,1050
10/15/2021 21:43,8992775000663,GERY SNACK KEJU,1,2000,0,2000,1712,288
10/15/2021 21:43,ROTI,ROTI 2000,1,2000,0,2000,1800,200
10/15/2021 21:43,8995555121244,SOSIS KIMBO,1,1000,0,1000,650,350
10/15/2021 21:45,8992696404441,BEAR BRAND 189ML,1,15000,0,15000,11000,4000
10/15/2021 21:48,8991111101316,JB OIL 50ML,1,9500,0,9500,8700,800
10/15/2021 21:48,gula gula,gula-gula karet,3,500,0,1500,1200,300
10/15/2021 21:48,8996001302316,MALKIST ABON SCT,1,1000,0,1000,840,160
10/15/2021 21:51,8998989110167,SURYA GUDANG GARAM 16 FILTER,1,26000,0,26000,23700,2300
10/15/2021 22:09,8995555111221,sosis kimbo,1,1000,0,1000,0,1000
10/15/2021 22:15,8995555111221,sosis kimbo,1,1000,0,1000,0,1000
10/15/2021 22:17,8995555111221,sosis kimbo,1,1000,0,1000,0,1000
10/15/2021 22:22,8992959508312,SWEETY SILVER PANTS XL1,6,3000,0,18000,13944,4056
10/15/2021 22:30,8995555111221,sosis kimbo,1,1000,0,1000,0,1000
10/15/2021 22:43,8998866200578,MIE SEDAAP KARI KENTAL,2,2700,0,5400,4662,738
10/15/2021 22:43,TUSTEL,TUSUK TELINGA,1,1000,0,1000,833,167
10/15/2021 22:43,8996001440001,TB JAHE SUSU,1,1500,0,1500,870,630
10/15/2021 22:43,8998866108003,EMERON HJB CLEANFRESH 10ML,1,5000,0,5000,4185,815
10/15/2021 22:43,8997018250010,Kopi jahe bungkus,1,1000,0,1000,800,200
10/15/2021 22:43,8991102023115,Sikat Gigi Formula,1,11000,0,11000,10000,1000
10/15/2021 22:43,8999909002821,MARLBORO BLACK 16,1,22000,0,22000,20850,1150
10/16/2021 16:42,8992761139018,ADES 600ML,1,3500,0,3500,2166,1334
10/16/2021 16:54,8993989311279,CLAS MILD 12,1,18000,0,18000,15800,2200
10/16/2021 17:08,8992979190986,TOTAL PUTIH SOFTENER,1,15000,0,15000,13524,1476
10/16/2021 17:08,8998866808729,ROYALE SOFT WHITE,1,5000,0,5000,4500,500
10/16/2021 17:08,SF TAWAR KUPAS,SAFFANAH ROTI TAWAR KUPAS,1,10000,0,10000,9000,1000
10/16/2021 17:08,8999999502409,ROYCO FDS BEEF 9G,4,500,0,2000,1500,500
10/16/2021 17:08,8998866202626,Top Kopi Gula Aren 22gr,3,1000,0,3000,1659,1341
10/16/2021 17:21,8995555111221,sosis kimbo,1,1000,0,1000,0,1000
10/16/2021 17:21,8993989311699,CLAS MILD 16 FILTER,1,24000,0,24000,21700,2300
10/16/2021 17:21,8997028590014,ARGUS 220ML,3,500,0,1500,906,594
10/16/2021 17:24,8886022830243,BATEREI ABC,4,2500,0,10000,7712,2288
10/16/2021 17:27,8998989500166,GUDANG GARAM MERAH BESAR 16KS,1,18000,0,18000,17000,1000
10/16/2021 17:29,8998866200301,MIE SEDAAP GORENG,2,2700,0,5400,4726,674
10/16/2021 17:30,8991002103535,GOOD DAY ORIGINAL,2,1500,0,3000,1780,1220
10/16/2021 17:51,089686043204,INDOMIE MIE ACEH,2,2700,0,5400,4904,496
10/16/2021 18:23,8993274532105,BOLU,2,1000,0,2000,1666,334
10/16/2021 18:23,8992775001844,Chocolatos original taste,2,1000,0,2000,1658,342
10/16/2021 18:23,8992761111540,FANTA STRAWBERY SLIM CAM 250ML,1,5000,0,5000,3750,1250
10/16/2021 18:24,ICE CREAM 3.500,ICE CREAM 3.500,2,3500,0,7000,6000,1000
10/16/2021 18:29,kentang,kripik kentang,2,1000,0,2000,1800,200
10/16/2021 18:29,8997028590052,ARGUS BTL 600ML,1,3000,0,3000,1458,1542
10/16/2021 18:29,8999999524722,SUNLIGHT LIME NEW PCH 435ML,1,10000,0,10000,9100,900
10/16/2021 18:29,8998989300261,GUDANG GARAM SURYA 12 FILTER,1,20000,0,20000,18150,1850
10/16/2021 18:29,8998866803694,SOKLIN SOFTERGENT PURPLE BAG 770 & PIRING,1,20000,0,20000,18055,1945
10/16/2021 18:29,8993379260798,SABUN MEDICARE LEMON,4,2500,0,10000,8948,1052
10/16/2021 18:29,8999999045920,LIFEBUOY TS TOTAL 10 110GR,1,15000,0,15000,14245,755
10/16/2021 18:29,8999999706180,PEPSODENT WHITE 190GR,1,10000,0,10000,9350,650
10/16/2021 18:29,8991001242013,Top,1,1000,0,1000,500,500
10/16/2021 20:19,089686021219,INTER MIE GORENG,2,1000,0,2000,1770,230
10/16/2021 20:19,8998989300261,GUDANG GARAM SURYA 12 FILTER,1,20000,0,20000,18150,1850
10/16/2021 20:19,8998866202312,NOODLE SEDAAP TASTY BAKMI AYAM 129 GR,1,5000,0,5000,4167,833
10/16/2021 20:19,8991002103764,GOOD DAY CAPPUCINO 10X25G,1,1500,0,1500,1395,105
10/16/2021 20:19,ROYCO,ROYCO RASA AYAM,4,500,0,2000,1500,500
10/16/2021 20:19,8996001410042,TB TORA MOKA,1,1500,0,1500,870,630
10/16/2021 20:19,Vita Jelly,Vita Jelly,1,1000,0,1000,766,234
10/16/2021 20:19,MLTO PINK,MOLTO ALL IN ONE,1,1000,0,1000,800,200
10/16/2021 20:19,8934868015031,REXONA DEO LOTION ICE COOL,1,4500,0,4500,3900,600
10/16/2021 20:19,8999999042639,RINSO ANTI NODA CLS LIQ 40ML,3,1000,0,3000,2415,585
10/16/2021 20:19,8997028590014,ARGUS 220ML,1,500,0,500,302,198
10/16/2021 20:21,gula,GULA,3,11500,0,34500,30000,4500
10/16/2021 20:26,8998989110167,SURYA GUDANG GARAM 16 FILTER,1,26000,0,26000,23700,2300
10/16/2021 20:27,8993989311699,CLAS MILD 16 FILTER,1,24000,0,24000,21700,2300
10/16/2021 20:33,8994867000162,ROKOK PUNDIMAS KRETEK16,1,10000,0,10000,8600,1400
10/16/2021 20:46,8996001305041,ROMA SANDWICH CKLT,1,7000,0,7000,5928,1072
10/16/2021 20:46,Gula gula pulpen,gula gula pulpen,1,2000,0,2000,1750,250
10/16/2021 21:05,089686061024,POP MIE MINI SOTO RL,1,3000,0,3000,2702,298
10/16/2021 21:29,8991111111995,C&C TONER 100ML,1,14000,0,14000,12900,1100
10/16/2021 21:29,6907992825076,JD WATERMELON APPLE,1,2000,0,2000,1700,300
10/16/2021 21:29,8992959117583,SFX DS REG FLOW WING 20,1,5000,0,5000,4288,712
10/17/2021 19:43,8998989300261,GUDANG GARAM SURYA 12 FILTER,1,20000,0,20000,18150,1850
10/17/2021 19:53,8998009040023,TEH KOTAK,1,5000,0,5000,2708,2292
10/17/2021 19:53,8993176110135,MINYAK TELON LANG 30ML,1,10000,0,10000,8167,1833
10/17/2021 19:53,8886467100048,pringles bbq,1,9000,0,9000,6333,2667
10/17/2021 19:53,gg,gula-gula koin,2,500,0,1000,800,200
10/17/2021 19:53,MTR,MOTOR,1,5000,0,5000,3500,1500
10/17/2021 19:53,8993379152017,SABUN CUCI SURYA 200G,1,3000,0,3000,2281,719
10/17/2021 19:53,8991102714846,MILKIDO CKLT,2,3000,0,6000,4306,1694
10/17/2021 19:53,8996001600146,TEH PUCUK HARUM 350ML,1,3000,0,3000,2314,686
10/17/2021 19:55,8996001600146,TEH PUCUK HARUM 350ML,1,3000,0,3000,2314,686
10/17/2021 19:55,8886013213208,FRENCH FREIS 2000,1,5000,0,5000,3750,1250
10/17/2021 19:55,ROTI,ROTI 2000,4,2000,0,8000,7200,800
10/17/2021 19:57,8992696521797,MILO 22G,1,2500,0,2500,1572,928
10/17/2021 19:57,8999999045623,MOLTO AIO BLUE SCH,5,1000,0,5000,4000,1000
10/17/2021 19:59,8998866608718,DAIA SOFTENER PINK,1,5000,0,5000,4450,550
10/17/2021 19:59,089686646047,SUNMARIE,2,7000,0,14000,13252,748
10/17/2021 20:00,8998866500463,BABY HAPPY PANTS M PCS,5,2000,0,10000,7150,2850
10/17/2021 20:01,089686646047,SUNMARIE,2,7000,0,14000,13252,748
10/17/2021 20:04,8998866200578,MIE SEDAAP KARI KENTAL,1,2700,0,2700,2331,369
10/17/2021 20:04,8992775002155,CHOCOLATOS DRINK,1,4000,0,4000,3520,480
10/17/2021 20:04,8991102026383,AIR CRYSTALINE 1.5 L,1,5000,0,5000,3471,1529
10/17/2021 20:04,8996001312278,MALKIST KEJU MANIS,1,6500,0,6500,5400,1100
10/17/2021 20:04,9556006014585,JB SHAMPOO SHOFT&SMOOTH 100ML,1,10500,0,10500,9450,1050
10/17/2021 20:06,MOLTO PINK,MOLTO ALL IN ONE 11 ML,2,500,0,1000,800,200
10/17/2021 20:06,8997878002088,Kiko,1,1000,0,1000,450,550
10/17/2021 20:07,ARG,ARGUS DOS 220ML,1,14500,0,14500,13300,1200
10/17/2021 20:07,089686386127,BUMBU RACIK NASI GORENG SOSIS,2,2000,0,4000,3240,760
10/17/2021 20:09,8997878002088,Kiko,2,1000,0,2000,900,1100
10/17/2021 20:09,MBL,MOBIL,1,5000,0,5000,3500,1500
10/17/2021 20:09,8999909002821,MARLBORO BLACK 16,1,22000,0,22000,20850,1150
10/17/2021 20:09,8997028590014,ARGUS 220ML,4,500,0,2000,1208,792
10/17/2021 20:11,KIKO,KIKO,2,1000,0,2000,1000,1000
10/17/2021 20:11,kentang,kripik kentang,1,1000,0,1000,900,100
10/17/2021 20:11,8999909001909,MAGNUM REVAMP BLACK 12,1,18000,0,18000,16300,1700
10/17/2021 20:11,TG,TEH GELAS,2,1000,0,2000,1458,542
10/17/2021 20:11,089686021219,INTER MIE GORENG,5,1000,0,5000,4425,575
10/17/2021 20:14,ROTI,ROTI 2000,1,2000,0,2000,1800,200
10/17/2021 20:14,8998866808729,ROYALE SOFT WHITE,1,5000,0,5000,4500,500
10/17/2021 20:14,089686021141,INTER MIE SOTO,2,1000,0,2000,1708,292
10/17/2021 20:14,4902430563895,PANTENE HALUS DAN LEMBUT 10ML,10,1000,0,10000,7860,2140
10/17/2021 20:17,089686021219,INTER MIE GORENG,5,1000,0,5000,4425,575
10/17/2021 20:17,ICE CREAM 6,ICE CREAM 6.000,1,6000,0,6000,5200,800
10/17/2021 20:17,ICE CREAM 3.500,ICE CREAM 3.500,1,3500,0,3500,3000,500
10/17/2021 20:17,jagung marning,jagung marning,1,5000,0,5000,4500,500
10/17/2021 20:17,YP,YUPI,8,250,0,2000,1664,336
10/17/2021 20:17,8992775001042,PILUS GARUDA MI GORENG,1,5000,0,5000,4810,190
10/17/2021 20:17,8998866202343,MIE SEDAAP KOREAN SPICY,2,2700,0,5400,4826,574
10/17/2021 20:20,8998989500166,GUDANG GARAM MERAH BESAR 16KS,1,18000,0,18000,17000,1000
10/17/2021 20:20,8998989300261,GUDANG GARAM SURYA 12 FILTER,1,20000,0,20000,18150,1850
10/17/2021 20:20,TUSTEL,TUSUK TELINGA,1,1000,0,1000,833,167
10/17/2021 20:20,KIKO,KIKO,3,1000,0,3000,1500,1500
10/17/2021 20:20,8992628022156,MINYAK GORENG BIMOLI POUCH 1 LT,1,17500,0,17500,16400,1100
10/17/2021 20:20,8998866200325,MIE SEDAAP SOTO,2,2700,0,5400,4564,836
10/17/2021 20:23,8998866200646,KOPI TOP MURNI,1,11000,0,11000,9600,1400
10/17/2021 20:23,ARG,ARGUS DOS 220ML,2,14500,0,29000,26600,2400
10/17/2021 20:23,8999999560713,MOLTO JAPANESE PEACH 720ML,1,19000,0,19000,17000,2000
10/17/2021 20:23,8992957214307,SAFARI MECES,1,5500,0,5500,4500,1000
10/17/2021 20:23,8992959508312,SWEETY SILVER PANTS XL1,1,3000,0,3000,2324,676
10/17/2021 20:23,8991002105409,KOPI KAPAL API,1,20000,0,20000,18888,1112
10/17/2021 20:43,8999909002821,MARLBORO BLACK 16,1,22000,0,22000,20850,1150
10/17/2021 22:09,gula,GULA,4,11500,0,46000,40000,6000
10/17/2021 22:09,8999999524838,SUNLIGHT MINT POUCH 755ML,1,18000,0,18000,15950,2050
10/17/2021 22:09,8999999524807,SUNLIGHT HABBATUSSAUDA POUCH 755ML,1,18000,0,18000,15950,2050
10/17/2021 22:22,8999999027056,LIFEBUOY ANTI KETOMBE 9ML,1,5000,0,5000,4500,500
10/17/2021 22:22,8999999059781,SUNLIGHT LIME NEW POUCH 210ML,1,5000,0,5000,4520,480
10/17/2021 22:22,8993379200886,SABUN HARMONY ORANGE 70G,1,2000,0,2000,1652,348
10/17/2021 22:22,8992775000663,GERY SNACK KEJU,1,2000,0,2000,1712,288
10/17/2021 22:22,8991001780225,twister black vann 80g,1,8000,0,8000,6700,1300
10/17/2021 22:30,8998989110167,SURYA GUDANG GARAM 16 FILTER,1,26000,0,26000,23700,2300
10/18/2021 20:06,8998898853100,SUSU JAHE,2,1500,0,3000,2360,640
10/18/2021 20:06,8993989311279,CLAS MILD 12,1,18000,0,18000,15800,2200
10/18/2021 20:06,KIKO,KIKO,3,1000,0,3000,1500,1500
10/18/2021 20:06,YP,YUPI,4,250,0,1000,832,168
10/18/2021 20:06,8992946521416,SABUN SHINZUI,1,5000,0,5000,4000,1000
10/18/2021 20:06,8994834006128,TICTIC PEDAS,1,2000,0,2000,1700,300
10/18/2021 20:06,8997028590045,ARGUS BTL 330ML,1,2000,0,2000,1291,709
10/18/2021 20:06,8997878004327,gula-gula milkita,4,250,0,1000,800,200
10/18/2021 20:06,8998989300261,GUDANG GARAM SURYA 12 FILTER,1,20000,0,20000,18150,1850
10/18/2021 20:11,Telur 3 Biji,Telur 3 Biji,1,5000,0,5000,3600,1400
10/18/2021 20:11,8999999520885,WIPOL 500 ML,1,10000,0,10000,8600,1400
10/18/2021 20:11,OJELLY,O'JELLY,2,500,0,1000,770,230
10/18/2021 20:11,8998866501033,MINYAK GORENG SEDAAP POUCH 2L,1,32000,0,32000,29683,2317
10/18/2021 20:11,MK,MASKER,1,5000,0,5000,4000,1000
10/18/2021 20:11,ROYCO,ROYCO RASA AYAM,2,500,0,1000,750,250
10/18/2021 20:11,8999999560720,MOLTO TRIKA JAPANESE PEACH 720ML,1,5000,0,5000,4000,1000
10/18/2021 20:11,7622201430184,OREO ORIGINAL 38G,1,2000,0,2000,1641,359
10/18/2021 20:11,Gula gula tusuk,gula gula tusuk,1,500,0,500,400,100
10/18/2021 20:11,PRG,PARAGO,1,500,0,500,400,100
10/18/2021 20:17,8991001242013,Top,3,1000,0,3000,1500,1500
10/18/2021 20:17,ARG,ARGUS DOS 220ML,1,14500,0,14500,13300,1200
10/18/2021 20:17,Gula gula tusuk,gula gula tusuk,1,500,0,500,400,100
10/18/2021 20:17,AMPLOP,AMPLOP,4,250,0,1000,700,300
10/18/2021 20:17,ROTI,ROTI 2000,1,2000,0,2000,1800,200
10/18/2021 20:17,8992388101085,NU GREEN TEA ORIGINAL 330ML,1,3500,0,3500,2768,732
10/18/2021 20:17,ICE CREAM,ICE CREAM 2000,1,2000,0,2000,1700,300
10/18/2021 20:17,8991002114067,PIKOPI,1,1000,0,1000,545,455
10/18/2021 20:17,8998989300261,GUDANG GARAM SURYA 12 FILTER,1,20000,0,20000,18150,1850
10/18/2021 20:17,8995555111221,sosis kimbo,1,1000,0,1000,850,150
10/18/2021 20:17,8998866202671,NOODLE SEDAAP MIE KOREAN SPICY SOUP CUP,1,5000,0,5000,4002,998
10/18/2021 20:19,8996001410042,TB TORA MOKA,1,1500,0,1500,870,630
10/18/2021 20:19,8991102228053,TEH GELAS BOTOL,1,3000,0,3000,1695,1305
10/18/2021 20:24,8991102987639,WFR TANGO LONG VNL 130G,1,5000,0,5000,4350,650
10/18/2021 20:24,8998866202244,EKOMIE BUMBU KALDU AYAM,2,1000,0,2000,1596,404
10/18/2021 20:24,TG,TEH GELAS,2,1000,0,2000,1458,542
10/18/2021 20:24,8998898853100,SUSU JAHE,1,1500,0,1500,1180,320
10/18/2021 20:24,8998866200561,EKOMIE SUPER 600GR,1,10000,0,10000,8615,1385
10/18/2021 20:24,8991102100823,Formula Acttion Protector 190 gr,1,10000,0,10000,9000,1000
10/18/2021 20:25,8991102714495,TANGO DRINK COKLAT,1,5000,0,5000,3818,1182
10/18/2021 20:28,8998866202626,Top Kopi Gula Aren 22gr,3,1000,0,3000,1659,1341
10/18/2021 20:28,8993274532105,BOLU,1,1000,0,1000,833,167
10/18/2021 20:28,089686727081,DORITOS 55G,1,7000,0,7000,5950,1050
10/18/2021 20:28,8999909002821,MARLBORO BLACK 16,2,22000,0,44000,41700,2300
10/18/2021 20:28,8994867007161,ROKOK PENA GOLD 20,2,18000,0,36000,33600,2400
10/18/2021 20:37,0105312686040047,yakult,5,2000,0,10000,7500,2500
10/18/2021 20:37,8997028590052,ARGUS BTL 600ML,1,3000,0,3000,1458,1542
10/18/2021 20:37,4902430553629,H&S LEMON 70ML,1,11000,0,11000,9501,1499
10/18/2021 20:37,8998989500166,GUDANG GARAM MERAH BESAR 16KS,1,18000,0,18000,17000,1000
10/18/2021 20:37,123124,KOREK BIASA,1,2000,0,2000,1300,700
10/18/2021 20:37,kentang,kripik kentang,3,1000,0,3000,2700,300
10/18/2021 20:37,8994834003752,TICTIC,1,2000,0,2000,1700,300
10/18/2021 20:37,8998866201377,KRISBEE FRIES KENTANG GORENG 68 GR,1,5500,0,5500,4620,880
10/18/2021 20:37,8997009510055,YOU C1000,1,15000,0,15000,13000,2000
10/18/2021 20:37,8997028590014,ARGUS 220ML,2,500,0,1000,604,396
10/18/2021 20:37,8995333032113,TERIGU GATOT KACA 1 KG,5,9000,0,45000,42860,2140
10/18/2021 20:37,gula,GULA,1,11500,0,11500,10000,1500
10/18/2021 20:37,089686010824,INDOMIE GORENG SPESIAL,1,2700,0,2700,2452,248
10/18/2021 20:37,8992696404441,BEAR BRAND 189ML,1,15000,0,15000,11000,4000
10/18/2021 20:38,8996001402023,TB TORA SUSU,2,1500,0,3000,1866,1134
10/18/2021 20:44,8994867000162,ROKOK PUNDIMAS KRETEK16,1,10000,0,10000,8600,1400
10/18/2021 20:50,8998866203227,MIE SEDAAP AYAM BAKAR LIMAU,5,2700,0,13500,10815,2685
10/18/2021 20:50,ARG,ARGUS DOS 220ML,3,14500,0,43500,39900,3600
10/18/2021 20:51,8992959117613,SFX DAUN SIRIH 1 WP,1,500,0,500,413,87
10/18/2021 21:00,76239878,MARLBORO GOLD,1,31000,0,31000,29650,1350
10/18/2021 21:05,8999909010567,234 DJI SAM SOE 16,1,22500,0,22500,21500,1000
10/18/2021 21:27,ICE CREAM 5.500,ICE CREAM 5.500,1,5500,0,5500,4700,800
10/18/2021 21:27,TELUR,TELUR,1,2000,0,2000,1200,800
10/18/2021 21:27,8998989110167,SURYA GUDANG GARAM 16 FILTER,1,26000,0,26000,23700,2300
10/18/2021 21:41,8992628022156,MINYAK GORENG BIMOLI POUCH 1 LT,1,17500,0,17500,16400,1100
10/19/2021 10:40,OJELLY,O'JELLY,2,500,0,1000,770,230
10/19/2021 10:49,AG,ARGUS,1,14500,0,14500,13500,1000
10/19/2021 11:21,8997028590014,ARGUS 220ML,4,500,0,2000,1208,792
10/19/2021 11:21,kentang,kripik kentang,1,1000,0,1000,900,100
10/19/2021 11:45,8998989300261,GUDANG GARAM SURYA 12 FILTER,1,20000,0,20000,18150,1850
10/19/2021 11:45,8999909096004,SAMPOERNA 16 FILTER,1,25000,0,25000,23100,1900
10/19/2021 11:48,8992388101085,NU GREEN TEA ORIGINAL 330ML,1,3500,0,3500,2768,732
10/19/2021 11:48,8997878004327,gula-gula milkita,4,250,0,1000,800,200
10/19/2021 20:04,8998989110167,SURYA GUDANG GARAM 16 FILTER,1,26000,0,26000,23700,2300
10/19/2021 20:09,gg,gula-gula koin,4,500,0,2000,1600,400
10/19/2021 21:03,8993093115008,tepun beras,1,8000,0,8000,7000,1000
10/19/2021 21:10,8886013257400,TWISTKO,1,1000,0,1000,900,100
10/19/2021 21:10,8998866202978,Guribee Rumput Laut 68 gr,1,6000,0,6000,5100,900
10/19/2021 21:10,8998866106474,POSH BLAZE PINK 150ML,1,19500,0,19500,17500,2000
10/19/2021 21:10,8992959508848,SWEETY SILVER PANTS L18,1,41500,0,41500,37728,3772
10/19/2021 21:11,8991188943536,SASA SANTAN KELAPA 65ML,2,3000,0,6000,4874,1126
10/19/2021 21:14,8998866200561,EKOMIE SUPER 600GR,1,10000,0,10000,8615,1385
10/19/2021 21:14,8992775913000,CHOCOLATOS CKLT 28G,1,2000,0,2000,1557,443
10/19/2021 21:17,8993001003908,INDOMILK KENTAL MANIS 545G,1,15000,0,15000,13333,1667
10/19/2021 21:17,8992992102423,WIPPY CREAM 200G,1,28000,0,28000,25990,2010
10/19/2021 21:17,8998866202626,Top Kopi Gula Aren 22gr,3,1000,0,3000,1659,1341
10/19/2021 21:17,8992775211410,PILUS GARUDA PEDAS,1,5000,0,5000,4886,114
10/19/2021 21:19,8998866203227,MIE SEDAAP AYAM BAKAR LIMAU,1,2700,0,2700,2163,537
10/19/2021 21:19,Vita Jelly,Vita Jelly,5,1000,0,5000,3830,1170
10/19/2021 21:21,8997028590014,ARGUS 220ML,4,500,0,2000,1208,792
10/19/2021 21:21,8991002114067,PIKOPI,1,1000,0,1000,545,455
10/19/2021 21:25,089686611601,QTELA,1,2000,0,2000,1800,200
10/19/2021 21:32,8998989300261,GUDANG GARAM SURYA 12 FILTER,1,20000,0,20000,18150,1850
10/19/2021 21:43,089686611601,QTELA,1,2000,0,2000,1800,200
10/19/2021 21:44,8998866202671,NOODLE SEDAAP MIE KOREAN SPICY SOUP CUP,2,5000,0,10000,8004,1996
10/19/2021 21:46,8994834006128,TICTIC PEDAS,1,2000,0,2000,1700,300
10/19/2021 21:46,089686611601,QTELA,2,2000,0,4000,3600,400
10/19/2021 21:46,ICE CREAM 3,ICE CREAM 3000,4,3000,0,12000,10400,1600
10/19/2021 21:49,8997028590052,ARGUS BTL 600ML,7,3000,0,21000,10206,10794
10/19/2021 21:49,8997028590045,ARGUS BTL 330ML,30,2000,0,60000,38730,21270
10/19/2021 21:49,8998866201711,KRISBEE KRUNCHY JAGUNG BAKAR MENTEGA 75 GR,1,5500,0,5500,4400,1100
10/19/2021 21:51,8998866500487,BABY HAPPY PANTS M 20P,1,37000,0,37000,33520,3480
10/19/2021 22:00,8992761145026,SPRITE PET 250ML,1,3500,0,3500,2417,1083
10/19/2021 22:10,ARG,ARGUS DOS 220ML,1,14500,0,14500,13300,1200
10/20/2021 11:10,8992775211410,PILUS GARUDA PEDAS,1,5000,0,5000,4886,114
10/20/2021 11:10,8998866203227,MIE SEDAAP AYAM BAKAR LIMAU,2,2700,0,5400,4326,1074
10/20/2021 11:10,8999999720940,CLEAR STYLING CREAM 100G,1,12000,0,12000,10615,1385
10/20/2021 11:10,8934868015024,REXONA DEO LOTION FREE SPIRIT 9G,1,2500,0,2500,2000,500
10/20/2021 11:12,089686611601,QTELA,1,2000,0,2000,1800,200
10/20/2021 11:12,8999999055769,FAIR&LOVELY MVIT FC FOAM 50 G,1,12500,0,12500,11715,785
10/20/2021 11:12,8999999559861,AXE DARK POCKET FRAG 17ML,1,10000,0,10000,8000,2000
10/20/2021 11:12,8999999195656,SARIWANGI 50X1.85,1,10000,0,10000,9405,595
10/22/2021 13:23,8999999518998,RINSO MOLTO PERFUME ESSENSE 770GR,1,21300,0,21300,19338,1962
10/22/2021 13:23,8999999514518,RINSO MOLTO PERF ESSENCE 215ML,1,5000,0,5000,4250,750
10/22/2021 13:23,8999999525675,MOLTO HYGIENE 720ML,1,28000,0,28000,25150,2850
10/22/2021 13:23,8996001355008,BENG-BENG SP20G,1,29000,0,29000,20000,9000
10/22/2021 13:23,8998009010569,ULTRA CHO 200,2,5000,0,10000,7916,2084
10/22/2021 13:23,gula,GULA,3,11500,0,34500,30000,4500
10/22/2021 13:23,8993058304201,BEJO JAHE MERAH,5,3000,0,15000,9465,5535
10/22/2021 16:37,KOPIKO,KOPIKO,2,250,0,500,350,150
10/22/2021 16:37,MILKITA,MILKITA,2,250,0,500,400,100
10/22/2021 16:37,089686611601,QTELA,1,2000,0,2000,1800,200
10/22/2021 16:37,ARG,ARGUS DOS 220ML,1,14500,0,14500,13300,1200
10/22/2021 16:37,8994834003752,TICTIC,1,2000,0,2000,1700,300
10/22/2021 16:37,8991102987639,WFR TANGO LONG VNL 130G,1,5000,0,5000,4350,650
10/22/2021 16:37,8998866200561,EKOMIE SUPER 600GR,1,10000,0,10000,8615,1385
10/22/2021 16:37,8998866200301,MIE SEDAAP GORENG,2,3000,0,6000,4828,1172
10/22/2021 16:37,8998989110167,SURYA GUDANG GARAM 16 FILTER,1,26000,0,26000,23700,2300
10/22/2021 16:37,8992761002022,SPRITE PET 390ML,1,5500,0,5500,4333,1167
10/22/2021 16:37,8992761145019,COCA COLA PET 250ML,1,3500,0,3500,2417,1083
10/22/2021 16:37,KIKO,KIKO,1,1000,0,1000,500,500
10/22/2021 16:37,8991102714495,TANGO DRINK COKLAT,2,5000,0,10000,7636,2364
10/22/2021 16:37,8993989311699,CLAS MILD 16 FILTER,1,24000,0,24000,21700,2300
10/22/2021 16:37,8992628022156,MINYAK GORENG BIMOLI POUCH 1 LT,1,17500,0,17500,16400,1100
10/22/2021 16:37,8992775913000,CHOCOLATOS CKLT 28G,4,2000,0,8000,6228,1772
10/23/2021 20:33,8998866604963,POWDET DAIA LEMON 290GR,2,5000,0,10000,8900,1100
10/23/2021 20:35,8995333032113,TERIGU GATOT KACA 1 KG,3,9000,0,27000,25716,1284
10/23/2021 20:35,8992628022156,MINYAK GORENG BIMOLI POUCH 1 LT,1,17500,0,17500,16400,1100
10/23/2021 20:37,gula,GULA,1,11500,0,11500,10000,1500
10/23/2021 20:57,8992628022156,MINYAK GORENG BIMOLI POUCH 1 LT,1,17500,0,17500,16400,1100
10/23/2021 20:57,8994834003752,TICTIC,2,2000,0,4000,3400,600
10/23/2021 20:57,8991188943536,SASA SANTAN KELAPA 65ML,2,3000,0,6000,4874,1126
10/23/2021 20:57,8998989300261,GUDANG GARAM SURYA 12 FILTER,2,20000,0,40000,36300,3700
10/23/2021 20:57,8991001242013,Top,2,1000,0,2000,1000,1000
10/23/2021 20:57,YP,YUPI,4,250,0,1000,832,168
10/23/2021 20:57,8997028590014,ARGUS 220ML,2,500,0,1000,604,396
10/23/2021 20:57,MK,MASKER,1,5000,0,5000,4000,1000
10/23/2021 20:57,8999801700054,SUSU FOYU 1 KG,1,22000,0,22000,19791,2209
10/23/2021 20:57,089686611601,QTELA,5,2000,0,10000,9000,1000
10/23/2021 20:57,0105312686040047,yakult,1,2000,0,2000,1500,500
10/23/2021 20:57,8999999195649,SARIWANGI 25X1.86G,1,6000,0,6000,5202,798
10/23/2021 20:57,8998989110167,SURYA GUDANG GARAM 16 FILTER,1,26000,0,26000,23700,2300
10/23/2021 20:57,8991102987639,WFR TANGO LONG VNL 130G,1,5000,0,5000,4350,650
10/24/2021 14:05,8992959953303,SWEETY BRONZE S64,1,80000,0,80000,76364,3636
10/24/2021 14:06,8992959953303,SWEETY BRONZE S64,1,80000,0,80000,76364,3636
10/25/2021 16:18,8997021290348,Teh Gunung Tengah,1,6000,0,6000,5000,1000
10/25/2021 16:18,8991188943062,SASA 250G,1,10000,0,10000,8500,1500
10/25/2021 16:18,gula,GULA,3,11500,0,34500,30000,4500
10/25/2021 18:29,ROTI,ROTI 2000,1,2000,0,2000,1800,200
10/25/2021 18:29,8992761139018,ADES 600ML,1,3500,0,3500,2166,1334
10/25/2021 18:29,ARG,ARGUS DOS 220ML,1,14500,0,14500,13300,1200
10/25/2021 18:29,8998866501033,MINYAK GORENG SEDAAP POUCH 2L,2,32000,0,64000,59366,4634
10/25/2021 20:56,8999909003439,MARLBORO CRAFTED 12,1,8000,0,8000,7250,750
10/25/2021 20:56,123124,KOREK BIASA,1,2000,0,2000,1300,700
10/25/2021 20:56,11222,LEM KOREA,1,10000,0,10000,8000,2000
10/25/2021 20:56,8993989311699,CLAS MILD 16 FILTER,3,24000,0,72000,65100,6900
10/25/2021 20:56,8992696523067,MILO ACTVGO UHT 180ML,1,4500,0,4500,3515,985
10/25/2021 20:56,8997028590045,ARGUS BTL 330ML,1,2000,0,2000,1291,709
10/25/2021 20:56,KIKO,KIKO,1,1000,0,1000,500,500
10/26/2021 20:32,8992696404441,BEAR BRAND 189ML,1,15000,0,15000,11000,4000
10/26/2021 20:36,Vita Jelly,Vita Jelly,1,1000,0,1000,766,234
10/26/2021 20:36,8995555111221,sosis kimbo,1,1000,0,1000,850,150
10/26/2021 20:57,8998989110167,SURYA GUDANG GARAM 16 FILTER,1,26000,0,26000,23700,2300
10/26/2021 21:29,8992979190986,TOTAL PUTIH SOFTENER,2,15000,0,30000,27048,2952
10/26/2021 21:29,8992761111540,FANTA STRAWBERY SLIM CAM 250ML,1,5000,0,5000,3750,1250
10/26/2021 21:29,8999999031602,SARI MURNI 20X1.6G,1,6000,0,6000,5400,600
10/26/2021 21:29,8999999707859,CLOSEUP GREEN 160G,1,15000,0,15000,13600,1400
10/26/2021 21:29,089686011036,INDOMIE GORENG PEDAS,2,2700,0,5400,4904,496
10/26/2021 21:29,8998866600101,CREAM EKONOMI LEMON 455G,1,5500,0,5500,4750,750
10/26/2021 21:29,8991004011906,KOPI BORONG,1,10000,0,10000,8333,1667
10/26/2021 21:29,8992736524306,Sasa Bumbu Nasi Goreng Barbeque,2,2000,0,4000,2362,1638
10/26/2021 21:29,8999999500399,LUX TS CAMELLIA WHITE,3,3500,0,10500,8400,2100
10/26/2021 21:29,8996001301142,ROMA KELAPA,1,8000,0,8000,7000,1000
10/26/2021 21:29,8998866600538,SOKLIN FLOORCLENER PINK 400ML,1,6000,0,6000,5025,975
10/26/2021 21:29,8999999400958,MOLTO PEWANGI BLUE 820ML,1,12500,0,12500,11275,1225
10/26/2021 21:29,8993989311699,CLAS MILD 16 FILTER,1,24000,0,24000,21700,2300
10/26/2021 22:02,8998866200325,MIE SEDAAP SOTO,2,2700,0,5400,4564,836
10/26/2021 22:02,8998866200301,MIE SEDAAP GORENG,1,3000,0,3000,2414,586
10/26/2021 22:17,9556001047175,NESCAFE ORI 240ML,2,8500,0,17000,15668,1332
10/27/2021 15:17,Vita Jelly,Vita Jelly,1,1000,0,1000,766,234
10/27/2021 17:07,8992388101085,NU GREEN TEA ORIGINAL 330ML,1,3500,0,3500,2768,732
10/27/2021 17:10,8996001312278,MALKIST KEJU MANIS,1,6500,0,6500,5400,1100
10/27/2021 17:12,8997028590052,ARGUS BTL 600ML,1,3000,0,3000,1458,1542
10/27/2021 17:26,8999999400958,MOLTO PEWANGI BLUE 820ML,1,12500,0,12500,11275,1225
10/27/2021 17:26,8998866608725,DAIA SOFTENER BAG 850G,1,18000,0,18000,15627,2373
10/27/2021 17:26,8999999195656,SARIWANGI 50X1.85,1,10000,0,10000,9405,595
10/27/2021 17:49,8998989110167,SURYA GUDANG GARAM 16 FILTER,1,26000,0,26000,23700,2300
10/27/2021 17:52,8998866610087,JAVANA ORIGINAL 350ML,1,3000,0,3000,2150,850
10/27/2021 18:23,BALON,BALON CABUT,1,1000,0,1000,900,100
10/27/2021 18:34,ARG,ARGUS DOS 220ML,3,14500,0,43500,39900,3600
10/27/2021 18:42,8997028590014,ARGUS 220ML,1,500,0,500,302,198
10/27/2021 18:42,OJELLY,O'JELLY,1,500,0,500,385,115
10/27/2021 18:46,8991909101016,URBAN MILD 16,1,17000,0,17000,15800,1200
10/27/2021 18:48,Vita Jelly,Vita Jelly,1,1000,0,1000,766,234
10/27/2021 18:59,Vita Jelly,Vita Jelly,1,1000,0,1000,766,234
10/27/2021 19:02,MK,MASKER,1,5000,0,5000,4000,1000
10/27/2021 19:13,8998866610278,DAIA VIOLET GUSSET 565G,2,10000,0,20000,17400,2600
10/27/2021 19:13,8998866500517,BABY HAPPY PANTS L PCS,1,2000,0,2000,1430,570
10/27/2021 19:13,8992628022156,MINYAK GORENG BIMOLI POUCH 1 LT,1,17500,0,17500,16400,1100
10/27/2021 19:13,8992717900310,KARA SUN,2,2500,0,5000,4000,1000
10/27/2021 19:13,TBR,TEPUNG BERAS ROSE BRAND,1,8000,0,8000,6150,1850
10/27/2021 19:13,8994834003752,TICTIC,2,2000,0,4000,3400,600
10/27/2021 19:13,OJELLY,O'JELLY,1,500,0,500,385,115
10/27/2021 19:13,8997028590014,ARGUS 220ML,3,500,0,1500,906,594
10/27/2021 19:13,8992628020152,MINYAK GOREG BIMOLI POUCH 2L,1,34000,0,34000,29800,4200
10/27/2021 19:13,Masako,Masako Gantung,1,6000,0,6000,5000,1000
10/27/2021 19:25,8999999048174,SUNSILK  BLK SHINE 70+21ML,1,9600,0,9600,8525,1075
10/27/2021 19:25,8998898853100,SUSU JAHE,2,1500,0,3000,2360,640
10/27/2021 19:25,8998989110129,SURYA KECIL MERAH 12KS,1,20000,0,20000,18450,1550
10/27/2021 19:25,6907992825076,JD WATERMELON APPLE,1,2000,0,2000,1700,300
10/27/2021 19:25,8999801700054,SUSU FOYU 1 KG,1,22000,0,22000,19791,2209
10/27/2021 19:25,089686611601,QTELA,1,2000,0,2000,1800,200
10/27/2021 19:25,8998989110501,gudang garam surya,2,2000,0,4000,2760,1240
10/27/2021 19:25,Vita Jelly,Vita Jelly,1,1000,0,1000,766,234
10/27/2021 19:25,089686021127,INTER MIE KALDU,1,1000,0,1000,813,187
10/27/2021 19:25,ROYCO,ROYCO RASA AYAM,2,500,0,1000,750,250
10/27/2021 19:25,8998866202954,Guribee BBQ Balado 68 gr,1,6000,0,6000,5100,900
10/27/2021 19:33,8998866202053,POTABEE AYAM BAKAR PEDAS 68GR,1,8000,0,8000,7200,800
10/27/2021 19:33,8992775001691,GARUDA ROSTA WAGYU BEEF 100G,1,8000,0,8000,7322,678
10/27/2021 19:33,089686727074,DORITOS 160G,2,12000,0,24000,21400,2600
10/27/2021 19:33,8991102303309,WFR TANGO SBJ 176G,1,10000,0,10000,8694,1306
10/27/2021 19:33,8992761139018,ADES 600ML,1,3500,0,3500,2166,1334
10/27/2021 19:33,8998866201865,KRISBEE PILLOW CHOCOLAVA 120 GR,3,8000,0,24000,21750,2250
10/27/2021 19:33,8998866202954,Guribee BBQ Balado 68 gr,1,6000,0,6000,5100,900
10/27/2021 19:33,8992388133345,NU MILK TEA TEH TARIK 330ML,1,6000,0,6000,5125,875
10/27/2021 19:33,8991102300544,WFR TANGO VNL 176G,1,10000,0,10000,8694,1306
10/27/2021 19:33,8991002114067,PIKOPI,3,1000,0,3000,1635,1365
10/27/2021 19:43,8998866201377,KRISBEE FRIES KENTANG GORENG 68 GR,1,5500,0,5500,4620,880
10/27/2021 19:43,ARG,ARGUS DOS 220ML,3,14500,0,43500,39900,3600
10/27/2021 19:43,BALON,BALON CABUT,1,1000,0,1000,900,100
10/27/2021 19:43,8996001301579,MALKIST CKLT KELAPA PACK,1,6500,0,6500,5400,1100
10/27/2021 19:43,8991102320184,TANGO CHOCO JAVAMOCCA,1,5000,0,5000,4350,650
10/27/2021 19:43,8991001780232,twister choco 80g,1,8000,0,8000,6700,1300
10/27/2021 19:43,8991001780225,twister black vann 80g,1,8000,0,8000,6700,1300
10/27/2021 19:43,8992775913000,CHOCOLATOS CKLT 28G,3,2000,0,6000,4671,1329
10/27/2021 19:43,OJELLY,O'JELLY,2,500,0,1000,770,230
10/27/2021 19:43,Vita Jelly,Vita Jelly,1,1000,0,1000,766,234
10/27/2021 19:54,Vita Jelly,Vita Jelly,1,1000,0,1000,766,234
10/27/2021 19:54,8998989110167,SURYA GUDANG GARAM 16 FILTER,1,26000,0,26000,23700,2300
10/27/2021 19:54,8997028590014,ARGUS 220ML,2,500,0,1000,604,396
10/27/2021 19:54,8993274532105,BOLU,1,1000,0,1000,833,167
10/27/2021 19:54,YP,YUPI,8,250,0,2000,1664,336
10/27/2021 19:54,KOPIKO,KOPIKO,4,250,0,1000,700,300
10/27/2021 19:54,Gula gula kopiko,gula gula kopiko,2,350,0,700,500,200
10/27/2021 19:54,8994867000179,ROKOK PENA MILD 16,1,14500,0,14500,13500,1000
10/27/2021 19:54,8999909001909,MAGNUM REVAMP BLACK 12,2,18000,0,36000,32600,3400
10/27/2021 19:54,8998989500166,GUDANG GARAM MERAH BESAR 16KS,2,18000,0,36000,34000,2000
10/27/2021 20:02,8993571003988,CAP 19 BEDAK TALK 100G,1,5500,0,5500,4250,1250
10/27/2021 20:02,8997218380159,ICHITAN BROWN SUGAR,1,8000,0,8000,6500,1500
10/27/2021 20:02,8992761139018,ADES 600ML,1,3500,0,3500,2166,1334
10/27/2021 20:02,ICE CREAM 5.000,ICE CREAM 5.000,1,5000,0,5000,4700,300
10/27/2021 20:02,8999909096004,SAMPOERNA 16 FILTER,1,25000,0,25000,23100,1900
10/27/2021 20:02,YP,YUPI,6,250,0,1500,1248,252
10/27/2021 20:02,TG APEL,TEH GELAS APEL,1,2000,0,2000,1178,822
10/27/2021 20:12,8997028590014,ARGUS 220ML,2,500,0,1000,604,396
10/27/2021 20:12,8998866200325,MIE SEDAAP SOTO,2,2700,0,5400,4564,836
10/27/2021 20:12,8999909000971,MAGNUM MILD 20,1,24000,0,24000,22750,1250
10/27/2021 20:12,MRC,MERICA LADA,1,1000,0,1000,889,111
10/27/2021 20:12,8998989110167,SURYA GUDANG GARAM 16 FILTER,1,26000,0,26000,23700,2300
10/27/2021 20:12,8997009510055,YOU C1000,1,15000,0,15000,13000,2000
10/27/2021 20:12,8998866203227,MIE SEDAAP AYAM BAKAR LIMAU,1,2700,0,2700,2163,537
10/27/2021 20:12,8992696521797,MILO 22G,1,2500,0,2500,1572,928
10/27/2021 20:12,8991102387286,TANGO LONG CKLT 47G,1,2000,0,2000,1551,449
10/27/2021 20:12,7622300405588,KEJUCAKE 16G,1,2000,0,2000,1641,359
10/27/2021 20:15,RT MNTG,ROTI SISIR MENTEGA,1,2000,0,2000,1600,400
10/27/2021 20:15,8994867007161,ROKOK PENA GOLD 20,1,18000,0,18000,16800,1200
10/27/2021 20:15,8998866200325,MIE SEDAAP SOTO,2,2700,0,5400,4564,836
10/27/2021 20:15,089686611601,QTELA,1,2000,0,2000,1800,200
10/27/2021 20:15,PRG,PARAGO,2,500,0,1000,800,200
10/27/2021 20:28,8998866200578,MIE SEDAAP KARI KENTAL,1,2700,0,2700,2331,369
10/27/2021 20:28,KIKO,KIKO,2,1000,0,2000,1000,1000
10/27/2021 20:28,8991102714860,MILKIDO STRAW,1,3000,0,3000,2153,847
10/27/2021 20:28,OJELLY,O'JELLY,2,500,0,1000,770,230
10/27/2021 20:28,8993072153595,LARISST COTTON 35G,1,5000,0,5000,3300,1700
10/27/2021 20:28,089686060027,POP MIE AYAM JUMBO,1,4500,0,4500,3833,667
10/27/2021 20:28,8992388101085,NU GREEN TEA ORIGINAL 330ML,2,3500,0,7000,5536,1464
10/27/2021 20:28,8998989110167,SURYA GUDANG GARAM 16 FILTER,1,26000,0,26000,23700,2300
10/27/2021 20:28,8997028590014,ARGUS 220ML,4,500,0,2000,1208,792
10/27/2021 20:28,7622201430184,OREO ORIGINAL 38G,1,2000,0,2000,1641,359
10/27/2021 20:35,SURYA,SURYA,2,500,0,1000,1000,0
10/27/2021 20:35,8991111101255,JB SHAMPOO GOLD 50ML,1,5000,0,5000,4500,500
10/27/2021 20:35,8998989300261,GUDANG GARAM SURYA 12 FILTER,1,20000,0,20000,18150,1850
10/27/2021 20:35,8992775001691,GARUDA ROSTA WAGYU BEEF 100G,2,8000,0,16000,14644,1356
10/27/2021 20:35,8997028590045,ARGUS BTL 330ML,1,2000,0,2000,1291,709
10/27/2021 20:35,8997009510055,YOU C1000,2,15000,0,30000,26000,4000
10/27/2021 20:35,8991002114067,PIKOPI,1,1000,0,1000,545,455
10/27/2021 20:35,8997028590014,ARGUS 220ML,2,500,0,1000,604,396
10/27/2021 20:35,089686021141,INTER MIE SOTO,2,1000,0,2000,1708,292
10/27/2021 20:35,089686021219,INTER MIE GORENG,2,1000,0,2000,1770,230
10/27/2021 20:42,Vita Jelly,Vita Jelly,2,1000,0,2000,1532,468
10/27/2021 20:42,8997028590014,ARGUS 220ML,4,500,0,2000,1208,792
10/27/2021 20:42,Garuda pilus,Garuda Pilus Pedas Pcs,4,500,0,2000,1632,368
10/27/2021 20:42,8998866200325,MIE SEDAAP SOTO,1,2700,0,2700,2282,418
10/27/2021 20:42,8996001440001,TB JAHE SUSU,1,1500,0,1500,870,630
10/27/2021 20:54,8991001780140,TWISTER CHOCO,1,5000,0,5000,4600,400
10/27/2021 20:54,8991102218085,CANNON BALL,1,10000,0,10000,9090,910
10/27/2021 20:54,PRG,PARAGO,4,500,0,2000,1600,400
10/27/2021 20:54,8997028590045,ARGUS BTL 330ML,1,2000,0,2000,1291,709
10/27/2021 20:54,MK,MASKER,1,5000,0,5000,4000,1000
10/27/2021 20:54,AMPLOP,AMPLOP,2,250,0,500,350,150
10/27/2021 20:54,gula,GULA,1,11500,0,11500,10000,1500
10/27/2021 20:54,76239878,MARLBORO GOLD,1,31000,0,31000,29650,1350
10/27/2021 20:54,ABC SPW,BATERAI ABC SPW,1,4500,0,4500,3893,607
10/27/2021 20:54,TBR,TEPUNG BERAS ROSE BRAND,1,8000,0,8000,6150,1850
10/27/2021 20:54,8998866107068,Mama lemon 230 ml,1,4000,0,4000,3500,500
10/27/2021 21:01,TBR,TEPUNG BERAS ROSE BRAND,1,8000,0,8000,6150,1850
10/27/2021 21:01,8992775002582,DILAN CHOCO,1,2000,0,2000,1503,497
10/27/2021 21:01,8992628020152,MINYAK GOREG BIMOLI POUCH 2L,1,34000,0,34000,29800,4200
10/27/2021 21:01,8992761111533,SPRITE SLIM CAM250ML,1,5000,0,5000,3750,1250
10/27/2021 21:01,8999999390198,SUNLIGHT LIME NEW POUCH 755ML,1,18000,0,18000,15950,2050
10/27/2021 21:01,8993379200879,SABUN HARMONY MELON 70G,1,2000,0,2000,1652,348
10/27/2021 21:01,8996001305041,ROMA SANDWICH CKLT,2,7000,0,14000,11856,2144
10/27/2021 21:01,8996001304549,SLAI OLAI 1000,1,1000,0,1000,825,175
10/27/2021 21:01,RT MNTG,ROTI SISIR MENTEGA,3,2000,0,6000,4800,1200
10/27/2021 21:01,8994834003752,TICTIC,1,2000,0,2000,1700,300
10/27/2021 21:01,8992775610367,Garuda Koro paggang,2,1000,0,2000,1656,344
10/27/2021 21:08,8997009510055,YOU C1000,1,15000,0,15000,13000,2000
10/27/2021 21:08,TELUR RAK,TELUR RAK,1,37000,0,37000,35000,2000
10/27/2021 21:08,8992745320326,STELLA ORG 200ML,1,15000,0,15000,13300,1700
10/27/2021 21:08,8992775001844,Chocolatos original taste,1,1000,0,1000,829,171
10/27/2021 21:08,8997028590014,ARGUS 220ML,4,500,0,2000,1208,792
10/27/2021 21:08,8991102303309,WFR TANGO SBJ 176G,1,10000,0,10000,8694,1306
10/27/2021 21:08,8991102714860,MILKIDO STRAW,1,3000,0,3000,2153,847
10/27/2021 21:08,8998989300261,GUDANG GARAM SURYA 12 FILTER,1,20000,0,20000,18150,1850
10/27/2021 21:08,8992761139018,ADES 600ML,1,3500,0,3500,2166,1334
10/27/2021 21:08,8997028590052,ARGUS BTL 600ML,1,3000,0,3000,1458,1542
10/27/2021 21:08,8999909096004,SAMPOERNA 16 FILTER,1,25000,0,25000,23100,1900
10/27/2021 21:08,8991909101016,URBAN MILD 16,1,17000,0,17000,15800,1200
10/27/2021 21:08,gg,gula-gula koin,6,500,0,3000,2400,600
10/27/2021 21:11,8991001242013,Top,1,1000,0,1000,500,500
10/27/2021 21:11,7622300335809,OREO SOFT CAKE,1,2000,0,2000,1641,359
10/27/2021 21:22,8997878004327,gula-gula milkita,4,250,0,1000,800,200
10/27/2021 21:22,gula gula,gula-gula karet,2,500,0,1000,800,200
10/27/2021 21:32,Telur 3 Biji,Telur 3 Biji,1,5000,0,5000,3600,1400
10/27/2021 21:32,8995555111221,sosis kimbo,2,1000,0,2000,1700,300
10/27/2021 21:32,4902430803380,DOWNY FLORAL PINK 10ML,2,500,0,1000,786,214
10/27/2021 21:32,8992628010139,MINYAK GORENG BIMOLI 5L,1,88500,0,88500,85675,2825
10/27/2021 21:32,8991914101513,VIPER KRETEK 12,1,6000,0,6000,5000,1000
10/27/2021 21:32,8992761002022,SPRITE PET 390ML,1,5500,0,5500,4333,1167
10/27/2021 21:32,8992761122430,FRESTEA GREEN HONEY 500ML,1,6500,0,6500,4708,1792
10/27/2021 21:32,8886013213208,FRENCH FREIS 2000,1,5000,0,5000,3750,1250
10/27/2021 21:32,RT BAKPIA,ROTI BAKPIA,3,1000,0,3000,2250,750
10/27/2021 21:32,gula,GULA,2,11500,0,23000,20000,3000
10/27/2021 21:32,8999999195656,SARIWANGI 50X1.85,1,10000,0,10000,9405,595
10/27/2021 21:37,8999909003873,MARLBORO 12,1,17000,0,17000,15750,1250
10/27/2021 22:04,8999909096004,SAMPOERNA 16 FILTER,1,25000,0,25000,23100,1900
10/27/2021 22:22,089686043204,INDOMIE MIE ACEH,1,2700,0,2700,2452,248
10/27/2021 22:22,8998866200301,MIE SEDAAP GORENG,1,3000,0,3000,2414,586
10/27/2021 22:22,YP,YUPI,2,250,0,500,416,84
10/27/2021 22:22,8991002304413,RELAXA GRAPE MINT,2,250,0,500,9000,-8500
10/27/2021 22:22,JGR SHN,JOGER SHINY SACHET,1,500,0,500,437,63
10/28/2021 20:31,8994834003752,TICTIC,1,2000,0,2000,1700,300
10/28/2021 20:31,jagung marning,jagung marning,1,5000,0,5000,4500,500
10/28/2021 20:31,8992959953044,SWEETY BRONZE XL1,2,3000,0,6000,4622,1378
10/28/2021 21:12,8999999008475,SUNLIGHT LIME NEW REF 1600ML,1,35000,0,35000,31955,3045
10/28/2021 21:12,8998866601535,BLEACHING SOKLIN PEMUTIH 500ML,1,7000,0,7000,4880,2120
10/28/2021 21:16,ICE CREAM,ICE CREAM 2000,4,2000,0,8000,6800,1200
10/28/2021 21:17,8992959508312,SWEETY SILVER PANTS XL1,4,3000,0,12000,9296,2704
10/28/2021 21:20,ICE CREAM 5.000,ICE CREAM 5.000,1,5000,0,5000,4700,300
10/28/2021 21:20,8992770034175,MASAKO,1,5000,0,5000,4000,1000
10/28/2021 21:25,8991102026383,AIR CRYSTALINE 1.5 L,1,5000,0,5000,3471,1529
10/28/2021 21:25,8991002342118,gula-gula kapal api,1,5000,0,5000,4000,1000
10/28/2021 21:25,8992775305188 pcs,Gery Salut Grentea pcs,1,1000,0,1000,812,188
10/28/2021 21:25,ICE CREAM 5.500,ICE CREAM 5.500,1,5500,0,5500,4700,800
10/28/2021 21:27,8998989110501,gudang garam surya,1,2000,0,2000,1380,620
10/28/2021 21:29,8992736025162,SASA TEPUNG PISANG GORENG,1,5000,0,5000,4455,545
10/28/2021 21:29,8993571003988,CAP 19 BEDAK TALK 100G,1,5500,0,5500,4250,1250
10/28/2021 21:30,FUZO,KUACI FUZO,4,1000,0,4000,3400,600
10/28/2021 21:33,8992761139018,ADES 600ML,1,3500,0,3500,2166,1334
10/28/2021 21:33,Gula gula tusuk,gula gula tusuk,6,500,0,3000,2400,600
10/28/2021 21:38,ARG,ARGUS DOS 220ML,2,14500,0,29000,26600,2400
10/28/2021 21:39,8998866501033,MINYAK GORENG SEDAAP POUCH 2L,1,32000,0,32000,29683,2317
10/28/2021 21:45,8998866202671,NOODLE SEDAAP MIE KOREAN SPICY SOUP CUP,2,5000,0,10000,8004,1996
10/28/2021 21:45,8997028590014,ARGUS 220ML,2,500,0,1000,604,396
10/28/2021 21:45,8998866200325,MIE SEDAAP SOTO,2,2700,0,5400,4564,836
10/28/2021 21:45,8992696404441,BEAR BRAND 189ML,2,15000,0,30000,22000,8000
10/28/2021 21:48,MK,MASKER,1,5000,0,5000,4000,1000
10/28/2021 21:48,8992775211410,PILUS GARUDA PEDAS,1,5000,0,5000,4886,114
10/28/2021 21:48,8992761164539,NUTRIBOOST ORANGE 300ML,1,6500,0,6500,5300,1200
10/28/2021 21:49,8991102387286,TANGO LONG CKLT 47G,1,2000,0,2000,1551,449
10/28/2021 21:49,8991102989534,TANGO VANILA 24G,1,1000,0,1000,609,391
10/28/2021 21:50,ICE CREAM 5.500,ICE CREAM 5.500,1,5500,0,5500,4700,800
10/28/2021 21:50,8992775211410,PILUS GARUDA PEDAS,1,5000,0,5000,4886,114
10/28/2021 21:50,089686611601,QTELA,1,2000,0,2000,1800,200
10/28/2021 21:50,8992761164539,NUTRIBOOST ORANGE 300ML,1,6500,0,6500,5300,1200
10/28/2021 21:53,8998866201889,KRISBEE PILLOW STRAWBERRY ICE CREAM 120GR,1,8000,0,8000,7250,750
10/28/2021 21:53,089686061024,POP MIE MINI SOTO RL,1,3000,0,3000,2702,298
10/28/2021 21:58,8993007003063,ENAAK 500G,1,11000,0,11000,9625,1375
10/28/2021 21:58,8996001600641,TORA CAPPUCINO,1,3500,0,3500,2750,750
10/28/2021 21:58,8998866107068,Mama lemon 230 ml,1,4000,0,4000,3500,500
10/28/2021 21:58,KRIPIK,KRIPIK KENTANG,2,1000,0,2000,1800,200
10/28/2021 21:58,8998866201490,POTABEE REGULER GRILLED SEAWED 68 GR,1,8000,0,8000,7200,800
10/28/2021 21:58,Gula gula kaki,gula gula kaki,6,500,0,3000,2400,600
10/28/2021 21:58,8992775001998,Gery Salut sandwich,1,1000,0,1000,815,185
10/28/2021 21:59,8997226411302,Cheese stick,1,5000,0,5000,3000,2000
10/28/2021 22:02,089686011036,INDOMIE GORENG PEDAS,2,2700,0,5400,4904,496
10/28/2021 22:02,8998866200325,MIE SEDAAP SOTO,1,2700,0,2700,2282,418
10/28/2021 22:02,8999999528812,CITRA  GOLDEN WHITE 120ML,1,11100,0,11100,10082,1018
10/28/2021 22:07,RT,ROTI,1,9000,0,9000,8000,1000
10/28/2021 22:07,8993989311699,CLAS MILD 16 FILTER,1,24000,0,24000,21700,2300
10/28/2021 22:07,8996001302347,SARI GANDUM FAM,2,8500,0,17000,15400,1600
10/28/2021 22:07,8992702000018,INDOMILK PUTIH 370G,1,10000,0,10000,9020,980
10/28/2021 22:14,RT ISI 6,ROTI ISI 6,2,6000,0,12000,10000,2000
10/28/2021 22:14,8998866201728,POTABEE SELECTION SALTED EGG 68G,1,8000,0,8000,7200,800
10/28/2021 22:14,8998866201889,KRISBEE PILLOW STRAWBERRY ICE CREAM 120GR,1,8000,0,8000,7250,750
10/28/2021 22:14,ICE CREAM 5,ICE CREAM 5000,2,5000,0,10000,8800,1200
10/28/2021 22:14,ICE CREAM 6,ICE CREAM 6.000,1,6000,0,6000,5200,800
10/28/2021 22:14,ICE CREAM 3,ICE CREAM 3000,1,3000,0,3000,2600,400
10/28/2021 22:14,ICE CREAM 3.500,ICE CREAM 3.500,1,3500,0,3500,3000,500
10/28/2021 22:14,8992761139018,ADES 600ML,1,3500,0,3500,2166,1334
10/28/2021 22:14,8998866201865,KRISBEE PILLOW CHOCOLAVA 120 GR,1,8000,0,8000,7250,750
10/28/2021 22:16,MTR,MOTOR,2,5000,0,10000,7000,3000
10/28/2021 22:16,ROTI,ROTI 2000,1,2000,0,2000,1800,200
10/28/2021 22:17,gula,GULA,4,11500,0,46000,40000,6000
10/28/2021 22:19,ARG,ARGUS DOS 220ML,1,14500,0,14500,13300,1200
10/28/2021 22:19,balon air,balon air,1,2000,0,2000,1700,300
10/28/2021 22:19,PRG,PARAGO,3,500,0,1500,1200,300
10/28/2021 22:22,BALON,BALON CABUT,3,1000,0,3000,2700,300
10/28/2021 22:22,8998866202244,EKOMIE BUMBU KALDU AYAM,2,1000,0,2000,1596,404
10/28/2021 22:22,KIKO,KIKO,2,1000,0,2000,1000,1000
10/28/2021 22:23,8998866501033,MINYAK GORENG SEDAAP POUCH 2L,1,32000,0,32000,29683,2317
10/28/2021 22:34,8998866501033,MINYAK GORENG SEDAAP POUCH 2L,1,34000,0,34000,29683,4317
10/28/2021 22:36,8999999706081,PEPSODENT WHITE 75G,1,5000,0,5000,3850,1150
10/28/2021 22:36,ARGUS,ARGUS,2,2000,0,4000,3000,1000
10/28/2021 22:36,8992761002039,FANTA STRAWBERRY PET 390 ML,1,5500,0,5500,4333,1167
10/28/2021 22:37,8992761002022,SPRITE PET 390ML,1,5500,0,5500,4333,1167
10/28/2021 22:37,8998009040023,TEH KOTAK,1,5000,0,5000,2708,2292
10/28/2021 22:38,8992775002155,CHOCOLATOS DRINK,3,4000,0,12000,10560,1440
10/28/2021 22:38,ICE CREAM 5.000,ICE CREAM 5.000,1,5000,0,5000,4700,300
10/28/2021 22:39,089686611601,QTELA,4,2000,0,8000,7200,800
10/29/2021 20:16,8998866200301,MIE SEDAAP GORENG,2,3000,0,6000,4828,1172
10/29/2021 20:16,8998866200325,MIE SEDAAP SOTO,1,2700,0,2700,2282,418
10/29/2021 20:16,8998989300261,GUDANG GARAM SURYA 12 FILTER,1,20000,0,20000,18150,1850
10/29/2021 20:26,8999909096004,SAMPOERNA 16 FILTER,1,25000,0,25000,23100,1900
10/29/2021 20:37,089686611601,QTELA,4,2000,0,8000,7200,800
10/29/2021 20:37,SF SOSIS,SAFFANAH ROTI SOSIS,1,6000,0,6000,5500,500
10/29/2021 20:38,8995333032113,TERIGU GATOT KACA 1 KG,1,9000,0,9000,8572,428
10/29/2021 20:40,8998866200301,MIE SEDAAP GORENG,3,3000,0,9000,7242,1758
10/29/2021 20:40,ROTI,ROTI 2000,1,2000,0,2000,1800,200
10/29/2021 20:40,8991102228053,TEH GELAS BOTOL,1,3000,0,3000,1695,1305
10/29/2021 20:43,8992628010139,MINYAK GORENG BIMOLI 5L,1,88500,0,88500,85675,2825
10/29/2021 20:44,8999999552367,SAHAJA CUCI PIRING 400ML,1,8500,0,8500,7300,1200
10/29/2021 20:45,8998009040023,TEH KOTAK,4,5000,0,20000,10832,9168
10/29/2021 20:51,8997009510055,YOU C1000,1,15000,0,15000,13000,2000
10/29/2021 20:51,MK,MASKER,1,5000,0,5000,4000,1000
10/29/2021 20:52,8992761145026,SPRITE PET 250ML,2,3500,0,7000,4834,2166
10/29/2021 21:10,8999999559519,Lifebuoy 500 ml,1,42500,0,42500,38000,4500
10/29/2021 21:15,8999999049447,REXONA WMN RO ADVANCED WHITE 45 ML,1,16500,0,16500,14900,1600
10/29/2021 21:15,9556006014585,JB SHAMPOO SHOFT&SMOOTH 100ML,1,10500,0,10500,9450,1050
10/29/2021 21:15,BALON,BALON CABUT,2,1000,0,2000,1800,200
10/29/2021 21:15,8991001503336,chacha minis hat,1,7500,0,7500,6400,1100
10/29/2021 21:15,8998866200325,MIE SEDAAP SOTO,1,2700,0,2700,2282,418
10/29/2021 21:15,8993093115008,tepun beras,1,8000,0,8000,7000,1000
10/29/2021 21:15,KIKO,KIKO,4,1000,0,4000,2000,2000
10/29/2021 21:15,8998866610087,JAVANA ORIGINAL 350ML,1,3000,0,3000,2150,850
10/29/2021 21:15,Gula gula kopiko,gula gula kopiko,8,350,0,2800,2000,800
10/29/2021 21:15,gula,GULA,1,11500,0,11500,10000,1500
10/29/2021 21:20,8999999554279,SAHAJAPMBRSH LT PCH 730ML,1,10000,0,10000,9100,900
10/29/2021 21:20,8992775311325,GERY SNACK&SEREAL 100G,2,7000,0,14000,12024,1976
10/29/2021 21:20,8992775001783,GERY SALUT MALKIST KELAPA,1,6500,0,6500,5516,984
10/29/2021 21:20,8991102300544,WFR TANGO VNL 176G,1,10000,0,10000,8694,1306
10/29/2021 21:20,8992931006256,tessa,1,1000,0,1000,900,100
10/29/2021 21:20,SKT,SIKAT CUCI,1,6000,0,6000,5000,1000
10/29/2021 21:20,8999999048488,SUNSILK SHP REFRESH ANTI DDRF 70+21ML,1,10000,0,10000,9075,925
10/29/2021 21:21,8998866609494,SOKLIN SOFTERGEN 280G BIRU,1,5000,0,5000,4425,575
10/29/2021 21:21,8998989300261,GUDANG GARAM SURYA 12 FILTER,1,20000,0,20000,18150,1850
10/29/2021 21:21,8992761139018,ADES 600ML,1,3500,0,3500,2166,1334
10/29/2021 21:21,balon air,balon air,2,2000,0,4000,3400,600
10/29/2021 21:23,8991188943062,SASA 250G,1,10000,0,10000,8500,1500
10/29/2021 21:23,8991909101016,URBAN MILD 16,1,17000,0,17000,15800,1200
10/29/2021 21:23,8995333032113,TERIGU GATOT KACA 1 KG,3,9000,0,27000,25716,1284
10/29/2021 21:23,8992628022156,MINYAK GORENG BIMOLI POUCH 1 LT,1,17500,0,17500,16400,1100
10/29/2021 21:24,8992736524306,Sasa Bumbu Nasi Goreng Barbeque,1,2000,0,2000,1181,819
10/29/2021 21:24,BALON,BALON CABUT,1,1000,0,1000,900,100
10/29/2021 21:25,BALON,BALON CABUT,2,1000,0,2000,1800,200
10/29/2021 21:25,8998866501033,MINYAK GORENG SEDAAP POUCH 2L,2,34000,0,68000,59366,8634
10/29/2021 21:29,ARG,ARGUS DOS 220ML,1,14500,0,14500,13300,1200
10/29/2021 21:29,SF SOSIS,SAFFANAH ROTI SOSIS,1,6000,0,6000,5500,500
10/29/2021 21:29,BALON,BALON CABUT,1,1000,0,1000,900,100
10/29/2021 21:29,ICE CREAM,ICE CREAM 2000,1,2000,0,2000,1700,300
10/29/2021 21:29,KIKO,KIKO,3,1000,0,3000,1500,1500
10/29/2021 21:29,Gula gula kaki,gula gula kaki,3,500,0,1500,1200,300
10/29/2021 21:29,8998989110167,SURYA GUDANG GARAM 16 FILTER,1,26000,0,26000,23700,2300
10/29/2021 21:29,8998989300261,GUDANG GARAM SURYA 12 FILTER,1,20000,0,20000,18150,1850
10/29/2021 21:29,8999909002821,MARLBORO BLACK 16,1,22000,0,22000,20850,1150
10/29/2021 21:29,8992959001875,SWEETY SILVER PANTS S1,2,2000,0,4000,3056,944
10/29/2021 21:29,BALON,BALON CABUT,1,1000,0,1000,900,100
10/29/2021 21:30,BALON,BALON CABUT,1,1000,0,1000,900,100
10/29/2021 21:31,BALON,BALON CABUT,9,1000,0,9000,8100,900
10/29/2021 21:31,8992761111533,SPRITE SLIM CAM250ML,1,5000,0,5000,3750,1250
10/29/2021 21:32,ROTI,ROTI 2000,1,2000,0,2000,1800,200
10/29/2021 21:32,8997028590052,ARGUS BTL 600ML,1,3000,0,3000,1458,1542
10/29/2021 21:32,KIKO,KIKO,6,1000,0,6000,3000,3000
10/29/2021 21:40,kiko,kiko,1,1000,0,1000,900,100
10/29/2021 21:40,balon air,balon air,1,2000,0,2000,1700,300
10/29/2021 21:40,RB,RED BOLD,3,20000,0,60000,56400,3600
10/29/2021 21:41,Telur 3 Biji,Telur 3 Biji,1,5000,0,5000,3600,1400
10/29/2021 21:41,ROTI,ROTI 2000,1,2000,0,2000,1800,200
10/29/2021 21:44,kiko,kiko,2,1000,0,2000,1800,200
10/29/2021 21:46,kiko,kiko,2,1000,0,2000,1800,200
10/29/2021 21:48,Vita Jelly,Vita Jelly,1,1000,0,1000,766,234
10/29/2021 21:48,8995150101696,M+SUSU ORIGINAL,1,5000,0,5000,4000,1000
10/29/2021 21:48,8997028590014,ARGUS 220ML,10,500,0,5000,3020,1980
10/29/2021 21:48,kiko,kiko,2,1000,0,2000,1800,200
10/29/2021 21:49,8992775002582,DILAN CHOCO,2,2000,0,4000,3006,994
10/29/2021 21:50,8992761002022,SPRITE PET 390ML,3,5500,0,16500,12999,3501
10/29/2021 21:50,8992761002039,FANTA STRAWBERRY PET 390 ML,2,5500,0,11000,8666,2334
10/29/2021 21:51,8998009010569,ULTRA CHO 200,2,5000,0,10000,7916,2084
10/29/2021 21:52,BALON,BALON CABUT,1,1000,0,1000,900,100
10/29/2021 21:57,8999909001909,MAGNUM REVAMP BLACK 12,1,18000,0,18000,16300,1700
10/29/2021 21:57,8998989500166,GUDANG GARAM MERAH BESAR 16KS,2,18000,0,36000,34000,2000
10/29/2021 21:59,8995333060772,TERIGU GATOT KACA 500GR,1,5000,0,5000,4346,654
10/29/2021 21:59,8997013180046,Tissu Tessi B,1,11000,0,11000,9800,1200
10/29/2021 21:59,8996001305041,ROMA SANDWICH CKLT,1,7000,0,7000,5928,1072
10/29/2021 22:20,Gula gula pulpen,gula gula pulpen,2,2000,0,4000,3500,500
10/29/2021 22:23,8997028590052,ARGUS BTL 600ML,1,3000,0,3000,1458,1542
10/29/2021 22:23,ICE CREAM 5.500,ICE CREAM 5.500,1,5500,0,5500,4700,800
10/29/2021 22:23,ICE CREAM 3,ICE CREAM 3000,3,3000,0,9000,7800,1200
10/29/2021 22:23,ICE CREAM,ICE CREAM 2000,1,2000,0,2000,1700,300
10/29/2021 22:24,8992775305164,GERY MALKIST GREEN TEA,1,6500,0,6500,5500,1000
10/29/2021 22:24,8997028590014,ARGUS 220ML,6,500,0,3000,1812,1188
10/30/2021 12:41,8992775002582,DILAN CHOCO,1,2000,0,2000,1503,497
10/30/2021 12:43,8999909000773,MARLBORO FILTER BLACK 12,1,17000,0,17000,15950,1050
10/30/2021 12:57,8998866201711,KRISBEE KRUNCHY JAGUNG BAKAR MENTEGA 75 GR,1,5500,0,5500,4400,1100
10/30/2021 12:57,123124,KOREK BIASA,2,2000,0,4000,2600,1400
10/30/2021 12:57,ROTI,ROTI 2000,2,2000,0,4000,3600,400
10/30/2021 12:57,8994867000162,ROKOK PUNDIMAS KRETEK16,1,10000,0,10000,8600,1400
10/30/2021 12:57,8992736624310,Sasa bumbu Nasi Goreng Jawa,1,2000,0,2000,1181,819
10/30/2021 12:57,089686021219,INTER MIE GORENG,1,1000,0,1000,885,115
10/30/2021 17:04,7622210462534,OREO MINI STRAW,1,7500,0,7500,6500,1000
10/30/2021 17:04,6907992823652,JD CHOCOLATE MILKSHAKE,1,6000,0,6000,5200,800
10/30/2021 17:06,8992959117583,SFX DS REG FLOW WING 20,1,5000,0,5000,4288,712
10/30/2021 17:06,8997878004327,gula-gula milkita,12,250,0,3000,2400,600
10/30/2021 21:21,8994834003752,TICTIC,1,2000,0,2000,1700,300
10/30/2021 21:21,Gula gula kaki,gula gula kaki,2,500,0,1000,800,200
10/30/2021 21:21,8997028590014,ARGUS 220ML,1,500,0,500,302,198
10/30/2021 21:21,8998866202626,Top Kopi Gula Aren 22gr,1,1000,0,1000,553,447
10/30/2021 21:21,Telur 3 Biji,Telur 3 Biji,1,5000,0,5000,3600,1400
10/30/2021 21:21,8998866200561,EKOMIE SUPER 600GR,1,10000,0,10000,8615,1385
10/30/2021 21:21,8991188943536,SASA SANTAN KELAPA 65ML,1,3000,0,3000,2437,563
10/30/2021 21:23,8999999528881,CITRA HBL NAT GLOWING WHITE UV,1,20000,0,20000,17703,2297
10/30/2021 21:24,8999909982000,SAMPOERNA 12 FILTER,1,19000,0,19000,16600,2400
10/30/2021 21:26,8850007014478,JB POWDER ACTIVE FRESH 100G,2,7000,0,14000,12060,1940
10/30/2021 21:32,6907992825069,JD FRUITY,1,5000,0,5000,4400,600
10/30/2021 21:32,6907992823935,JD SWEETCORN,1,3500,0,3500,3000,500
10/30/2021 21:38,kiko,kiko,2,1000,0,2000,1800,200
10/30/2021 21:38,Gula gula kaki,gula gula kaki,2,500,0,1000,800,200
10/30/2021 21:38,8991102384841,WFR TANGO LONG CKLT 130G,1,5000,0,5000,4345,655
10/30/2021 21:39,8993989311699,CLAS MILD 16 FILTER,1,24000,0,24000,21700,2300
10/30/2021 21:39,8999999046989,LIFEBUOY MILD CARE 60G,1,3000,0,3000,1911,1089
10/30/2021 21:45,RT,ROTI,1,9000,0,9000,8000,1000
10/30/2021 21:45,089686011036,INDOMIE GORENG PEDAS,1,2700,0,2700,2452,248
10/30/2021 21:45,8998866200646,KOPI TOP MURNI,1,11000,0,11000,9600,1400
10/30/2021 21:45,8992716109172,BISKUAT BOLU SCT,1,2000,0,2000,1641,359
10/30/2021 21:45,8992736424293,SASA BUMBU NASI GORENG 20G,1,2000,0,2000,1136,864
10/30/2021 21:45,8995555121244,SOSIS KIMBO,2,1000,0,2000,1300,700
10/30/2021 21:45,7622300335809,OREO SOFT CAKE,1,2000,0,2000,1641,359
10/30/2021 21:45,8998866201469,POTABEE REGULER BBQ BEEF 68 GR,1,8000,0,8000,7200,800
10/30/2021 21:45,8998866200561,EKOMIE SUPER 600GR,1,10000,0,10000,8615,1385
10/30/2021 21:46,8993007003063,ENAAK 500G,1,11000,0,11000,9625,1375
10/30/2021 21:52,8998866200578,MIE SEDAAP KARI KENTAL,6,2700,0,16200,13986,2214
10/30/2021 21:52,8991102228053,TEH GELAS BOTOL,1,3000,0,3000,1695,1305
10/30/2021 21:52,BALON,BALON CABUT,8,1000,0,8000,7200,800
10/30/2021 21:55,8997028590045,ARGUS BTL 330ML,1,2000,0,2000,1291,709
10/30/2021 21:55,8998866610087,JAVANA ORIGINAL 350ML,1,3000,0,3000,2150,850
10/30/2021 21:55,8991102026383,AIR CRYSTALINE 1.5 L,1,5000,0,5000,3471,1529
10/30/2021 21:57,8999909096004,SAMPOERNA 16 FILTER,1,25000,0,25000,23100,1900
10/30/2021 21:57,8992761166212,FRESTEA APPLE 350ML,1,4500,0,4500,3000,1500
10/30/2021 22:01,8993379241858,SABUN HARMONY LEMON 70G,1,2000,0,2000,1652,348
10/30/2021 22:01,8998866500487,BABY HAPPY PANTS M 20P,1,37000,0,37000,33520,3480
10/30/2021 22:01,8998866610087,JAVANA ORIGINAL 350ML,1,3000,0,3000,2150,850
10/30/2021 22:01,8998866200820,NOODLE SEDAAP MIE AYAM BAWANG TLR CUP 77 GR,1,4500,0,4500,3650,850
10/30/2021 22:01,8998989300261,GUDANG GARAM SURYA 12 FILTER,1,20000,0,20000,18150,1850
10/30/2021 22:01,BALON,BALON CABUT,3,1000,0,3000,2700,300
10/30/2021 22:01,MK BIASA,MASKERBIASA,1,2000,0,2000,1500,500
10/30/2021 22:07,8998866200882,SUKSESMIE GORENG AYAM KRMS 133GR,1,3500,0,3500,3047,453
10/30/2021 22:07,8998989300261,GUDANG GARAM SURYA 12 FILTER,1,20000,0,20000,18150,1850
10/30/2021 22:07,BALON,BALON CABUT,1,1000,0,1000,900,100
10/30/2021 22:07,Telur 3 Biji,Telur 3 Biji,1,5000,0,5000,3600,1400
10/30/2021 22:07,kiko,kiko,1,1000,0,1000,900,100
10/30/2021 22:07,8997028590014,ARGUS 220ML,4,500,0,2000,1208,792
10/30/2021 22:07,089686061024,POP MIE MINI SOTO RL,1,3000,0,3000,2702,298
10/30/2021 22:07,8994834006128,TICTIC PEDAS,1,2000,0,2000,1700,300
10/30/2021 22:07,PRG,PARAGO,2,500,0,1000,800,200
10/30/2021 22:12,8997018720018,SIRUP DHT,1,23000,0,23000,20958,2042
10/30/2021 22:12,BALON,BALON CABUT,9,1000,0,9000,8100,900
10/30/2021 22:12,gula,GULA,2,11500,0,23000,20000,3000
10/30/2021 22:12,8992775315057,GERY SALUT MALKIST COKLAT,1,6500,0,6500,5516,984
10/30/2021 22:12,8991102714846,MILKIDO CKLT,1,3000,0,3000,2153,847
10/30/2021 22:12,089686010824,INDOMIE GORENG SPESIAL,1,2700,0,2700,2452,248
10/30/2021 22:12,Gula gula kaki,gula gula kaki,8,500,0,4000,3200,800
10/30/2021 22:17,8991002114067,PIKOPI,3,1000,0,3000,1635,1365
10/30/2021 22:17,8991102228053,TEH GELAS BOTOL,1,3000,0,3000,1695,1305
10/30/2021 22:17,Gula gula kaki,gula gula kaki,6,500,0,3000,2400,600
10/30/2021 22:17,kiko,kiko,4,1000,0,4000,3600,400
10/30/2021 22:18,YP,YUPI,4,250,0,1000,832,168
10/30/2021 22:19,BALON,BALON CABUT,2,1000,0,2000,1800,200
10/30/2021 22:19,8993989311699,CLAS MILD 16 FILTER,1,24000,0,24000,21700,2300
10/30/2021 22:19,8997028590014,ARGUS 220ML,2,500,0,1000,604,396
10/30/2021 22:21,8998866200578,MIE SEDAAP KARI KENTAL,1,2700,0,2700,2331,369
10/30/2021 22:21,089686021127,INTER MIE KALDU,1,1000,0,1000,813,187
10/30/2021 22:21,8998866501033,MINYAK GORENG SEDAAP POUCH 2L,1,34000,0,34000,29683,4317
10/30/2021 22:22,8992775002582,DILAN CHOCO,1,2000,0,2000,1503,497
10/30/2021 22:22,ARG,ARGUS DOS 220ML,1,14500,0,14500,13300,1200
10/30/2021 22:24,8998866501033,MINYAK GORENG SEDAAP POUCH 2L,1,34000,0,34000,29683,4317
10/30/2021 22:29,KRIPIK,KRIPIK KENTANG,2,1000,0,2000,1800,200
10/30/2021 22:29,kiko,kiko,3,1000,0,3000,2700,300
10/30/2021 22:29,8999999059781,SUNLIGHT LIME NEW POUCH 210ML,1,5000,0,5000,4520,480
10/30/2021 22:29,8999999524722,SUNLIGHT LIME NEW PCH 435ML,1,10000,0,10000,9100,900
10/30/2021 22:30,8999909096004,SAMPOERNA 16 FILTER,1,25000,0,25000,23100,1900
10/30/2021 22:36,8999999524722,SUNLIGHT LIME NEW PCH 435ML,1,10000,0,10000,9100,900
10/30/2021 22:36,Gula gula pulpen,gula gula pulpen,5,2000,0,10000,8750,1250
10/30/2021 22:36,8999999030179,PEPSODENT ACTION 123 COMPLETE 75G,1,6700,0,6700,5170,1530
10/30/2021 22:36,8993335523363,TOTAL ALMEERA 250G,1,5000,0,5000,4100,900
10/30/2021 22:36,8991102385121,WFR TANGO VNL 7G,1,8300,0,8300,7455,845
10/30/2021 22:36,gula,GULA,1,11500,0,11500,10000,1500
10/30/2021 22:36,ROTI,ROTI 2000,1,2000,0,2000,1800,200
10/30/2021 22:36,BALON,BALON CABUT,2,1000,0,2000,1800,200
10/30/2021 22:36,8992716109172,BISKUAT BOLU SCT,1,2000,0,2000,1641,359
10/30/2021 22:36,8997028590014,ARGUS 220ML,2,500,0,1000,604,396
10/30/2021 22:36,OJELLY,O'JELLY,1,500,0,500,385,115
10/30/2021 22:37,ARG,ARGUS DOS 220ML,2,14500,0,29000,26600,2400
10/30/2021 22:38,8995333032113,TERIGU GATOT KACA 1 KG,4,9000,0,36000,34288,1712
10/30/2021 22:38,gula,GULA,1,11500,0,11500,10000,1500
10/30/2021 22:39,8997028590052,ARGUS BTL 600ML,1,3000,0,3000,1458,1542
10/30/2021 22:39,8992770033178,Masako,4,500,0,2000,1800,200
10/31/2021 20:06,8999909096004,SAMPOERNA 16 FILTER,1,25000,0,25000,23100,1900
10/31/2021 20:06,8886013213208,FRENCH FREIS 2000,3,5000,0,15000,11250,3750
10/31/2021 20:13,8999909096004,SAMPOERNA 16 FILTER,1,25000,0,25000,23100,1900
10/31/2021 20:13,8991102026383,AIR CRYSTALINE 1.5 L,1,5000,0,5000,3471,1529
10/31/2021 20:13,8992761166212,FRESTEA APPLE 350ML,2,4500,0,9000,6000,3000
10/31/2021 20:29,8991102228053,TEH GELAS BOTOL,1,3000,0,3000,1695,1305
10/31/2021 20:29,8998866200837,NOODLE SEDAAPMIE SOTO CUP 81 GR,1,4500,0,4500,3738,762
10/31/2021 20:29,089686060461,POP MIE RASA KARI AYAM,1,4500,0,4500,3833,667
10/31/2021 20:29,Telur 3 Biji,Telur 3 Biji,1,5000,0,5000,3600,1400
10/31/2021 20:32,8999999533434,CLEAR SHP COOL SPORT MNTL MEN 9 ML,1,10300,0,10300,9300,1000
10/31/2021 20:55,8998866608718,DAIA SOFTENER PINK,1,5000,0,5000,4450,550
10/31/2021 21:17,8998866202695,KOPI MAYOR,1,6000,0,6000,4500,1500
10/31/2021 21:19,8991102714846,MILKIDO CKLT,1,3000,0,3000,2153,847
10/31/2021 21:23,8996001314005,ROMA KELAPA CREAM CKLT,1,8000,0,8000,6642,1358
10/31/2021 21:42,8999999033187,LIFEBUOY SHP KUAT&BERKILAU 340ML,1,29500,0,29500,26850,2650
10/31/2021 21:42,8999999001193,LIFEBUOY BW TOTAL10 LD REFF 450 ML,1,25000,0,25000,22110,2890
10/31/2021 21:42,8999999027261,LIFEBUOY BW LEMONFRESH LD REFF 450 ML,1,25000,0,25000,22110,2890
10/31/2021 21:42,8999999024475,CITRA BW PEARLY WHITE LD 400ML,1,21000,0,21000,19000,2000
10/31/2021 21:42,8999999528225,CITRA PEARLY WHITE BTL 220ML,1,17200,0,17200,15450,1750
10/31/2021 22:09,TERASI,ABC TERASI SCT,2,500,0,1000,580,420
10/31/2021 22:09,8992696404441,BEAR BRAND 189ML,1,12000,0,12000,8585,3415
10/31/2021 22:09,8993058105013,EXTRA JOSS,1,12000,0,12000,9773,2227
10/31/2021 22:15,ICE CREAM 3,ICE CREAM 3000,1,3000,0,3000,2600,400
10/31/2021 22:15,8998989500166,GUDANG GARAM MERAH BESAR 16KS,1,18000,0,18000,17000,1000
10/31/2021 22:15,8999801700030,SUSU FOYU,1,11500,0,11500,10450,1050
10/31/2021 22:15,8996001410042,TB TORA MOKA,4,1500,0,6000,3480,2520
10/31/2021 22:18,8992736025162,SASA TEPUNG PISANG GORENG,1,5000,0,5000,4455,545
10/31/2021 22:18,8992696521797,MILO 22G,10,2500,0,25000,15720,9280
10/31/2021 22:18,RT 1000,ROTI 1000,4,1000,0,4000,3200,800
10/31/2021 22:18,MBL,MOBIL,1,5000,0,5000,3500,1500
10/31/2021 22:18,8992736925134,SASA TEPUNG BUMBU SERBAGUNA,1,5500,0,5500,4700,800
10/31/2021 22:18,8999999037765,pepsodent 225 gr,1,12000,0,12000,10500,1500
11/1/2021 9:56,8997028590014,ARGUS 220ML,6,500,0,3000,1812,1188
11/1/2021 20:19,krupuk k,Krupuk Kentang,2,5000,0,10000,9000,1000
11/1/2021 20:20,8998866500470,BABY HAPPY PANTS M 9P,1,17000,0,17000,15175,1825
11/1/2021 20:20,8999999024482,CITRA BW PEARLY WHITE REFF 220ML,1,12000,0,12000,10700,1300
11/1/2021 20:21,8992959508312,SWEETY SILVER PANTS XL1,1,3000,0,3000,2324,676
11/1/2021 20:22,Telur 3 Biji,Telur 3 Biji,1,5000,0,5000,3600,1400
11/1/2021 20:23,8995333060772,TERIGU GATOT KACA 500GR,1,5000,0,5000,4346,654
11/1/2021 20:23,8992761166205,FRESTEA GREEN HONEY 350ML,1,4500,0,4500,3000,1500
11/1/2021 20:23,8992761164539,NUTRIBOOST ORANGE 300ML,1,6500,0,6500,5300,1200
11/1/2021 20:23,ROTI,ROTI 2000,1,2000,0,2000,1800,200
11/1/2021 20:23,8998009040023,TEH KOTAK,1,5000,0,5000,2708,2292
11/1/2021 20:30,8998866201728,POTABEE SELECTION SALTED EGG 68G,1,8000,0,8000,7200,800
11/1/2021 20:30,ARG,ARGUS DOS 220ML,1,14500,0,14500,13300,1200
11/1/2021 20:30,ABC SPW,BATERAI ABC SPW,1,4500,0,4500,3893,607
11/1/2021 20:30,8994867007161,ROKOK PENA GOLD 20,1,18000,0,18000,16800,1200
11/1/2021 20:30,Gula gula pulpen,gula gula pulpen,4,2000,0,8000,7000,1000
11/1/2021 20:30,8992775312469,GERY SALUT COKELAT,1,11000,0,11000,9983,1017
11/1/2021 20:30,8997028590052,ARGUS BTL 600ML,1,3000,0,3000,1458,1542
11/1/2021 20:30,8998866200325,MIE SEDAAP SOTO,2,2700,0,5400,4564,836
11/1/2021 20:30,8993176110081,MINYAK KAYU PUTIH 30ML,1,12000,0,12000,9091,2909
11/1/2021 20:30,8992775002582,DILAN CHOCO,1,2000,0,2000,1503,497
11/1/2021 20:33,ICE CREAM 6,ICE CREAM 6.000,1,6000,0,6000,5200,800
11/1/2021 20:33,8991002121089,GOOD DAY ORI CAPPUCINO,2,7000,0,14000,9500,4500
11/1/2021 20:33,8992761164539,NUTRIBOOST ORANGE 300ML,1,6500,0,6500,5300,1200
11/1/2021 20:33,ICE CREAM 5,ICE CREAM 5000,2,5000,0,10000,8800,1200
11/1/2021 20:35,ICE CREAM 6,ICE CREAM 6.000,1,6000,0,6000,5200,800
11/1/2021 20:35,Vita Jelly,Vita Jelly,2,1000,0,2000,1532,468
11/1/2021 20:35,ROTI,ROTI 2000,1,2000,0,2000,1800,200
11/1/2021 20:35,8998866201889,KRISBEE PILLOW STRAWBERRY ICE CREAM 120GR,1,8000,0,8000,7250,750
11/1/2021 20:41,8995333060772,TERIGU GATOT KACA 500GR,1,5000,0,5000,4346,654
11/1/2021 20:41,8999999195649,SARIWANGI 25X1.86G,1,6000,0,6000,5202,798
11/1/2021 20:41,8997028380165,BISKUIT,1,10000,0,10000,9000,1000
11/1/2021 20:41,gula,GULA,1,11500,0,11500,10000,1500
11/1/2021 20:41,ICE CREAM 5,ICE CREAM 5000,1,5000,0,5000,4400,600
11/1/2021 20:41,8999999049461,REXONA WMN ROINVISIBLE DRY 45 ML,1,15000,0,15000,13550,1450
11/1/2021 20:41,8991102230308,BLASTER PINK,1,5000,0,5000,3106,1894
11/1/2021 20:41,8997878004327,gula-gula milkita,10,250,0,2500,2000,500
11/1/2021 20:41,ROTI,ROTI 2000,5,2000,0,10000,9000,1000
11/1/2021 20:41,8997028590014,ARGUS 220ML,3,500,0,1500,906,594
11/1/2021 20:41,8993989311699,CLAS MILD 16 FILTER,1,24000,0,24000,21700,2300
11/1/2021 20:41,8992761164539,NUTRIBOOST ORANGE 300ML,1,6500,0,6500,5300,1200
11/1/2021 20:41,8991102228053,TEH GELAS BOTOL,1,3000,0,3000,1695,1305
11/1/2021 20:44,8992959953037,SWEETY BRONZE L1,2,2500,0,5000,3638,1362
11/1/2021 20:44,8992957220087,COKLAT SINGA,4,2000,0,8000,6800,1200
11/1/2021 20:47,8997028590014,ARGUS 220ML,2,500,0,1000,604,396
11/1/2021 20:47,8998866202664,POTABEE WAGYU BEEF STEAK 68 GR,1,8000,0,8000,7200,800
11/1/2021 20:47,8998009040023,TEH KOTAK,1,5000,0,5000,2708,2292
11/1/2021 20:47,8998866501033,MINYAK GORENG SEDAAP POUCH 2L,2,34000,0,68000,59366,8634
11/1/2021 20:47,ARG,ARGUS DOS 220ML,1,14500,0,14500,13300,1200
11/1/2021 20:49,8992761122331,FRESTEA APPEL 500ML,1,6500,0,6500,4791,1709
11/1/2021 20:51,MTR,MOTOR,1,5000,0,5000,3500,1500
11/1/2021 20:51,Vita Jelly,Vita Jelly,5,1000,0,5000,3830,1170
11/1/2021 20:51,7992912508305,SWEETY SILVER PANTS L1,4,2500,0,10000,7528,2472
11/1/2021 20:51,8992761111533,SPRITE SLIM CAM250ML,1,5000,0,5000,3750,1250
11/1/2021 20:52,8997028590014,ARGUS 220ML,4,500,0,2000,1208,792
11/1/2021 20:57,8999999706081,PEPSODENT WHITE 75G,1,5000,0,5000,3850,1150
11/1/2021 20:57,6907992824963,JD MILKY CHOCOLATE,3,3000,0,9000,7800,1200
11/1/2021 20:58,JD VM,JD VANILLA MILKSHAKE,1,5000,0,5000,4300,700
11/1/2021 20:59,8991102387286,TANGO LONG CKLT 47G,2,2000,0,4000,3102,898
11/1/2021 21:01,8998866202244,EKOMIE BUMBU KALDU AYAM,1,1000,0,1000,798,202
11/1/2021 21:01,8998866501033,MINYAK GORENG SEDAAP POUCH 2L,2,34000,0,68000,59366,8634
11/1/2021 21:02,Vita Jelly,Vita Jelly,1,1000,0,1000,766,234
11/1/2021 21:05,8992994110112,yakult,1,10000,0,10000,7000,3000
11/1/2021 21:07,Gula gula kaki,gula gula kaki,1,500,0,500,400,100
11/1/2021 21:13,ARG,ARGUS DOS 220ML,6,14500,0,87000,79800,7200
11/1/2021 21:13,gula,GULA,4,11500,0,46000,40000,6000
11/1/2021 21:14,8997012030748,MADU ENAK,1,1000,0,1000,900,100
11/1/2021 21:15,ICE CREAM 3,ICE CREAM 3000,1,3000,0,3000,2600,400
11/1/2021 21:17,8991001503107,CHACHA PEANUT 35GR,1,5500,0,5500,4900,600
11/1/2021 21:19,8992736524306,Sasa Bumbu Nasi Goreng Barbeque,1,2000,0,2000,1181,819
11/1/2021 21:19,Telur 3 Biji,Telur 3 Biji,1,5000,0,5000,3600,1400
11/1/2021 21:19,TS,TISSUE TESSY,1,5000,0,5000,4200,800
11/1/2021 21:23,8998866610087,JAVANA ORIGINAL 350ML,1,3000,0,3000,2150,850
11/1/2021 21:23,8993351139807,REAL GOOD,1,1000,0,1000,800,200
11/1/2021 21:24,kiko,kiko,1,1000,0,1000,900,100
11/1/2021 21:26,8993351139807,REAL GOOD,1,1000,0,1000,800,200
11/1/2021 21:26,8993351139807,REAL GOOD,1,1000,0,1000,800,200
11/1/2021 21:27,Gula gula tusuk,gula gula tusuk,1,500,0,500,400,100
11/1/2021 21:29,8998866202343,MIE SEDAAP KOREAN SPICY,1,3000,0,3000,2413,587
11/1/2021 21:38,8992753031894,FRISIAN FLAG,2,2000,0,4000,2000,2000
11/1/2021 21:38,TG MARKISA,TEH GELAS MARKISA,1,2000,0,2000,1178,822
11/1/2021 21:40,089686067002,POP MIE PDS DOWER RS AYAM,4,5000,0,20000,17800,2200
11/1/2021 21:44,8998989110167,SURYA GUDANG GARAM 16 FILTER,1,26000,0,26000,23700,2300
11/1/2021 21:44,8999909001909,MAGNUM REVAMP BLACK 12,1,18000,0,18000,16300,1700
11/1/2021 21:44,8998989500166,GUDANG GARAM MERAH BESAR 16KS,1,18000,0,18000,17000,1000
11/1/2021 21:44,8994867007161,ROKOK PENA GOLD 20,1,18000,0,18000,16800,1200
11/1/2021 21:44,ARG,ARGUS DOS 220ML,1,14500,0,14500,13300,1200
11/1/2021 21:45,8998866501033,MINYAK GORENG SEDAAP POUCH 2L,1,34000,0,34000,29683,4317
11/1/2021 21:45,kiko,kiko,2,1000,0,2000,1800,200
11/1/2021 21:48,CC,NICE FACIAL KILOAN 900 GR DUO,1,34500,0,34500,31325,3175
11/1/2021 21:48,ICE CREAM 5,ICE CREAM 5000,1,5000,0,5000,4400,600
11/1/2021 21:48,8998866501033,MINYAK GORENG SEDAAP POUCH 2L,1,34000,0,34000,29683,4317
11/1/2021 21:49,8999801700054,SUSU FOYU 1 KG,1,22000,0,22000,19791,2209
11/1/2021 21:49,gula,GULA,1,11500,0,11500,10000,1500
11/1/2021 21:50,8992761111533,SPRITE SLIM CAM250ML,1,5000,0,5000,3750,1250
11/1/2021 21:50,8997028590014,ARGUS 220ML,2,500,0,1000,604,396
11/1/2021 21:51,ICE CREAM,ICE CREAM 2000,1,2000,0,2000,1700,300
11/1/2021 21:51,8992775211410,PILUS GARUDA PEDAS,1,5000,0,5000,4886,114
11/1/2021 21:55,8997021870076,FRESH CARE SANDAL WOOD 10ML,1,12000,0,12000,10000,2000
11/1/2021 21:55,8991102228053,TEH GELAS BOTOL,1,3000,0,3000,1695,1305
11/1/2021 21:55,8998009040023,TEH KOTAK,1,5000,0,5000,2708,2292
11/1/2021 21:55,Vita Jelly,Vita Jelly,4,1000,0,4000,3064,936
11/1/2021 21:55,8991102387286,TANGO LONG CKLT 47G,1,2000,0,2000,1551,449
11/1/2021 21:55,8991102026383,AIR CRYSTALINE 1.5 L,1,5000,0,5000,3471,1529
11/1/2021 21:55,ROTI,ROTI 2000,1,2000,0,2000,1800,200
11/1/2021 21:59,ICE CREAM 3,ICE CREAM 3000,1,3000,0,3000,2600,400
11/1/2021 21:59,8997028590014,ARGUS 220ML,6,500,0,3000,1812,1188
11/1/2021 21:59,Garuda Pilus,Garuda Pilus Rasa Abon Pcs,2,500,0,1000,802,198
11/1/2021 21:59,8999801700054,SUSU FOYU 1 KG,1,22000,0,22000,19791,2209
11/1/2021 21:59,8998866201520,KOPI TOP TORAJA MURNI,1,11000,0,11000,9600,1400
11/1/2021 21:59,8998866202626,Top Kopi Gula Aren 22gr,1,1000,0,1000,553,447
11/1/2021 22:04,9556001047175,NESCAFE ORI 240ML,1,8500,0,8500,7834,666
11/1/2021 22:07,gula,GULA,3,11500,0,34500,30000,4500
11/1/2021 22:11,8999999551223,RINSO ACTIVE FRESH LIQ 700ML,1,19500,0,19500,17900,1600
11/1/2021 22:11,Telur 7 Biji,Telur 7 Biji,1,10000,0,10000,8400,1600
11/1/2021 22:11,RT,ROTI,1,9000,0,9000,8000,1000
11/1/2021 22:11,8992702000018,INDOMILK PUTIH 370G,1,10000,0,10000,9208,792
11/1/2021 22:12,MARS,MARSHMELLOW,2,500,0,1000,866,134
11/1/2021 22:12,8992761166205,FRESTEA GREEN HONEY 350ML,1,4500,0,4500,3000,1500
11/1/2021 22:13,Garuda pilus pcs,Garuda pilus Rasa Mi Goreng pcs,2,1000,0,2000,1616,384
11/1/2021 22:21,8997218380074,ICHITAN MILK TEA,1,8000,0,8000,6500,1500
11/1/2021 22:21,YP,YUPI,4,250,0,1000,832,168
11/1/2021 22:29,8992959850046,CONFI PANTS M10,1,80000,0,80000,75120,4880
11/1/2021 22:33,8998866202299,KECAP MANIS SEDAAP SPC REFILL 220ML,1,9500,0,9500,8500,1000
11/2/2021 21:04,Garuda pilus pcs,Garuda pilus Rasa Mi Goreng pcs,2,1000,0,2000,1616,384
11/2/2021 21:04,8994834006128,TICTIC PEDAS,1,2000,0,2000,1700,300
11/2/2021 21:04,BALON,BALON CABUT,1,1000,0,1000,900,100
11/2/2021 21:04,8992959001875,SWEETY SILVER PANTS S1,2,2000,0,4000,3056,944
11/2/2021 21:05,8997210107877,VORTEX SMART 3,1,5000,0,5000,4750,250
11/2/2021 21:06,8997210107877,VORTEX SMART 3,1,5000,0,5000,4750,250
11/2/2021 21:20,8993379152017,SABUN CUCI SURYA 200G,2,3000,0,6000,4562,1438
11/2/2021 21:20,8991002121010,GOOD DAY FANTASTIC MOCACINNO,1,7000,0,7000,4750,2250
11/2/2021 21:20,8998866200561,EKOMIE SUPER 600GR,2,10000,0,20000,17230,2770
11/2/2021 21:20,089686386127,BUMBU RACIK NASI GORENG SOSIS,1,2000,0,2000,1620,380
11/2/2021 21:26,8999909004221,SAMPOERNA ULTRAMILD 16,1,22000,0,22000,20350,1650
11/2/2021 21:26,8999999530488,AXE PERFECT CONTROL POMADE 75G,1,30200,0,30200,28050,2150
11/2/2021 21:26,8999999034726,PONDS MEN WHITE BOOST 50G,1,18500,0,18500,17160,1340
11/2/2021 21:26,8992388133345,NU MILK TEA TEH TARIK 330ML,2,6000,0,12000,10250,1750
11/2/2021 21:31,8998898852127,KKB ENER-G MANGGA,1,5500,0,5500,4824,676
11/2/2021 21:35,8991102103091,Formula Proteksi,1,3500,0,3500,2650,850
11/2/2021 21:35,8998866202626,Top Kopi Gula Aren 22gr,1,1000,0,1000,553,447
11/2/2021 21:35,8998866606158,NUVO ACTIVE COOL 110G,1,3000,0,3000,2600,400
11/2/2021 21:35,8997027300089,NOMOS,1,4000,0,4000,2963,1037
11/2/2021 21:43,8992959117583,SFX DS REG FLOW WING 20,2,5000,0,10000,8576,1424
11/2/2021 21:43,8993351139807,REAL GOOD,16,1000,0,16000,12800,3200
11/2/2021 21:50,8993007002967,KRIMER KENTAL MANIS,1,10500,0,10500,9791,709
11/2/2021 21:51,OJELLY,O'JELLY,2,500,0,1000,770,230
11/2/2021 21:57,8992775211410,PILUS GARUDA PEDAS,1,5000,0,5000,4886,114
11/2/2021 21:57,8998866202619,MIE SEDAAP KOREAN SPICY SOUP,1,2700,0,2700,2322,378
11/2/2021 21:57,8993351139807,REAL GOOD,2,1000,0,2000,1600,400
11/2/2021 21:57,8998866201889,KRISBEE PILLOW STRAWBERRY ICE CREAM 120GR,1,8000,0,8000,7250,750
11/2/2021 21:57,8992775002582,DILAN CHOCO,2,2000,0,4000,3006,994
11/2/2021 21:57,8993571004732,SALAS SALEP CAP19 6G,1,7000,0,7000,6000,1000
11/2/2021 21:57,8997027300089,NOMOS,1,4000,0,4000,2963,1037
11/2/2021 21:58,8998989500166,GUDANG GARAM MERAH BESAR 16KS,1,18000,0,18000,17000,1000
11/2/2021 21:58,8994867007161,ROKOK PENA GOLD 20,2,18000,0,36000,33600,2400
11/2/2021 21:58,8993351139807,REAL GOOD,3,1000,0,3000,2400,600
11/2/2021 22:00,8994834006128,TICTIC PEDAS,1,2000,0,2000,1700,300
11/2/2021 22:03,8998898101409,TOLAK ANGIN SIDOMUNCUL,2,3500,0,7000,5416,1584
11/2/2021 22:08,8998866609494,SOKLIN SOFTERGEN 280G BIRU,1,5000,0,5000,4425,575
11/2/2021 22:08,ARG,ARGUS DOS 220ML,1,14500,0,14500,13300,1200
11/2/2021 22:19,8886022830243,BATEREI ABC,5,2500,0,12500,9640,2860
11/2/2021 22:26,8999999524722,SUNLIGHT LIME NEW PCH 435ML,2,10000,0,20000,18200,1800
11/2/2021 22:26,8992702000063,INDOMILK COKLAT 370G,1,10000,0,10000,9208,792
11/2/2021 22:28,8999909001909,MAGNUM REVAMP BLACK 12,1,18000,0,18000,16300,1700
11/2/2021 22:32,8993989311699,CLAS MILD 16 FILTER,1,24000,0,24000,21700,2300
11/2/2021 22:32,8992761166205,FRESTEA GREEN HONEY 350ML,1,4500,0,4500,3000,1500
11/2/2021 22:32,8991909101016,URBAN MILD 16,1,17000,0,17000,15800,1200
11/2/2021 22:32,8992761139018,ADES 600ML,1,3500,0,3500,2166,1334
11/2/2021 22:32,8999999007782,FAIR&LOVELY MULTIVITAMIN CREAM 25 MG,1,16500,0,16500,14905,1595
11/2/2021 22:32,Telur 3 Biji,Telur 3 Biji,1,5000,0,5000,3600,1400
11/2/2021 22:32,089686386127,BUMBU RACIK NASI GORENG SOSIS,1,2000,0,2000,1620,380
11/2/2021 22:32,8998866202244,EKOMIE BUMBU KALDU AYAM,1,1000,0,1000,798,202
11/2/2021 22:32,8993351139807,REAL GOOD,2,1000,0,2000,1600,400
11/2/2021 22:36,8994867006997,ROKOK PENA BOLD 20BTG,1,17000,0,17000,15000,2000
11/2/2021 22:36,RT,ROTI,1,9000,0,9000,8000,1000
11/2/2021 22:36,8993351139807,REAL GOOD,1,1000,0,1000,800,200
11/2/2021 22:36,8991102714846,MILKIDO CKLT,1,3000,0,3000,2153,847
11/2/2021 22:36,8992761111540,FANTA STRAWBERY SLIM CAM 250ML,1,5000,0,5000,3750,1250
11/2/2021 22:36,8998866501033,MINYAK GORENG SEDAAP POUCH 2L,3,34000,0,102000,89049,12951
11/2/2021 22:37,8993351139807,REAL GOOD,2,1000,0,2000,1600,400
11/2/2021 22:37,YP,YUPI,4,250,0,1000,832,168
11/2/2021 22:41,7622300335809,OREO SOFT CAKE,1,2000,0,2000,1641,359
11/2/2021 22:41,089686011036,INDOMIE GORENG PEDAS,1,2700,0,2700,2452,248
11/2/2021 22:41,7622201430153,OREO CHOCOLATE 38G,1,2000,0,2000,1641,359
11/2/2021 22:41,8993351139807,REAL GOOD,3,1000,0,3000,2400,600
11/2/2021 22:41,8999801700030,SUSU FOYU,1,11500,0,11500,10450,1050
11/2/2021 22:41,8995150101696,M+SUSU ORIGINAL,3,5000,0,15000,12000,3000
11/2/2021 22:41,8998866200882,SUKSESMIE GORENG AYAM KRMS 133GR,1,3500,0,3500,3047,453
11/2/2021 22:42,8991102281416,PERMEN MINTZ PPMINT,1,5000,0,5000,4000,1000
11/2/2021 22:45,8999909001909,MAGNUM REVAMP BLACK 12,1,18000,0,18000,16300,1700
11/2/2021 22:45,8998009040023,TEH KOTAK,1,5000,0,5000,2708,2292
11/2/2021 22:45,8997028590052,ARGUS BTL 600ML,2,3000,0,6000,2916,3084
11/2/2021 22:45,8991914101513,VIPER KRETEK 12,1,6000,0,6000,5000,1000
11/3/2021 11:43,8998989110167,SURYA GUDANG GARAM 16 FILTER,1,26000,0,26000,23700,2300
11/3/2021 20:37,8991102228053,TEH GELAS BOTOL,1,3000,0,3000,1695,1305
11/3/2021 20:40,8995555111221,sosis kimbo,2,1000,0,2000,1700,300
11/3/2021 20:40,GGK,PLAYGUM PERMEN KARET,4,500,0,2000,1600,400
11/3/2021 20:45,8994935000049,MINYAK GORENG DAMAI 5L,1,75000,0,75000,73780,1220
11/3/2021 20:48,8991004011906,KOPI BORONG,1,10000,0,10000,8333,1667
11/3/2021 20:48,8997021290348,Teh Gunung Tengah,1,6000,0,6000,5000,1000
11/3/2021 20:48,8997027300089,NOMOS,2,4000,0,8000,5926,2074
11/3/2021 20:48,8999999049416,REXONA MEN RO QUANTUM 45 ML,1,15000,0,15000,13550,1450
11/3/2021 20:50,8993351139807,REAL GOOD,6,1000,0,6000,4800,1200
11/3/2021 20:50,BALON,BALON CABUT,1,1000,0,1000,900,100
11/3/2021 20:50,8998989300261,GUDANG GARAM SURYA 12 FILTER,1,20000,0,20000,18150,1850
11/3/2021 20:51,123124,KOREK BIASA,1,2000,0,2000,1300,700
11/3/2021 20:51,8934868015031,REXONA DEO LOTION ICE COOL,1,4500,0,4500,3900,600
11/3/2021 20:51,8998989110501,gudang garam surya,2,2000,0,4000,2760,1240
11/3/2021 21:03,6907992825076,JD WATERMELON APPLE,1,2000,0,2000,1700,300
11/3/2021 21:09,8991102024778,FORMULA SENSITIVE,1,12000,0,12000,10000,2000
11/3/2021 21:09,8992725910424,LISTERINE FRESH BURST 250ML,1,19000,0,19000,17550,1450
11/3/2021 21:09,8998866106313,EMERON LOVELY GLOW&BRIGHT 200ML,1,7500,0,7500,6475,1025
11/3/2021 21:09,8998989110501,gudang garam surya,3,2000,0,6000,4140,1860
11/3/2021 21:09,ROTI,ROTI 2000,2,2000,0,4000,3600,400
11/3/2021 21:09,RT,ROTI,1,9000,0,9000,8000,1000
11/3/2021 21:20,RB,RED BOLD,1,20000,0,20000,18800,1200
11/3/2021 21:20,8992628022156,MINYAK GORENG BIMOLI POUCH 1 LT,1,17500,0,17500,16675,825
11/3/2021 21:20,8999999042639,RINSO ANTI NODA CLS LIQ 40ML,2,1000,0,2000,1610,390
11/3/2021 21:20,8997028590052,ARGUS BTL 600ML,1,3000,0,3000,1458,1542
11/3/2021 21:20,089686021127,INTER MIE KALDU,1,1000,0,1000,813,187
11/3/2021 21:20,8998866202619,MIE SEDAAP KOREAN SPICY SOUP,1,2700,0,2700,2322,378
11/3/2021 21:20,Garuda pilus,Garuda Pilus Pedas Pcs,2,500,0,1000,816,184
11/3/2021 21:20,8997009510017,YOU C1000 LEMON,1,10000,0,10000,9166,834
11/3/2021 21:20,8999999059781,SUNLIGHT LIME NEW POUCH 210ML,1,5000,0,5000,4520,480
11/3/2021 21:24,8992761111519,COCA COLA SLIM CAM 250ML,3,5000,0,15000,11250,3750
11/3/2021 22:06,8997021870076,FRESH CARE SANDAL WOOD 10ML,1,12000,0,12000,10000,2000
11/3/2021 22:13,ICE CREAM 3,ICE CREAM 3000,1,3000,0,3000,2600,400
11/3/2021 22:13,8998866608459,POWDET DAIA PUTIH BAG 290GR,1,5000,0,5000,4450,550
11/3/2021 22:13,8991102987639,WFR TANGO LONG VNL 130G,1,5000,0,5000,4350,650
11/3/2021 22:13,711844110083,KECAP ABC 275 ML,1,16000,0,16000,15000,1000
11/3/2021 22:13,711844120037,SAMBAL ABC 135 ML,1,7000,0,7000,5600,1400
11/3/2021 22:13,8996001351895,ZUPERRR KEJU SUSU,1,10000,0,10000,8000,2000
11/3/2021 22:13,8993351139807,REAL GOOD,3,1000,0,3000,2400,600
11/3/2021 22:18,8997028590014,ARGUS 220ML,6,500,0,3000,1812,1188
11/3/2021 22:18,089686021141,INTER MIE SOTO,2,1000,0,2000,1708,292
11/3/2021 22:18,8993351139807,REAL GOOD,2,1000,0,2000,1600,400
11/3/2021 22:18,8998989110501,gudang garam surya,4,2000,0,8000,5520,2480
11/3/2021 22:18,KRIPIK,KRIPIK KENTANG,3,1000,0,3000,2700,300
11/3/2021 22:18,089686021127,INTER MIE KALDU,2,1000,0,2000,1626,374
11/3/2021 22:18,8998866202244,EKOMIE BUMBU KALDU AYAM,1,1000,0,1000,798,202
11/3/2021 22:18,RT 1000,ROTI 1000,1,1000,0,1000,800,200
11/4/2021 10:13,8991102714631,TANGO TETRA CKLT,1,5000,0,5000,4545,455
11/4/2021 20:02,8999999008475,SUNLIGHT LIME NEW REF 1600ML,1,35000,0,35000,31955,3045
11/4/2021 20:07,8993351139807,REAL GOOD,3,1000,0,3000,2400,600
11/4/2021 20:07,8998866803694,SOKLIN SOFTERGENT PURPLE BAG 770 & PIRING,1,20000,0,20000,18055,1945
11/4/2021 20:07,ROTI,ROTI 2000,1,2000,0,2000,1800,200
11/4/2021 20:07,8997028590014,ARGUS 220ML,2,500,0,1000,604,396
11/4/2021 20:07,8998989300261,GUDANG GARAM SURYA 12 FILTER,1,20000,0,20000,18150,1850
11/4/2021 20:07,8994867006997,ROKOK PENA BOLD 20BTG,1,17000,0,17000,15000,2000
11/4/2021 20:07,8997028590052,ARGUS BTL 600ML,1,3000,0,3000,1458,1542
11/4/2021 20:07,KOPIKO,KOPIKO,4,250,0,1000,700,300
11/4/2021 20:07,Telur 7 Biji,Telur 7 Biji,1,10000,0,10000,8400,1600
11/4/2021 20:07,8998866200325,MIE SEDAAP SOTO,4,2700,0,10800,9128,1672
11/4/2021 20:13,8886022971298,BATERAI ALKALINE 06,1,12000,0,12000,10557,1443
11/4/2021 20:13,8992959001875,SWEETY SILVER PANTS S1,2,2000,0,4000,3056,944
11/4/2021 20:13,8992957220087,COKLAT SINGA,2,2000,0,4000,3400,600
11/4/2021 20:22,8998866606158,NUVO ACTIVE COOL 110G,3,3000,0,9000,7800,1200
11/4/2021 20:22,8999999030179,PEPSODENT ACTION 123 COMPLETE 75G,1,6700,0,6700,5170,1530
11/4/2021 20:22,8992775305003 pcs,Gery Salut Coklat pcs,2,1000,0,2000,1624,376
11/4/2021 20:22,8992702000063,INDOMILK COKLAT 370G,1,10000,0,10000,9208,792
11/4/2021 20:22,8998866201377,KRISBEE FRIES KENTANG GORENG 68 GR,1,5500,0,5500,4620,880
11/4/2021 20:22,8993351139807,REAL GOOD,3,1000,0,3000,2400,600
11/4/2021 20:22,8998866202244,EKOMIE BUMBU KALDU AYAM,1,1000,0,1000,798,202
11/4/2021 20:22,8997018250218,JAHE MERAH,1,1000,0,1000,833,167
11/4/2021 20:22,8998898847109,KOPI JAHE,1,1500,0,1500,1180,320
11/4/2021 20:22,8997018250058,SUSU JAHE,1,1000,0,1000,800,200
11/4/2021 20:22,8992388101085,NU GREEN TEA ORIGINAL 330ML,1,3500,0,3500,2768,732
11/4/2021 20:22,8992959953334,SWEETY BRONZE XL42,1,80000,0,80000,75455,4545
11/4/2021 20:22,gula,GULA,1,11500,0,11500,10000,1500
11/4/2021 20:41,8998866888639,GIV HIJAU KOTAK 76G,1,2000,0,2000,1820,180
11/4/2021 20:41,8998866601429,POWDET DAIA BUNGA BAG 290GR,3,5000,0,15000,13350,1650
11/4/2021 20:41,8992775000663,GERY SNACK KEJU,1,2000,0,2000,1712,288
11/4/2021 20:41,8992761122430,FRESTEA GREEN HONEY 500ML,1,6500,0,6500,4708,1792
11/4/2021 20:41,8998866201889,KRISBEE PILLOW STRAWBERRY ICE CREAM 120GR,1,8000,0,8000,7250,750
11/4/2021 20:41,8991111101422,JB POWDER 200G,1,11700,0,11700,10660,1040
11/4/2021 20:41,8991111101965,JB POWDER 300G,1,12500,0,12500,11250,1250
11/4/2021 20:41,8991111102832,JB POWDER BEDTIME 300G,1,14500,0,14500,13120,1380
11/4/2021 20:51,8993176110081,MINYAK KAYU PUTIH 30ML,1,12000,0,12000,9091,2909
11/4/2021 20:51,8991102987639,WFR TANGO LONG VNL 130G,1,5000,0,5000,4350,650
11/4/2021 20:51,8991001780140,TWISTER CHOCO,1,5000,0,5000,4600,400
11/4/2021 20:51,ROTI,ROTI 2000,2,2000,0,4000,3600,400
11/4/2021 20:51,089686386127,BUMBU RACIK NASI GORENG SOSIS,1,2000,0,2000,1620,380
11/4/2021 20:51,089686021219,INTER MIE GORENG,1,1000,0,1000,885,115
11/4/2021 20:51,089686011036,INDOMIE GORENG PEDAS,1,2700,0,2700,2452,248
11/4/2021 20:51,KRIPIK,KRIPIK KENTANG,1,1000,0,1000,900,100
11/4/2021 20:51,TBR,TEPUNG BERAS ROSE BRAND,1,8000,0,8000,6150,1850
11/4/2021 20:51,ARG,ARGUS DOS 220ML,1,14500,0,14500,13300,1200
11/4/2021 20:51,ICE CREAM 3,ICE CREAM 3000,1,3000,0,3000,2600,400
11/4/2021 20:51,8999909096004,SAMPOERNA 16 FILTER,1,25000,0,25000,23100,1900
11/4/2021 20:51,8998866501033,MINYAK GORENG SEDAAP POUCH 2L,3,34000,0,102000,89049,12951
11/4/2021 20:59,8995333060772,TERIGU GATOT KACA 500GR,1,5000,0,5000,4346,654
11/4/2021 20:59,8998866202244,EKOMIE BUMBU KALDU AYAM,1,1000,0,1000,798,202
11/4/2021 20:59,8998866202626,Top Kopi Gula Aren 22gr,1,1000,0,1000,553,447
11/4/2021 20:59,11222,LEM KOREA,1,10000,0,10000,8000,2000
11/4/2021 20:59,8999999706081,PEPSODENT WHITE 75G,1,5000,0,5000,3850,1150
11/4/2021 20:59,7118441101378,KECAP ABC 520 ML,1,19000,0,19000,17800,1200
11/4/2021 20:59,SMBL,SAMBAL ABC BLINK 335 ML,1,14000,0,14000,12550,1450
11/4/2021 20:59,8996001301142,ROMA KELAPA,1,8000,0,8000,7000,1000
11/4/2021 20:59,8997028380165,BISKUIT,1,10000,0,10000,9000,1000
11/4/2021 20:59,8992959953013,SWEETY BRONZE S1,6,2000,0,12000,8274,3726
11/4/2021 20:59,8993351139807,REAL GOOD,4,1000,0,4000,3200,800
11/4/2021 20:59,8999999526863,MOLTO ALL IN ONE PINK 11ML,1,5500,0,5500,4800,700
11/4/2021 21:02,8998866105644,EMERON LOVELY SMOTH&BRIGHT 200ML,1,7500,0,7500,6475,1025
11/4/2021 21:02,8997028590014,ARGUS 220ML,3,500,0,1500,906,594
11/4/2021 21:02,8994834006128,TICTIC PEDAS,1,2000,0,2000,1700,300
11/4/2021 21:02,YP,YUPI,6,250,0,1500,1248,252
11/4/2021 21:02,8998866202978,Guribee Rumput Laut 68 gr,1,6000,0,6000,5100,900
11/4/2021 21:02,8999909096004,SAMPOERNA 16 FILTER,2,25000,0,50000,46200,3800
11/4/2021 21:03,8997028590014,ARGUS 220ML,6,500,0,3000,1812,1188
11/4/2021 21:04,8998866200325,MIE SEDAAP SOTO,1,2700,0,2700,2282,418
11/4/2021 21:04,ARG,ARGUS DOS 220ML,1,14500,0,14500,13300,1200
11/4/2021 21:07,8999999516208,ROYCO FDS CHICKEN NEW 230G,1,10000,0,10000,9000,1000
11/4/2021 21:26,8998989300261,GUDANG GARAM SURYA 12 FILTER,1,20000,0,20000,18150,1850
11/4/2021 21:26,8991102989312,WFR TANGO SBJ 7G,1,10000,0,10000,8200,1800
11/4/2021 21:26,8998866202312,NOODLE SEDAAP TASTY BAKMI AYAM 129 GR,1,5000,0,5000,4167,833
11/4/2021 21:26,8998866200578,MIE SEDAAP KARI KENTAL,2,2700,0,5400,4662,738
11/4/2021 21:26,089686021219,INTER MIE GORENG,4,1000,0,4000,3540,460
11/4/2021 21:26,8998866608459,POWDET DAIA PUTIH BAG 290GR,1,5000,0,5000,4450,550
11/4/2021 21:26,8996001410042,TB TORA MOKA,10,1500,0,15000,8700,6300
11/4/2021 21:26,8998866612180,SOKLIN SOFTERGEN 280G SAKURA,1,5000,0,5000,4425,575
11/4/2021 21:26,8991102714846,MILKIDO CKLT,1,3000,0,3000,2153,847
11/4/2021 21:26,8997028590052,ARGUS BTL 600ML,1,3000,0,3000,1458,1542
11/4/2021 21:26,8999999524722,SUNLIGHT LIME NEW PCH 435ML,1,10000,0,10000,9100,900
11/4/2021 21:26,8999999520878,WIPOL 240ML,1,5000,0,5000,4250,750
11/4/2021 21:26,8992696422650,NESCAFE FRENCH VANILLA,1,5000,0,5000,4099,901
11/4/2021 21:26,8999999031930,PEPSODENT TB TRIPLE CLEAN,1,3500,0,3500,2850,650
11/4/2021 21:26,8991188943536,SASA SANTAN KELAPA 65ML,1,3000,0,3000,2437,563
11/4/2021 21:26,8992705025124,AGAR-AGAR SATELIT MERAH,2,3500,0,7000,5208,1792
11/4/2021 21:30,8997028590014,ARGUS 220ML,6,500,0,3000,1812,1188
11/4/2021 21:30,8995150109418,M+SUSU RASA MANGGA,1,5000,0,5000,4000,1000
11/4/2021 21:30,8998866501033,MINYAK GORENG SEDAAP POUCH 2L,2,34000,0,68000,59366,8634
11/4/2021 21:30,8994397000021,LEM FOX,1,12000,0,12000,10800,1200
11/4/2021 21:30,8991102714891,Kopi Seruput susu tulen 200 ml,1,3000,0,3000,2375,625
11/4/2021 21:30,8997028590052,ARGUS BTL 600ML,2,3000,0,6000,2916,3084
11/4/2021 21:30,8991102281416,PERMEN MINTZ PPMINT,1,5000,0,5000,4000,1000
11/4/2021 21:31,8999801700054,SUSU FOYU 1 KG,1,22000,0,22000,19791,2209
11/4/2021 21:32,8998866108003,EMERON HJB CLEANFRESH 10ML,1,5000,0,5000,4185,815
11/4/2021 21:37,ARG,ARGUS DOS 220ML,1,14500,0,14500,13300,1200
11/4/2021 21:37,089686834307,FREISS LECI,1,11000,0,11000,8750,2250
11/4/2021 21:37,8998866201711,KRISBEE KRUNCHY JAGUNG BAKAR MENTEGA 75 GR,1,5500,0,5500,4400,1100
11/4/2021 21:37,8991188943536,SASA SANTAN KELAPA 65ML,2,3000,0,6000,4874,1126
11/4/2021 21:39,8998866202619,MIE SEDAAP KOREAN SPICY SOUP,5,2700,0,13500,11610,1890
11/4/2021 21:39,8991102385121,WFR TANGO VNL 7G,1,8300,0,8300,7455,845
11/4/2021 21:39,BALON,BALON CABUT,3,1000,0,3000,2700,300
11/4/2021 21:40,gula,GULA,1,11500,0,11500,10000,1500
11/4/2021 21:40,8991102987639,WFR TANGO LONG VNL 130G,2,5000,0,10000,8700,1300
11/4/2021 21:42,8991102989312,WFR TANGO SBJ 7G,1,10000,0,10000,8200,1800
11/4/2021 21:42,8998866200325,MIE SEDAAP SOTO,4,2700,0,10800,9128,1672
11/4/2021 21:42,8999999524722,SUNLIGHT LIME NEW PCH 435ML,2,10000,0,20000,18200,1800
11/4/2021 21:43,9556006014585,JB SHAMPOO SHOFT&SMOOTH 100ML,1,10500,0,10500,9450,1050
11/4/2021 21:43,8993335521260,Sabun Total Violet 900gr,1,15000,0,15000,13800,1200
11/4/2021 21:50,8999909096004,SAMPOERNA 16 FILTER,1,25000,0,25000,23100,1900
11/4/2021 21:50,8998866202244,EKOMIE BUMBU KALDU AYAM,2,1000,0,2000,1596,404
11/4/2021 21:50,8997028590014,ARGUS 220ML,6,500,0,3000,1812,1188
11/4/2021 21:50,8998866608305,GIV BENGKOANG KOTAK 76G,1,2000,0,2000,1820,180
11/4/2021 21:50,ROTI,ROTI 2000,1,2000,0,2000,1800,200
11/4/2021 21:50,8998989500166,GUDANG GARAM MERAH BESAR 16KS,1,18000,0,18000,17000,1000
11/4/2021 21:50,8998866202671,NOODLE SEDAAP MIE KOREAN SPICY SOUP CUP,1,5000,0,5000,4002,998
11/4/2021 21:50,089686011036,INDOMIE GORENG PEDAS,1,2700,0,2700,2452,248
11/4/2021 21:50,ICE CREAM,ICE CREAM 2000,8,2000,0,16000,13600,2400
11/4/2021 21:50,8992736925134,SASA TEPUNG BUMBU SERBAGUNA,1,5500,0,5500,4700,800
11/4/2021 21:50,8998866692663,SOKLIN FLOORCLENER KUNING 450ML,1,7000,0,7000,6385,615
11/4/2021 21:50,gula,GULA,1,11500,0,11500,10000,1500
11/4/2021 21:50,8999909096004,SAMPOERNA 16 FILTER,1,25000,0,25000,23100,1900
11/5/2021 21:13,8998989300261,GUDANG GARAM SURYA 12 FILTER,1,20000,0,20000,18150,1850
11/5/2021 21:13,8998866200325,MIE SEDAAP SOTO,1,2700,0,2700,2282,418
11/5/2021 21:15,089686060126,POP MIE BASO JUMBO,1,4500,0,4500,3833,667
11/5/2021 21:15,089686060362,POP MIE SOTO AYAM JUMBO,1,4500,0,4500,3833,667
11/5/2021 21:17,7622201430153,OREO CHOCOLATE 38G,2,2000,0,4000,3282,718
11/5/2021 21:33,PULPEN,PULPEN BIASA,3,2000,0,6000,4500,1500
11/5/2021 21:34,8991102228053,TEH GELAS BOTOL,1,3000,0,3000,1695,1305
11/5/2021 21:34,8998009040023,TEH KOTAK,1,5000,0,5000,2708,2292
11/5/2021 21:38,8991102026383,AIR CRYSTALINE 1.5 L,1,5000,0,5000,3471,1529
11/5/2021 21:38,Telur 3 Biji,Telur 3 Biji,1,5000,0,5000,3600,1400
11/5/2021 21:38,8992775000663,GERY SNACK KEJU,1,2000,0,2000,1712,288
11/5/2021 21:38,PULPEN,PULPEN BIASA,8,2000,0,16000,12000,4000
11/5/2021 21:38,8991002121065,GOOD DAY AVOCADO DELIGHT,1,6000,0,6000,4295,1705
11/5/2021 21:40,123124,KOREK BIASA,1,2000,0,2000,1300,700
11/5/2021 21:40,8997028590052,ARGUS BTL 600ML,2,3000,0,6000,2916,3084
11/5/2021 21:40,8991102281416,PERMEN MINTZ PPMINT,1,5000,0,5000,4000,1000
11/5/2021 21:40,YP,YUPI,16,250,0,4000,3328,672
11/5/2021 21:40,8994834006128,TICTIC PEDAS,1,2000,0,2000,1700,300
11/5/2021 21:40,8997028590014,ARGUS 220ML,2,500,0,1000,604,396
11/5/2021 22:26,8997028590014,ARGUS 220ML,2,500,0,1000,604,396
11/5/2021 22:26,8997028590052,ARGUS BTL 600ML,1,3000,0,3000,1458,1542
11/5/2021 22:28,8992696404441,BEAR BRAND 189ML,1,12000,0,12000,8585,3415
11/5/2021 22:32,8998866608305,GIV BENGKOANG KOTAK 76G,5,2000,0,10000,9100,900
11/5/2021 22:33,089686727081,DORITOS 55G,1,7000,0,7000,5950,1050
11/5/2021 22:33,ICE CREAM 3,ICE CREAM 3000,1,3000,0,3000,2600,400
11/5/2021 22:33,ARGUS,ARGUS,1,2000,0,2000,1500,500
11/5/2021 22:35,Telur 3 Biji,Telur 3 Biji,4,5000,0,20000,14400,5600
11/6/2021 17:18,8992979130012,TOTAL LEMON SOFTENER,1,15000,0,15000,13800,1200
11/6/2021 17:18,8999999557447,PEPSODENT ACTION123 SIWAK 110G,2,9000,0,18000,16000,2000
11/6/2021 17:18,8992736925134,SASA TEPUNG BUMBU SERBAGUNA,1,5500,0,5500,4700,800
11/6/2021 17:18,4902430400886,PANTENE HAIRFALL 130ML,1,20000,0,20000,17860,2140
11/6/2021 17:18,8999999533724,CITRA TS PEARLY WHITE CNT 70G,2,2300,0,4600,3800,800
11/6/2021 17:18,gula,GULA,2,11500,0,23000,20000,3000
11/6/2021 17:20,8999909010567,234 DJI SAM SOE 16,2,22500,0,45000,43000,2000
11/6/2021 17:23,8998866107457,POSH SUMMER LOVE 150ML,1,19500,0,19500,17500,2000
11/6/2021 17:23,8999908059802,MY BABY POWDER KUNING,1,5000,0,5000,3276,1724
11/6/2021 17:23,ROTI,ROTI 2000,2,2000,0,4000,3600,400
11/6/2021 17:30,8993351139807,REAL GOOD,2,1000,0,2000,1600,400
11/6/2021 18:16,8997028590014,ARGUS 220ML,2,500,0,1000,604,396
11/6/2021 18:16,8998989110501,gudang garam surya,2,2000,0,4000,2760,1240
11/6/2021 19:26,8991102022347,SIKAT GIGI FORMULA RIPPLE,1,3000,0,3000,4583,-1583
11/6/2021 19:34,8997028590014,ARGUS 220ML,1,500,0,500,302,198
11/6/2021 19:34,8997028590052,ARGUS BTL 600ML,3,3000,0,9000,4374,4626
11/6/2021 19:34,8998009040023,TEH KOTAK,1,5000,0,5000,2708,2292
11/6/2021 19:36,8997028590014,ARGUS 220ML,4,500,0,2000,1208,792
11/6/2021 19:36,8997028590052,ARGUS BTL 600ML,1,3000,0,3000,1458,1542
11/6/2021 19:36,8991102714846,MILKIDO CKLT,1,3000,0,3000,2153,847
11/6/2021 19:36,8992761111533,SPRITE SLIM CAM250ML,1,5000,0,5000,3750,1250
11/6/2021 19:43,8998866201490,POTABEE REGULER GRILLED SEAWED 68 GR,1,8000,0,8000,7200,800
11/6/2021 19:43,JD VM,JD VANILLA MILKSHAKE,1,5000,0,5000,4300,700
11/6/2021 19:43,ARG,ARGUS DOS 220ML,1,14500,0,14500,13300,1200
11/6/2021 19:43,Gula gula kopiko,gula gula kopiko,3,350,0,1050,750,300
11/6/2021 19:43,8991102987639,WFR TANGO LONG VNL 130G,1,5000,0,5000,4350,650
11/6/2021 19:43,8991102387286,TANGO LONG CKLT 47G,1,2000,0,2000,1551,449
11/6/2021 19:43,Gula gula pulpen,gula gula pulpen,2,2000,0,4000,3500,500
11/6/2021 19:43,8991909101016,URBAN MILD 16,1,17000,0,17000,15800,1200
11/6/2021 19:46,8992761111533,SPRITE SLIM CAM250ML,1,5000,0,5000,3750,1250
11/6/2021 19:46,8998989500166,GUDANG GARAM MERAH BESAR 16KS,1,18000,0,18000,17000,1000
11/6/2021 19:46,ROTI,ROTI 2000,1,2000,0,2000,1800,200
11/6/2021 19:46,8997028590014,ARGUS 220ML,1,500,0,500,302,198
11/6/2021 19:46,8993351139807,REAL GOOD,3,1000,0,3000,2400,600
11/6/2021 19:46,RB,RED BOLD,1,20000,0,20000,18800,1200
11/6/2021 19:51,8994867006997,ROKOK PENA BOLD 20BTG,1,17000,0,17000,15000,2000
11/6/2021 19:51,0105312686040047,yakult,1,2000,0,2000,1500,500
11/6/2021 19:51,ARG 330,ARGUS DOS 330ML,1,35000,0,35000,31000,4000
11/6/2021 19:51,ROTI,ROTI 2000,1,2000,0,2000,1800,200
11/6/2021 19:51,ARG,ARGUS DOS 220ML,1,14500,0,14500,13300,1200
11/6/2021 19:51,8992736925134,SASA TEPUNG BUMBU SERBAGUNA,1,5500,0,5500,4700,800
11/6/2021 19:51,8991102987639,WFR TANGO LONG VNL 130G,1,5000,0,5000,4350,650
11/6/2021 19:51,8992696523067,MILO ACTVGO UHT 180ML,1,4500,0,4500,3719,781
11/6/2021 19:51,8993007001359,INDOMILK KM SCT 37G,1,1500,0,1500,1083,417
11/6/2021 19:51,8999909010567,234 DJI SAM SOE 16,1,22500,0,22500,21500,1000
11/6/2021 19:57,8991102714495,TANGO DRINK COKLAT,2,5000,0,10000,7636,2364
11/6/2021 19:57,8992760223015,OREO CHOCOLATE CREAM 133G,1,8000,0,8000,6300,1700
11/6/2021 19:57,JL,JELLY,2,500,0,1000,800,200
11/6/2021 19:57,8992628020152,MINYAK GOREG BIMOLI POUCH 2L,1,35000,0,35000,29800,5200
11/6/2021 19:57,8992775002582,DILAN CHOCO,1,2000,0,2000,1503,497
11/6/2021 20:01,089686727081,DORITOS 55G,1,7000,0,7000,5950,1050
11/6/2021 20:01,8991102987639,WFR TANGO LONG VNL 130G,1,5000,0,5000,4350,650
11/6/2021 20:05,6907992824963,JD MILKY CHOCOLATE,1,3000,0,3000,2600,400
11/6/2021 20:10,6907992824963,JD MILKY CHOCOLATE,1,3000,0,3000,2600,400
11/6/2021 20:10,8994867000162,ROKOK PUNDIMAS KRETEK16,1,10000,0,10000,8600,1400
11/6/2021 20:10,8997028590014,ARGUS 220ML,3,500,0,1500,906,594
11/6/2021 20:10,8999999538453,SUNSILK SHP SOFT AND  SMOOTH 55 ML,1,5000,0,5000,3750,1250
11/6/2021 20:10,8992946521416,SABUN SHINZUI,2,5000,0,10000,8000,2000
11/6/2021 20:14,8997028590014,ARGUS 220ML,4,500,0,2000,1208,792
11/6/2021 20:14,8992775610367,Garuda Koro paggang,3,1000,0,3000,2484,516
11/6/2021 20:14,8994867000162,ROKOK PUNDIMAS KRETEK16,1,10000,0,10000,8600,1400
11/6/2021 20:14,8992730002992,HAI CANDY,2,7000,0,14000,12000,2000
11/6/2021 20:14,ICE CREAM,ICE CREAM 2000,10,2000,0,20000,17000,3000
11/6/2021 20:14,8993351139807,REAL GOOD,4,1000,0,4000,3200,800
11/6/2021 20:14,8998866200561,EKOMIE SUPER 600GR,2,10000,0,20000,17230,2770
11/6/2021 20:18,6907992823843,JD MOCHA CRISPY,1,5000,0,5000,4400,600
11/6/2021 20:18,8991102714495,TANGO DRINK COKLAT,1,5000,0,5000,3818,1182
11/6/2021 20:18,gula,GULA,2,11500,0,23000,20000,3000
11/6/2021 20:18,ROTI,ROTI 2000,3,2000,0,6000,5400,600
11/6/2021 20:18,8992959117613,SFX DAUN SIRIH 1 WP,2,500,0,1000,826,174
11/6/2021 20:18,8991102213189,BLASTER UNGU,1,5000,0,5000,3106,1894
11/6/2021 20:23,8997028590014,ARGUS 220ML,11,500,0,5500,3322,2178
11/6/2021 20:23,8997878004327,gula-gula milkita,4,250,0,1000,800,200
11/6/2021 20:23,ROTI,ROTI 2000,5,2000,0,10000,9000,1000
11/6/2021 20:23,gula,GULA,1,11500,0,11500,10000,1500
11/6/2021 20:23,8998866604963,POWDET DAIA LEMON 290GR,1,5000,0,5000,4450,550
11/6/2021 20:23,8997028590052,ARGUS BTL 600ML,1,3000,0,3000,1458,1542
11/6/2021 20:23,8991001242013,Top,1,1000,0,1000,500,500
11/6/2021 20:23,8992775001844,Chocolatos original taste,1,1000,0,1000,829,171
11/6/2021 20:28,8997028590014,ARGUS 220ML,6,500,0,3000,1812,1188
11/6/2021 20:28,JD VM,JD VANILLA MILKSHAKE,2,5000,0,10000,8600,1400
11/6/2021 20:28,YP,YUPI,4,250,0,1000,832,168
11/6/2021 20:28,8992775203422,GARUDA ROSTA OVEN BAWANG 100G,1,8000,0,8000,7322,678
11/6/2021 20:28,8992959117613,SFX DAUN SIRIH 1 WP,2,500,0,1000,826,174
11/6/2021 20:30,8997028590014,ARGUS 220ML,6,500,0,3000,1812,1188
11/6/2021 20:30,gula,GULA,1,11500,0,11500,10000,1500
11/6/2021 20:30,9556001004673,MILO NESTLE MALAYSIA ACTIVE GO,1,85000,0,85000,80000,5000
11/6/2021 20:30,8991102987639,WFR TANGO LONG VNL 130G,1,5000,0,5000,4350,650
11/6/2021 20:32,8997028590014,ARGUS 220ML,4,500,0,2000,1208,792
11/6/2021 20:32,711844340008,ABC TERASI,1,7000,0,7000,5800,1200
11/6/2021 20:32,8992770033178,Masako,10,500,0,5000,4500,500
11/6/2021 20:33,8997028590014,ARGUS 220ML,4,500,0,2000,1208,792
11/6/2021 20:33,8998866200646,KOPI TOP MURNI,1,11000,0,11000,9600,1400
11/6/2021 20:33,ARG,ARGUS DOS 220ML,3,14500,0,43500,39900,3600
11/6/2021 20:35,711844610095,LARISSA UDANG 500 GR,1,11000,0,11000,9790,1210
11/6/2021 20:40,ROTI,ROTI 2000,1,2000,0,2000,1800,200
11/6/2021 20:40,8998866201452,POTABEE REGULER BBQ BEEF 35GR,1,5000,0,5000,4150,850
11/6/2021 20:40,8991188943536,SASA SANTAN KELAPA 65ML,1,3000,0,3000,2437,563
11/6/2021 20:40,8992736624310,Sasa bumbu Nasi Goreng Jawa,1,2000,0,2000,1181,819
11/6/2021 20:40,8999999192150,ROYCO FDS CHICKEN 100GR,1,5000,0,5000,4300,700
11/6/2021 20:40,8992959117538,SFX COMFORT SLIM WING 20,1,12000,0,12000,10947,1053
11/6/2021 20:40,8991102994422,TANGO WALUT CHOCOBNN 18G,1,9000,0,9000,8661,339
11/6/2021 20:40,8991102714846,MILKIDO CKLT,2,3000,0,6000,4306,1694
11/6/2021 20:46,8999999524722,SUNLIGHT LIME NEW PCH 435ML,1,10000,0,10000,9100,900
11/6/2021 20:46,8999999036836,LUX BW VELVET JASMINE LD REFF 450 ML,1,25000,0,25000,22110,2890
11/6/2021 20:46,8998866607315,SOKLIN SOFTERGENT SAKURA 770G & PIRING,1,20000,0,20000,18055,1945
11/6/2021 20:46,gula,GULA,2,11500,0,23000,20000,3000
11/6/2021 20:46,8991914101513,VIPER KRETEK 12,1,6000,0,6000,5000,1000
11/6/2021 20:47,ABC,BATERAI ABC BIRU,2,2500,0,5000,3856,1144
11/6/2021 20:48,8999999529321,PONDS ACNE SOL MICELLAR WTR 100ML,1,25000,0,25000,22800,2200
11/6/2021 20:53,gula,GULA,4,11500,0,46000,40000,6000
11/6/2021 20:53,8992696404441,SUSU BURUANG,1,13000,0,13000,8585,4415
11/6/2021 20:53,6907992823935,JD SWEETCORN,1,3500,0,3500,3000,500
11/6/2021 20:53,8993351139807,REAL GOOD,2,1000,0,2000,1600,400
11/6/2021 20:53,8999909000971,MAGNUM MILD 20,1,24000,0,24000,22750,1250
11/6/2021 20:53,8999999559854,AXE BLACK POCKET FRAG 17ML,1,10000,0,10000,8000,2000
11/6/2021 20:53,8992628022156,MINYAK GORENG BIMOLI POUCH 1 LT,1,17500,0,17500,16675,825
11/6/2021 20:53,8997028590052,ARGUS BTL 600ML,1,3000,0,3000,1458,1542
11/6/2021 20:53,8992761111533,SPRITE SLIM CAM250ML,1,5000,0,5000,3750,1250
11/6/2021 20:53,8993335521260,Sabun Total Violet 900gr,1,15000,0,15000,13800,1200
11/6/2021 20:54,8997009510055,YOU C1000,1,15000,0,15000,13000,2000
11/6/2021 20:55,ARGUS DOS,ARGUS DOS,1,15000,0,15000,13500,1500
11/6/2021 20:57,8999909010567,234 DJI SAM SOE 16,2,22500,0,45000,43000,2000
11/6/2021 20:57,gg,gula-gula koin,10,500,0,5000,4000,1000
11/6/2021 20:57,8998866200325,MIE SEDAAP SOTO,1,2700,0,2700,2282,418
11/6/2021 20:57,8998866202244,EKOMIE BUMBU KALDU AYAM,1,1000,0,1000,798,202
11/6/2021 21:14,8995333060772,TERIGU GATOT KACA 500GR,1,5000,0,5000,4346,654
11/6/2021 21:14,YP,YUPI,4,250,0,1000,832,168
11/6/2021 21:14,7622201430184,OREO ORIGINAL 38G,1,2000,0,2000,1641,359
11/6/2021 21:14,8991188943536,SASA SANTAN KELAPA 65ML,1,3000,0,3000,2437,563
11/6/2021 21:14,8999999560720,MOLTO TRIKA JAPANESE PEACH 720ML,1,5000,0,5000,4000,1000
11/6/2021 21:14,8992760223015,OREO CHOCOLATE CREAM 133G,1,8000,0,8000,6300,1700
11/6/2021 21:20,8991914101513,VIPER KRETEK 12,1,6000,0,6000,5000,1000
11/6/2021 21:20,8992775312414,GERY CHOCO HEZELNUT,1,11000,0,11000,9983,1017
11/6/2021 21:20,8991002105430,KAPAL API 65G,1,5000,0,5000,4145,855
11/6/2021 21:20,8998866803694,SOKLIN SOFTERGENT PURPLE BAG 770 & PIRING,1,20000,0,20000,18055,1945
11/6/2021 21:20,8999999552367,SAHAJA CUCI PIRING 400ML,1,8500,0,8500,7300,1200
11/6/2021 21:20,gula,GULA,2,11500,0,23000,20000,3000
11/6/2021 21:20,ROTI,ROTI 2000,1,2000,0,2000,1800,200
11/6/2021 21:20,8997878004327,gula-gula milkita,10,250,0,2500,2000,500
11/6/2021 21:20,KRIPIK,KRIPIK KENTANG,1,1000,0,1000,900,100
11/6/2021 21:20,8997009460435,SEDAP NET,2,500,0,1000,800,200
11/6/2021 21:26,8991914101513,VIPER KRETEK 12,2,6000,0,12000,10000,2000
11/6/2021 21:26,8999801700030,SUSU FOYU,1,11500,0,11500,10450,1050
11/6/2021 21:26,8995150101719,M+SUSU RASA SODA GEMBIRA,1,5000,0,5000,4000,1000
11/6/2021 21:26,8998989500166,GUDANG GARAM MERAH BESAR 16KS,1,18000,0,18000,17000,1000
11/6/2021 21:26,8994867007161,ROKOK PENA GOLD 20,1,18000,0,18000,16800,1200
11/6/2021 22:07,8996001302347,SARI GANDUM FAM,1,8500,0,8500,7700,800
11/6/2021 22:07,8996001301142,ROMA KELAPA,1,8000,0,8000,7000,1000
11/6/2021 22:07,8996001305041,ROMA SANDWICH CKLT,2,7000,0,14000,11856,2144
11/6/2021 22:07,8993083929837,BISKITOP BLACK COOKIES,1,27000,0,27000,23700,3300
11/6/2021 22:07,8992761139018,ADES 600ML,1,3500,0,3500,2166,1334
11/6/2021 22:07,8997021110028,Garam Kasar,1,3000,0,3000,1500,1500
11/6/2021 22:07,8999999192150,ROYCO FDS CHICKEN 100GR,1,5000,0,5000,4300,700
11/6/2021 22:07,BALON,BALON CABUT,3,1000,0,3000,2700,300
11/6/2021 22:07,8997028590014,ARGUS 220ML,1,500,0,500,302,198
11/6/2021 22:07,6907992825076,JD WATERMELON APPLE,1,2000,0,2000,1700,300
11/6/2021 22:11,8991102987639,WFR TANGO LONG VNL 130G,1,5000,0,5000,4350,650
11/6/2021 22:11,8991102387286,TANGO LONG CKLT 47G,1,2000,0,2000,1551,449
11/6/2021 22:11,8993351139807,REAL GOOD,2,1000,0,2000,1600,400
11/6/2021 22:11,BALON,BALON CABUT,1,1000,0,1000,900,100
11/6/2021 22:12,8993351139807,REAL GOOD,1,1000,0,1000,800,200
11/6/2021 22:12,ARG,ARGUS DOS 220ML,1,14500,0,14500,13300,1200
11/6/2021 22:13,ARG,ARGUS DOS 220ML,2,14500,0,29000,26600,2400
11/6/2021 22:19,8997028590014,ARGUS 220ML,6,500,0,3000,1812,1188
11/6/2021 22:19,8998866202343,MIE SEDAAP KOREAN SPICY,2,3000,0,6000,4826,1174
11/6/2021 22:19,8998866200301,MIE SEDAAP GORENG,1,3000,0,3000,2414,586
11/6/2021 22:20,8998866200301,MIE SEDAAP GORENG,1,3000,0,3000,2414,586
11/6/2021 22:20,8998866200325,MIE SEDAAP SOTO,2,2700,0,5400,4564,836
11/6/2021 22:30,8993351139807,REAL GOOD,1,1000,0,1000,800,200
11/6/2021 22:30,8999909002821,MARLBORO BLACK 16,1,22000,0,22000,20900,1100
11/6/2021 22:30,8997028590045,ARGUS BTL 330ML,2,2000,0,4000,2582,1418
11/6/2021 22:30,0105312686040047,yakult,1,2000,0,2000,1500,500
11/6/2021 22:30,ROTI,ROTI 2000,1,2000,0,2000,1800,200
11/6/2021 22:30,7622201430184,OREO ORIGINAL 38G,1,2000,0,2000,1641,359
11/6/2021 22:30,8999909004221,SAMPOERNA ULTRAMILD 16,1,22000,0,22000,20350,1650
11/6/2021 22:30,123124,KOREK BIASA,1,2000,0,2000,1300,700
11/6/2021 22:30,8992760223015,OREO CHOCOLATE CREAM 133G,1,8000,0,8000,6300,1700
11/6/2021 22:30,8998866200851,NOODLE SEDAAP MIE BAKSO SPESIAL CUP 77 GR,3,4500,0,13500,11214,2286
11/6/2021 22:37,8998866202060,POTABEE AYAM BAKAR PEDAS 35 GR,1,5000,0,5000,4150,850
11/6/2021 22:37,8998866201452,POTABEE REGULER BBQ BEEF 35GR,1,5000,0,5000,4150,850
11/6/2021 22:37,8991102384841,WFR TANGO LONG CKLT 130G,1,5000,0,5000,4345,655
11/6/2021 22:37,8991102023115,Sikat Gigi Formula,1,11000,0,11000,10000,1000
11/6/2021 22:37,8999999710880,PEPSODENT ACTION123 HERBAL 75G,1,7500,0,7500,6650,850
11/6/2021 22:37,8993989311699,CLAS MILD 16 FILTER,1,24000,0,24000,21700,2300
11/6/2021 22:37,BR,BERAS 10L,1,86500,0,86500,85000,1500
11/6/2021 22:37,Telur 7 Biji,Telur 7 Biji,1,10000,0,10000,8400,1600
11/6/2021 22:37,8998866608718,DAIA SOFTENER PINK,1,5000,0,5000,4450,550
11/6/2021 22:37,8997028590014,ARGUS 220ML,2,500,0,1000,604,396
11/6/2021 22:37,8995555111221,sosis kimbo,1,1000,0,1000,850,150
11/6/2021 22:39,8991102714846,MILKIDO CKLT,1,3000,0,3000,2153,847
11/6/2021 22:39,8993351139807,REAL GOOD,1,1000,0,1000,800,200
11/6/2021 22:39,8992775002582,DILAN CHOCO,1,2000,0,2000,1503,497
11/7/2021 16:08,6907992823669,JD MILKY STRAW,1,3000,0,3000,2600,400
11/7/2021 16:08,8991001503336,chacha minis hat,1,7500,0,7500,6400,1100
11/7/2021 16:57,BALON,BALON CABUT,3,1000,0,3000,2700,300
11/7/2021 17:12,ROTI,ROTI 2000,2,2000,0,4000,3600,400
11/7/2021 17:16,RT,ROTI,1,9000,0,9000,8000,1000
11/7/2021 17:33,Telur 3 Biji,Telur 3 Biji,1,5000,0,5000,3600,1400
11/7/2021 18:57,8998989121163,SURYA PRO MERAH,1,22000,0,22000,20100,1900
11/7/2021 18:58,ARGUS,ARGUS,1,2000,0,2000,1500,500
11/7/2021 19:56,18997028590011,ARGUS DOS,3,15000,0,45000,40500,4500
11/7/2021 20:11,8991102714860,MILKIDO STRAW,1,3000,0,3000,2153,847
11/7/2021 21:25,8991102281416,PERMEN MINTZ PPMINT,1,5000,0,5000,4000,1000
11/7/2021 21:38,8992959953136,SWEETY BRONZE L20,1,40000,0,40000,36770,3230
11/7/2021 22:03,TELUR RAK,TELUR RAK,1,38000,0,38000,35000,3000
11/7/2021 22:06,ROTI,ROTI 2000,1,2000,0,2000,1800,200
11/7/2021 22:06,8993093115008,tepun beras,3,8000,0,24000,21000,3000
11/7/2021 22:08,jagung marning,jagung marning,1,5000,0,5000,4500,500
11/7/2021 22:08,kri,kripik pisang,2,5000,0,10000,8000,2000
11/7/2021 22:08,8991102281430,PERMEN MINTZ DUOMINT,1,5000,0,5000,4000,1000
11/7/2021 22:08,8998989500166,GUDANG GARAM MERAH BESAR 16KS,1,18000,0,18000,17000,1000
11/7/2021 22:08,8999909004221,SAMPOERNA ULTRAMILD 16,1,22000,0,22000,20350,1650
11/7/2021 22:13,8993093115008,tepun beras,3,8000,0,24000,21000,3000
11/7/2021 22:13,8992933243116,NUTRIJELLL KELAPA,1,6000,0,6000,4833,1167
11/7/2021 22:13,18997028590011,ARGUS DOS,1,15000,0,15000,13500,1500
11/7/2021 22:13,8995333032113,TERIGU GATOT KACA 1 KG,2,9000,0,18000,17144,856
11/7/2021 22:13,8998866202244,EKOMIE BUMBU KALDU AYAM,3,1000,0,3000,2394,606
11/7/2021 22:13,8992388101085,NU GREEN TEA ORIGINAL 330ML,1,3500,0,3500,2768,732
11/7/2021 22:13,7622210462534,OREO MINI STRAW,1,7500,0,7500,6500,1000
11/7/2021 22:13,8997028590052,ARGUS BTL 600ML,2,3000,0,6000,2916,3084
11/7/2021 22:13,7622300335809,OREO SOFT CAKE,1,2000,0,2000,1641,359
11/7/2021 22:14,8992760223015,OREO CHOCOLATE CREAM 133G,1,8000,0,8000,6300,1700
11/7/2021 22:14,7622201430153,OREO CHOCOLATE 38G,1,2000,0,2000,1641,359
11/7/2021 22:16,8997028590014,ARGUS 220ML,2,500,0,1000,604,396
11/7/2021 22:16,089686021219,INTER MIE GORENG,1,1000,0,1000,885,115
11/7/2021 22:16,8999909004221,SAMPOERNA ULTRAMILD 16,1,22000,0,22000,20350,1650
11/7/2021 22:16,8999999559045,SUNLIGHT LIME CREAM 110G,1,2000,0,2000,1800,200
11/8/2021 11:47,8998989110167,SURYA GUDANG GARAM 16 FILTER,1,26000,0,26000,23700,2300
11/8/2021 20:09,8991002105409,KOPI KAPAL API,2,20000,0,40000,37776,2224
11/8/2021 20:09,8993007003063,ENAAK 500G,1,11000,0,11000,9625,1375
11/8/2021 20:09,8997213203095,INLITE 7W,1,34000,0,34000,31000,3000
11/8/2021 20:24,8998989500166,GUDANG GARAM MERAH BESAR 16KS,1,18000,0,18000,17000,1000
11/8/2021 20:24,8991909101016,URBAN MILD 16,2,17000,0,34000,31600,2400
11/8/2021 20:37,8992628020152,MINYAK GOREG BIMOLI POUCH 2L,1,35000,0,35000,29800,5200
11/8/2021 20:57,4902430553636,H&S LEMON  160ML,1,25000,0,25000,18900,6100
11/8/2021 20:57,6907992823935,JD SWEETCORN,1,3500,0,3500,3000,500
11/8/2021 21:22,8997028590045,ARGUS BTL 330ML,1,2000,0,2000,1291,709
11/8/2021 21:22,8991102714907,Kopi Seruput Simanis Aren 200ml,1,3000,0,3000,2375,625
11/8/2021 21:37,8999909000377,SAMPOERNA AVOLUTION,1,31000,0,31000,29450,1550
11/8/2021 22:07,8886008101091,"AQUA 1,5 ML",2,5500,0,11000,9200,1800
11/8/2021 22:17,8992628022156,MINYAK GORENG BIMOLI POUCH 1 LT,1,17500,0,17500,16675,825
11/8/2021 22:19,kri,kripik pisang,1,5000,0,5000,4000,1000
11/8/2021 22:19,8995139505019,UPIN IPIN,1,2000,0,2000,1600,400
11/8/2021 22:19,0105312686040047,yakult,1,2000,0,2000,1500,500
11/8/2021 22:21,8996001301142,ROMA KELAPA,1,8000,0,8000,7000,1000
11/8/2021 22:21,ROTI,ROTI 2000,1,2000,0,2000,1800,200
11/9/2021 21:10,9556001025272,NESCAFE LATTE 240ML,1,8500,0,8500,7834,666
11/9/2021 21:18,8999801700030,SUSU FOYU,1,11500,0,11500,10450,1050
11/9/2021 21:32,8993989311699,CLAS MILD 16 FILTER,1,24000,0,24000,21700,2300
11/9/2021 21:34,8995139505019,UPIN IPIN,2,2000,0,4000,3200,800
11/9/2021 21:34,8997009460343,NEXI NET,2,1000,0,2000,1800,200
11/9/2021 22:32,8997018920081,RED BULD,1,20000,0,20000,18000,2000
11/10/2021 18:55,8997009510055,YOU C1000,1,15000,0,15000,13000,2000
11/10/2021 18:55,8999999042592,RINSO MOLTO PERFUME ESSENSE LIQ 4OML,2,1000,0,2000,1604,396
11/10/2021 18:55,SF SOSIS,SAFFANAH ROTI SOSIS,1,6000,0,6000,5500,500
11/10/2021 18:55,8993274532105,BOLU,2,1000,0,2000,1666,334
11/10/2021 19:00,8997028590014,ARGUS 220ML,2,500,0,1000,604,396
11/10/2021 19:00,8991102714846,MILKIDO CKLT,1,3000,0,3000,2153,847
11/10/2021 19:00,8997009460343,NEXI NET,1,1000,0,1000,900,100
11/10/2021 19:00,123124,KOREK BIASA,2,2000,0,4000,2600,1400
11/10/2021 19:00,8997021870595,HOT IN CREAM AROMA THERAPY 60G,1,12500,0,12500,11360,1140
11/10/2021 19:00,8993351139807,REAL GOOD,3,1000,0,3000,2400,600
11/10/2021 19:09,CSM,ROTI COKLAT MATAHARI,1,6000,0,6000,5000,1000
11/10/2021 19:09,gula,GULA,4,11500,0,46000,40000,6000
11/10/2021 19:09,8992761002015,COCA COLA PET 390ML,1,5500,0,5500,4333,1167
11/10/2021 19:09,0105312686040047,yakult,5,2000,0,10000,7500,2500
11/10/2021 19:09,8997218380074,ICHITAN MILK TEA,1,8000,0,8000,6500,1500
11/10/2021 19:09,8991102987639,WFR TANGO LONG VNL 130G,1,5000,0,5000,4350,650
11/10/2021 19:09,8999801700030,SUSU FOYU,1,11500,0,11500,10450,1050
11/10/2021 19:09,089686021127,INTER MIE KALDU,3,1000,0,3000,2439,561
11/10/2021 19:09,089686386127,BUMBU RACIK NASI GORENG SOSIS,1,2000,0,2000,1620,380
11/10/2021 19:09,ROTI,ROTI 2000,1,2000,0,2000,1800,200
11/10/2021 19:09,8998989110501,gudang garam surya,2,2000,0,4000,2760,1240
11/10/2021 19:09,8998989110167,SURYA GUDANG GARAM 16 FILTER,1,26000,0,26000,23700,2300
11/10/2021 19:13,089686011036,INDOMIE GORENG PEDAS,4,2700,0,10800,9808,992
11/10/2021 19:13,8993351139807,REAL GOOD,3,1000,0,3000,2400,600
11/10/2021 19:13,8991102026383,AIR CRYSTALINE 1.5 L,1,5000,0,5000,3471,1529
11/10/2021 19:13,Vita Jelly,Vita Jelly,5,1000,0,5000,3830,1170
11/10/2021 19:13,8998866203227,MIE SEDAAP AYAM BAKAR LIMAU,2,2700,0,5400,4326,1074
11/10/2021 19:18,8991002103764,GOOD DAY CAPPUCINO 10X25G,2,1500,0,3000,2790,210
11/10/2021 19:18,8994867000162,ROKOK PUNDIMAS KRETEK16,1,10000,0,10000,8600,1400
11/10/2021 19:18,8991102281430,PERMEN MINTZ DUOMINT,1,5000,0,5000,4000,1000
11/10/2021 19:18,8997028590014,ARGUS 220ML,1,500,0,500,302,198
11/10/2021 19:18,8996001600269,LE MINERAL 600ML,1,3000,0,3000,1688,1312
11/10/2021 19:18,RT BAKPIA,ROTI BAKPIA,2,1000,0,2000,1500,500
11/10/2021 19:18,8993335523363,TOTAL ALMEERA 250G,1,5000,0,5000,4100,900
11/10/2021 19:18,8998866203227,MIE SEDAAP AYAM BAKAR LIMAU,2,2700,0,5400,4326,1074
11/10/2021 19:20,8999999059781,SUNLIGHT LIME NEW POUCH 210ML,1,5000,0,5000,4520,480
11/10/2021 19:20,8992628022156,MINYAK GORENG BIMOLI POUCH 1 LT,1,17500,0,17500,16675,825
11/10/2021 19:20,Gula gula kaki,gula gula kaki,4,500,0,2000,1600,400
11/10/2021 19:20,8999999531508,MOLTO HYGIENE SC 10ML,4,500,0,2000,1920,80
11/10/2021 19:21,8998866608404,Softener,1,5000,0,5000,4560,440
11/10/2021 19:22,8998989110167,SURYA GUDANG GARAM 16 FILTER,1,26000,0,26000,23700,2300
11/10/2021 19:33,KLOP,KLOP SALUTO,1,16000,0,16000,14545,1455
11/10/2021 19:33,8992775305034,Geri Salut Malkist Bungkus,1,18000,0,18000,16250,1750
11/10/2021 19:33,8992775311547,Chocolatos,4,2000,0,8000,6000,2000
11/10/2021 19:33,8998866201377,KRISBEE FRIES KENTANG GORENG 68 GR,1,5500,0,5500,4620,880
11/10/2021 19:33,8996001304129,SLAI OLAI STROBERI,1,12000,0,12000,9900,2100
11/10/2021 19:33,8991004011906,KOPI BORONG,1,10000,0,10000,8333,1667
11/10/2021 19:40,8991002105430,KAPAL API 65G,1,5000,0,5000,4145,855
11/10/2021 19:40,8992775002582,DILAN CHOCO,1,2000,0,2000,1503,497
11/10/2021 19:42,8936036023657,CHOCO-PIE,1,3000,0,3000,2500,500
11/10/2021 19:58,8999909096004,SAMPOERNA 16 FILTER,1,25000,0,25000,23100,1900
11/10/2021 20:06,8995333032113,TERIGU GATOT KACA 1 KG,4,9000,0,36000,34288,1712
11/10/2021 20:58,ROTI,ROTI 2000,1,2000,0,2000,1800,200
11/10/2021 20:58,8993274532105,BOLU,2,1000,0,2000,1666,334
11/10/2021 20:58,8995555111221,sosis kimbo,3,1000,0,3000,2550,450
11/10/2021 21:03,8992628020152,MINYAK GOREG BIMOLI POUCH 2L,1,35000,0,35000,29800,5200
11/10/2021 21:12,8997028590045,ARGUS BTL 330ML,1,2000,0,2000,1291,709
11/10/2021 21:17,8999909002821,MARLBORO BLACK 16,1,22000,0,22000,20900,1100
11/10/2021 21:17,8994867007161,ROKOK PENA GOLD 20,1,18000,0,18000,16800,1200
11/10/2021 21:18,8992628020152,MINYAK GOREG BIMOLI POUCH 2L,2,35000,0,70000,59600,10400
11/10/2021 21:23,8993351139807,REAL GOOD,1,1000,0,1000,800,200
11/10/2021 21:26,KRIPIK,KRIPIK KENTANG,1,1000,0,1000,900,100
11/10/2021 21:26,8992388101085,NU GREEN TEA ORIGINAL 330ML,3,3500,0,10500,8304,2196
11/10/2021 21:26,8992628020152,MINYAK GOREG BIMOLI POUCH 2L,3,35000,0,105000,89400,15600
11/10/2021 21:27,8997878004327,gula-gula milkita,8,250,0,2000,1600,400
11/10/2021 21:30,8997218380159,ICHITAN BROWN SUGAR,2,8000,0,16000,13000,3000
11/10/2021 21:31,8991102714860,MILKIDO STRAW,1,3000,0,3000,2153,847
11/10/2021 22:08,8992696404441,SUSU BURUANG,1,13000,0,13000,8585,4415
11/10/2021 22:10,8993007001359,INDOMILK KM SCT 37G,2,1500,0,3000,2166,834
11/10/2021 22:10,8999801700030,SUSU FOYU,1,11500,0,11500,10450,1050
11/10/2021 22:13,8996001305041,ROMA SANDWICH CKLT,1,7000,0,7000,5928,1072
11/10/2021 22:13,8993351139807,REAL GOOD,2,1000,0,2000,1600,400
11/10/2021 22:13,8997009460343,NEXI NET,1,1000,0,1000,900,100
11/10/2021 22:14,8992775211410,PILUS GARUDA PEDAS,1,5000,0,5000,4886,114
11/10/2021 22:14,6907992823935,JD SWEETCORN,1,3500,0,3500,3000,500
11/10/2021 22:23,8998866200325,MIE SEDAAP SOTO,4,2700,0,10800,9128,1672
11/10/2021 22:29,TERASI,ABC TERASI SCT,1,1500,0,1500,1000,500
11/10/2021 22:34,8997218010230,yohoo,9,1000,0,9000,8100,900
11/11/2021 15:56,9556001047175,NESCAFE ORI 240ML,1,8500,0,8500,7834,666
11/11/2021 15:56,8999909001909,MAGNUM REVAMP BLACK 12,1,18000,0,18000,16300,1700
11/11/2021 15:56,8997009461654,MORIS VANILLA,1,1000,0,1000,400,600
11/11/2021 15:56,YP,YUPI,2,250,0,500,416,84
11/11/2021 16:51,8999909096004,SAMPOERNA 16 FILTER,1,25000,0,25000,23100,1900
11/11/2021 16:51,8999909004221,SAMPOERNA ULTRAMILD 16,1,22000,0,22000,20350,1650
11/11/2021 16:51,8999909001909,MAGNUM REVAMP BLACK 12,1,18000,0,18000,16300,1700
11/11/2021 16:51,TG MARKISA,TEH GELAS MARKISA,2,2000,0,4000,2356,1644
11/11/2021 16:51,089686017748,SARIMIE GORENG ISI 2,1,3500,0,3500,3120,380
11/11/2021 16:51,8998866200578,MIE SEDAAP KARI KENTAL,1,2700,0,2700,2331,369
11/11/2021 16:51,Gula gula tusuk,gula gula tusuk,2,500,0,1000,800,200
11/11/2021 16:54,8991002105430,KAPAL API 65G,4,5000,0,20000,16580,3420
11/11/2021 16:54,8998866202244,EKOMIE BUMBU KALDU AYAM,5,1000,0,5000,3990,1010
11/11/2021 16:54,8998866200882,SUKSESMIE GORENG AYAM KRMS 133GR,2,3500,0,7000,6094,906
11/11/2021 16:54,8999999195656,SARIWANGI 50X1.85,1,10000,0,10000,9405,595
11/11/2021 16:54,8998866200301,MIE SEDAAP GORENG,3,3000,0,9000,7242,1758
11/11/2021 16:54,gula,GULA,2,11500,0,23000,20000,3000
11/11/2021 18:29,8992696520103,DNCO INSTANT CKLT 39G,1,3500,0,3500,3000,500
11/11/2021 18:57,8996200900092,HEROCYN 85GR,1,13000,0,13000,11650,1350
11/11/2021 19:00,4902430553629,H&S LEMON 70ML,1,11000,0,11000,9501,1499
11/11/2021 19:17,MK,MASKER,1,5000,0,5000,4000,1000
11/11/2021 19:22,8991001502926,Chaca Peanut,1,1000,0,1000,800,200
11/11/2021 19:22,8995139505019,UPIN IPIN,2,2000,0,4000,3200,800
11/11/2021 19:22,8997878004327,gula-gula milkita,4,250,0,1000,800,200
11/11/2021 19:22,8886001038011,BENG-BENG SCT,2,1500,0,3000,2000,1000
11/11/2021 19:33,8991102987639,WFR TANGO LONG VNL 130G,1,5000,0,5000,4350,650
11/11/2021 19:33,8991102989381,TANGO LONG BUBBLEGUM 130G,1,5000,0,5000,4350,650
11/11/2021 19:33,8998009040023,TEH KOTAK,2,5000,0,10000,5416,4584
11/11/2021 19:50,8997028590052,ARGUS BTL 600ML,1,3000,0,3000,1458,1542
11/11/2021 19:50,8886001038011,BENG-BENG SCT,1,1500,0,1500,1000,500
11/11/2021 19:50,8997009461753,TOP ELIT,1,1000,0,1000,400,600
11/11/2021 19:52,8999999195649,SARIWANGI 25X1.86G,2,6000,0,12000,10404,1596
11/11/2021 19:54,8998866203227,MIE SEDAAP AYAM BAKAR LIMAU,1,2700,0,2700,2163,537
11/11/2021 19:54,089686044249,SUPERMI NUTRIMI STEAK AYAM,1,3500,0,3500,2800,700
11/11/2021 19:59,8997001300074,Tokyo Night,1,8500,0,8500,6500,2000
11/11/2021 19:59,8992761002022,SPRITE PET 390ML,1,5500,0,5500,4333,1167
11/11/2021 19:59,8991102714891,Kopi Seruput susu tulen 200 ml,1,3000,0,3000,2375,625
11/11/2021 19:59,8993989311699,CLAS MILD 16 FILTER,1,24000,0,24000,21700,2300
11/11/2021 20:01,8992959117583,SFX DS REG FLOW WING 20,1,5000,0,5000,4288,712
11/11/2021 20:08,8999909002821,MARLBORO BLACK 16,1,22000,0,22000,20900,1100
11/11/2021 20:09,8998866202312,NOODLE SEDAAP TASTY BAKMI AYAM 129 GR,1,5000,0,5000,4167,833
11/11/2021 20:10,8886013257400,TWISTKO,1,1000,0,1000,900,100
11/11/2021 20:17,8998989110501,gudang garam surya,2,2000,0,4000,2760,1240
11/11/2021 20:17,KRIPIK MK,KRIPIK MAKKORONI,1,5000,0,5000,4000,1000
11/11/2021 20:17,SF TAWAR KUPAS,SAFFANAH ROTI TAWAR KUPAS,1,10000,0,10000,9000,1000
11/11/2021 20:17,8886013257400,TWISTKO,1,1000,0,1000,900,100
11/11/2021 20:17,Garuda Pilus,Garuda Pilus Rasa Abon Pcs,1,500,0,500,401,99
11/11/2021 20:17,MILKITA,MILKITA,2,250,0,500,400,100
11/11/2021 20:17,RT MNTG,ROTI SISIR MENTEGA,2,2000,0,4000,3200,800
11/11/2021 20:17,SOSIS,SO NICE SAPI,1,1000,0,1000,940,60
11/11/2021 20:17,gg,gula-gula koin,10,500,0,5000,4000,1000
11/11/2021 20:17,ICE CREAM 5,ICE CREAM 5000,1,5000,0,5000,4400,600
11/11/2021 20:17,8995139505019,UPIN IPIN,1,2000,0,2000,1600,400
11/11/2021 20:17,8997009462040,TIARA,5,1000,0,5000,2125,2875
11/11/2021 20:25,SOSIS,SO NICE SAPI,2,1000,0,2000,1880,120
11/11/2021 20:25,TAMARA,TAMARA,6,1000,0,6000,2520,3480
11/11/2021 20:25,8992775311615,CHOCOLATOS,1,12000,0,12000,9983,2017
11/11/2021 20:25,8992761164539,NUTRIBOOST ORANGE 300ML,1,6500,0,6500,5300,1200
11/11/2021 20:25,8992761139018,ADES 600ML,2,3500,0,7000,4332,2668
11/11/2021 20:25,8993379152017,SABUN CUCI SURYA 200G,1,3000,0,3000,2281,719
11/11/2021 20:25,TUSTEL,TUSUK TELINGA,1,1000,0,1000,833,167
11/11/2021 20:25,8999909010567,234 DJI SAM SOE 16,1,22500,0,22500,21500,1000
11/11/2021 20:36,8991002105430,KOPI KAPAL API 65G,1,5000,0,5000,4145,855
11/11/2021 20:38,8998989110167,SURYA GUDANG GARAM 16 FILTER,1,26000,0,26000,23700,2300
11/11/2021 20:38,ICE CREAM 5,ICE CREAM 5000,1,5000,0,5000,4400,600
11/11/2021 20:38,8993351139807,REAL GOOD,5,1000,0,5000,4000,1000
11/11/2021 20:38,8997218010230,yohoo,5,1000,0,5000,4500,500
11/11/2021 22:09,8886020033431,KAPUR AJAIB ANTI KECOA DAN NYAMUK,1,3000,0,3000,2700,300
11/12/2021 20:44,8997013180046,Tissu Tessi B,2,11000,0,22000,19600,2400
11/12/2021 20:49,8996001308059,Sari gandum sandwich,2,2000,0,4000,3400,600
11/12/2021 20:53,8997028590045,ARGUS BTL 330ML,1,2000,0,2000,1291,709
11/12/2021 21:00,Telur 3 Biji,Telur 3 Biji,1,5000,0,5000,3600,1400
11/12/2021 21:18,ARGUS,ARGUS,1,2000,0,2000,1500,500
11/12/2021 21:19,ARG,ARGUS DOS 220ML,3,15000,0,45000,40500,4500
11/12/2021 21:31,8886022971298,BATERAI ALKALINE 06,1,12000,0,12000,10557,1443
11/12/2021 21:39,8992979120013,TOTAL BUNGA SOFTENER,1,15000,0,15000,13800,1200
11/12/2021 21:39,8999999008475,SUNLIGHT LIME NEW REF 1600ML,1,35000,0,35000,31955,3045
11/12/2021 21:55,8998989500166,GUDANG GARAM MERAH BESAR 16KS,1,18000,0,18000,17000,1000
11/12/2021 21:55,8999909002821,MARLBORO BLACK 16,1,22000,0,22000,20900,1100
11/12/2021 22:41,8998989110167,SURYA GUDANG GARAM 16 FILTER,1,26000,0,26000,23700,2300
11/14/2021 21:48,8998989110167,SURYA GUDANG GARAM 16 FILTER,3,26000,0,78000,71100,6900
11/14/2021 22:04,8996001328163,GULA GULA TAMARIN,8,250,0,2000,1600,400
11/14/2021 22:04,8997013180046,Tissu Tessi B,1,11000,0,11000,9800,1200
11/14/2021 22:04,8992761136178,SPRITE 1L,1,10000,0,10000,9000,1000
11/14/2021 22:04,8997009510123,ORANGE WATER,3,8000,0,24000,18795,5205
11/14/2021 22:10,8992761164539,NUTRIBOOST ORANGE 300ML,1,6500,0,6500,5300,1200
11/14/2021 22:10,9556001047175,NESCAFE ORI 240ML,1,8500,0,8500,7834,666
11/14/2021 22:10,KRIPIK MK,KRIPIK MAKKORONI,1,5000,0,5000,4000,1000
11/14/2021 22:10,8994834003752,TICTIC,1,2000,0,2000,1700,300
11/14/2021 22:10,8992761002022,SPRITE PET 390ML,2,5500,0,11000,8666,2334
11/14/2021 22:10,8992775315057,GERY SALUT MALKIST COKLAT,1,6500,0,6500,5516,984
11/14/2021 22:10,8997028590014,ARGUS 220ML,2,500,0,1000,604,396
11/14/2021 22:12,8886008101053,AQUA 600 ML,1,3500,0,3500,2125,1375
11/14/2021 22:16,MK,MASKER,2,5000,0,10000,8000,2000
11/14/2021 22:16,8992761002022,SPRITE PET 390ML,1,5500,0,5500,4333,1167
11/14/2021 22:16,8994191103638,GULA GULA KARET,10,500,0,5000,4000,1000
11/14/2021 22:16,8996001320068,GULA GULA KOPIKO,6,250,0,1500,1200,300
11/14/2021 22:16,8991102987639,WFR TANGO LONG VNL 130G,1,5000,0,5000,4350,650
11/15/2021 19:19,8992775001783,GERY SALUT MALKIST KELAPA,1,6500,0,6500,5516,984
11/15/2021 19:19,8991102281430,PERMEN MINTZ DUOMINT,1,5000,0,5000,4000,1000
11/15/2021 19:19,8886008101053,AQUA 600 ML,1,3500,0,3500,2125,1375
11/15/2021 19:19,8992741952262,GULA GULA YUPI,6,250,0,1500,1200,300
11/15/2021 19:19,8997009510055,YOU C1000,2,15000,0,30000,26000,4000
11/15/2021 19:19,8992761164539,NUTRIBOOST ORANGE 300ML,1,6500,0,6500,5300,1200
11/15/2021 19:19,8991002303928,GULA GULA RELAXA,6,250,0,1500,1200,300
11/15/2021 19:21,8997028590045,ARGUS BTL 330ML,2,2000,0,4000,2582,1418
11/15/2021 19:21,8991002303928,GULA GULA RELAXA,4,250,0,1000,800,200
11/15/2021 19:21,PULPEN,PULPEN BIASA,2,2000,0,4000,3000,1000
11/15/2021 19:21,8997028590014,ARGUS 220ML,2,500,0,1000,604,396
11/15/2021 19:21,8991909101016,URBAN MILD 16,1,17000,0,17000,15800,1200
11/15/2021 19:23,8995333032113,TERIGU GATOT KACA 1 KG,4,9000,0,36000,34288,1712
11/15/2021 19:23,gula,GULA,1,11500,0,11500,10000,1500
11/15/2021 19:29,8886008101053,AQUA 600 ML,1,3500,0,3500,2125,1375
11/15/2021 19:29,ROTI,ROTI 2000,1,2000,0,2000,1800,200
11/15/2021 19:29,MK,MASKER,1,5000,0,5000,4000,1000
11/15/2021 19:29,8999909010567,234 DJI SAM SOE 16,1,22500,0,22500,21500,1000
11/15/2021 19:29,8993989331659,ROKOK CLAS MILD SILVER,1,22000,0,22000,18900,3100
11/15/2021 19:29,8992775211410,PILUS GARUDA PEDAS,1,5000,0,5000,4886,114
11/15/2021 19:29,8998866202619,MIE SEDAAP KOREAN SPICY SOUP,2,2700,0,5400,4644,756
11/15/2021 19:39,BALON GAS,BALON GAS,1,500,0,500,400,100
11/15/2021 19:41,8991102320184,TANGO CHOCO JAVAMOCCA,1,5000,0,5000,4350,650
11/15/2021 19:41,8997218380159,ICHITAN BROWN SUGAR,1,8000,0,8000,6500,1500
11/15/2021 19:41,8992761166212,FRESTEA APPLE 350ML,1,4500,0,4500,3000,1500
11/15/2021 19:44,PULPEN,PULPEN BIASA,1,2000,0,2000,1500,500
11/15/2021 19:44,8997028590014,ARGUS 220ML,1,500,0,500,302,198
11/15/2021 19:44,8994191103980,GULA GULA MARS,3,500,0,1500,1200,300
11/15/2021 19:46,8998989110167,SURYA GUDANG GARAM 16 FILTER,2,26000,0,52000,47400,4600
11/15/2021 19:49,8992775001844,Chocolatos original taste,1,1000,0,1000,829,171
11/15/2021 19:55,8992775000250,CHOCOLATOS MATCHA,1,2000,0,2000,1557,443
11/15/2021 19:55,8997028590014,ARGUS 220ML,1,500,0,500,302,198
11/15/2021 19:55,8994191103980,GULA GULA MARS,3,500,0,1500,1200,300
11/15/2021 19:55,8993274532105,BOLU,2,1000,0,2000,1666,334
11/15/2021 19:55,8992761122430,FRESTEA GREEN HONEY 500ML,1,6500,0,6500,4708,1792
11/15/2021 19:55,8992761002022,SPRITE PET 390ML,1,5500,0,5500,4333,1167
11/15/2021 20:00,8997028590014,ARGUS 220ML,1,500,0,500,302,198
11/15/2021 20:13,8991002114067,PIKOPI,1,1000,0,1000,545,455
11/15/2021 20:17,8994867007161,ROKOK PENA GOLD 20,1,18000,0,18000,16800,1200
11/15/2021 20:17,ICE CREAM,ICE CREAM 2000,1,2000,0,2000,1700,300
11/17/2021 15:09,8992959953198,SWEETY BRONZE XL 26+2,1,60000,0,60000,54091,5909
11/17/2021 15:17,SF GULUNG,SAFFANAH ROTI GULUNG,1,6000,0,6000,5500,500
11/17/2021 15:17,TG MARKISA,TEH GELAS MARKISA,1,2000,0,2000,1178,822
11/17/2021 15:17,8992761111540,FANTA STRAWBERY SLIM CAM 250ML,1,5000,0,5000,3750,1250
11/17/2021 15:17,8999909004221,SAMPOERNA ULTRAMILD 16,1,22000,0,22000,20350,1650
11/17/2021 15:17,8998866201865,KRISBEE PILLOW CHOCOLAVA 120 GR,1,8000,0,8000,7250,750
11/17/2021 15:17,8992696523067,MILO ACTVGO UHT 180ML,1,4500,0,4500,3719,781
11/17/2021 15:17,kri,kripik pisang,1,5000,0,5000,4000,1000
11/17/2021 15:19,TG MARKISA,TEH GELAS MARKISA,1,2000,0,2000,1178,822
11/17/2021 15:19,8992388101085,NU GREEN TEA ORIGINAL 330ML,1,3500,0,3500,2768,732
11/17/2021 15:30,8992702000063,INDOMILK COKLAT 370G,1,10000,0,10000,9208,792
11/17/2021 15:30,8998866201865,KRISBEE PILLOW CHOCOLAVA 120 GR,1,8000,0,8000,7250,750
11/17/2021 15:30,8992761139018,ADES 600ML,1,3500,0,3500,2166,1334
11/17/2021 15:30,8998866202619,MIE SEDAAP KOREAN SPICY SOUP,2,2700,0,5400,4644,756
11/17/2021 15:30,8999999533731,CITRA TS NATURE WHITE 70G,1,2200,0,2200,1900,300
11/17/2021 15:30,8997028590045,ARGUS BTL 330ML,1,2000,0,2000,1291,709
11/17/2021 15:30,6907992823874,JD CRUNCHY CHOCO BLUEBERRY,1,5500,0,5500,4700,800
11/17/2021 15:30,8997009460343,NEXI NET,2,1000,0,2000,1800,200
11/17/2021 15:30,8997028590014,ARGUS 220ML,2,500,0,1000,604,396
11/17/2021 15:30,8994834003752,TICTIC,2,2000,0,4000,3400,600
11/17/2021 15:30,8992388101085,NU GREEN TEA ORIGINAL 330ML,1,3500,0,3500,2768,732
11/17/2021 15:30,8996001600269,LE MINERAL 600ML,1,3000,0,3000,1688,1312
11/17/2021 15:30,8996001600375,LE MINERAL 330ML,2,2000,0,4000,2834,1166
11/17/2021 15:35,8996001328163,GULA GULA TAMARIN,4,250,0,1000,800,200
11/17/2021 15:35,gula,GULA,1,11500,0,11500,10000,1500
11/17/2021 15:35,8992696425316,NESCAFE BLACK,1,5000,0,5000,4099,901
11/17/2021 15:35,8992761164539,NUTRIBOOST ORANGE 300ML,1,6500,0,6500,5300,1200
11/17/2021 15:35,KRIPIK,KRIPIK KENTANG,1,1000,0,1000,900,100
11/17/2021 15:35,8886001038011,BENG-BENG SCT,1,1500,0,1500,1000,500
11/17/2021 15:35,8998866200561,EKOMIE SUPER 600GR,1,10000,0,10000,8615,1385
11/17/2021 15:46,8998989110129,SURYA KECIL MERAH 12KS,1,20000,0,20000,18450,1550
11/17/2021 15:46,8999909982000,SAMPOERNA 12 FILTER,1,19000,0,19000,16600,2400
11/17/2021 15:46,8997218380159,ICHITAN BROWN SUGAR,1,8000,0,8000,6500,1500
11/17/2021 15:46,8996001600375,LE MINERAL 330ML,1,2000,0,2000,1417,583
11/17/2021 15:46,8999909001909,MAGNUM REVAMP BLACK 12,1,18000,0,18000,16300,1700
11/17/2021 15:46,8992716109172,BISKUAT BOLU SCT,1,2000,0,2000,1641,359
11/17/2021 15:46,8997028590014,ARGUS 220ML,4,500,0,2000,1208,792
11/17/2021 15:46,8996001308059,Sari gandum sandwich,3,2000,0,6000,5100,900
11/17/2021 15:46,8995150101696,M+SUSU ORIGINAL,1,5000,0,5000,4000,1000
11/17/2021 15:46,8993351139807,REAL GOOD,2,1000,0,2000,1600,400
11/17/2021 15:46,8998989500166,GUDANG GARAM MERAH BESAR 16KS,1,18000,0,18000,17000,1000
11/17/2021 15:46,gula,GULA,1,11500,0,11500,10000,1500
11/17/2021 15:46,8998989300261,GUDANG GARAM SURYA 12 FILTER,1,20000,0,20000,18150,1850
11/17/2021 15:59,8998866202619,MIE SEDAAP KOREAN SPICY SOUP,1,2700,0,2700,2322,378
11/17/2021 15:59,089686021127,INTER MIE KALDU,1,1000,0,1000,813,187
11/17/2021 15:59,8998989300261,GUDANG GARAM SURYA 12 FILTER,1,20000,0,20000,18150,1850
11/17/2021 15:59,8998989110501,gudang garam surya,1,2000,0,2000,1380,620
11/17/2021 15:59,8997028590014,ARGUS 220ML,2,500,0,1000,604,396
11/17/2021 15:59,8995555111221,sosis kimbo,4,1000,0,4000,3400,600
11/17/2021 15:59,8998866200325,MIE SEDAAP SOTO,1,2700,0,2700,2282,418
11/17/2021 15:59,8993989311699,CLAS MILD 16 FILTER,1,24000,0,24000,21700,2300
11/17/2021 15:59,8992959953334,SWEETY BRONZE XL42,1,80000,0,80000,75455,4545
11/17/2021 15:59,SFX,SOFTEX DAUN SIRIH 1,1,500,0,500,413,87
11/17/2021 15:59,8991001242013,Top,1,1000,0,1000,500,500
11/17/2021 15:59,8999909004221,SAMPOERNA ULTRAMILD 16,1,22000,0,22000,20350,1650
11/17/2021 15:59,8998989110129,SURYA KECIL MERAH 12KS,1,20000,0,20000,18450,1550
11/17/2021 16:08,8998989500166,GUDANG GARAM MERAH BESAR 16KS,1,18000,0,18000,17000,1000
11/17/2021 16:08,gula,GULA,2,11500,0,23000,20000,3000
11/17/2021 16:08,8999999030179,PEPSODENT ACTION 123 COMPLETE 75G,1,6700,0,6700,5170,1530
11/17/2021 16:08,8991004011906,KOPI BORONG,1,10000,0,10000,8333,1667
11/17/2021 16:08,8991002105409,KOPI KAPAL API,1,20000,0,20000,18888,1112
11/17/2021 16:08,8995139505019,UPIN IPIN,2,2000,0,4000,3200,800
11/17/2021 16:08,8992628022156,MINYAK GORENG BIMOLI POUCH 1 LT,1,17500,0,17500,16675,825
11/17/2021 16:08,ROTI,ROTI 2000,1,2000,0,2000,1800,200
11/17/2021 16:08,8992775312469,GERY SALUT COKELAT,1,11000,0,11000,9983,1017
11/17/2021 16:08,8992388101085,NU GREEN TEA ORIGINAL 330ML,1,3500,0,3500,2768,732
11/17/2021 16:08,8991102987639,WFR TANGO LONG VNL 130G,1,5000,0,5000,4350,650
11/17/2021 16:08,089686021219,INTER MIE GORENG,5,1000,0,5000,4425,575
11/17/2021 16:08,8991102228053,TEH GELAS BOTOL,2,3000,0,6000,3390,2610
11/17/2021 16:16,8992761111533,SPRITE SLIM CAM250ML,1,5000,0,5000,3750,1250
11/17/2021 16:16,6907992823829,JD MILKY MILK,1,3000,0,3000,2600,400
11/17/2021 16:16,8991102714907,Kopi Seruput Simanis Aren 200ml,1,3000,0,3000,2375,625
11/17/2021 16:16,6907992823669,JD MILKY STRAW,4,3000,0,12000,10400,1600
11/17/2021 16:16,8995150101696,M+SUSU ORIGINAL,1,5000,0,5000,4000,1000
11/17/2021 16:16,8994867007161,ROKOK PENA GOLD 20,1,18000,0,18000,16800,1200
11/17/2021 16:16,8998989110501,gudang garam surya,1,2000,0,2000,1380,620
11/17/2021 16:16,8998866200561,EKOMIE SUPER 600GR,1,10000,0,10000,8615,1385
11/17/2021 16:16,8999801700054,SUSU FOYU 1 KG,1,22000,0,22000,19791,2209
11/17/2021 16:16,8996001302323,MALKIST ABON,1,6500,0,6500,4800,1700
11/17/2021 16:16,8993989311699,CLAS MILD 16 FILTER,1,24000,0,24000,21700,2300
11/17/2021 16:16,8998989300261,GUDANG GARAM SURYA 12 FILTER,1,20000,0,20000,18150,1850
11/17/2021 16:16,123124,KOREK BIASA,1,2000,0,2000,1300,700
11/17/2021 16:25,RT MNTG,ROTI SISIR MENTEGA,3,2000,0,6000,4800,1200
11/17/2021 16:25,7622201430153,OREO CHOCOLATE 38G,1,2000,0,2000,1641,359
11/17/2021 16:25,gula,GULA,4,11500,0,46000,40000,6000
11/17/2021 16:25,8991102714907,Kopi Seruput Simanis Aren 200ml,1,3000,0,3000,2375,625
11/17/2021 16:25,8997028590014,ARGUS 220ML,4,500,0,2000,1208,792
11/17/2021 16:25,8995139505019,UPIN IPIN,1,2000,0,2000,1600,400
11/17/2021 16:25,RT BAKPIA,ROTI BAKPIA,5,1000,0,5000,3750,1250
11/17/2021 16:25,8991102022347,SIKAT GIGI FORMULA RIPPLE,1,5000,0,5000,4583,417
11/17/2021 16:25,8998866200301,MIE SEDAAP GORENG,2,3000,0,6000,4828,1172
11/17/2021 16:25,8998866200325,MIE SEDAAP SOTO,1,2700,0,2700,2282,418
11/17/2021 16:25,8992696404441,SUSU BURUANG,1,13000,0,13000,8585,4415
11/17/2021 16:25,6907992823935,JD SWEETCORN,1,3500,0,3500,3000,500
11/17/2021 16:25,8996001308059,Sari gandum sandwich,1,2000,0,2000,1700,300
11/17/2021 16:32,RT MNTG,ROTI SISIR MENTEGA,1,2000,0,2000,1600,400
11/17/2021 16:32,8998989500166,GUDANG GARAM MERAH BESAR 16KS,1,18000,0,18000,17000,1000
11/17/2021 16:32,123124,KOREK BIASA,1,2000,0,2000,1300,700
11/17/2021 16:32,8993007003902,Susu Kental Manis Indo milk,1,15000,0,15000,13333,1667
11/17/2021 16:32,TBR,TEPUNG BERAS ROSE BRAND,1,8000,0,8000,6150,1850
11/17/2021 16:32,8886030322907,PORSTEX BIRU 500ML,1,15500,0,15500,13000,2500
11/17/2021 16:32,8998866200301,MIE SEDAAP GORENG,2,3000,0,6000,4828,1172
11/17/2021 16:32,8998866202619,MIE SEDAAP KOREAN SPICY SOUP,2,2700,0,5400,4644,756
11/17/2021 16:32,089686021127,INTER MIE KALDU,5,1000,0,5000,4065,935
11/17/2021 16:32,8997028590045,ARGUS BTL 330ML,2,2000,0,4000,2582,1418
11/17/2021 16:32,8995333032113,TERIGU GATOT KACA 1 KG,1,9000,0,9000,8572,428
11/17/2021 16:32,8995333060703,TERIGU KOMPAS 1KG,1,10500,0,10500,9816,684
11/17/2021 16:33,8992628020152,MINYAK GOREG BIMOLI POUCH 2L,1,35000,0,35000,29800,5200
11/17/2021 16:36,8991001111883,SILVERQUEEN CHUNKYBAR 33G,2,8000,0,16000,14300,1700
11/17/2021 16:46,8997028590014,ARGUS 220ML,4,500,0,2000,1208,792
11/17/2021 16:46,8995333032113,TERIGU GATOT KACA 1 KG,1,9000,0,9000,8572,428
11/17/2021 16:46,8995333060703,TERIGU KOMPAS 1KG,1,10500,0,10500,9816,684
11/17/2021 16:46,TBR,TEPUNG BERAS ROSE BRAND,1,8000,0,8000,6150,1850
11/17/2021 16:46,TELUR RAK,TELUR RAK,1,38000,0,38000,35000,3000
11/17/2021 16:46,Beras,Beras Liter,4,8000,0,32000,30000,2000
11/17/2021 16:46,8998866202244,EKOMIE BUMBU KALDU AYAM,3,1000,0,3000,2394,606
11/17/2021 16:46,ARG,ARGUS DOS 220ML,1,15000,0,15000,13500,1500
11/20/2021 11:49,gula,GULA,1,11500,0,11500,10000,1500
11/20/2021 14:59,8998866200646,KOPI TOP MURNI,1,11000,0,11000,9600,1400
11/20/2021 15:07,6916597571752,TOFFEE R. COKLAT,2,1000,0,2000,1400,600
11/20/2021 15:32,8991002105584,KAPAL API 6.5 G,2,500,0,1000,780,220
11/20/2021 15:52,8997218010230,yohoo,4,1000,0,4000,3600,400
11/20/2021 16:02,6907992823966,JD BLUEBERRY,1,3500,0,3500,3000,500
11/20/2021 16:24,8997028590045,ARGUS BTL 330ML,35,2000,0,70000,45185,24815
11/20/2021 16:24,8997028590052,ARGUS BTL 600ML,10,3000,0,30000,14580,15420
11/20/2021 16:24,8994023000050,MEGKEJU SERBAGUNA 165G,1,13000,0,13000,12000,1000
11/20/2021 16:24,8995139505019,UPIN IPIN,2,2000,0,4000,3200,800
11/20/2021 16:24,gula,GULA,3,11500,0,34500,30000,4500
11/20/2021 16:24,8995333060703,TERIGU KOMPAS 1KG,1,10500,0,10500,9816,684
11/20/2021 16:24,8998989110167,SURYA GUDANG GARAM 16 FILTER,1,26000,0,26000,23700,2300
11/20/2021 16:24,ICE CREAM 6,ICE CREAM 6.000,3,6000,0,18000,15600,2400
11/20/2021 16:24,8999999531423,CITRA SUN SPF20 230ML,1,22300,0,22300,20735,1565
11/20/2021 16:24,8999999528966,CITRA FRESH WHITE 120ML,1,13200,0,13200,11875,1325
11/20/2021 16:24,8993351139807,REAL GOOD,2,1000,0,2000,1600,400
11/20/2021 16:24,8999999192150,ROYCO FDS CHICKEN 100GR,1,5000,0,5000,4300,700
11/20/2021 16:24,8993226365522,GARAM MEJA GYURI 200GR,1,2000,0,2000,1700,300
11/20/2021 16:25,8998989300261,GUDANG GARAM SURYA 12 FILTER,1,20000,0,20000,18150,1850
11/20/2021 16:25,4800361347594,LACTOGEN 1 180G,1,28000,0,28000,26033,1967
11/20/2021 16:33,ARG,ARGUS DOS 220ML,2,15000,0,30000,27000,3000
11/20/2021 16:39,8992959930762,CONFI CLASS DAY XL1,1,6500,0,6500,5682,818
11/20/2021 16:39,8992696404441,SUSU BURUANG,1,13000,0,13000,8585,4415
11/20/2021 16:39,8992946511790,SHINZUI 85G,1,5000,0,5000,3475,1525
11/20/2021 16:41,8997210107877,VORTEX SMART 3,2,5000,0,10000,9500,500
11/20/2021 16:45,8886022830243,BATEREI ABC,2,3000,0,6000,3856,2144
11/20/2021 16:52,8998989300261,GUDANG GARAM SURYA 12 FILTER,1,20000,0,20000,18150,1850
11/20/2021 17:08,123124,KOREK BIASA,1,2000,0,2000,1300,700
11/20/2021 17:08,8991906105758,ROKOK LA BOLD,1,27000,0,27000,24900,2100
11/20/2021 17:08,8999909096004,SAMPOERNA 16 FILTER,2,25000,0,50000,46200,3800
11/20/2021 17:08,8992696419742,NESCAFE COFFE CREAM,1,5000,0,5000,4099,901
11/20/2021 17:08,8993351139807,REAL GOOD,4,1000,0,4000,3200,800
11/20/2021 17:08,8997009460657,STICK COKELAT,1,1000,0,1000,425,575
11/20/2021 17:08,8992775002582,DILAN CHOCO,1,2000,0,2000,1503,497
11/20/2021 17:08,Vita Jelly,Vita Jelly,1,1000,0,1000,766,234
11/20/2021 17:12,ICE CREAM 5.000,ICE CREAM 5.000,1,5000,0,5000,4700,300
11/20/2021 17:12,BALON GAS,BALON GAS,8,500,0,4000,3200,800
11/20/2021 17:16,Gula gula kaki,gula gula kaki,1,500,0,500,400,100
11/20/2021 17:16,8994834006128,TICTIC PEDAS,2,2000,0,4000,3400,600
11/20/2021 17:16,8997028590045,ARGUS BTL 330ML,1,2000,0,2000,1291,709
11/20/2021 17:16,9556040040038,SUSU F&N,5,35000,0,175000,150000,25000
11/20/2021 17:16,8992730950194,GULA GULA KOIN,10,500,0,5000,4000,1000
11/20/2021 17:16,8999801700030,SUSU FOYU,1,11500,0,11500,10450,1050
11/20/2021 17:16,8994834003752,TICTIC,1,2000,0,2000,1700,300
11/20/2021 17:18,8996001308059,Sari gandum sandwich,1,2000,0,2000,1700,300
11/20/2021 17:18,8999909004221,SAMPOERNA ULTRAMILD 16,1,22000,0,22000,20350,1650
11/20/2021 17:18,8994867006997,ROKOK PENA BOLD 20BTG,1,17000,0,17000,15000,2000
11/20/2021 17:20,MK,MASKER,1,5000,0,5000,4000,1000
11/20/2021 17:22,8996001308059,Sari gandum sandwich,1,2000,0,2000,1700,300
11/20/2021 17:22,8995333060772,TERIGU GATOT KACA 500GR,1,5000,0,5000,4346,654
11/20/2021 17:22,8995333032113,TERIGU GATOT KACA 1 KG,3,9000,0,27000,25716,1284
11/20/2021 17:22,gula,GULA,1,11500,0,11500,10000,1500
11/20/2021 17:23,8995555111221,sosis kimbo,1,1000,0,1000,850,150
11/20/2021 17:23,8999909002821,MARLBORO BLACK 16,1,22000,0,22000,20900,1100
11/20/2021 17:23,711844110083,KECAP ABC 275 ML,1,16000,0,16000,15000,1000
11/20/2021 17:26,8995333032113,TERIGU GATOT KACA 1 KG,2,9000,0,18000,17144,856
11/20/2021 17:26,8993093115008,tepun beras,3,8000,0,24000,21000,3000
11/20/2021 17:26,8992761002022,SPRITE PET 390ML,1,5500,0,5500,4333,1167
11/20/2021 17:26,8992696404441,SUSU BURUANG,1,13000,0,13000,8585,4415
11/20/2021 17:35,8998866201520,KOPI TOP TORAJA MURNI,1,11000,0,11000,9600,1400
11/20/2021 17:35,8993007000086,INDOMILK CKLT 1L,1,16500,0,16500,14791,1709
11/20/2021 17:35,089686043204,INDOMIE MIE ACEH,1,2700,0,2700,2452,248
11/20/2021 17:35,ABC,BATERAI ABC BIRU,1,2500,0,2500,1928,572
11/20/2021 17:38,ABC,BATERAI ABC BIRU,1,3000,0,3000,1928,1072
11/20/2021 17:41,8993351139807,REAL GOOD,2,1000,0,2000,1600,400
11/20/2021 17:41,8991188943062,SASA 250G,1,10000,0,10000,8500,1500
11/20/2021 17:41,8997218010230,yohoo,1,1000,0,1000,900,100
11/20/2021 17:41,PRG,PARAGO,2,500,0,1000,800,200
11/20/2021 17:43,PRG,PARAGO,2,500,0,1000,800,200
11/20/2021 17:44,ARG,ARGUS DOS 220ML,1,15000,0,15000,13500,1500
11/20/2021 17:46,8994867007161,ROKOK PENA GOLD 20,1,19000,0,19000,17400,1600
11/20/2021 17:56,8992696419742,NESCAFE COFFE CREAM,1,5000,0,5000,4099,901
11/20/2021 17:56,8993226365522,GARAM MEJA GYURI 200GR,1,2000,0,2000,1700,300
11/20/2021 17:56,ABC,BATERAI ABC BIRU,2,3000,0,6000,3856,2144
11/20/2021 17:56,8997028590014,ARGUS 220ML,6,500,0,3000,1812,1188
11/20/2021 17:56,8991102987639,WFR TANGO LONG VNL 130G,1,5000,0,5000,4350,650
11/20/2021 17:56,RT MNTG,ROTI SISIR MENTEGA,1,2000,0,2000,1600,400
11/20/2021 17:56,ARG,ARGUS DOS 220ML,3,15000,0,45000,40500,4500
11/20/2021 17:56,8991909101016,URBAN MILD 16,1,17000,0,17000,15800,1200
11/20/2021 17:56,123124,KOREK BIASA,1,2000,0,2000,1300,700
11/20/2021 17:56,8998989300261,GUDANG GARAM SURYA 12 FILTER,1,20000,0,20000,18150,1850
11/20/2021 17:56,8997218010230,yohoo,1,1000,0,1000,900,100
11/20/2021 17:56,8996001600399,LE MINERAL 1500ML,1,5000,0,5000,4042,958
11/20/2021 17:56,8999909004221,SAMPOERNA ULTRAMILD 16,1,22000,0,22000,20350,1650
11/20/2021 18:05,RT MNTG,ROTI SISIR MENTEGA,2,2000,0,4000,3200,800
11/20/2021 18:05,8992761145033,FANTA STRAW PET 250ML,1,3500,0,3500,2417,1083
11/20/2021 18:05,8991002105409,KOPI KAPAL API,1,20000,0,20000,18888,1112
11/20/2021 18:05,8998866692663,SOKLIN FLOORCLENER KUNING 450ML,1,7000,0,7000,6385,615
11/20/2021 18:05,8999999390198,SUNLIGHT LIME NEW POUCH 755ML,1,18000,0,18000,15950,2050
11/20/2021 18:05,SF SOSIS,SAFFANAH ROTI SOSIS,1,6000,0,6000,5500,500
11/20/2021 18:05,8997006030006,RX BOLD,1,20000,0,20000,18100,1900
11/20/2021 18:05,8996001308059,Sari gandum sandwich,1,2000,0,2000,1700,300
11/20/2021 18:05,Vita Jelly,Vita Jelly,1,1000,0,1000,766,234
11/20/2021 18:05,8999909002821,MARLBORO BLACK 16,1,22000,0,22000,20900,1100
11/20/2021 18:05,8994867006997,ROKOK PENA BOLD 20BTG,1,17000,0,17000,15000,2000
11/20/2021 18:05,JL,JELLY,2,500,0,1000,800,200
11/20/2021 18:05,8993007000680,INDOMILK 1L,1,16500,0,16500,14792,1708
11/20/2021 18:16,8996001600269,LE MINERAL 600ML,1,3000,0,3000,1688,1312
11/20/2021 18:16,8992775001783,GERY SALUT MALKIST KELAPA,1,6500,0,6500,5516,984
11/20/2021 18:16,8998866201490,POTABEE REGULER GRILLED SEAWED 68 GR,1,8000,0,8000,7200,800
11/20/2021 18:16,8998866203104,MIE SEDAAP SINGAPORE,3,2500,0,7500,6798,702
11/20/2021 18:16,8999999710866,PEPSODENT 123 HERBAL 190G,1,18000,0,18000,17500,500
11/20/2021 18:16,8996001308059,Sari gandum sandwich,2,2000,0,4000,3400,600
11/20/2021 18:16,MK,MASKER,2,5000,0,10000,8000,2000
11/20/2021 18:16,8998989300261,GUDANG GARAM SURYA 12 FILTER,1,20000,0,20000,18150,1850
11/20/2021 18:16,8994834006128,TICTIC PEDAS,1,2000,0,2000,1700,300
11/20/2021 18:16,TAMARA,TAMARA,4,1000,0,4000,1680,2320
11/20/2021 18:16,JL,JELLY,4,500,0,2000,1600,400
11/20/2021 18:16,BALON GAS,BALON GAS,2,500,0,1000,800,200
11/20/2021 18:16,RT MENARA,ROTI TAWAR MENARA,1,8000,0,8000,7200,800
11/20/2021 18:26,lolipop,lolipop,2,1000,0,2000,1700,300
11/20/2021 18:26,711844110021,KECAP ABC 600 ML,2,22000,0,44000,41400,2600
11/20/2021 18:26,8998866200561,EKOMIE SUPER 600GR,1,10000,0,10000,8615,1385
11/20/2021 18:26,8992628020152,MINYAK GOREG BIMOLI POUCH 2L,1,35000,0,35000,29800,5200
11/20/2021 18:26,8995333060772,TERIGU GATOT KACA 500GR,1,5000,0,5000,4346,654
11/20/2021 18:26,RT MNTG,ROTI SISIR MENTEGA,2,2000,0,4000,3200,800
11/20/2021 18:26,8998866202244,EKOMIE BUMBU KALDU AYAM,3,1000,0,3000,2394,606
11/20/2021 18:26,8998866202619,MIE SEDAAP KOREAN SPICY SOUP,1,2700,0,2700,2322,378
11/20/2021 18:26,JL,JELLY,2,500,0,1000,800,200
11/20/2021 18:26,8998866201490,POTABEE REGULER GRILLED SEAWED 68 GR,1,8000,0,8000,7200,800
11/20/2021 18:32,Garuda pilus,Garuda Pilus Pedas Pcs,2,500,0,1000,816,184
11/20/2021 18:32,8997028590014,ARGUS 220ML,10,500,0,5000,3020,1980
11/20/2021 18:32,TAMARA,TAMARA,4,1000,0,4000,1680,2320
11/20/2021 18:55,8998866200301,MIE SEDAAP GORENG,1,3000,0,3000,2414,586
11/20/2021 18:55,089686043204,INDOMIE MIE ACEH,1,2700,0,2700,2452,248
11/20/2021 18:55,gula,GULA,1,11500,0,11500,10000,1500
11/20/2021 18:55,RT MNTG,ROTI SISIR MENTEGA,1,2000,0,2000,1600,400
11/20/2021 18:55,8999909085114,SAMPOERNA KRETEK HIJAU 12,1,13000,0,13000,11650,1350
11/20/2021 18:55,11222,LEM KOREA,1,10000,0,10000,8000,2000
11/20/2021 18:55,8997028590052,ARGUS BTL 600ML,1,3000,0,3000,1458,1542
11/20/2021 18:55,8991102987639,WFR TANGO LONG VNL 130G,1,5000,0,5000,4350,650
11/20/2021 18:55,089686386011,BUMBU RACIK NASI GORENG,1,2000,0,2000,1450,550
11/20/2021 18:55,8999999036836,LUX BW VELVET JASMINE LD REFF 450 ML,1,25000,0,25000,22110,2890
11/20/2021 18:55,8994834006128,TICTIC PEDAS,1,2000,0,2000,1700,300
11/20/2021 18:58,8992984920110,CUKA DAPUR DUA BELIBIS,1,4500,0,4500,3250,1250
11/20/2021 18:58,8999999502409,ROYCO FDS BEEF 9G,12,500,0,6000,4500,1500
11/20/2021 18:58,8999999059781,SUNLIGHT LIME NEW POUCH 210ML,1,5000,0,5000,4520,480
11/20/2021 19:01,8997018460150,MARLBORO ICE BURST 20,1,31000,0,31000,29650,1350
11/20/2021 19:02,8994191103638,GULA GULA KARET,8,500,0,4000,3200,800
11/20/2021 19:15,8995333060703,TERIGU KOMPAS 1KG,1,10500,0,10500,9816,684
11/20/2021 19:15,RB,RED BOLD,1,20000,0,20000,18800,1200
11/20/2021 19:15,8992775305164,GERY MALKIST GREEN TEA,1,6500,0,6500,5500,1000
11/20/2021 19:15,8992761145026,SPRITE PET 250ML,1,3500,0,3500,2417,1083
11/20/2021 19:15,8991102714846,MILKIDO CKLT,2,3000,0,6000,4306,1694
11/20/2021 19:15,8993154789575,GULA GULA TUSUK,2,500,0,1000,800,200
11/20/2021 19:15,ARG,ARGUS DOS 220ML,5,15000,0,75000,67500,7500
11/20/2021 19:15,76239878,MARLBORO GOLD,1,31000,0,31000,29650,1350
11/20/2021 19:15,8991102228053,TEH GELAS BOTOL,1,3000,0,3000,1695,1305
11/20/2021 19:15,8991102714907,Kopi Seruput Simanis Aren 200ml,1,3000,0,3000,2375,625
11/20/2021 19:15,8996001600375,LE MINERAL 330ML,1,2000,0,2000,1417,583
11/20/2021 19:15,TEMBAK,TEMBAK SNIPPER,1,3500,0,3500,2500,1000
11/20/2021 19:15,7622210437686,BISKUAT,2,500,0,1000,800,200
11/20/2021 19:32,gula gula,gula-gula karet,2,500,0,1000,800,200
11/20/2021 19:32,8994867006997,ROKOK PENA BOLD 20BTG,1,17000,0,17000,15000,2000
11/20/2021 19:32,8998866202626,Top Kopi Gula Aren 22gr,2,1000,0,2000,1106,894
11/20/2021 19:32,SF SOSIS,SAFFANAH ROTI SOSIS,1,6000,0,6000,5500,500
11/20/2021 19:32,8998866608046,KECAP MANIS SEDAAP POUCH 225ML,1,8500,0,8500,7744,756
11/20/2021 19:32,7622210437686,BISKUAT,4,500,0,2000,1600,400
11/20/2021 19:32,8999999530266,LIFEBUOY MATCHA GREENTEA 100ML,1,10500,0,10500,9405,1095
11/20/2021 19:32,8997028590014,ARGUS 220ML,2,500,0,1000,604,396
11/20/2021 19:32,RT MNTG,ROTI SISIR MENTEGA,1,2000,0,2000,1600,400
11/20/2021 19:32,8998989300261,GUDANG GARAM SURYA 12 FILTER,1,20000,0,20000,18150,1850
11/20/2021 19:32,8999999518998,RINSO MOLTO PERFUME ESSENSE 770GR,1,21300,0,21300,19338,1962
11/20/2021 19:32,8992628020152,MINYAK GOREG BIMOLI POUCH 2L,1,35000,0,35000,29800,5200
11/20/2021 19:32,8994907000428,KECAP SACHET ABC,20,600,0,12000,10000,2000
11/20/2021 19:40,8998866203227,MIE SEDAAP AYAM BAKAR LIMAU,1,2700,0,2700,2163,537
11/20/2021 19:40,8991102023115,Sikat Gigi Formula,1,11000,0,11000,10000,1000
11/20/2021 19:40,8997027300089,NOMOS,1,4000,0,4000,2963,1037
11/20/2021 19:40,8998989300261,GUDANG GARAM SURYA 12 FILTER,1,20000,0,20000,18150,1850
11/20/2021 19:40,7622300335809,OREO SOFT CAKE,1,2000,0,2000,1641,359
11/20/2021 19:40,8995555111221,sosis kimbo,1,1000,0,1000,850,150
11/20/2021 19:40,089686727081,DORITOS 55G,1,7000,0,7000,5950,1050
11/20/2021 19:40,8997028590014,ARGUS 220ML,4,500,0,2000,1208,792
11/20/2021 19:40,8991102384841,WFR TANGO LONG CKLT 130G,1,5000,0,5000,4345,655
11/20/2021 19:40,gula,GULA,1,11500,0,11500,10000,1500
11/20/2021 19:40,8996001305041,ROMA SANDWICH CKLT,1,7000,0,7000,5928,1072
11/20/2021 19:40,RT MNTG,ROTI SISIR MENTEGA,2,2000,0,4000,3200,800
11/20/2021 19:40,8992760223015,OREO CHOCOLATE CREAM 133G,1,8000,0,8000,6300,1700
11/20/2021 19:40,ROTI,ROTI 2000,1,2000,0,2000,1800,200
11/20/2021 19:40,8996001600399,LE MINERAL 1500ML,1,5000,0,5000,4042,958
11/20/2021 19:50,8992959117583,SOFTEX DAUN SIRIH,1,5000,0,5000,4288,712
11/20/2021 19:50,8996001320068,GULA GULA KOPIKO,4,250,0,1000,800,200
11/20/2021 19:50,8998866200325,MIE SEDAAP SOTO,1,2700,0,2700,2282,418
11/20/2021 19:50,8998866200301,MIE SEDAAP GORENG,2,3000,0,6000,4828,1172
11/20/2021 19:50,8999909096004,SAMPOERNA 16 FILTER,1,25000,0,25000,23100,1900
11/20/2021 19:50,ROTI,ROTI 2000,2,2000,0,4000,3600,400
11/20/2021 19:50,kri,kripik pisang,1,5000,0,5000,4000,1000
11/20/2021 19:50,8996001440520,ENERGEN JAGUNG,2,1500,0,3000,2300,700
11/20/2021 19:50,8994907001272,KECAP ABC 700 ML,1,22500,0,22500,21000,1500
11/20/2021 19:53,8995333032113,TERIGU GATOT KACA 1 KG,3,9000,0,27000,25716,1284
11/20/2021 20:05,gula,GULA,3,11500,0,34500,30000,4500
11/20/2021 20:05,089686021127,INTER MIE KALDU,2,1000,0,2000,1626,374
11/20/2021 20:05,8992770033178,Masako,6,500,0,3000,2700,300
11/20/2021 20:05,8995555111221,sosis kimbo,2,1000,0,2000,1700,300
11/20/2021 20:05,8998989300261,GUDANG GARAM SURYA 12 FILTER,1,20000,0,20000,18150,1850
11/20/2021 20:05,Telur 3 Biji,Telur 3 Biji,1,5000,0,5000,3600,1400
11/20/2021 20:05,8992775002735,CHOCOLATOS SUSU COKELAT,1,4000,0,4000,3520,480
11/20/2021 20:05,8991909101016,URBAN MILD 16,1,17000,0,17000,15800,1200
11/20/2021 20:05,8997878004327,GULA GULA MILKITA,10,250,0,2500,2000,500
11/20/2021 20:05,8998989110167,SURYA GUDANG GARAM 16 FILTER,1,26000,0,26000,23700,2300
11/20/2021 20:46,8998989110501,gudang garam surya,2,2000,0,4000,2760,1240
11/20/2021 20:46,8997028590014,ARGUS 220ML,2,500,0,1000,604,396
11/21/2021 18:31,8991102987639,WFR TANGO LONG VNL 130G,3,5000,0,15000,13050,1950
11/21/2021 18:31,8994834006128,TICTIC PEDAS,2,2000,0,4000,3400,600
11/21/2021 18:31,8997028590014,ARGUS 220ML,6,500,0,3000,1812,1188
11/21/2021 18:31,123124,KOREK BIASA,1,2000,0,2000,1300,700
11/21/2021 18:31,8992741952262,GULA GULA YUPI,2,250,0,500,400,100
11/21/2021 18:31,8999909004221,SAMPOERNA ULTRAMILD 16,1,22000,0,22000,20350,1650
11/21/2021 18:31,089686727074,DORITOS 160G,1,12000,0,12000,10700,1300
11/21/2021 18:31,8998866201490,POTABEE REGULER GRILLED SEAWED 68 GR,1,8000,0,8000,7200,800
11/21/2021 18:31,8996001600269,LE MINERAL 600ML,1,3000,0,3000,1688,1312
11/21/2021 18:31,8991914101513,VIPER KRETEK 12,1,6000,0,6000,5000,1000
11/21/2021 18:31,8994867000162,ROKOK PUNDIMAS KRETEK16,1,10000,0,10000,8600,1400
11/21/2021 18:31,6907992823966,JD BLUEBERRY,2,3500,0,7000,6000,1000
11/21/2021 18:31,8992730950194,GULA GULA KOIN,2,500,0,1000,800,200
11/21/2021 18:31,8998866200301,MIE SEDAAP GORENG,3,3000,0,9000,7242,1758
11/21/2021 18:31,8993154789575,GULA GULA TUSUK,1,500,0,500,400,100
11/21/2021 18:31,BALON GAS,BALON GAS,1,500,0,500,400,100
11/21/2021 18:39,8992770061034,SAJIKU,1,2000,0,2000,1500,500
11/21/2021 18:39,MBL,MOBIL,1,5000,0,5000,3500,1500
11/21/2021 18:39,PULPEN,PULPEN BIASA,3,2000,0,6000,4500,1500
11/21/2021 18:39,8991002303928,GULA GULA RELAXA,4,250,0,1000,800,200
11/21/2021 18:39,8994834006128,TICTIC PEDAS,1,2000,0,2000,1700,300
11/21/2021 18:39,8997226852006,TEH CAP KAMPUNG MANIS,1,12000,0,12000,10000,2000
11/21/2021 18:39,8997028590014,ARGUS 220ML,2,500,0,1000,604,396
11/21/2021 18:39,8991001503336,chacha minis hat,1,7500,0,7500,6400,1100
11/21/2021 18:39,8992959508893,SWEETY SILVER PANTS S9,1,14500,0,14500,13107,1393
11/21/2021 18:39,Telur 3 Biji,Telur 3 Biji,1,5000,0,5000,3600,1400
11/21/2021 18:40,JELLY,JELLY AGAR,1,1000,0,1000,900,100
11/21/2021 18:43,JELLY,JELLY AGAR,2,1000,0,2000,1800,200
11/21/2021 18:43,8997009510123,ORANGE WATER,1,8000,0,8000,6265,1735
11/21/2021 18:43,8997028590014,ARGUS 220ML,2,500,0,1000,604,396
11/21/2021 18:43,089686021219,INTER MIE GORENG,1,1000,0,1000,885,115
11/21/2021 18:43,KRIPIK,KRIPIK KENTANG,1,1000,0,1000,900,100
11/21/2021 18:43,Garuda pilus pcs,Garuda pilus Rasa Mi Goreng pcs,1,1000,0,1000,808,192
11/21/2021 18:53,JELLY,JELLY AGAR,2,1000,0,2000,1800,200
11/21/2021 18:53,8997009461753,TOP ELIT,2,1000,0,2000,800,1200
11/21/2021 18:53,8999909002821,MARLBORO BLACK 16,1,22000,0,22000,20900,1100
11/21/2021 18:53,KRIPIK,KRIPIK KENTANG,1,1000,0,1000,900,100
11/21/2021 18:53,8992775001806 pcs,Gery salut malkist chocolate coconut pcs,1,1000,0,1000,812,188
11/21/2021 18:53,8992979130012,TOTAL LEMON SOFTENER,1,15000,0,15000,13800,1200
11/21/2021 18:53,4987176052780,PARFUM DOWNY 10 ML,2,500,0,1000,750,250
11/21/2021 18:53,8992761111519,COCA COLA SLIM CAM 250ML,1,5000,0,5000,3750,1250
11/21/2021 18:53,8993989311279,CLAS MILD 12,1,18000,0,18000,15800,2200
11/21/2021 18:53,8997028590014,ARGUS 220ML,4,500,0,2000,1208,792
11/21/2021 18:53,8991102103091,Formula Proteksi,1,3500,0,3500,2650,850
11/21/2021 18:53,8999999034733,PONDS MEN WHITE BOOST 100G,1,29500,0,29500,26620,2880
11/21/2021 18:53,ROTI,ROTI 2000,1,2000,0,2000,1800,200
11/21/2021 18:53,8992761111533,SPRITE SLIM CAM250ML,1,5000,0,5000,3750,1250
11/21/2021 18:53,8998989110167,SURYA GUDANG GARAM 16 FILTER,1,26000,0,26000,23700,2300
11/21/2021 18:53,8991102228053,TEH GELAS BOTOL,1,3000,0,3000,1695,1305
11/21/2021 18:58,ARG,ARGUS DOS 220ML,1,15000,0,15000,13500,1500
11/21/2021 18:58,8992761111533,SPRITE SLIM CAM250ML,1,5000,0,5000,3750,1250
11/21/2021 18:58,8998009040023,TEH KOTAK,1,5000,0,5000,2708,2292
11/21/2021 18:58,8992628020152,MINYAK GOREG BIMOLI POUCH 2L,2,35000,0,70000,59600,10400
11/21/2021 18:58,9556001004673,MILO NESTLE MALAYSIA ACTIVE GO,1,85000,0,85000,80000,5000
11/21/2021 18:58,8997028590014,ARGUS 220ML,4,500,0,2000,1208,792
11/21/2021 19:03,8992775002582,DILAN CHOCO,1,2000,0,2000,1503,497
11/21/2021 19:03,8997218010230,yohoo,1,1000,0,1000,900,100
11/21/2021 19:07,8991001780232,twister choco 80g,1,8000,0,8000,6700,1300
11/21/2021 19:07,8993154789575,GULA GULA TUSUK,1,500,0,500,400,100
11/21/2021 19:08,8993154789575,GULA GULA TUSUK,2,500,0,1000,800,200
11/21/2021 19:26,8991102381024,FULLO VNL PCK,1,10000,0,10000,9000,1000
11/21/2021 19:26,8998989110167,SURYA GUDANG GARAM 16 FILTER,1,26000,0,26000,23700,2300
11/21/2021 19:26,123124,KOREK BIASA,1,2000,0,2000,1300,700
11/21/2021 19:26,ARG,ARGUS DOS 220ML,5,15000,0,75000,67500,7500
11/21/2021 19:26,kri,kripik pisang,1,5000,0,5000,4000,1000
11/21/2021 19:26,8998866202954,Guribee BBQ Balado 68 gr,1,6000,0,6000,5100,900
11/21/2021 19:26,8999999524722,SUNLIGHT LIME NEW PCH 435ML,1,10000,0,10000,9100,900
11/21/2021 19:26,BALON,BALON CABUT,3,1000,0,3000,2700,300
11/21/2021 19:26,8997878004327,GULA GULA MILKITA,4,250,0,1000,800,200
11/21/2021 19:26,SF GULUNG,SAFFANAH ROTI GULUNG,1,6000,0,6000,5500,500
11/21/2021 19:26,VTM,VITAMIN CIMIN,2,500,0,1000,850,150
11/21/2021 19:26,SF TAWAR KUPAS,SAFFANAH ROTI TAWAR KUPAS,1,10000,0,10000,9000,1000
11/21/2021 19:26,TBR,TEPUNG BERAS ROSE BRAND,1,8000,0,8000,6150,1850
11/21/2021 19:43,8998989300261,GUDANG GARAM SURYA 12 FILTER,1,20000,0,20000,18150,1850
11/21/2021 19:43,Pulpen,pulpen,1,1000,0,1000,750,250
11/21/2021 19:43,VTM,VITAMIN CIMIN,6,500,0,3000,2550,450
11/21/2021 19:43,8996001328163,GULA GULA TAMARIN,4,250,0,1000,800,200
11/21/2021 19:43,8991909101016,URBAN MILD 16,1,17000,0,17000,15800,1200
11/21/2021 19:43,123124,KOREK BIASA,1,2000,0,2000,1300,700
11/21/2021 19:43,8992628020152,MINYAK GOREG BIMOLI POUCH 2L,1,35000,0,35000,29800,5200
11/21/2021 19:43,8999999518998,RINSO MOLTO PERFUME ESSENSE 770GR,1,21300,0,21300,19338,1962
11/21/2021 19:43,ROTI,ROTI 2000,4,2000,0,8000,7200,800
11/21/2021 19:43,8998866202244,EKOMIE BUMBU KALDU AYAM,1,1000,0,1000,798,202
11/21/2021 19:43,MBL,MOBIL,1,5000,0,5000,3500,1500
11/21/2021 19:43,TEMBAK,TEMBAK SNIPPER,1,3500,0,3500,2500,1000
11/21/2021 19:43,8997878004327,GULA GULA MILKITA,10,250,0,2500,2000,500
11/21/2021 20:05,SF TAWAR KUPAS,SAFFANAH ROTI TAWAR KUPAS,1,10000,0,10000,9000,1000
11/21/2021 20:05,8999909002821,MARLBORO BLACK 16,1,22000,0,22000,20900,1100
11/21/2021 20:05,ABC,BATERAI ABC BIRU,2,3000,0,6000,3856,2144
11/21/2021 20:05,8997028590014,ARGUS 220ML,2,500,0,1000,604,396
11/21/2021 20:05,8997009462040,TIARA,2,1000,0,2000,850,1150
11/21/2021 20:05,Vita Jelly,Vita Jelly,2,1000,0,2000,1532,468
11/21/2021 20:05,MARS,MARSHMELLOW,4,500,0,2000,1732,268
11/21/2021 20:05,MK,MASKER,1,5000,0,5000,4000,1000
11/21/2021 20:05,8992705025124,AGAR-AGAR SATELIT MERAH,1,3500,0,3500,2604,896
11/21/2021 20:05,8992933241112,NUTRIJELL COKLAT,1,7000,0,7000,6416,584
11/21/2021 20:05,8991111101255,JB SHAMPOO GOLD 50ML,1,5000,0,5000,4500,500
11/21/2021 20:05,ICE CREAM 5.000,ICE CREAM 5.000,1,5000,0,5000,4700,300
11/21/2021 20:05,4902430563888,SHAMPO PANTENE,2,1000,0,2000,1500,500
11/21/2021 20:05,8992775311547,Chocolatos,3,2000,0,6000,4500,1500
11/21/2021 20:05,RT BAKPIA,ROTI BAKPIA,2,1000,0,2000,1500,500
11/21/2021 20:14,8993274532105,BOLU,7,1000,0,7000,5831,1169
11/21/2021 20:14,8998989300261,GUDANG GARAM SURYA 12 FILTER,1,20000,0,20000,18150,1850
11/21/2021 20:14,8992759120264,LARISST 220,1,10000,0,10000,9200,800
11/21/2021 20:14,8991909101016,URBAN MILD 16,1,17000,0,17000,15800,1200
11/21/2021 20:14,VTM,VITAMIN CIMIN,3,500,0,1500,1275,225
11/21/2021 20:14,8998866200301,MIE SEDAAP GORENG,1,3000,0,3000,2414,586
11/21/2021 20:14,MILKITA,MILKITA,2,250,0,500,400,100
11/21/2021 20:14,8991914101513,VIPER KRETEK 12,2,6000,0,12000,10000,2000
11/21/2021 20:14,8991102714679,TANGO TETRA STRAW,1,5000,0,5000,4545,455
11/21/2021 20:14,8992696404441,SUSU BURUANG,1,13000,0,13000,8585,4415
11/21/2021 20:14,8991102300544,WFR TANGO VNL 176G,2,10000,0,20000,17388,2612
11/21/2021 20:14,8996001305041,ROMA SANDWICH CKLT,1,7000,0,7000,5928,1072
11/21/2021 20:14,8997028590014,ARGUS 220ML,6,500,0,3000,1812,1188
11/21/2021 20:14,8991102987875,WFR TANGO POUCH CKL 115G,1,8000,0,8000,6786,1214
11/21/2021 20:23,8991001503336,chacha minis hat,2,7500,0,15000,12800,2200
11/21/2021 20:23,8992775211434,PILUS GARUDA SAPI PANGGANG,1,5000,0,5000,4810,190
11/21/2021 20:23,8998666002525,TB TORA CAFE CAPPUCINO,1,1000,0,1000,780,220
11/21/2021 20:23,8997028590014,ARGUS 220ML,2,500,0,1000,604,396
11/21/2021 20:23,8998866202671,NOODLE SEDAAP MIE KOREAN SPICY SOUP CUP,1,5000,0,5000,4002,998
11/21/2021 20:23,8991102281416,PERMEN MINTZ PPMINT,1,5000,0,5000,4000,1000
11/21/2021 20:23,8991102213189,BLASTER UNGU,1,5000,0,5000,3106,1894
11/21/2021 20:23,6907992825076,JD WATERMELON APPLE,1,2000,0,2000,1700,300
11/21/2021 20:23,MK,MASKER,1,5000,0,5000,4000,1000
11/21/2021 20:23,8991102228053,TEH GELAS BOTOL,1,3000,0,3000,1695,1305
11/21/2021 20:23,ROTI,ROTI 2000,1,2000,0,2000,1800,200
11/21/2021 20:23,7622201430184,OREO ORIGINAL 38G,1,2000,0,2000,1641,359
11/21/2021 20:23,8997009462040,TIARA,1,1000,0,1000,425,575
11/21/2021 20:23,6907992823959,JD HAWTHORN BERRY,1,2000,0,2000,1700,300
11/21/2021 20:23,8998989500166,GUDANG GARAM MERAH BESAR 16KS,2,18000,0,36000,34000,2000
11/21/2021 20:26,8998989300261,GUDANG GARAM SURYA 12 FILTER,1,20000,0,20000,18150,1850
11/21/2021 20:26,8999909001909,MAGNUM REVAMP BLACK 12,1,18000,0,18000,16300,1700
11/21/2021 20:26,8992730950194,GULA GULA KOIN,10,500,0,5000,4000,1000
11/21/2021 20:26,7622300335809,OREO SOFT CAKE,1,2000,0,2000,1641,359
11/21/2021 20:26,8998866608305,GIV BENGKOANG KOTAK 76G,1,2000,0,2000,1820,180
11/21/2021 20:26,RT 1000,ROTI 1000,1,1000,0,1000,800,200
11/21/2021 20:30,8997028590014,ARGUS 220ML,6,500,0,3000,1812,1188
11/21/2021 20:30,8995555111221,sosis kimbo,1,1000,0,1000,850,150
11/21/2021 20:31,8995555111221,sosis kimbo,5,1000,0,5000,4250,750
11/21/2021 20:43,Telur 3 Biji,Telur 3 Biji,1,5000,0,5000,3600,1400
11/21/2021 20:43,8997028380165,BISKUIT,1,10000,0,10000,9000,1000
11/21/2021 20:43,8996001600399,LE MINERAL 1500ML,1,5000,0,5000,4042,958
11/21/2021 20:43,8992694242618,ZWITSAL BB PWD CLSC 100GR,1,7800,0,7800,6930,870
11/21/2021 20:43,8999908284907,MY BABY MINYAK TELON 90ML,1,25000,0,25000,22700,2300
11/21/2021 20:43,gula,GULA,1,11500,0,11500,10000,1500
11/21/2021 20:43,8992761111519,COCA COLA SLIM CAM 250ML,1,5000,0,5000,3750,1250
11/21/2021 20:43,ARG,ARGUS DOS 220ML,4,15000,0,60000,54000,6000
11/21/2021 20:43,8992761111533,SPRITE SLIM CAM250ML,1,5000,0,5000,3750,1250
11/21/2021 20:43,8993274532105,BOLU,1,1000,0,1000,833,167
11/21/2021 20:43,8992959953082,SWEETY BRONZE L8,1,17000,0,17000,15380,1620
11/21/2021 20:43,8992717900310,KARA SUN,3,2500,0,7500,6000,1500
11/21/2021 20:43,8998866200301,MIE SEDAAP GORENG,3,3000,0,9000,7242,1758
11/21/2021 20:43,8998866200820,NOODLE SEDAAP MIE AYAM BAWANG TLR CUP 77 GR,1,4500,0,4500,3650,850
11/21/2021 20:43,8994867007161,ROKOK PENA GOLD 20,1,19000,0,19000,17400,1600
11/21/2021 20:50,8991909101016,URBAN MILD 16,1,17000,0,17000,15800,1200
11/21/2021 20:50,123124,KOREK BIASA,1,2000,0,2000,1300,700
11/21/2021 20:50,VTM,VITAMIN CIMIN,1,500,0,500,425,75
11/21/2021 20:50,gula,GULA,2,11500,0,23000,20000,3000
11/21/2021 20:50,BOLU,BOLU KARAMEL,1,10000,0,10000,9000,1000
11/21/2021 20:50,BALON GAS,BALON GAS,2,500,0,1000,800,200
11/21/2021 20:50,8992730950194,GULA GULA KOIN,1,500,0,500,400,100
11/21/2021 20:50,6907992825076,JD WATERMELON APPLE,1,2000,0,2000,1700,300
11/21/2021 20:50,8998866200561,EKOMIE SUPER 600GR,3,10000,0,30000,25845,4155
11/21/2021 20:50,SKT,SIKAT CUCI,1,6000,0,6000,5000,1000
11/21/2021 20:50,8997013180107,Tissu Roll,1,12500,0,12500,11000,1500
11/21/2021 20:50,8991001780140,TWISTER CHOCO,1,5000,0,5000,4600,400
11/21/2021 20:50,8997878004327,GULA GULA MILKITA,4,250,0,1000,800,200
11/21/2021 20:50,8992730996185,GULA GULA CRISPY,1,2000,0,2000,1500,500
11/21/2021 20:50,ROTI,ROTI 2000,1,2000,0,2000,1800,200
11/21/2021 20:53,8992696404441,SUSU BURUANG,1,13000,0,13000,8585,4415
11/21/2021 20:53,8999999059781,SUNLIGHT LIME NEW POUCH 210ML,1,5000,0,5000,4520,480
11/21/2021 20:53,8992959117583,SOFTEX DAUN SIRIH,1,5000,0,5000,4288,712
11/21/2021 20:53,8998866200301,MIE SEDAAP GORENG,3,3000,0,9000,7242,1758
11/21/2021 20:53,089686043204,INDOMIE MIE ACEH,1,2700,0,2700,2452,248
11/21/2021 20:54,8991102281416,PERMEN MINTZ PPMINT,1,5000,0,5000,4000,1000
11/21/2021 21:02,8997009461753,TOP ELIT,5,1000,0,5000,2000,3000
11/21/2021 21:02,6907992823867,JD CRUNCHY CHOCOLATE MALT,4,5500,0,22000,18800,3200
11/21/2021 21:02,8999999059781,SUNLIGHT LIME NEW POUCH 210ML,1,5000,0,5000,4520,480
11/21/2021 21:02,8992725910424,LISTERINE FRESH BURST 250ML,1,19000,0,19000,17550,1450
11/21/2021 21:02,8992775315057,GERY SALUT MALKIST COKLAT,1,6500,0,6500,5516,984
11/21/2021 21:02,8999909096004,SAMPOERNA 16 FILTER,1,25000,0,25000,23100,1900
11/21/2021 21:02,ARG,ARGUS DOS 220ML,1,15000,0,15000,13500,1500
11/21/2021 21:02,8991102002400,SABUN PRIMA PROTECT,1,17000,0,17000,15600,1400
11/21/2021 21:02,8999999555450,VIXAL PEMB PORS BIRU 190ML,1,5000,0,5000,4200,800
11/21/2021 21:02,8998866200301,MIE SEDAAP GORENG,1,3000,0,3000,2414,586
11/21/2021 21:02,8998866202770,MIE SEDAAP SALERO PADANG,1,2500,0,2500,2362,138
11/21/2021 21:02,ROTI,ROTI 2000,1,2000,0,2000,1800,200
11/21/2021 21:02,8993335521260,Sabun Total Violet 900gr,1,15000,0,15000,13800,1200
11/21/2021 21:09,8991002105409,KOPI KAPAL API,1,20000,0,20000,18888,1112
11/21/2021 21:09,8998866600521,SOKLIN FLOORCLENER KUNING 400ML,1,6000,0,6000,5025,975
11/21/2021 21:09,8999909000971,MAGNUM MILD 20,1,24000,0,24000,22750,1250
11/21/2021 21:09,ARG,ARGUS DOS 220ML,1,15000,0,15000,13500,1500
11/21/2021 21:09,7622210462534,OREO MINI STRAW,2,7500,0,15000,13000,2000
11/21/2021 21:09,8991102380805,FULLO  CKL PCK 8G,1,11000,0,11000,9900,1100
11/21/2021 21:09,8996001355008,BENG-BENG SP20G,1,29000,0,29000,20000,9000
11/21/2021 21:09,BALON GAS,BALON GAS,6,500,0,3000,2400,600
11/21/2021 21:09,8997028590014,ARGUS 220ML,1,500,0,500,302,198
11/21/2021 21:09,8991102384841,WFR TANGO LONG CKLT 130G,1,5000,0,5000,4345,655
11/21/2021 21:09,TAMARA,TAMARA,6,1000,0,6000,2520,3480
11/21/2021 21:09,8992959953020,SWEETY BRONZE M1,1,3000,0,3000,2671,329
11/21/2021 21:09,8992959508893,SWEETY SILVER PANTS S9,1,14500,0,14500,13107,1393
11/21/2021 21:14,MRC,MERICA LADA,5,1000,0,5000,4445,555
11/21/2021 21:14,8999801700030,SUSU FOYU,1,11500,0,11500,10450,1050
11/21/2021 21:14,BALON GAS,BALON GAS,2,500,0,1000,800,200
11/21/2021 21:14,8993226112508,GARAM REFINA,2,3000,0,6000,4922,1078
11/21/2021 21:14,089686021127,INTER MIE KALDU,6,1000,0,6000,4878,1122
11/21/2021 21:14,8998866202619,MIE SEDAAP KOREAN SPICY SOUP,2,2700,0,5400,4644,756
11/21/2021 21:14,8998866200882,SUKSESMIE GORENG AYAM KRMS 133GR,1,3500,0,3500,3047,453
11/21/2021 22:04,8998989110167,SURYA GUDANG GARAM 16 FILTER,2,26000,0,52000,47400,4600
11/21/2021 22:13,TEPUN KANJI,TEPUN KANJI 1 LT,1,11000,0,11000,10000,1000
11/21/2021 22:13,TEPUN,TEPUN KANJI,1,5500,0,5500,4400,1100
11/21/2021 22:20,gula,GULA,1,11500,0,11500,10000,1500
11/21/2021 22:20,8999908284907,MY BABY MINYAK TELON 90ML,1,25000,0,25000,22700,2300
11/21/2021 22:20,8998866611206,FRES&NATURAL BLACK 100ML,1,11500,0,11500,10310,1190
11/21/2021 22:20,8999999554897,DOVE SHP DANDRUFF CARE 9ML,1,11000,0,11000,9300,1700
11/21/2021 22:20,8997013180046,Tissu Tessi B,1,11000,0,11000,9800,1200
11/21/2021 22:20,8991102714846,MILKIDO CKLT,1,3000,0,3000,2153,847
11/21/2021 22:20,8998866601535,BLEACHING SOKLIN PEMUTIH 500ML,1,7000,0,7000,4880,2120
11/21/2021 22:30,MAINAN,MAINAN BALING BALING,1,2000,0,2000,1500,500
11/21/2021 22:30,8992716109172,BISKUAT BOLU SCT,1,2000,0,2000,1641,359
11/21/2021 22:30,8999999036546,LUX BW WHITE VELVET 250ML,1,20000,0,20000,17900,2100
11/21/2021 22:30,8991111101255,JB SHAMPOO GOLD 50ML,1,5000,0,5000,4500,500
11/21/2021 22:30,089686021127,INTER MIE KALDU,4,1000,0,4000,3252,748
11/21/2021 22:30,8991188943062,SASA 250G,1,10000,0,10000,8500,1500
11/21/2021 22:33,089686021127,INTER MIE KALDU,4,1000,0,4000,3252,748
11/21/2021 22:34,ICE CREAM 5,ICE CREAM 5000,2,5000,0,10000,8800,1200
11/21/2021 22:35,8994191103638,GULA GULA KARET,1,500,0,500,400,100
11/21/2021 22:37,8991102714846,MILKIDO CKLT,1,3000,0,3000,2153,847
11/21/2021 22:37,8998866606158,NUVO ACTIVE COOL 110G,2,3000,0,6000,5200,800
11/21/2021 22:41,MAINAN,MAINAN BALING BALING,2,2000,0,4000,3000,1000
11/21/2021 22:41,8992702000063,INDOMILK COKLAT 370G,1,10000,0,10000,9208,792
11/21/2021 22:41,8999999195649,SARIWANGI 25X1.86G,1,6000,0,6000,5202,798
11/21/2021 22:48,8992959117583,SOFTEX DAUN SIRIH,2,5000,0,10000,8576,1424
11/21/2021 22:48,8991102714846,MILKIDO CKLT,1,3000,0,3000,2153,847
11/21/2021 22:48,4902430557122,KONSENTRAT DOWNY,5,1000,0,5000,3750,1250
11/21/2021 22:48,MRC,MERICA LADA,5,1000,0,5000,4445,555
11/21/2021 22:49,8991102002400,SABUN PRIMA PROTECT,1,17000,0,17000,15600,1400
11/21/2021 22:49,8886008101091,"AQUA 1,5 ML",1,5500,0,5500,4600,900
11/21/2021 22:50,8998866201728,POTABEE SELECTION SALTED EGG 68G,1,8000,0,8000,7200,800
11/21/2021 22:52,TEPUN KANJI,TEPUN KANJI 1 LT,2,11000,0,22000,20000,2000
11/21/2021 22:52,8993379254469,SABUN LERVIA 90G,1,5000,0,5000,3077,1923
11/21/2021 22:52,8999999538453,SUNSILK SHP SOFT AND  SMOOTH 55 ML,1,5000,0,5000,3750,1250
11/21/2021 22:55,8992959953112,SWEETY BRONZE S20,1,30000,0,30000,26540,3460
11/21/2021 23:00,8999999036546,LUX BW WHITE VELVET 250ML,1,20000,0,20000,17900,2100
11/21/2021 23:00,8999999195649,SARIWANGI 25X1.86G,1,6000,0,6000,5202,798
11/21/2021 23:00,8991102987639,WFR TANGO LONG VNL 130G,1,5000,0,5000,4350,650
11/21/2021 23:00,RT CD,ROTI COKLAT DURIAN,1,8000,0,8000,7200,800
11/21/2021 23:00,8992702000063,INDOMILK COKLAT 370G,1,10000,0,10000,9208,792
11/21/2021 23:00,Telur,Telur,10,2000,0,20000,0,20000
11/23/2021 20:25,8993007000062,INDOMILK CHOCOLATE 190ML,1,5000,0,5000,3475,1525
11/23/2021 20:40,6907992825076,JD WATERMELON APPLE,9,2000,0,18000,15300,2700
11/23/2021 20:52,ARG,ARGUS DOS 220ML,1,15000,0,15000,13500,1500
11/23/2021 21:10,8991188943062,SASA 250G,2,10000,0,20000,17000,3000
11/23/2021 21:16,MATERAI,MATERAI,3,15000,0,45000,30000,15000
11/23/2021 21:27,8994867000179,ROKOK PENA MILD 16,1,15500,0,15500,14500,1000
11/23/2021 21:42,8992696422650,NESCAFE FRENCH VANILLA,1,5000,0,5000,4099,901
11/23/2021 21:42,8997218010230,yohoo,2,1000,0,2000,1800,200
11/23/2021 21:47,8997218010230,yohoo,1,1000,0,1000,900,100
11/23/2021 22:09,8997028590045,ARGUS BTL 330ML,1,2000,0,2000,1291,709
11/25/2021 18:58,8992770033178,Masako,6,500,0,3000,2700,300
11/25/2021 18:58,8995555111221,sosis kimbo,2,1000,0,2000,1700,300
11/25/2021 19:02,8995150101719,M+SUSU RASA SODA GEMBIRA,1,5000,0,5000,4000,1000
11/25/2021 19:02,gula,GULA,1,11500,0,11500,10000,1500
11/25/2021 19:02,8998989300261,GUDANG GARAM SURYA 12 FILTER,1,20000,0,20000,18150,1850
11/25/2021 19:02,Telur 3 Biji,Telur 3 Biji,1,5000,0,5000,3600,1400
11/25/2021 19:02,8992775002155,CHOCOLATOS DRINK,1,4000,0,4000,3520,480
11/25/2021 19:04,SFX,SOFTEX DAUN SIRIH 1,4,500,0,2000,1652,348
11/25/2021 19:04,8998989300261,GUDANG GARAM SURYA 12 FILTER,1,20000,0,20000,18150,1850
11/25/2021 19:10,gula,GULA,4,11500,0,46000,40000,6000
11/25/2021 19:25,8995333032113,TERIGU GATOT KACA 1 KG,4,9000,0,36000,34288,1712
11/25/2021 19:25,gula,GULA,1,11500,0,11500,10000,1500
11/25/2021 20:13,8993989311699,CLAS MILD 16 FILTER,1,24000,0,24000,21700,2300
11/25/2021 21:40,8886013213208,FRENCH FREIS 2000,1,5000,0,5000,3750,1250
11/25/2021 21:40,8996001355756,BENG-BENG MAXX SCT,1,2500,0,2500,2041,459
11/25/2021 21:40,7622300405588,KEJUCAKE 16G,1,2000,0,2000,1641,359
11/25/2021 21:40,8996001312445,MALKIST CAPPUCINO,1,6500,0,6500,5400,1100
11/25/2021 21:40,8997028590014,ARGUS 220ML,4,500,0,2000,1208,792
11/25/2021 21:40,8992775305003 pcs,Gery Salut Coklat pcs,1,1000,0,1000,812,188
11/25/2021 21:41,8997218010230,yohoo,3,1000,0,3000,2700,300
11/25/2021 21:50,8996001401200,GENTLEGEN,2,18000,0,36000,32000,4000
11/25/2021 21:56,8999999195656,SARIWANGI 50X1.85,1,10000,0,10000,9405,595
11/25/2021 21:58,8995139620736,MI GORENG SEJATI,1,2000,0,2000,1700,300
11/25/2021 22:00,AMPLOP,AMPLOP,2,250,0,500,350,150
11/25/2021 22:03,VTM,VITAMIN CIMIN,10,500,0,5000,4250,750
11/25/2021 22:03,8996001600375,LE MINERAL 330ML,4,2000,0,8000,5668,2332
11/25/2021 22:03,ROTI,ROTI 2000,1,2000,0,2000,1800,200
11/25/2021 22:03,MK,MASKER,1,5000,0,5000,4000,1000
11/25/2021 22:03,8992775002582,DILAN CHOCO,1,2000,0,2000,1503,497
11/25/2021 22:03,8997218010230,yohoo,1,1000,0,1000,900,100
11/25/2021 22:03,8993379210854,SABUN HARMONY APPLE 70G,1,2000,0,2000,1652,348
11/25/2021 22:03,8998866109130,SHAMPOOZINC,2,1000,0,2000,600,1400
11/25/2021 22:06,8992717900310,KARA SUN,3,2500,0,7500,6000,1500
11/25/2021 22:08,089686611878,QTELA TEMPE,1,6000,0,6000,5370,630
11/25/2021 22:08,8991914101513,VIPER KRETEK 12,2,6000,0,12000,10000,2000
11/25/2021 22:08,8996001600375,LE MINERAL 330ML,19,2000,0,38000,26923,11077
11/25/2021 22:09,8998989110167,SURYA GUDANG GARAM 16 FILTER,1,26000,0,26000,23700,2300
11/26/2021 21:03,8992628034159,BIMOLI 1 LT,1,21000,0,21000,19000,2000
11/26/2021 21:03,ARG,ARGUS DOS 220ML,5,15000,0,75000,67500,7500
11/26/2021 21:03,8991914101513,VIPER KRETEK 12,2,6000,0,12000,10000,2000
11/26/2021 21:27,8991188943062,SASA 250G,2,10000,0,20000,17000,3000
11/26/2021 22:18,089686010824,INDOMIE GORENG SPESIAL,2,2700,0,5400,4904,496
11/26/2021 22:44,8998866200325,MIE SEDAAP SOTO,2,2700,0,5400,4564,836
11/27/2021 20:43,8992979190986,TOTAL PUTIH SOFTENER,1,15000,0,15000,13524,1476
11/27/2021 20:43,8999999707859,CLOSEUP GREEN 160G,1,15000,0,15000,13600,1400
11/27/2021 20:43,8999999533731,CITRA TS NATURE WHITE 70G,2,2200,0,4400,3800,600
11/27/2021 20:43,8992761111540,FANTA STRAWBERY SLIM CAM 250ML,1,5000,0,5000,3750,1250
11/27/2021 20:47,8999909002821,MARLBORO BLACK 16,1,22000,0,22000,20900,1100
11/27/2021 20:47,8998989300261,GUDANG GARAM SURYA 12 FILTER,1,20000,0,20000,18150,1850
11/27/2021 21:05,8998866200325,MIE SEDAAP SOTO,2,2700,0,5400,4564,836
11/27/2021 21:35,8998866107457,POSH SUMMER LOVE 150ML,2,19500,0,39000,35000,4000
11/27/2021 21:37,1212060005003,IMPLORA,1,20000,0,20000,1900,18100
11/27/2021 21:44,9556006060667,JB BEDTIME 400ML (REFILL),1,24500,0,24500,23390,1110
11/27/2021 21:44,8997021870908,HOT IN CREAM STRONG 60G,1,12500,0,12500,11390,1110
11/27/2021 22:03,8993335529419,Sabun Total de Parfumee Floral Vibes,1,24500,0,24500,22000,2500
11/27/2021 22:53,Telur 7 Biji,Telur 7 Biji,1,10000,0,10000,8400,1600
11/27/2021 22:53,089686011036,INDOMIE GORENG PEDAS,4,2700,0,10800,9808,992
11/27/2021 22:53,8997009510055,YOU C1000,1,15000,0,15000,13000,2000
11/28/2021 20:26,8992761002039,FANTA STRAWBERRY PET 390 ML,1,5500,0,5500,4333,1167
11/28/2021 20:26,8996001600375,LE MINERAL 330ML,1,2000,0,2000,1417,583
11/28/2021 21:03,8991914101513,VIPER KRETEK 12,1,6000,0,6000,5000,1000
11/28/2021 21:31,6907992824963,JD MILKY CHOCOLATE,1,3000,0,3000,2600,400
11/28/2021 21:32,8998989110167,SURYA GUDANG GARAM 16 FILTER,1,26000,0,26000,23700,2300
11/28/2021 21:32,8998989100120,GUDANG GARAM MINI,1,19000,0,19000,16600,2400
11/28/2021 22:01,ARG,ARGUS DOS 220ML,1,15000,0,15000,13500,1500
11/28/2021 22:17,8997028590045,ARGUS BTL 330ML,1,2000,0,2000,1291,709
12/3/2021 10:21,8999909004221,SAMPOERNA ULTRAMILD 16,1,22000,0,22000,20350,1650
12/3/2021 10:49,8997028590014,ARGUS 220ML,4,500,0,2000,1208,792
12/3/2021 11:05,8992628022156,MINYAK GORENG BIMOLI POUCH 1 LT,1,17500,0,17500,16675,825
12/3/2021 11:05,8995333000822,TERIGU KOMPAS SOFT 500GR,1,5500,0,5500,4967,533
12/3/2021 11:05,8998989300261,GUDANG GARAM SURYA 12 FILTER,1,20000,0,20000,18150,1850
12/3/2021 11:27,8993176110074,MINYAK KAYU PUTIH 60ML,1,20000,0,20000,17333,2667
12/3/2021 11:35,8997034170194,ZIGGY 16,5,14000,0,70000,63000,7000
12/3/2021 11:35,8997079804221,FORZA 12,2,11000,0,22000,20000,2000
12/3/2021 11:35,8998898829129,KKB ENER-G JERUK,2,5500,0,11000,9648,1352
12/3/2021 11:35,8991102281430,PERMEN MINTZ DUOMINT,1,5000,0,5000,4000,1000
12/3/2021 11:35,8991001780065,TWISTER BLACK 140G,1,13000,0,13000,11700,1300
12/3/2021 11:35,8991001770301,SELAMAT CLACK VANILA,1,13000,0,13000,11800,1200
12/3/2021 11:37,8993989311279,CLAS MILD 12,1,18000,0,18000,15800,2200
12/3/2021 12:49,8999909004221,SAMPOERNA ULTRAMILD 16,1,22000,0,22000,20350,1650
12/3/2021 12:58,6907992825069,JD FRUITY,1,5000,0,5000,4400,600
12/3/2021 14:25,8997028590052,ARGUS BTL 600ML,1,3000,0,3000,1458,1542
12/3/2021 15:25,8886020033431,KAPUR AJAIB ANTI KECOA DAN NYAMUK,1,3000,0,3000,2700,300
12/3/2021 16:24,ROTI,ROTI 2000,1,2000,0,2000,1800,200
12/3/2021 17:23,7622300405588,KEJUCAKE 16G,1,2000,0,2000,1641,359
12/3/2021 17:23,7622300335809,OREO SOFT CAKE,2,2000,0,4000,3282,718
12/3/2021 17:25,8992959508886,SWEETY SILVER PANTS XL 6+1,1,17500,0,17500,15531,1969
12/3/2021 17:25,089686611618,QTELA BARBEQUE,1,5000,0,5000,4266,734
12/3/2021 17:25,8992696523067,MILO ACTVGO UHT 180ML,1,4500,0,4500,3719,781
12/3/2021 17:25,8997218380159,ICHITAN BROWN SUGAR,1,8000,0,8000,6500,1500
12/3/2021 17:25,8886013213208,FRENCH FREIS 2000,1,5000,0,5000,3750,1250
12/3/2021 18:30,8994867007161,ROKOK PENA GOLD 20,1,19000,0,19000,17400,1600
12/3/2021 18:30,6907992825076,JD WATERMELON APPLE,1,2000,0,2000,1700,300
12/3/2021 18:30,8996001600382,"TEH PUCUK 1,36 L",1,12000,0,12000,10000,2000
12/3/2021 18:35,ARG,ARGUS DOS 220ML,6,15000,0,90000,81000,9000
12/3/2021 18:47,8992959117583,SOFTEX DAUN SIRIH,1,5000,0,5000,4288,712
12/3/2021 18:55,8997028590014,ARGUS 220ML,2,500,0,1000,604,396
12/3/2021 19:04,8993989311279,CLAS MILD 12,1,18000,0,18000,15800,2200
12/3/2021 19:45,8993335521260,Sabun Total Violet 900gr,1,15000,0,15000,13800,1200
12/3/2021 19:45,8998866200646,KOPI TOP MURNI,1,11000,0,11000,9600,1400
12/3/2021 19:45,MILKITA,MILKITA,8,250,0,2000,1600,400
12/3/2021 19:52,8997028590014,ARGUS 220ML,4,500,0,2000,1208,792
12/4/2021 10:49,8996001305041,ROMA SANDWICH CKLT,1,7000,0,7000,5928,1072
12/4/2021 10:49,8992760223015,OREO CHOCOLATE CREAM 133G,1,8000,0,8000,6300,1700
12/4/2021 11:06,8886008101053,AQUA 600 ML,2,3500,0,7000,4250,2750
12/4/2021 11:06,8992761139018,ADES 600ML,1,3500,0,3500,2166,1334
12/4/2021 11:06,8999909004221,SAMPOERNA ULTRAMILD 16,1,22000,0,22000,20350,1650
12/4/2021 12:36,8999909002821,MARLBORO BLACK 16,1,22000,0,22000,20900,1100
12/4/2021 12:50,MBL,MOBIL,1,5000,0,5000,3500,1500
12/4/2021 12:50,6907992823973,JD PINEAPPLE,2,5000,0,10000,8600,1400
12/4/2021 14:39,8998989110167,SURYA GUDANG GARAM 16 FILTER,1,26000,0,26000,23700,2300
12/4/2021 14:39,8991909101016,URBAN MILD 16,1,17000,0,17000,15800,1200
12/4/2021 14:39,ROTI,ROTI 2000,6,2000,0,12000,10800,1200
12/4/2021 15:11,MILKITA,MILKITA,4,250,0,1000,800,200
12/4/2021 15:11,8992775002582,DILAN CHOCO,1,2000,0,2000,1503,497
12/4/2021 16:58,8998866612258,RAPIKA SAKURA POUCH 400ML,1,5000,0,5000,4500,500
12/4/2021 16:58,8991001780492,SELAMAT COKLAT,1,13000,0,13000,11800,1200
12/4/2021 17:45,8991002105409,KOPI KAPAL API,1,20000,0,20000,18888,1112
12/4/2021 17:45,8992716109172,BISKUAT BOLU SCT,1,2000,0,2000,1641,359
12/4/2021 18:11,PD,PENDEKAR,40,500,0,20000,14000,6000
12/4/2021 18:30,8997028590014,ARGUS 220ML,2,500,0,1000,604,396
12/4/2021 18:54,8999801700030,SUSU FOYU,1,11500,0,11500,10450,1050
12/4/2021 18:54,ARG,ARGUS DOS 220ML,2,15000,0,30000,27000,3000
12/4/2021 19:10,8997218380074,ICHITAN MILK TEA,1,8000,0,8000,6500,1500
12/4/2021 19:57,8995555121244,SOSIS KIMBO,4,1000,0,4000,2600,1400
12/4/2021 19:57,8997009460343,NEXI NET,3,1000,0,3000,2700,300
12/4/2021 19:57,8997218010230,yohoo,2,1000,0,2000,1800,200
12/4/2021 19:57,8998866200882,SUKSESMIE GORENG AYAM KRMS 133GR,1,3500,0,3500,3047,453
12/4/2021 20:57,8992761111540,FANTA STRAWBERY SLIM CAM 250ML,1,5000,0,5000,3750,1250
12/4/2021 20:57,ROTI,ROTI 2000,1,2000,0,2000,1800,200
12/4/2021 22:06,8991909101016,URBAN MILD 16,1,17000,0,17000,15800,1200
12/4/2021 22:28,8996001600375,LE MINERAL 330ML,1,2000,0,2000,1417,583
12/4/2021 22:45,8992761139018,ADES 600ML,1,3500,0,3500,2166,1334
12/4/2021 22:45,8992761166205,FRESTEA GREEN HONEY 350ML,1,4500,0,4500,3000,1500
12/4/2021 22:45,7622201430153,OREO CHOCOLATE 38G,2,2000,0,4000,3282,718
12/4/2021 22:48,8997009510055,YOU C1000,1,15000,0,15000,13000,2000
12/4/2021 22:53,8993007003063,ENAAK 500G,1,11000,0,11000,9625,1375
12/4/2021 22:53,gula,GULA,2,11500,0,23000,20000,3000
12/5/2021 10:33,8998989300261,GUDANG GARAM SURYA 12 FILTER,1,20000,0,20000,18150,1850
12/5/2021 10:33,8995333032113,TERIGU GATOT KACA 1 KG,4,9000,0,36000,34288,1712
12/5/2021 10:33,gula,GULA,1,11500,0,11500,10000,1500
12/5/2021 10:33,8998989500166,GUDANG GARAM MERAH BESAR 16KS,1,18000,0,18000,17000,1000
12/5/2021 10:33,8999999706180,PEPSODENT WHITE 190GR,1,10000,0,10000,9350,650
12/5/2021 10:33,8999999031930,PEPSODENT TB TRIPLE CLEAN,1,3500,0,3500,2850,650
12/5/2021 10:33,8997009510055,YOU C1000,1,15000,0,15000,13000,2000
12/5/2021 10:33,8992696404441,SUSU BURUANG,1,13000,0,13000,8585,4415
12/5/2021 10:33,8998866200325,MIE SEDAAP SOTO,1,2700,0,2700,2282,418
12/5/2021 10:33,KIKO,KIKO,1,1000,0,1000,500,500
12/5/2021 10:33,KERUPUK 1000,KERUPUK BALADO,5,1000,0,5000,4500,500
12/5/2021 10:33,8995555111221,sosis kimbo,4,1000,0,4000,3400,600
12/5/2021 10:33,8991001502926,Chaca Peanut,2,1000,0,2000,1600,400
12/5/2021 10:33,089686043051,INDOMIE COTO MAKASSAR,1,2800,0,2800,2525,275
12/5/2021 10:33,8998866200882,SUKSESMIE GORENG AYAM KRMS 133GR,1,3500,0,3500,3047,453
12/5/2021 10:33,8991102228053,TEH GELAS BOTOL,1,3000,0,3000,1695,1305
12/5/2021 10:33,ARGUS,ARGUS,1,2000,0,2000,1500,500
12/5/2021 10:34,4902430553636,H&S LEMON  160ML,1,25000,0,25000,18900,6100
12/5/2021 10:34,8999999034733,PONDS MEN WHITE BOOST 100G,1,29500,0,29500,26620,2880
12/5/2021 10:34,8993379254469,SABUN LERVIA 90G,1,5000,0,5000,3077,1923
12/5/2021 10:34,8991102024099,FORMULA CURVE,1,5000,0,5000,3000,2000
12/5/2021 10:34,8991102103091,Formula Proteksi,1,3500,0,3500,2650,850
12/5/2021 10:34,8998866610261,DAIA VIOLET GUSSET BAG 290 GR,1,5000,0,5000,4450,550
12/5/2021 10:34,8998866608404,Softener,1,5000,0,5000,4560,440
12/5/2021 10:34,8991102989381,TANGO LONG BUBBLEGUM 130G,1,5000,0,5000,4350,650
12/5/2021 10:40,8994867007161,ROKOK PENA GOLD 20,2,19000,0,38000,34800,3200
12/5/2021 10:40,8999801700030,SUSU FOYU,1,11500,0,11500,10450,1050
12/5/2021 10:40,8992761166038,MMP ORANGE 300ML,1,5000,0,5000,3750,1250
12/5/2021 10:40,8999909096004,SAMPOERNA 16 FILTER,1,25000,0,25000,23100,1900
12/5/2021 10:40,089686611878,QTELA TEMPE,1,6000,0,6000,5370,630
12/5/2021 10:40,balon air,balon air,1,2000,0,2000,1700,300
12/5/2021 10:40,8997028590014,ARGUS 220ML,2,500,0,1000,604,396
12/5/2021 10:40,8998989500166,GUDANG GARAM MERAH BESAR 16KS,1,18000,0,18000,17000,1000
12/5/2021 10:40,ROTI,ROTI 2000,2,2000,0,4000,3600,400
12/5/2021 10:40,8996001410042,TB TORA MOKA,2,1500,0,3000,1740,1260
12/5/2021 10:40,8998989300261,GUDANG GARAM SURYA 12 FILTER,1,20000,0,20000,18150,1850
12/5/2021 10:40,6907992823973,JD PINEAPPLE,2,5000,0,10000,8600,1400
12/5/2021 10:40,MBL,MOBIL,1,5000,0,5000,3500,1500
12/5/2021 10:40,6907992825076,JD WATERMELON APPLE,1,2000,0,2000,1700,300
12/5/2021 10:40,kiko,kiko,1,1000,0,1000,900,100
12/5/2021 10:40,8999909002876,SAMPOERNA ULTRAMILD 12,1,19000,0,19000,17300,1700
12/5/2021 10:40,gula,GULA,2,11500,0,23000,20000,3000
12/5/2021 10:40,8991188943536,SASA SANTAN KELAPA 65ML,1,3000,0,3000,2437,563
12/5/2021 10:40,OSCAR,"OSKAR""S",2,1000,0,2000,850,1150
12/5/2021 10:40,8991002103931,GOOD DAY CARREBIAN NUT,1,1500,0,1500,890,610
12/5/2021 10:40,8996001440049,ENERGEN,1,1500,0,1500,1200,300
12/5/2021 10:40,8996001302316,MALKIST ABON SCT,1,1000,0,1000,840,160
12/5/2021 10:45,089686727081,DORITOS 55G,1,7000,0,7000,5950,1050
12/5/2021 10:45,8992388133345,NU MILK TEA TEH TARIK 330ML,1,6000,0,6000,5125,875
12/5/2021 10:45,8998989300261,GUDANG GARAM SURYA 12 FILTER,1,20000,0,20000,18150,1850
12/5/2021 10:45,8999909002821,MARLBORO BLACK 16,1,22000,0,22000,20900,1100
12/5/2021 10:45,8997028590052,ARGUS BTL 600ML,1,3000,0,3000,1458,1542
12/5/2021 10:45,8994867007161,ROKOK PENA GOLD 20,1,19000,0,19000,17400,1600
12/5/2021 10:54,8996001304129,SLAI OLAI STROBERI,1,12000,0,12000,9900,2100
12/5/2021 10:54,8999999005580,DOVE DEO WMN RONOURISH & SMOOTH 40 ML,1,17800,0,17800,16050,1750
12/5/2021 10:54,8992761111519,COCA COLA SLIM CAM 250ML,1,5000,0,5000,3750,1250
12/5/2021 10:54,8997218380159,ICHITAN BROWN SUGAR,1,8000,0,8000,6500,1500
12/5/2021 10:54,8992741952262,GULA GULA YUPI,4,250,0,1000,800,200
12/5/2021 10:54,8999801700030,SUSU FOYU,1,11500,0,11500,10450,1050
12/5/2021 10:54,8719200177314,BLUE BAND 15G,2,2000,0,4000,3000,1000
12/5/2021 10:54,8993989311279,CLAS MILD 12,1,18000,0,18000,15800,2200
12/5/2021 10:54,ARG,ARGUS DOS 220ML,4,15000,0,60000,54000,6000
12/5/2021 10:54,8996001600399,LE MINERAL 1500ML,1,5000,0,5000,4042,958
12/5/2021 10:54,KRIPIK MK,KRIPIK MAKKORONI,1,5000,0,5000,4000,1000
12/5/2021 10:54,8998866501033,MINYAK GORENG SEDAAP POUCH 2L,1,37000,0,37000,35000,2000
12/5/2021 10:54,8992759120264,LARISST 220,1,10000,0,10000,9200,800
12/5/2021 10:54,8995333060703,TERIGU KOMPAS 1KG,1,10500,0,10500,9816,684
12/5/2021 11:04,Telur 3 Biji,Telur 3 Biji,1,5000,0,5000,3600,1400
12/5/2021 11:25,8999909002876,SAMPOERNA ULTRAMILD 12,1,19000,0,19000,17300,1700
12/5/2021 11:39,6907992823935,JD SWEETCORN,1,3500,0,3500,3000,500
12/5/2021 11:39,6907992823591,JD STRAW MILKSHAKE,1,5000,0,5000,4300,700
12/5/2021 14:02,6907992823942,JD JUJUBE,1,4500,0,4500,3800,700
12/5/2021 14:02,7622300335809,OREO SOFT CAKE,1,2000,0,2000,1641,359
12/5/2021 14:34,8998866202978,Guribee Rumput Laut 68 gr,1,6000,0,6000,5100,900
12/5/2021 14:38,ARG,ARGUS DOS 220ML,1,15000,0,15000,13500,1500
12/5/2021 14:38,8886013213208,FRENCH FREIS 2000,1,5000,0,5000,3750,1250
12/5/2021 14:38,ROTI,ROTI 2000,1,2000,0,2000,1800,200
12/5/2021 14:42,8996001305331,ROMA SANDWICH LEMON,1,7000,0,7000,5500,1500
12/5/2021 14:42,8992694242502,ZWITZAL SOAP CALSSIC 70G,1,3800,0,3800,3410,390
12/5/2021 14:42,8992946512285,"SHINZU""U",1,5000,0,5000,4000,1000
12/5/2021 14:42,8991188943536,SASA SANTAN KELAPA 65ML,1,3000,0,3000,2437,563
12/5/2021 14:42,8991102714624,Tanggo Kido Drink 115ml,1,3000,0,3000,2000,1000
12/5/2021 14:42,8992696521629,DNCO COKLT UHT 180ML,1,5000,0,5000,3533,1467
12/5/2021 14:42,8997011931107,Ketumbar bubuk,5,1000,0,5000,4165,835
12/5/2021 14:42,8992959020012,SWEETY SILVER PANTS XL34,1,78000,0,78000,73637,4363
12/5/2021 14:42,8993274532082,BULO COKLAT,2,1000,0,2000,1666,334
12/5/2021 14:42,ROTI,ROTI 2000,1,2000,0,2000,1800,200
12/5/2021 15:09,gula,GULA,3,11500,0,34500,30000,4500
12/5/2021 18:14,8998866200578,MIE SEDAAP KARI KENTAL,3,2700,0,8100,6993,1107
12/5/2021 18:14,8998866203227,MIE SEDAAP AYAM BAKAR LIMAU,2,2700,0,5400,4326,1074
12/5/2021 18:14,8998989300261,GUDANG GARAM SURYA 12 FILTER,1,20000,0,20000,18150,1850
12/5/2021 18:14,8999999529673,CLEARA  IC MENTHOL 80ML,1,11200,0,11200,10120,1080
12/5/2021 19:01,8992388133345,NU MILK TEA TEH TARIK 330ML,1,6000,0,6000,5125,875
12/5/2021 19:01,8992388133017,NU MILK TEA ORI 330ML,1,6000,0,6000,5125,875
12/5/2021 19:01,8992775315057,GERY SALUT MALKIST COKLAT,1,6500,0,6500,5516,984
12/5/2021 19:01,KOPIKO,KOPIKO,2,250,0,500,350,150
12/5/2021 19:28,MBL,MOBIL,1,5000,0,5000,3500,1500
12/5/2021 19:28,ROTI,ROTI 2000,4,2000,0,8000,7200,800
12/5/2021 19:28,8997011700123,BIHUN JAGUNG 300GR,3,6000,0,18000,14937,3063
12/5/2021 19:33,8996001600399,LE MINERAL 1500ML,1,5000,0,5000,4042,958
12/5/2021 19:53,089686043051,INDOMIE COTO MAKASSAR,1,2800,0,2800,2525,275
12/5/2021 19:53,8998866200301,MIE SEDAAP GORENG,2,3000,0,6000,4828,1172
12/5/2021 19:53,8992761166212,FRESTEA APPLE 350ML,1,4500,0,4500,3000,1500
12/5/2021 19:53,8999801700030,SUSU FOYU,2,11500,0,23000,20900,2100
12/5/2021 19:53,8991001502926,Chaca Peanut,2,1000,0,2000,1600,400
12/5/2021 19:53,lolipop,lolipop,2,1000,0,2000,1700,300
12/5/2021 19:58,8991002105430,KOPI KAPAL API 65G,1,5000,0,5000,4145,855
12/5/2021 19:58,8996001440049,ENERGEN,2,1500,0,3000,2400,600
12/5/2021 20:17,8998989300261,GUDANG GARAM SURYA 12 FILTER,1,20000,0,20000,18150,1850
12/5/2021 20:25,8998989110167,SURYA GUDANG GARAM 16 FILTER,1,26000,0,26000,23700,2300
12/5/2021 20:25,8992696404441,SUSU BURUANG,1,13000,0,13000,8585,4415
12/5/2021 20:44,8998989500166,GUDANG GARAM MERAH BESAR 16KS,1,18000,0,18000,17000,1000
12/5/2021 20:44,8999909001909,MAGNUM REVAMP BLACK 12,1,18000,0,18000,16300,1700
12/5/2021 20:53,8992775001783,GERY SALUT MALKIST KELAPA,1,6500,0,6500,5516,984
12/5/2021 20:53,8992775315057,GERY SALUT MALKIST COKLAT,1,6500,0,6500,5516,984
12/5/2021 20:55,8994867000162,ROKOK PUNDIMAS KRETEK16,1,10000,0,10000,8600,1400
12/5/2021 21:52,711844610095,LARISSA UDANG 500 GR,1,11000,0,11000,9790,1210
12/5/2021 22:08,8999909096004,SAMPOERNA 16 FILTER,1,25000,0,25000,23100,1900
12/5/2021 22:08,8998989300261,GUDANG GARAM SURYA 12 FILTER,1,20000,0,20000,18150,1850
12/5/2021 22:10,8998989500166,GUDANG GARAM MERAH BESAR 16KS,1,18000,0,18000,17000,1000
12/5/2021 22:24,8992388133345,NU MILK TEA TEH TARIK 330ML,1,6000,0,6000,5125,875
12/5/2021 22:24,7622300335809,OREO SOFT CAKE,2,2000,0,4000,3282,718
12/5/2021 22:24,8992741952262,GULA GULA YUPI,4,250,0,1000,800,200
12/5/2021 22:31,8991004011906,KOPI BORONG,2,10000,0,20000,16666,3334
12/5/2021 22:31,gula,GULA,2,11500,0,23000,20000,3000
12/6/2021 12:38,8998866203272,MIE SUKSES MANTAP ISI 2,2,3500,0,7000,6092,908
12/6/2021 12:47,8997028590014,ARGUS 220ML,2,500,0,1000,604,396
12/6/2021 12:47,KERUPUK,KERUPUK BALADO,1,1000,0,1000,900,100
12/6/2021 12:47,8997009461753,TOP ELIT,1,1000,0,1000,400,600
12/6/2021 12:56,8997028590014,ARGUS 220ML,4,500,0,2000,1208,792
12/6/2021 12:56,8991102987639,WFR TANGO LONG VNL 130G,1,5000,0,5000,4350,650
12/6/2021 13:02,gula,GULA,1,11500,0,11500,10000,1500
12/6/2021 13:02,8998866200646,KOPI TOP MURNI,1,11000,0,11000,9600,1400
12/6/2021 13:02,8999999036836,LUX BW VELVET JASMINE LD REFF 450 ML,1,25000,0,25000,22110,2890
12/6/2021 13:02,8992628034159,BIMOLI 1 LT,1,21000,0,21000,19000,2000
12/6/2021 13:17,8994867007161,ROKOK PENA GOLD 20,1,19000,0,19000,17400,1600
12/6/2021 13:53,8999909085114,SAMPOERNA KRETEK HIJAU 12,1,13000,0,13000,11650,1350
12/6/2021 13:53,8994867007161,ROKOK PENA GOLD 20,1,19000,0,19000,17400,1600
12/6/2021 17:07,8998866201377,KRISBEE FRIES KENTANG GORENG 68 GR,1,5500,0,5500,4620,880
12/6/2021 17:07,gula gula,gula-gula karet,2,500,0,1000,800,200
12/6/2021 17:44,8998989300261,GUDANG GARAM SURYA 12 FILTER,1,20000,0,20000,18150,1850
12/6/2021 17:44,ROTI,ROTI 2000,1,2000,0,2000,1800,200
12/6/2021 17:44,8998866200882,SUKSESMIE GORENG AYAM KRMS 133GR,1,3500,0,3500,3047,453
12/6/2021 17:44,MILKITA,MILKITA,6,250,0,1500,1200,300
12/6/2021 17:52,8998866200578,MIE SEDAAP KARI KENTAL,3,2700,0,8100,6993,1107
12/6/2021 17:52,8998866200325,MIE SEDAAP SOTO,2,2700,0,5400,4564,836
12/6/2021 17:52,Telur 7 Biji,Telur 7 Biji,1,10000,0,10000,8400,1600
12/6/2021 17:52,8998989110167,SURYA GUDANG GARAM 16 FILTER,1,26000,0,26000,23700,2300
12/6/2021 17:52,8996001328163,GULA GULA TAMARIN,6,250,0,1500,1200,300
12/6/2021 17:58,8998866610261,DAIA VIOLET GUSSET BAG 290 GR,1,5000,0,5000,4450,550
12/6/2021 17:58,8992946512285,"SHINZU""U",1,5000,0,5000,4000,1000
12/6/2021 17:58,8997027300089,NOMOS,1,4000,0,4000,2963,1037
12/6/2021 17:58,7622201430153,OREO CHOCOLATE 38G,1,2000,0,2000,1641,359
12/6/2021 17:58,8991001242013,Top,2,1000,0,2000,1000,1000
12/6/2021 18:19,8997028590014,ARGUS 220ML,10,500,0,5000,3020,1980
12/6/2021 18:32,8994867000162,ROKOK PUNDIMAS KRETEK16,1,10000,0,10000,8600,1400
12/6/2021 18:46,8998866106542,EMERON LOVELY NAT PINK 200ML,1,6000,0,6000,5075,925
12/6/2021 18:46,8991001780133,TWISTER BLACK,1,5000,0,5000,4600,400
12/6/2021 18:46,8996001312278,MALKIST KEJU MANIS,1,6500,0,6500,5400,1100
12/6/2021 18:46,8991102387286,TANGO LONG CKLT 47G,10,1700,0,17000,15510,1490
12/6/2021 18:46,8992775305188 pcs,Gery Salut Grentea pcs,7,1000,0,7000,5684,1316
12/6/2021 18:46,8886008101091,"AQUA 1,5 ML",1,5000,0,5000,4600,400
12/6/2021 18:47,8998989300261,GUDANG GARAM SURYA 12 FILTER,1,20000,0,20000,18150,1850
12/6/2021 18:47,123124,KOREK BIASA,1,2000,0,2000,1300,700
12/6/2021 19:42,8992959508916,SWEETY SILVER PANTS XXL18,1,54500,0,54500,49546,4954
12/6/2021 19:44,8992775002582,DILAN CHOCO,1,2000,0,2000,1503,497
12/6/2021 19:45,8999999533731,CITRA TS NATURE WHITE 70G,2,2200,0,4400,3800,600
12/6/2021 19:45,8999999533724,CITRA TS PEARLY WHITE CNT 70G,1,2300,0,2300,1900,400
12/6/2021 19:51,8999999195649,SARIWANGI 25X1.86G,1,6000,0,6000,5202,798
12/6/2021 19:56,8998866613705,EMERON LOVELY COOL&BRIGHT 200ML,1,7500,0,7500,6475,1025
12/6/2021 19:56,8991102308861,FULLO BLASTO,1,16000,0,16000,14545,1455
12/6/2021 20:02,8998989300261,GUDANG GARAM SURYA 12 FILTER,1,20000,0,20000,18150,1850
12/6/2021 20:02,8992759120264,LARISST 220,1,10000,0,10000,9200,800
12/6/2021 20:02,8998866200301,MIE SEDAAP GORENG,1,3000,0,3000,2414,586
12/6/2021 20:02,089686043051,INDOMIE COTO MAKASSAR,1,2800,0,2800,2525,275
12/6/2021 20:02,8998866200325,MIE SEDAAP SOTO,1,2700,0,2700,2282,418
12/6/2021 20:30,8991909101016,URBAN MILD 16,1,17000,0,17000,15800,1200
12/6/2021 20:30,8991102987639,WFR TANGO LONG VNL 130G,1,5000,0,5000,4350,650
12/7/2021 16:12,8999909096004,SAMPOERNA 16 FILTER,1,25000,0,25000,23100,1900
12/7/2021 17:08,8993379200886,SABUN HARMONY ORANGE 70G,3,2000,0,6000,4956,1044
12/7/2021 17:08,8993379200855,SABUN HARMONY STRAWBERRY 70G,1,2000,0,2000,1652,348
12/7/2021 17:08,8993335529358,Sabun Oxyklin Cair 750ml,1,21000,0,21000,19200,1800
12/7/2021 17:08,8999999059781,SUNLIGHT LIME NEW POUCH 210ML,1,5000,0,5000,4520,480
12/7/2021 17:09,8851019210292,POCKY 40 GR,1,7000,0,7000,5671,1329
12/7/2021 17:09,8992730950194,GULA GULA KOIN,4,500,0,2000,1600,400
12/7/2021 17:09,MILKITA,MILKITA,4,250,0,1000,800,200
12/7/2021 17:18,8991102385336,TANGO WAFFLE MILK,1,10000,0,10000,8200,1800
12/7/2021 17:18,8998866202770,MIE SEDAAP SALERO PADANG,1,2500,0,2500,2362,138
12/7/2021 21:34,MARS,MARSHMELLOW,22,500,0,11000,9526,1474
12/7/2021 21:34,8998866607315,SOKLIN SOFTERGENT SAKURA 770G & PIRING,1,20000,0,20000,18055,1945
12/7/2021 21:34,8998866692663,SOKLIN FLOORCLENER KUNING 450ML,1,7000,0,7000,6385,615
12/7/2021 21:34,8993324850401,GENTLE CUTTON BUDS 60,1,5000,0,5000,4650,350
12/7/2021 21:34,8999999536244,SUNSILK SHP THICK N LONG170ML,1,20000,0,20000,18150,1850
12/7/2021 21:34,8999999036607,LUX TS SOFT ROSE 75G,2,3500,0,7000,5600,1400
12/7/2021 21:52,8992959953044,SWEETY BRONZE XL1,1,3000,0,3000,2311,689
12/7/2021 22:35,8998866202978,Guribee Rumput Laut 68 gr,1,6000,0,6000,5100,900
12/7/2021 22:35,8992760221028,OREO ORIGINAL 133G,1,8000,0,8000,6300,1700
12/7/2021 22:35,8998866610223,DAIA VIOLET BAG 850G & PIRING,1,18000,0,18000,15627,2373
12/8/2021 10:16,8886013213208,FRENCH FREIS 2000,2,5000,0,10000,7500,2500
12/8/2021 10:16,8992761166205,FRESTEA GREEN HONEY 350ML,2,4500,0,9000,6000,3000
12/8/2021 10:16,ROTI,ROTI 2000,3,2000,0,6000,5400,600
12/8/2021 10:16,8996001600375,LE MINERAL 330ML,2,2000,0,4000,2834,1166
12/8/2021 10:16,8996001600269,LE MINERAL 600ML,1,3000,0,3000,1688,1312
12/8/2021 10:16,balon air,balon air,2,2000,0,4000,3400,600
12/8/2021 10:57,ARG,ARGUS DOS 220ML,1,15000,0,15000,13500,1500
12/8/2021 10:57,8997013180046,Tissu Tessi B,1,11000,0,11000,9800,1200
12/8/2021 10:57,Telur 3 Biji,Telur 3 Biji,1,5000,0,5000,3600,1400
12/8/2021 11:42,8996001600399,LE MINERAL 1500ML,3,5000,0,15000,12126,2874
12/8/2021 12:02,8998989300261,GUDANG GARAM SURYA 12 FILTER,1,20000,0,20000,18150,1850
12/8/2021 13:53,8997028590014,ARGUS 220ML,4,500,0,2000,1208,792
12/8/2021 13:55,8993989311699,CLAS MILD 16 FILTER,1,24000,0,24000,21700,2300
12/8/2021 14:10,9999,ISOLASI LAKBAN,2,8000,0,16000,13000,3000
12/8/2021 14:41,gula,GULA,2,11500,0,23000,20000,3000
12/8/2021 15:04,4902430401142,PANTENE HAIRFALL 70ML,1,12500,0,12500,11439,1061
12/8/2021 15:05,SURYA BTG,SURYA BATANG,3,1666,0,4998,4140,858
12/8/2021 15:05,8997028590014,ARGUS 220ML,2,500,0,1000,604,396
12/8/2021 17:03,7622201430153,OREO CHOCOLATE 38G,1,2000,0,2000,1641,359
12/8/2021 17:03,8998866604741,RAPIKA BIANG UBGU 250MLBTL,1,8500,0,8500,7650,850
12/8/2021 17:03,8997028590014,ARGUS 220ML,4,500,0,2000,1208,792
12/8/2021 17:03,8991002103931,GOOD DAY CARREBIAN NUT,2,1500,0,3000,1780,1220
12/8/2021 17:04,8991001780133,TWISTER BLACK,2,5000,0,10000,9200,800
12/8/2021 17:04,8992775002599,DILAN CHOCO CRUNCHY,1,20000,0,20000,18040,1960
12/8/2021 17:19,MILKITA,MILKITA,8,250,0,2000,1600,400
12/8/2021 17:19,KIKO,KIKO,1,1000,0,1000,500,500
12/8/2021 17:19,8994834006128,TICTIC PEDAS,2,2000,0,4000,3400,600
12/8/2021 17:19,8992775311509,gery garuda,1,1000,0,1000,700,300
12/8/2021 17:35,089686043051,INDOMIE COTO MAKASSAR,2,2800,0,5600,5050,550
12/8/2021 17:35,PD,PENDEKAR,1,500,0,500,350,150
12/8/2021 18:12,8999909982000,SAMPOERNA 12 FILTER,1,19000,0,19000,16600,2400
12/8/2021 18:12,8998989300261,GUDANG GARAM SURYA 12 FILTER,1,20000,0,20000,18150,1850
12/8/2021 18:38,8998989500166,GUDANG GARAM MERAH BESAR 16KS,1,18000,0,18000,17000,1000
12/8/2021 18:38,8998866613262,SUKSESMIE SOTO 111 GR,1,3500,0,3500,2770,730
12/8/2021 18:45,8998989300261,GUDANG GARAM SURYA 12 FILTER,1,20000,0,20000,18150,1850
12/8/2021 18:53,ARG,ARGUS DOS 220ML,1,15000,0,15000,13500,1500
12/8/2021 19:02,ARG,ARGUS DOS 220ML,1,15000,0,15000,13500,1500
12/8/2021 19:02,kiko,kiko,2,1000,0,2000,1800,200
12/8/2021 19:02,8991102228053,TEH GELAS BOTOL,1,3000,0,3000,1695,1305
12/8/2021 19:24,8998866200882,SUKSESMIE GORENG AYAM KRMS 133GR,2,3500,0,7000,6094,906
12/8/2021 19:24,8998866200813,NOODLE SEDAAP MIE GORENG CUP 85 GR,1,5000,0,5000,4002,998
12/8/2021 19:29,MK,MASKER,1,5000,0,5000,4000,1000
12/8/2021 19:35,8991102230308,BLASTER PINK,1,5000,0,5000,3106,1894
12/8/2021 19:38,KIKO,KIKO,1,1000,0,1000,500,500
12/8/2021 19:40,8997009510055,YOU C1000,1,15000,0,15000,13000,2000
12/8/2021 19:44,kiko,kiko,1,1000,0,1000,900,100
12/8/2021 20:03,MK,MASKER,1,5000,0,5000,4000,1000
12/8/2021 20:09,8998989300261,GUDANG GARAM SURYA 12 FILTER,1,20000,0,20000,18150,1850
12/8/2021 20:09,8996001600269,LE MINERAL 600ML,1,3000,0,3000,1688,1312
12/8/2021 20:15,8996001600399,LE MINERAL 1500ML,1,5000,0,5000,4042,958
12/8/2021 20:21,8998866613262,SUKSESMIE SOTO 111 GR,1,3500,0,3500,2770,730
12/8/2021 20:27,8997009510055,YOU C1000,2,15000,0,30000,26000,4000
12/8/2021 20:32,8999909002821,MARLBORO BLACK 16,1,22000,0,22000,20900,1100
12/8/2021 20:36,8999909096004,SAMPOERNA 16 FILTER,1,25000,0,25000,23100,1900
12/8/2021 20:57,8991909101016,URBAN MILD 16,1,17000,0,17000,15800,1200
12/8/2021 21:50,8998866202312,NOODLE SEDAAP TASTY BAKMI AYAM 129 GR,2,5000,0,10000,8334,1666
12/8/2021 22:06,8991906105758,ROKOK LA BOLD,1,27000,0,27000,24900,2100
12/8/2021 22:09,8997021110028,Garam Kasar,2,3000,0,6000,3000,3000
12/8/2021 22:32,8996001600399,LE MINERAL 1500ML,1,5000,0,5000,4042,958
12/9/2021 14:52,gula,GULA,10,11500,0,115000,100000,15000
12/9/2021 14:52,8999999506520,SUNSILK RFR ANTI DDRF 340ML,1,41200,0,41200,37890,3310
12/9/2021 14:52,8999999003067,VASELINE SPF24 100ML,1,19500,0,19500,17600,1900
12/9/2021 15:00,gula,GULA,2,11500,0,23000,20000,3000
12/9/2021 16:12,8992628026147,BIMOLI 250ML,1,8000,0,8000,6650,1350
12/9/2021 16:12,8997012320832,Mamaqu,1,5000,0,5000,4500,500
12/9/2021 16:22,8999999195656,SARIWANGI 50X1.85,1,10000,0,10000,9405,595
12/9/2021 16:24,8991102454155,WAFFLE CHIZMILL,1,9000,0,9000,8498,502
12/9/2021 17:07,8993007000680,INDOMILK 1L,1,16500,0,16500,14792,1708
12/9/2021 17:55,8998989300261,GUDANG GARAM SURYA 12 FILTER,1,20000,0,20000,18150,1850
12/9/2021 18:18,8997028590014,ARGUS 220ML,6,500,0,3000,1812,1188
12/9/2021 18:18,KIKO,KIKO,2,1000,0,2000,1000,1000
12/9/2021 18:30,ARG,ARGUS DOS 220ML,1,15000,0,15000,13500,1500
12/9/2021 19:04,8998989500166,GUDANG GARAM MERAH BESAR 16KS,1,18000,0,18000,17000,1000
12/9/2021 19:05,8998866201520,KOPI TOP TORAJA MURNI,1,11000,0,11000,9600,1400
12/9/2021 19:05,SURYA BTG,SURYA BATANG,3,1666,0,4998,4140,858
12/9/2021 19:35,8991102320184,TANGO CHOCO JAVAMOCCA,2,5000,0,10000,8700,1300
12/9/2021 19:35,8992775001653,GERY SALUT CHOCOLATE COCONUT,1,2000,0,2000,1476,524
12/9/2021 19:44,gula,GULA,1,11500,0,11500,10000,1500
12/9/2021 19:44,8994191103638,GULA GULA KARET,1,500,0,500,400,100
12/9/2021 19:50,8999999524722,SUNLIGHT LIME NEW PCH 435ML,1,10000,0,10000,9100,900
12/9/2021 20:20,8998989300261,GUDANG GARAM SURYA 12 FILTER,1,20000,0,20000,18150,1850
12/9/2021 20:22,8999909002821,MARLBORO BLACK 16,1,22000,0,22000,20900,1100
12/9/2021 20:22,8886008101091,"AQUA 1,5 ML",1,5000,0,5000,4600,400
12/9/2021 20:38,8992696523081,MILO UHT 110ML,2,2500,0,5000,4546,454
12/9/2021 20:38,8991914101513,VIPER KRETEK 12,1,6000,0,6000,5000,1000
12/9/2021 20:54,8999909982000,SAMPOERNA 12 FILTER,1,19000,0,19000,16600,2400
12/9/2021 21:27,6907992825076,JD WATERMELON APPLE,6,2000,0,12000,10200,1800
12/9/2021 21:27,6907992823935,JD SWEETCORN,1,3500,0,3500,3000,500
12/9/2021 21:27,6907992823867,JD CRUNCHY CHOCOLATE MALT,1,5500,0,5500,4700,800
12/9/2021 22:11,8991906105758,ROKOK LA BOLD,1,26000,0,26000,24900,1100
12/10/2021 11:59,8997009510123,ORANGE WATER,1,8000,0,8000,6265,1735
12/10/2021 11:59,8997028590014,ARGUS 220ML,2,500,0,1000,604,396
12/10/2021 11:59,gula,GULA,4,11500,0,46000,40000,6000
12/10/2021 11:59,8994907000428,KECAP SACHET ABC,2,600,0,1200,1000,200
12/10/2021 11:59,8994867000162,ROKOK PUNDIMAS KRETEK16,1,10000,0,10000,8600,1400
12/10/2021 11:59,6907992825076,JD WATERMELON APPLE,1,2000,0,2000,1700,300
12/10/2021 11:59,6907992823935,JD SWEETCORN,1,3500,0,3500,3000,500
12/10/2021 11:59,kiko,kiko,1,1000,0,1000,900,100
12/10/2021 11:59,Pulpen,pulpen,2,1000,0,2000,1500,500
12/10/2021 11:59,9556001004673,MILO NESTLE MALAYSIA ACTIVE GO,1,85000,0,85000,80000,5000
12/10/2021 11:59,8999999059903,PONDS AGE MIRACLE DAY CREAM 10G,1,28500,0,28500,25850,2650
12/10/2021 11:59,8992753631209,OMELA 370,1,9500,0,9500,8400,1100
12/10/2021 11:59,8992702000018,INDOMILK PUTIH 370G,1,10000,0,10000,9208,792
12/10/2021 11:59,8992628022156,MINYAK GORENG BIMOLI POUCH 1 LT,1,17500,0,17500,16675,825
12/10/2021 11:59,8998989300261,GUDANG GARAM SURYA 12 FILTER,1,20000,0,20000,18150,1850
12/10/2021 11:59,8992696404441,SUSU BERUANG,1,13000,0,13000,8585,4415
12/10/2021 12:00,KIKO,KIKO,1,1000,0,1000,500,500
12/10/2021 12:00,8997011700123,BIHUN JAGUNG 300GR,1,6000,0,6000,4979,1021
12/10/2021 12:00,ARG,ARGUS DOS 220ML,2,15000,0,30000,27000,3000
12/10/2021 12:32,8994834006128,TICTIC PEDAS,2,2000,0,4000,3400,600
12/10/2021 12:32,MARS,MARSHMELLOW,2,500,0,1000,866,134
12/10/2021 12:45,8992388133017,NU MILK TEA ORI 330ML,2,6000,0,12000,10250,1750
12/10/2021 12:45,8997028590045,ARGUS BTL 330ML,2,2000,0,4000,2582,1418
12/10/2021 12:45,ROTI,ROTI 2000,1,2000,0,2000,1800,200
12/10/2021 12:45,8998989100120,GUDANG GARAM MINI,1,19000,0,19000,16600,2400
12/10/2021 14:00,6907992825076,JD WATERMELON APPLE,1,2000,0,2000,1700,300
12/10/2021 14:00,6907992823874,JD CRUNCHY CHOCO BLUEBERRY,1,5500,0,5500,4700,800
12/10/2021 14:01,8998866200301,MIE SEDAAP GORENG,1,3000,0,3000,2414,586
12/10/2021 14:33,8998989100120,GUDANG GARAM MINI,1,19000,0,19000,16600,2400
12/10/2021 14:33,8994867007161,ROKOK PENA GOLD 20,3,19000,0,57000,52200,4800
12/10/2021 14:33,ARG,ARGUS DOS 220ML,1,15000,0,15000,13500,1500
12/10/2021 14:46,8994867000162,ROKOK PUNDIMAS KRETEK16,1,10000,0,10000,8600,1400
12/10/2021 15:00,8997009510123,ORANGE WATER,1,8000,0,8000,6265,1735
12/10/2021 15:03,8998989300261,GUDANG GARAM SURYA 12 FILTER,1,20000,0,20000,18150,1850
12/10/2021 15:03,8994834006128,TICTIC PEDAS,2,2000,0,4000,3400,600
12/10/2021 15:03,ROTI,ROTI 2000,2,2000,0,4000,3600,400
12/10/2021 15:17,ARG,ARGUS DOS 220ML,1,15000,0,15000,13500,1500
12/10/2021 15:17,LT,LIPSTIK HANASUI,1,27000,0,27000,27000,0
12/10/2021 15:17,SURYA BTG,SURYA BATANG,1,2000,0,2000,1380,620
12/10/2021 16:15,ROTI,ROTI 2000,2,2000,0,4000,3600,400
12/10/2021 16:15,8998866200301,MIE SEDAAP GORENG,1,3000,0,3000,2414,586
12/10/2021 17:00,8999999552374,Sahaja Pencuri Piring 720 Ml,1,13500,0,13500,12000,1500
12/10/2021 17:00,8992806145417,SCOTCH BRITE,2,3500,0,7000,4814,2186
12/10/2021 17:00,KPS,KAPAS MEI QIAN,1,5000,0,5000,4750,250
12/10/2021 17:00,8999999559854,AXE BLACK POCKET FRAG 17ML,2,10000,0,20000,16000,4000
12/10/2021 17:00,8998866603409,RAPIKA UNGU POUCH 400ML,1,5000,0,5000,4500,500
12/10/2021 17:00,8998866612890,GIV TIN & ZAITUN KOTAK 76G,5,2000,0,10000,9100,900
12/10/2021 17:00,8992959117583,SOFTEX DAUN SIRIH,2,5000,0,10000,8576,1424
12/10/2021 17:00,8999999059781,SUNLIGHT LIME NEW POUCH 210ML,1,5000,0,5000,4520,480
12/10/2021 17:00,8998866609029,DAIA PUTIH GUSSWET 565G,1,10000,0,10000,8700,1300
12/10/2021 17:00,8998866610261,DAIA VIOLET GUSSET BAG 290 GR,2,5000,0,10000,8900,1100
12/10/2021 17:00,8998866613002,CREAM EKONOMI PINK 455G,1,5500,0,5500,4750,750
12/10/2021 17:00,8998866611152,CREAM EKONOMI VIOLET 455G,1,5500,0,5500,4750,750
12/10/2021 17:00,8998866608329,CREAM EKONOMI PUTIH 455G,1,5500,0,5500,4750,750
12/10/2021 17:00,8998866671736,CREAM EKONOMI 455G,1,5500,0,5500,4750,750
12/10/2021 17:00,8991102103091,Formula Proteksi,2,3500,0,7000,5300,1700
12/10/2021 17:00,8999999706180,PEPSODENT WHITE 190GR,1,10000,0,10000,9350,650
12/10/2021 17:00,8999999557447,PEPSODENT ACTION123 SIWAK 110G,1,9000,0,9000,8000,1000
12/10/2021 17:00,8999999552473,PEPSODENT ACTION123 SIWAK 65G,1,6200,0,6200,5600,600
12/10/2021 17:00,8999999031930,PEPSODENT TB TRIPLE CLEAN,3,3500,0,10500,8550,1950
12/10/2021 17:00,8995333060703,TERIGU KOMPAS 1KG,1,10500,0,10500,9816,684
12/10/2021 17:00,SASA,SASA,18,500,0,9000,7200,1800
12/10/2021 17:00,BON,BONCABE,10,1000,0,10000,9000,1000
12/10/2021 17:02,8999999552374,Sahaja Pencuri Piring 720 Ml,2,13500,0,27000,24000,3000
12/10/2021 18:19,8991102320184,TANGO CHOCO JAVAMOCCA,2,5000,0,10000,8700,1300
12/10/2021 18:19,8851019210292,POCKY 40 GR,2,7000,0,14000,11342,2658
12/10/2021 18:19,8998866202978,Guribee Rumput Laut 68 gr,2,6000,0,12000,10200,1800
12/10/2021 18:19,8992696523081,MILO UHT 110ML,4,2500,0,10000,9092,908
12/10/2021 18:19,9556006012093,JB BATH TOPTOETOE 200ML,1,16000,0,16000,14820,1180
12/10/2021 18:28,8998989300261,GUDANG GARAM SURYA 12 FILTER,1,20000,0,20000,18150,1850
12/10/2021 18:28,6907992823904,JD CRUNCHY CHOCOLATE VAN,1,8000,0,8000,6800,1200
12/10/2021 18:40,MARS,MARSHMELLOW,2,500,0,1000,866,134
12/10/2021 18:40,8996001328163,GULA GULA TAMARIN,8,250,0,2000,1600,400
12/10/2021 18:40,8997028590014,ARGUS 220ML,4,500,0,2000,1208,792
12/11/2021 10:22,8998866203272,MIE SUKSES MANTAP ISI 2,1,3500,0,3500,3046,454
12/11/2021 10:23,8998866203227,MIE SEDAAP AYAM BAKAR LIMAU,1,2700,0,2700,2163,537
12/11/2021 10:34,MK,MASKER,1,5000,0,5000,4000,1000
12/11/2021 10:34,MBL,MOBIL,2,5000,0,10000,7000,3000
12/11/2021 10:34,8998866605151,CLING HIJAU POUCH 425ML,1,4000,0,4000,3250,750
12/11/2021 10:34,8998866106542,EMERON LOVELY NAT PINK 200ML,1,6000,0,6000,5075,925
12/11/2021 10:34,8991102023115,Sikat Gigi Formula,1,11000,0,11000,10000,1000
12/11/2021 10:34,8992694247163,ZWITSAL SOAP RICH N HON 70G,3,4000,0,12000,10230,1770
12/11/2021 10:34,8999999042592,RINSO MOLTO PERFUME ESSENSE LIQ 4OML,3,1000,0,3000,2406,594
12/11/2021 10:34,8995150101696,M+SUSU ORIGINAL,1,5000,0,5000,4000,1000
12/11/2021 10:34,8999999195649,SARIWANGI 25X1.86G,1,6000,0,6000,5202,798
12/11/2021 10:34,089686043051,INDOMIE COTO MAKASSAR,1,2800,0,2800,2525,275
12/11/2021 10:34,089686021127,INTER MIE KALDU,5,1000,0,5000,4065,935
12/11/2021 10:34,8992736624310,Sasa bumbu Nasi Goreng Jawa,1,2000,0,2000,1181,819
12/11/2021 10:34,TERASI,ABC TERASI SCT,2,1500,0,3000,2000,1000
12/11/2021 10:44,8998866500135,HERSPROTEX SOFTCARE WINGS,1,5500,0,5500,4820,680
12/11/2021 10:44,6907992825076,JD WATERMELON APPLE,1,2000,0,2000,1700,300
12/11/2021 10:44,ROTI,ROTI 2000,3,2000,0,6000,5400,600
12/11/2021 10:44,8997028590014,ARGUS 220ML,6,500,0,3000,1812,1188
12/11/2021 10:44,8993989311279,CLAS MILD 12,1,18000,0,18000,15800,2200
12/11/2021 10:44,4902430745703,DOWNY SUNRISE FRESH 10ML,4,500,0,2000,1572,428
12/11/2021 10:44,8992775002582,DILAN CHOCO,1,2000,0,2000,1503,497
12/11/2021 10:44,8999909002821,MARLBORO BLACK 16,1,22000,0,22000,20900,1100
12/11/2021 10:44,8999999529697,CLEAR DEEP CLEANSE MEN 160ML,1,24700,0,24700,22700,2000
12/11/2021 10:44,8999999390198,SUNLIGHT LIME NEW POUCH 755ML,1,18000,0,18000,15950,2050
12/11/2021 10:44,8994867007161,ROKOK PENA GOLD 20,1,19000,0,19000,17400,1600
12/11/2021 10:44,SURYA BTG,SURYA BATANG,3,2000,0,6000,4140,1860
12/11/2021 10:44,8991914101513,VIPER KRETEK 12,2,6000,0,12000,10000,2000
12/11/2021 10:54,ROTI,ROTI 2000,2,2000,0,4000,3600,400
12/11/2021 10:54,kentang,kripik kentang,1,1000,0,1000,900,100
12/11/2021 10:54,balon air,balon air,2,2000,0,4000,3400,600
12/11/2021 10:54,8993989311699,CLAS MILD 16 FILTER,1,24000,0,24000,21700,2300
12/11/2021 10:54,8992761111519,COCA COLA SLIM CAM 250ML,1,5000,0,5000,3750,1250
12/11/2021 10:54,MRC,MERICA LADA,1,1000,0,1000,889,111
12/11/2021 10:54,8992761111540,FANTA STRAWBERY SLIM CAM 250ML,1,5000,0,5000,3750,1250
12/11/2021 10:54,6907992825076,JD WATERMELON APPLE,1,2000,0,2000,1700,300
12/11/2021 10:54,kiko,kiko,1,1000,0,1000,900,100
12/11/2021 10:54,8992696404441,SUSU BERUANG,1,13000,0,13000,8585,4415
12/11/2021 10:54,8997009510055,YOU C1000,1,15000,0,15000,13000,2000
12/11/2021 10:54,8998866202244,EKOMIE BUMBU KALDU AYAM,1,1000,0,1000,798,202
12/11/2021 10:54,8998866200844,NOODLE SEDAAP MIE KARI SPESIAL CUP 81 GR,1,4500,0,4500,3650,850
12/11/2021 11:05,8998866200325,MIE SEDAAP SOTO,2,2700,0,5400,4564,836
12/11/2021 11:05,MK,MASKER,2,5000,0,10000,8000,2000
12/11/2021 11:05,ARG,ARGUS DOS 220ML,1,15000,0,15000,13500,1500
12/11/2021 11:05,8996001302316,MALKIST ABON SCT,1,1000,0,1000,840,160
12/11/2021 11:05,8998989500166,GUDANG GARAM MERAH BESAR 16KS,1,18000,0,18000,17000,1000
12/11/2021 11:05,8999909096004,SAMPOERNA 16 FILTER,4,25000,0,100000,92400,7600
12/11/2021 11:05,8991102384841,WFR TANGO LONG CKLT 130G,3,5000,0,15000,13035,1965
12/11/2021 11:05,8992775311615,CHOCOLATOS,1,12000,0,12000,9983,2017
12/11/2021 11:05,8994867007161,ROKOK PENA GOLD 20,1,19000,0,19000,17400,1600
12/11/2021 11:05,8999909004221,SAMPOERNA ULTRAMILD 16,1,22000,0,22000,20350,1650
12/11/2021 11:05,8999999401245,RINSO ANTI NODA NCLASSIC 1.4KG,1,36500,0,36500,33147,3353
12/11/2021 11:05,8998866606158,NUVO ACTIVE COOL 110G,1,3000,0,3000,2600,400
12/11/2021 11:05,PULPEN,PULPEN BIASA,1,2000,0,2000,1500,500
12/11/2021 11:05,8996001305041,ROMA SANDWICH CKLT,2,7000,0,14000,11856,2144
12/11/2021 11:05,8999999195649,SARIWANGI 25X1.86G,1,6000,0,6000,5202,798
12/11/2021 11:13,8991102384841,WFR TANGO LONG CKLT 130G,1,5000,0,5000,4345,655
12/11/2021 11:13,8992696523067,MILO ACTVGO UHT 180ML,2,4500,0,9000,7438,1562
12/11/2021 11:13,8994834006128,TICTIC PEDAS,4,2000,0,8000,6800,1200
12/11/2021 11:13,8886001038011,BENG-BENG SCT,1,1500,0,1500,1000,500
12/11/2021 11:13,8998866202237,NOODLE SEDAAP TASTY AYAM GEPREK 124 GR,1,5000,0,5000,4167,833
12/11/2021 11:13,ROTI,ROTI 2000,5,2000,0,10000,9000,1000
12/11/2021 11:13,8997028590045,ARGUS BTL 330ML,1,2000,0,2000,1291,709
12/11/2021 11:13,8996001326237,GULA GULA KIS,8,250,0,2000,1600,400
12/11/2021 11:13,BALON,BALON CABUT,4,1000,0,4000,3600,400
12/11/2021 11:13,ARG,ARGUS DOS 220ML,1,15000,0,15000,13500,1500
12/11/2021 11:13,8999999524722,SUNLIGHT LIME NEW PCH 435ML,1,10000,0,10000,9100,900
12/11/2021 11:13,8999999192150,ROYCO FDS CHICKEN 100GR,1,5000,0,5000,4300,700
12/11/2021 11:13,8998866200844,NOODLE SEDAAP MIE KARI SPESIAL CUP 81 GR,1,4500,0,4500,3650,850
12/11/2021 11:13,8991102022347,SIKAT GIGI FORMULA RIPPLE,1,5000,0,5000,4583,417
12/11/2021 11:13,8991102103091,Formula Proteksi,1,3500,0,3500,2650,850
12/11/2021 11:22,6907992823935,JD SWEETCORN,2,3500,0,7000,6000,1000
12/11/2021 11:22,4902430563888,SHAMPO PANTENE,2,1000,0,2000,1500,500
12/11/2021 11:22,8999999524722,SUNLIGHT LIME NEW PCH 435ML,1,10000,0,10000,9100,900
12/11/2021 11:22,8886008101091,"AQUA 1,5 ML",2,5000,0,10000,9200,800
12/11/2021 11:22,8996001600399,LE MINERAL 1500ML,1,5000,0,5000,4042,958
12/11/2021 11:22,8995333060703,TERIGU KOMPAS 1KG,1,10500,0,10500,9816,684
12/11/2021 11:22,8999999526894,RINSO ROYAL GOLD 40ML,1,1000,0,1000,805,195
12/11/2021 11:22,8997009510123,ORANGE WATER,1,8000,0,8000,6265,1735
12/11/2021 11:22,gula,GULA,4,11500,0,46000,40000,6000
12/11/2021 11:22,8997028590014,ARGUS 220ML,2,500,0,1000,604,396
12/11/2021 11:22,8994867000162,ROKOK PUNDIMAS KRETEK16,1,10000,0,10000,8600,1400
12/11/2021 11:22,6907992825076,JD WATERMELON APPLE,1,2000,0,2000,1700,300
12/11/2021 11:22,kiko,kiko,1,1000,0,1000,900,100
12/11/2021 11:22,Pulpen,pulpen,1,1000,0,1000,750,250
12/11/2021 11:22,9556001004673,MILO NESTLE MALAYSIA ACTIVE GO,1,85000,0,85000,80000,5000
12/11/2021 11:31,8999999059903,PONDS AGE MIRACLE DAY CREAM 10G,1,28500,0,28500,25850,2650
12/11/2021 11:31,8992753631209,OMELA 370,1,10000,0,10000,8400,1600
12/11/2021 11:31,8992702000063,INDOMILK COKLAT 370G,1,10000,0,10000,9208,792
12/11/2021 11:31,8992628022156,MINYAK GORENG BIMOLI POUCH 1 LT,1,18000,0,18000,16675,1325
12/11/2021 11:31,8998989300261,GUDANG GARAM SURYA 12 FILTER,1,20000,0,20000,18150,1850
12/11/2021 11:31,8992696404441,SUSU BERUANG,1,13000,0,13000,8585,4415
12/11/2021 11:31,kiko,kiko,4,1000,0,4000,3600,400
12/11/2021 11:31,ARG,ARGUS DOS 220ML,2,15000,0,30000,27000,3000
12/11/2021 11:31,8998866805414,SOKLIN SMART SOFTERNER 800G & PIRING,1,20000,0,20000,18630,1370
12/11/2021 11:31,8991102228053,TEH GELAS BOTOL,1,3000,0,3000,1695,1305
12/11/2021 11:31,8999999059781,SUNLIGHT LIME NEW POUCH 210ML,1,5000,0,5000,4520,480
12/11/2021 11:31,4902430563864,shampo pantene,10,1000,0,10000,7500,2500
12/11/2021 11:31,TBR,TEPUNG BERAS ROSE BRAND,1,8000,0,8000,6150,1850
12/11/2021 11:31,8998866202237,NOODLE SEDAAP TASTY AYAM GEPREK 124 GR,1,5000,0,5000,4167,833
12/11/2021 11:31,8992628020152,MINYAK GOREG BIMOLI POUCH 2L,1,35000,0,35000,29800,5200
12/11/2021 11:42,kiko,kiko,1,1000,0,1000,900,100
12/11/2021 11:42,6907992825076,JD WATERMELON APPLE,1,2000,0,2000,1700,300
12/11/2021 11:42,8998866203227,MIE SEDAAP AYAM BAKAR LIMAU,1,2700,0,2700,2163,537
12/11/2021 11:42,Garuda pilus,Garuda Pilus Pedas Pcs,3,500,0,1500,1224,276
12/11/2021 11:42,ROTI,ROTI 2000,1,2000,0,2000,1800,200
12/11/2021 11:42,UBI,KRIPIK UBI,1,5000,0,5000,4000,1000
12/11/2021 11:42,KRIPIK,KRIPIK KENTANG,1,1000,0,1000,900,100
12/11/2021 11:42,8991102022347,SIKAT GIGI FORMULA RIPPLE,2,5000,0,10000,9166,834
12/11/2021 11:42,8993560026004,DETTOL ORIGINAL,1,20000,0,20000,18524,1476
12/11/2021 11:42,8998866601429,POWDET DAIA BUNGA BAG 290GR,1,5000,0,5000,4450,550
12/11/2021 11:42,8999999534752,PEPSODENT ACTION123 CHARCOAL 65G,1,7400,0,7400,6710,690
12/11/2021 11:42,8991111102603,JB SHAMPOO GOLD 100ML,1,9200,0,9200,8250,950
12/11/2021 11:42,8997028590014,ARGUS 220ML,4,500,0,2000,1208,792
12/11/2021 11:42,8995333032113,TERIGU GATOT KACA 1 KG,4,9000,0,36000,34288,1712
12/11/2021 11:59,gula,GULA,5,11500,0,57500,50000,7500
12/11/2021 11:59,8851019015132,POCKY DOUBLE CHOCOLATE 47G,2,7300,0,14600,11342,3258
12/11/2021 11:59,8992761166052,FRESTEA MELATI 350ML,1,4500,0,4500,3000,1500
12/11/2021 11:59,8991102714846,MILKIDO CKLT,1,3000,0,3000,2153,847
12/11/2021 11:59,8998866611107,RAPIKA BIANG GOLD 250MLBTL,1,8500,0,8500,7650,850
12/11/2021 11:59,8991102384841,WFR TANGO LONG CKLT 130G,1,5000,0,5000,4345,655
12/11/2021 11:59,8999909002821,MARLBORO BLACK 16,1,22000,0,22000,20900,1100
12/11/2021 11:59,8999999059781,SUNLIGHT LIME NEW POUCH 210ML,1,5000,0,5000,4520,480
12/11/2021 11:59,8999999046996,LIFEBUOY TOTAL10 60G,1,3000,0,3000,1800,1200
12/11/2021 11:59,Telur,Telur,2,2000,0,4000,0,4000
12/11/2021 11:59,8996001302316,MALKIST ABON SCT,1,1000,0,1000,840,160
12/11/2021 11:59,8997012321204,MAXX BUMBU BALADO,1,5000,0,5000,4100,900
12/11/2021 11:59,8995333060772,TERIGU GATOT KACA 500GR,1,5000,0,5000,4346,654
12/11/2021 11:59,8992742360844,POLYTEX SABUT STENLESS,1,4000,0,4000,2200,1800
12/11/2021 12:12,SURYA BTG,SURYA BATANG,2,2000,0,4000,2760,1240
12/11/2021 12:20,711844340008,ABC TERASI,1,7000,0,7000,5800,1200
12/11/2021 12:31,kiko,kiko,1,1000,0,1000,900,100
12/11/2021 12:35,6907992825076,JD WATERMELON APPLE,1,2000,0,2000,1700,300
12/11/2021 12:35,8992730950194,GULA GULA KOIN,6,500,0,3000,2400,600
12/11/2021 13:21,8996001600269,LE MINERAL 600ML,12,3000,0,36000,20256,15744
12/11/2021 13:41,8998989300261,GUDANG GARAM SURYA 12 FILTER,1,20000,0,20000,18150,1850
12/11/2021 13:41,8998866203272,MIE SUKSES MANTAP ISI 2,1,3500,0,3500,3046,454
12/11/2021 14:09,8998866202244,EKOMIE BUMBU KALDU AYAM,10,1000,0,10000,7980,2020
12/11/2021 15:29,7622201430153,OREO CHOCOLATE 38G,1,2000,0,2000,1641,359
12/11/2021 15:29,kiko,kiko,1,1000,0,1000,900,100
12/11/2021 15:29,8992775002582,DILAN CHOCO,1,2000,0,2000,1503,497
12/11/2021 15:29,76164217,MARLBORO MERAH,1,31000,0,31000,29650,1350
12/11/2021 15:29,8992959117583,SOFTEX DAUN SIRIH,1,5000,0,5000,4288,712
12/11/2021 15:29,8992775312469,GERY SALUT COKELAT,1,11000,0,11000,9983,1017
12/11/2021 15:29,8991102384841,WFR TANGO LONG CKLT 130G,1,5000,0,5000,4345,655
12/11/2021 15:29,8886013213208,FRENCH FREIS 2000,2,5000,0,10000,7500,2500
12/11/2021 15:29,8992775211410,PILUS GARUDA PEDAS,2,5500,0,11000,9772,1228
12/11/2021 15:29,8996001600399,LE MINERAL 1500ML,1,5000,0,5000,4042,958
12/11/2021 15:29,8996001320068,GULA GULA KOPIKO,8,250,0,2000,1600,400
12/11/2021 15:29,8999999049447,REXONA WMN RO ADVANCED WHITE 45 ML,1,16500,0,16500,14900,1600
12/11/2021 15:54,8996001600269,LE MINERAL 600ML,1,3000,0,3000,1688,1312
12/11/2021 15:54,8886008101053,AQUA 600 ML,1,3500,0,3500,2125,1375
12/11/2021 15:54,8992775001042,PILUS GARUDA MI GORENG,1,5000,0,5000,4810,190
12/11/2021 17:02,ARG,ARGUS DOS 220ML,1,15000,0,15000,13500,1500
12/11/2021 17:03,8994867007161,ROKOK PENA GOLD 20,1,19000,0,19000,17400,1600
12/11/2021 17:03,8999909002821,MARLBORO BLACK 16,1,22000,0,22000,20900,1100
12/11/2021 17:25,TK,TEPUNG KETAN,1,13000,0,13000,13000,0
12/11/2021 17:25,8995333000822,TERIGU KOMPAS SOFT 500GR,1,5500,0,5500,4967,533
12/11/2021 17:29,8997011700123,BIHUN JAGUNG 300GR,3,6000,0,18000,14937,3063
12/11/2021 17:35,PD,PENDEKAR,40,500,0,20000,14000,6000
12/11/2021 18:20,8998866500708,FLORIDINA ORANGE,1,3000,0,3000,2500,500
12/11/2021 18:20,8991002121010,GOOD DAY FANTASTIC MOCACINNO,1,7000,0,7000,4750,2250
12/11/2021 18:20,8991102987639,WFR TANGO LONG VNL 130G,1,5000,0,5000,4350,650
12/11/2021 18:36,SURYA BTG,SURYA BATANG,1,2000,0,2000,1380,620
12/11/2021 18:36,8998989500166,GUDANG GARAM MERAH BESAR 16KS,1,18000,0,18000,17000,1000
12/11/2021 18:47,8998866200561,EKOMIE SUPER 600GR,2,10000,0,20000,17230,2770
12/11/2021 18:48,VTM,VITAMIN CIMIN,3,500,0,1500,1275,225
12/11/2021 18:48,KIKO,KIKO,2,1000,0,2000,1000,1000
12/11/2021 18:48,COKLAT,COKLAT COIN,1,500,0,500,425,75
12/11/2021 18:50,8994867000162,ROKOK PUNDIMAS KRETEK16,1,10000,0,10000,8600,1400
12/11/2021 19:07,8998866200578,MIE SEDAAP KARI KENTAL,1,2700,0,2700,2331,369
12/11/2021 19:07,8998866200561,EKOMIE SUPER 600GR,2,10000,0,20000,17230,2770
12/11/2021 19:09,8999909096004,SAMPOERNA 16 FILTER,2,25000,0,50000,46200,3800
12/11/2021 19:10,123124,KOREK BIASA,1,2000,0,2000,1300,700
12/11/2021 19:21,8998989300261,GUDANG GARAM SURYA 12 FILTER,1,20000,0,20000,18150,1850
12/11/2021 19:21,089686021127,INTER MIE KALDU,2,1000,0,2000,1626,374
12/11/2021 19:21,ROTI,ROTI 2000,2,2000,0,4000,3600,400
12/11/2021 20:02,8992761122430,FRESTEA GREEN HONEY 500ML,1,6500,0,6500,4708,1792
12/11/2021 20:02,8999999195656,SARIWANGI 50X1.85,1,10000,0,10000,9405,595
12/11/2021 20:05,8998989300261,GUDANG GARAM SURYA 12 FILTER,1,20000,0,20000,18150,1850
12/11/2021 20:15,8993154789575,GULA GULA TUSUK,10,500,0,5000,4000,1000
12/11/2021 21:12,8997009510055,YOU C1000,2,15000,0,30000,26000,4000
12/11/2021 21:15,8998866500708,FLORIDINA ORANGE,3,3000,0,9000,7500,1500
12/11/2021 21:15,ARG,ARGUS DOS 220ML,1,15000,0,15000,13500,1500
12/11/2021 21:18,8998866200301,MIE SEDAAP GORENG,3,3000,0,9000,7242,1758
12/11/2021 21:18,8998866203227,MIE SEDAAP AYAM BAKAR LIMAU,2,2700,0,5400,4326,1074
12/11/2021 21:55,8997028590014,ARGUS 220ML,2,500,0,1000,604,396
12/11/2021 22:12,8997028590014,ARGUS 220ML,4,500,0,2000,1208,792
12/11/2021 22:13,TG,TEH GELAS,6,1000,0,6000,4374,1626
12/11/2021 22:16,8999999001155,LIFEBUOY BW TOTAL10 300ML,1,24000,0,24000,21550,2450
12/11/2021 22:16,8991102024099,FORMULA CURVE,1,5000,0,5000,3000,2000
12/11/2021 22:16,8886013213208,FRENCH FREIS 2000,2,5000,0,10000,7500,2500
12/11/2021 22:16,8999999706449,CLOSEUP ICY WHITE 65G,1,9000,0,9000,7865,1135
12/11/2021 22:25,8991914101513,VIPER KRETEK 12,2,6000,0,12000,10000,2000
12/11/2021 22:45,8995102703534,TERASI DUO 6 GR,1,4000,0,4000,3720,280
12/11/2021 22:51,8998866203272,SUKSES AYAM GEPREK,1,4000,0,4000,3046,954
12/12/2021 11:44,8997021110028,Garam Kasar,1,3000,0,3000,1500,1500
12/12/2021 12:22,8991909101016,URBAN MILD 16,1,17000,0,17000,15800,1200
12/12/2021 12:22,VTM,VITAMIN CIMIN,2,500,0,1000,850,150
12/12/2021 12:22,123124,KOREK BIASA,1,2000,0,2000,1300,700
12/12/2021 12:33,6907992823591,JD STRAW MILKSHAKE,4,5000,0,20000,17200,2800
12/12/2021 13:28,8997028590014,ARGUS 220ML,2,500,0,1000,604,396
12/12/2021 14:59,8998866200301,MIE SEDAAP GORENG,1,3000,0,3000,2414,586
12/12/2021 14:59,8998866200325,MIE SEDAAP SOTO,1,2700,0,2700,2282,418
12/12/2021 16:43,SURYA BTG,SURYA BATANG,3,1666,0,4998,4140,858
12/12/2021 19:12,ROTI,ROTI 2000,5,2000,0,10000,9000,1000
12/12/2021 19:12,8999999195656,SARIWANGI 50X1.85,1,10000,0,10000,9405,595
12/12/2021 19:50,8992959508947,SWEETY SILVER PANTS XL 44,1,98000,0,98000,90152,7848
12/12/2021 20:26,8999909982000,SAMPOERNA 12 FILTER,1,19000,0,19000,16600,2400
12/12/2021 20:26,8998989300261,GUDANG GARAM SURYA 12 FILTER,1,20000,0,20000,18150,1850
12/12/2021 21:17,8997028590045,ARGUS BTL 330ML,1,2000,0,2000,1291,709
12/12/2021 22:00,8998989300261,GUDANG GARAM SURYA 12 FILTER,1,20000,0,20000,18150,1850
12/12/2021 22:00,8994867000162,ROKOK PUNDIMAS KRETEK16,1,10000,0,10000,8600,1400
12/12/2021 22:11,ARG,ARGUS DOS 220ML,1,15000,0,15000,13500,1500
12/12/2021 22:11,8993058105013,EXTRA JOSS,1,12000,0,12000,9773,2227
12/12/2021 22:11,8998866202237,NOODLE SEDAAP TASTY AYAM GEPREK 124 GR,1,5000,0,5000,4167,833
12/12/2021 22:13,089686727081,DORITOS 55G,1,7000,0,7000,5950,1050
12/12/2021 22:13,TG APEL,TEH GELAS APEL,1,2000,0,2000,1178,822
12/12/2021 22:13,8992741952262,GULA GULA YUPI,4,250,0,1000,800,200
12/13/2021 11:56,kiko,kiko,9,1000,0,9000,8100,900
12/13/2021 11:56,6907992825076,JD WATERMELON APPLE,1,2000,0,2000,1700,300
12/13/2021 11:56,8994907000428,KECAP SACHET ABC,4,600,0,2400,2000,400
12/13/2021 11:56,8995555121244,SOSIS KIMBO,2,1000,0,2000,1300,700
12/13/2021 11:56,8997011700123,BIHUN JAGUNG 300GR,1,6000,0,6000,4979,1021
12/13/2021 11:56,8886467100017,PRINGLES,2,23000,0,46000,38000,8000
12/13/2021 11:56,8997218380135,ICHITAN GREEN TEA,1,8000,0,8000,6500,1500
12/13/2021 11:56,8996001320068,GULA GULA KOPIKO,8,250,0,2000,1600,400
12/13/2021 11:56,8992775311547,Chocolatos,4,2000,0,8000,6000,2000
12/13/2021 11:56,8996001410042,TB TORA MOKA,1,1500,0,1500,870,630
12/13/2021 11:56,8997028590014,ARGUS 220ML,12,500,0,6000,3624,2376
12/13/2021 11:56,8992959107607,SFX COMFORT SLIM 1,1,5000,0,5000,4000,1000
12/13/2021 11:56,8992959117613,SFX DAUN SIRIH 1 WP,6,500,0,3000,2478,522
12/13/2021 11:56,VTM,VITAMIN CIMIN,1,500,0,500,425,75
12/13/2021 11:56,7622201430153,OREO CHOCOLATE 38G,1,2000,0,2000,1641,359
12/13/2021 11:56,8999999534752,PEPSODENT ACTION123 CHARCOAL 65G,1,7400,0,7400,6710,690
12/13/2021 11:56,8886013213208,FRENCH FREIS 2000,1,5000,0,5000,3750,1250
12/13/2021 11:56,8998866200837,NOODLE SEDAAPMIE SOTO CUP 81 GR,1,4500,0,4500,3738,762
12/13/2021 11:56,8998009010569,ULTRA CHO 200,2,5000,0,10000,7916,2084
12/13/2021 11:56,ROTI,ROTI 2000,1,2000,0,2000,1800,200
12/13/2021 11:56,8999909085114,SAMPOERNA KRETEK HIJAU 12,1,13000,0,13000,11650,1350
12/13/2021 11:56,8996001600375,LE MINERAL 330ML,1,2000,0,2000,1417,583
12/13/2021 11:56,SONICE,SONICE SOSIS AYAM,1,24000,0,24000,23500,500
12/13/2021 11:56,8992696523067,MILO ACTVGO UHT 180ML,1,4500,0,4500,3719,781
12/13/2021 11:56,8996001355008,BENG-BENG SP20G,1,29000,0,29000,20000,9000
12/13/2021 11:56,8991102945370,Tango Choco Javamocca 20x7 gr,1,10000,0,10000,8200,1800
12/13/2021 12:01,8991102026383,AIR CRYSTALINE 1.5 L,1,5000,0,5000,3471,1529
12/13/2021 12:15,8992761166205,FRESTEA GREEN HONEY 350ML,1,4500,0,4500,3000,1500
12/13/2021 12:20,8999908284907,MY BABY MINYAK TELON 90ML,1,25000,0,25000,22700,2300
12/13/2021 12:40,RB,RED BOLD,1,20000,0,20000,18800,1200
12/13/2021 12:40,8998989300261,GUDANG GARAM SURYA 12 FILTER,1,20000,0,20000,18150,1850
12/13/2021 12:40,KIKO,KIKO,1,1000,0,1000,500,500
12/13/2021 13:09,8997028590014,ARGUS 220ML,4,500,0,2000,1208,792
12/13/2021 13:09,KIKO,KIKO,1,1000,0,1000,500,500
12/13/2021 13:09,6907992823973,JD PINEAPPLE,2,5000,0,10000,8600,1400
12/13/2021 13:21,8993335522427,OXYKLIN VIOLET 800 G,1,21500,0,21500,19208,2292
12/13/2021 13:21,089686021127,INTER MIE KALDU,2,1000,0,2000,1626,374
12/13/2021 13:21,8997011700123,BIHUN JAGUNG 300GR,1,6000,0,6000,4979,1021
12/13/2021 14:06,8999909096004,SAMPOERNA 16 FILTER,1,25000,0,25000,23100,1900
12/13/2021 14:09,6907992825076,JD WATERMELON APPLE,1,2000,0,2000,1700,300
12/13/2021 14:09,6907992824963,JD MILKY CHOCOLATE,1,3000,0,3000,2600,400
12/13/2021 14:38,8995333000822,TERIGU KOMPAS SOFT 500GR,1,5500,0,5500,4967,533
12/13/2021 14:38,8994867000162,ROKOK PUNDIMAS KRETEK16,1,10000,0,10000,8600,1400
12/13/2021 14:38,8994867007161,ROKOK PENA GOLD 20,2,19000,0,38000,34800,3200
12/13/2021 15:14,6907992823935,JD SWEETCORN,1,3500,0,3500,3000,500
12/13/2021 15:14,8996001440049,ENERGEN,1,1500,0,1500,1200,300
12/13/2021 15:38,8992775001783,GERY SALUT MALKIST KELAPA,1,6500,0,6500,5516,984
12/13/2021 15:38,8997218380159,ICHITAN BROWN SUGAR,1,8000,0,8000,6500,1500
12/13/2021 15:53,MRC,MERICA LADA,3,1000,0,3000,2667,333
12/13/2021 15:53,8995555121244,SOSIS KIMBO,2,1000,0,2000,1300,700
12/13/2021 16:15,8999999390198,SUNLIGHT LIME NEW POUCH 755ML,1,18000,0,18000,15950,2050
12/13/2021 17:20,089686021127,INTER MIE KALDU,6,1000,0,6000,4878,1122
12/13/2021 17:20,8998866200301,MIE SEDAAP GORENG,1,3000,0,3000,2414,586
12/13/2021 17:20,8998866200325,MIE SEDAAP SOTO,1,2700,0,2700,2282,418
12/13/2021 19:01,8995333032113,TERIGU GATOT KACA 1 KG,5,9000,0,45000,42860,2140
12/13/2021 19:01,089686043051,INDOMIE COTO MAKASSAR,1,2800,0,2800,2525,275
12/13/2021 19:30,8991102320184,TANGO CHOCO JAVAMOCCA,1,5000,0,5000,4350,650
12/13/2021 19:30,8992705025124,AGAR-AGAR SATELIT MERAH,2,3500,0,7000,5208,1792
12/13/2021 19:30,TBR,TEPUNG BERAS ROSE BRAND,1,8000,0,8000,6150,1850
12/13/2021 19:30,8994191103638,GULA GULA KARET,4,500,0,2000,1600,400
12/13/2021 19:30,8995555171225,KIMBO SOSIS,2,1000,0,2000,1800,200
12/13/2021 19:34,8992775001653,GERY SALUT CHOCOLATE COCONUT,1,2000,0,2000,1476,524
12/13/2021 20:02,ROTI,ROTI 2000,1,2000,0,2000,1800,200
12/13/2021 20:02,8998989300261,GUDANG GARAM SURYA 12 FILTER,1,20000,0,20000,18150,1850
12/13/2021 20:42,8993007003063,ENAAK 500G,1,11000,0,11000,9625,1375
12/13/2021 20:42,gula,GULA,1,11500,0,11500,10000,1500
12/13/2021 20:42,MILKITA,MILKITA,2,250,0,500,400,100
12/13/2021 21:01,8992775002582,DILAN CHOCO,2,2000,0,4000,3006,994
12/13/2021 21:01,KIKO,KIKO,2,1000,0,2000,1000,1000
12/13/2021 21:09,8850007652588,C&C NATURAL BRIGHT 100ML,1,22000,0,22000,19900,2100
12/13/2021 21:09,8998866108126,POSH HIJAB WINTER MAGIC 150ML,1,19500,0,19500,17500,2000
12/13/2021 21:09,8998866200578,MIE SEDAAP KARI KENTAL,2,2700,0,5400,4662,738
12/13/2021 21:09,8998866200301,MIE SEDAAP GORENG,2,3000,0,6000,4828,1172
12/13/2021 21:09,PULPEN SNOWMAN,PULPEN SNOWMAN,1,2500,0,2500,2000,500
12/13/2021 21:29,8999909002821,MARLBORO BLACK 16,1,22000,0,22000,21000,1000
12/13/2021 21:50,8998866600569,SOKLIN LANTAI HIJAU 400ML,1,6000,0,6000,5025,975
12/13/2021 21:50,8999909010567,234 DJI SAM SOE 16,1,22500,0,22500,21500,1000
12/13/2021 21:51,8997218380074,ICHITAN MILK TEA,1,8000,0,8000,6500,1500
12/14/2021 13:06,8991002106116,KOPI KAPTEN,1,7000,0,7000,5120,1880
12/14/2021 13:06,8991914101513,VIPER KRETEK 12,2,6000,0,12000,10000,2000
12/14/2021 13:06,8998009010569,ULTRA CHO 200,1,5000,0,5000,3958,1042
12/14/2021 13:23,8997028590014,ARGUS 220ML,4,500,0,2000,1208,792
12/14/2021 13:23,8995555111221,SOSIS KIMBO,1,1000,0,1000,850,150
12/14/2021 15:44,123124,KOREK BIASA,1,2000,0,2000,1300,700
12/14/2021 15:44,8991909101016,URBAN MILD 16,1,17000,0,17000,15800,1200
12/14/2021 15:44,ROYCO,ROYCO RASA AYAM,6,500,0,3000,2250,750
12/14/2021 16:45,8998989500166,GUDANG GARAM MERAH BESAR 16KS,1,18000,0,18000,17000,1000
12/14/2021 16:45,8994867007161,ROKOK PENA GOLD 20,1,19000,0,19000,17400,1600
12/14/2021 17:05,8992775002582,DILAN CHOCO,1,2000,0,2000,1503,497
12/14/2021 17:05,8999801700030,SUSU FOYU,1,11500,0,11500,10450,1050
12/14/2021 17:05,KOPIKO,KOPIKO,2,250,0,500,350,150
12/14/2021 18:34,gula,GULA,3,11500,0,34500,30000,4500
12/14/2021 18:34,8992696521797,MILO 22G,2,2500,0,5000,3144,1856
12/14/2021 18:35,8998866203272,SUKSES AYAM GEPREK,2,4000,0,8000,6092,1908
12/14/2021 18:35,TG,TEH GELAS,1,1000,0,1000,729,271
12/14/2021 18:35,Garuda pilus pcs,Garuda pilus Rasa Mi Goreng pcs,1,1000,0,1000,808,192
12/14/2021 18:41,8999909096004,SAMPOERNA 16 FILTER,1,25000,0,25000,23100,1900
12/14/2021 18:44,ARG,ARGUS DOS 220ML,1,15000,0,15000,13500,1500
12/14/2021 18:44,8991102228053,TEH GELAS BOTOL,1,3000,0,3000,1695,1305
12/14/2021 18:44,4902430563864,shampo pantene,2,1000,0,2000,1500,500
12/14/2021 18:54,8994867000179,ROKOK PENA MILD 16,1,15500,0,15500,14500,1000
12/14/2021 19:45,8999999050009,SUNLIGHT LIME NEW POUCH 95ML,1,2000,0,2000,1600,400
12/14/2021 19:45,8999999559557,LUX BW MAGICAL ORCHID 85ML,1,5000,0,5000,4000,1000
12/14/2021 20:20,8998866606158,NUVO ACTIVE COOL 110G,1,3000,0,3000,2600,400
12/14/2021 20:20,8993379254469,SABUN LERVIA 90G,1,5000,0,5000,3077,1923
12/14/2021 20:37,LP,LIPTIN IMPLORA,1,20000,0,20000,20000,0
12/14/2021 21:11,8999909002821,MARLBORO BLACK 16,1,22000,0,22000,21000,1000
12/14/2021 21:16,8996001600375,LE MINERAL 330ML,2,2000,0,4000,2834,1166
12/14/2021 21:49,8998989300261,GUDANG GARAM SURYA 12 FILTER,1,20000,0,20000,18150,1850
12/14/2021 22:09,8994867000162,ROKOK PUNDIMAS KRETEK16,1,10000,0,10000,8600,1400
12/14/2021 22:09,lolipop,lolipop,2,1000,0,2000,1700,300
12/14/2021 22:09,8997028590014,ARGUS 220ML,1,500,0,500,302,198
12/14/2021 22:09,8993470279651,JOGER CHOCKY BAR,1,1000,0,1000,867,133
12/14/2021 22:09,MILKITA,MILKITA,6,250,0,1500,1200,300
12/14/2021 22:09,ROTI,ROTI 2000,3,2000,0,6000,5400,600
12/14/2021 22:09,ARG,ARGUS DOS 220ML,1,15000,0,15000,13500,1500
12/14/2021 22:09,8997011700123,BIHUN JAGUNG 300GR,1,6000,0,6000,4979,1021
12/14/2021 22:09,6907992823973,JD PINEAPPLE,1,5000,0,5000,4300,700
12/14/2021 22:09,8993989311699,CLAS MILD 16 FILTER,1,24000,0,24000,21700,2300
12/14/2021 22:23,8998989110167,SURYA GUDANG GARAM 16 FILTER,1,26000,0,26000,23700,2300
12/14/2021 22:25,8999999046996,LIFEBUOY TOTAL10 60G,1,3000,0,3000,1800,1200
12/14/2021 22:25,8999999524722,SUNLIGHT LIME NEW PCH 435ML,1,10000,0,10000,9100,900
12/14/2021 22:25,8998866608459,POWDET DAIA PUTIH BAG 290GR,1,5000,0,5000,4450,550
12/14/2021 22:25,8994420100018,SARDEN SAUS PEDAS,1,7000,0,7000,5833,1167
12/15/2021 12:35,8998989110167,SURYA GUDANG GARAM 16 FILTER,1,26000,0,26000,23700,2300
12/15/2021 12:44,8994867000162,ROKOK PUNDIMAS KRETEK16,1,10000,0,10000,8600,1400
12/15/2021 12:47,KERIPIK,KERIPIK UBI,1,2000,0,2000,1800,200
12/15/2021 13:22,8995555111221,SOSIS KIMBO,1,1000,0,1000,850,150
12/15/2021 14:00,8998989300261,GUDANG GARAM SURYA 12 FILTER,1,20000,0,20000,18150,1850
12/15/2021 14:00,6907992823966,JD BLUEBERRY,1,3500,0,3500,3000,500
12/15/2021 14:00,6907992823935,JD SWEETCORN,1,3500,0,3500,3000,500
12/15/2021 14:14,8998866200301,MIE SEDAAP GORENG,1,3000,0,3000,2414,586
12/15/2021 14:14,8996001301142,ROMA KELAPA,1,8000,0,8000,7000,1000
12/15/2021 14:14,8992760223015,OREO CHOCOLATE CREAM 133G,1,8000,0,8000,6300,1700
12/15/2021 14:17,089686043051,INDOMIE COTO MAKASSAR,1,2800,0,2800,2525,275
12/15/2021 14:17,8998866202619,MIE SEDAAP KOREAN SPICY SOUP,2,2700,0,5400,4644,756
12/15/2021 15:20,8999909085114,SAMPOERNA KRETEK HIJAU 12,1,13000,0,13000,11650,1350
12/15/2021 15:21,8993335521260,Sabun Total Violet 900gr,1,15000,0,15000,13800,1200
12/15/2021 15:29,6907992823874,JD CRUNCHY CHOCO BLUEBERRY,1,5500,0,5500,4700,800
12/15/2021 15:29,8993989311699,CLAS MILD 16 FILTER,1,24000,0,24000,21700,2300
12/15/2021 15:38,6907992823867,JD CRUNCHY CHOCOLATE MALT,1,5500,0,5500,4700,800
12/15/2021 16:25,gula,GULA,1,11500,0,11500,10000,1500
12/15/2021 17:44,8999999559564,LUX BW SOFT ROSE 90ML,1,5000,0,5000,4000,1000
12/15/2021 17:44,8998866608718,DAIA SOFTENER PINK,2,5000,0,10000,8900,1100
12/15/2021 17:44,8998866613699,EMERON LOVELY COOLBRIGHT 100ML,1,4300,0,4300,3800,500
12/15/2021 17:45,8998866201728,POTABEE SELECTION SALTED EGG 68G,1,8000,0,8000,7200,800
12/15/2021 17:45,8998866201865,KRISBEE PILLOW CHOCOLAVA 120 GR,1,8000,0,8000,7250,750
12/15/2021 17:45,8998009010569,ULTRA CHO 200,1,5000,0,5000,3958,1042
12/15/2021 17:59,8996001600269,LE MINERAL 600ML,1,3000,0,3000,1688,1312
12/15/2021 17:59,8997028590014,ARGUS 220ML,4,500,0,2000,1208,792
12/15/2021 18:06,8991188943536,SASA SANTAN KELAPA 65ML,2,3000,0,6000,4874,1126
12/15/2021 19:24,8994867007161,ROKOK PENA GOLD 20,1,19000,0,19000,17400,1600
12/15/2021 19:29,ARG,ARGUS DOS 220ML,1,15000,0,15000,13500,1500
12/15/2021 19:39,8999909002821,MARLBORO BLACK 16,1,22000,0,22000,21000,1000
12/15/2021 20:22,8999909010567,234 DJI SAM SOE 16,1,22500,0,22500,21500,1000
12/15/2021 20:29,8998866200325,MIE SEDAAP SOTO,1,2700,0,2700,2282,418
12/15/2021 20:29,8998866200301,MIE SEDAAP GORENG,1,3000,0,3000,2414,586
12/15/2021 20:29,8998866200578,MIE SEDAAP KARI KENTAL,1,2700,0,2700,2331,369
12/15/2021 20:59,8994867000179,ROKOK PENA MILD 16,1,15500,0,15500,14500,1000
12/15/2021 21:01,ARG,ARGUS DOS 220ML,3,15000,0,45000,40500,4500
12/15/2021 21:01,gula,GULA,4,11500,0,46000,40000,6000
12/15/2021 21:53,SURYA BTG,SURYA BATANG,6,2000,0,12000,8280,3720
12/15/2021 22:06,8991909101016,URBAN MILD 16,1,17000,0,17000,15800,1200
12/15/2021 22:06,SURYA BTG,SURYA BATANG,1,2000,0,2000,1380,620
12/16/2021 12:19,8996001600375,LE MINERAL 330ML,1,2000,0,2000,1417,583
12/16/2021 18:04,8996001600269,LE MINERAL 600ML,1,3000,0,3000,1688,1312
12/16/2021 18:04,8998989300261,GUDANG GARAM SURYA 12 FILTER,1,20000,0,20000,18150,1850
12/16/2021 18:16,8998866610261,DAIA VIOLET GUSSET BAG 290 GR,1,5000,0,5000,4450,550
12/16/2021 18:16,8999999050009,SUNLIGHT LIME NEW POUCH 95ML,1,2000,0,2000,1600,400
12/16/2021 18:16,089686043051,INDOMIE COTO MAKASSAR,1,2800,0,2800,2525,275
12/16/2021 18:16,8991102384841,WFR TANGO LONG CKLT 130G,3,5000,0,15000,13035,1965
12/16/2021 18:16,8996001304129,SLAI OLAI STROBERI,1,12000,0,12000,9900,2100
12/16/2021 18:16,8991102380805,FULLO  CKL PCK 8G,1,11000,0,11000,9900,1100
12/16/2021 18:16,8996001301142,ROMA KELAPA,4,8000,0,32000,28000,4000
12/16/2021 18:16,8998866202343,MIE SEDAAP KOREAN SPICY,5,3000,0,15000,12065,2935
12/16/2021 18:16,8992775312414,GERY CHOCO HEZELNUT,1,11000,0,11000,9983,1017
12/16/2021 18:16,8998989500166,GUDANG GARAM MERAH BESAR 16KS,2,18000,0,36000,34000,2000
12/16/2021 18:16,8851019210292,POCKY 40 GR,1,7000,0,7000,5671,1329
12/16/2021 18:16,8992959508305,SWEETY SILVER PANST L1,2,2500,0,5000,3764,1236
12/16/2021 18:16,8998866109130,SHAMPOOZINC,11,1000,0,11000,3300,7700
12/16/2021 18:16,8998866200578,MIE SEDAAP KARI KENTAL,2,2700,0,5400,4662,738
12/16/2021 18:16,Garuda pilus pcs,Garuda pilus Rasa Mi Goreng pcs,1,1000,0,1000,808,192
12/16/2021 18:16,8998009010569,ULTRA CHO 200,2,5000,0,10000,7916,2084
12/16/2021 18:16,8991102714624,Tanggo Kido Drink 115ml,2,3000,0,6000,4000,2000
12/16/2021 18:16,8998866203272,SUKSES AYAM GEPREK,1,4000,0,4000,3046,954
12/16/2021 18:16,8992775315057,GERY SALUT MALKIST COKLAT,1,6500,0,6500,5516,984
12/16/2021 18:16,JGR SHN,JOGER SHINY SACHET,2,500,0,1000,874,126
12/16/2021 18:16,Garuda pilus,Garuda Pilus Pedas Pcs,6,500,0,3000,2448,552
12/16/2021 18:16,8997028590045,ARGUS BTL 330ML,2,2000,0,4000,2582,1418
12/16/2021 18:16,KIKO,KIKO,6,1000,0,6000,3000,3000
12/16/2021 18:16,8996001328163,GULA GULA TAMARIN,8,250,0,2000,1600,400
12/16/2021 18:16,9556001004673,MILO NESTLE MALAYSIA ACTIVE GO,1,85000,0,85000,80000,5000
12/16/2021 18:16,8992761145033,FANTA STRAW PET 250ML,1,3500,0,3500,2417,1083
12/16/2021 18:16,8994834006128,TICTIC PEDAS,1,2000,0,2000,1700,300
12/16/2021 18:16,PRG,PARAGO,1,500,0,500,400,100
12/16/2021 18:16,8998866202619,MIE SEDAAP KOREAN SPICY SOUP,2,2700,0,5400,4644,756
12/16/2021 18:16,089686611878,QTELA TEMPE,1,6000,0,6000,5370,630
12/16/2021 18:16,8997009460343,NEXI NET,2,1000,0,2000,1800,200
12/16/2021 18:16,8997009461753,TOP ELIT,3,1000,0,3000,1200,1800
12/16/2021 18:16,8997878004327,GULA GULA MILKITA,2,250,0,500,400,100
12/16/2021 18:16,8999909001909,MAGNUM REVAMP BLACK 12,1,18000,0,18000,16300,1700
12/16/2021 18:16,8997027300089,NOMOS,1,4000,0,4000,2963,1037
12/16/2021 18:16,8998866202244,EKOMIE BUMBU KALDU AYAM,12,1000,0,12000,9576,2424
12/16/2021 18:16,8992742360844,POLYTEX SABUT STENLESS,1,4000,0,4000,2200,1800
12/16/2021 18:16,8991002105430,KOPI KAPAL API 65G,4,5000,0,20000,16580,3420
12/16/2021 18:16,8996001600375,LE MINERAL 330ML,1,2000,0,2000,1417,583
12/16/2021 18:16,8994867007161,ROKOK PENA GOLD 20,1,19000,0,19000,17400,1600
12/16/2021 18:16,KERIPIK,KERIPIK UBI,1,2000,0,2000,1800,200
12/16/2021 18:23,ROTI,ROTI 2000,2,2000,0,4000,3600,400
12/16/2021 18:28,8999999195656,SARIWANGI 50X1.85,1,10000,0,10000,9405,595
12/16/2021 18:28,8996001302316,MALKIST ABON SCT,3,1000,0,3000,2520,480
12/16/2021 19:02,8992761111533,SPRITE SLIM CAM250ML,1,5000,0,5000,3750,1250
12/16/2021 19:02,8886001038011,BENG-BENG SCT,2,1500,0,3000,2000,1000
12/16/2021 19:05,8992761111533,SPRITE SLIM CAM250ML,1,5000,0,5000,3750,1250
12/16/2021 19:05,8886013213208,FRENCH FREIS 2000,2,5000,0,10000,7500,2500
12/16/2021 19:30,8999909010567,234 DJI SAM SOE 16,2,22500,0,45000,43000,2000
12/16/2021 19:49,gula,GULA,1,11500,0,11500,10000,1500
12/16/2021 19:49,8994191103638,GULA GULA KARET,1,500,0,500,400,100
12/16/2021 20:03,PULPEN SNOWMAN,PULPEN SNOWMAN,1,2500,0,2500,2000,500
12/16/2021 20:20,6907992825076,JD WATERMELON APPLE,1,2000,0,2000,1700,300
12/16/2021 20:20,6907992823669,JD MILKY STRAW,1,3000,0,3000,2600,400
12/16/2021 20:20,6907992824963,JD MILKY CHOCOLATE,1,3000,0,3000,2600,400
12/16/2021 20:20,MARS,MARSHMELLOW,6,500,0,3000,2598,402
12/16/2021 20:22,Vita Jelly,Vita Jelly,1,1000,0,1000,766,234
12/16/2021 20:32,8998866202343,MIE SEDAAP KOREAN SPICY,2,3000,0,6000,4826,1174
12/16/2021 20:32,8998866200301,MIE SEDAAP GORENG,4,3000,0,12000,9656,2344
12/16/2021 20:32,8998989110167,SURYA GUDANG GARAM 16 FILTER,1,26000,0,26000,23700,2300
12/16/2021 20:32,8991102228053,TEH GELAS BOTOL,1,3000,0,3000,1695,1305
12/16/2021 20:34,089686021127,INTER MIE KALDU,5,1000,0,5000,4065,935
12/16/2021 20:34,8998866202244,EKOMIE BUMBU KALDU AYAM,7,1000,0,7000,5586,1414
12/16/2021 20:34,8992959508947,SWEETY SILVER PANTS XL 44,1,98000,0,98000,90152,7848
12/16/2021 20:44,KIKO,KIKO,1,1000,0,1000,500,500
12/16/2021 20:50,8997218380074,ICHITAN MILK TEA,1,8000,0,8000,6500,1500
12/16/2021 20:55,8992979190986,TOTAL PUTIH SOFTENER,1,15000,0,15000,13524,1476
12/16/2021 20:55,8999999707859,CLOSEUP GREEN 160G,1,15000,0,15000,13600,1400
12/16/2021 20:55,8998866107464,POSH FRESH SPIRIT 150ML,1,19500,0,19500,17500,2000
12/16/2021 20:55,8999999533717,CITRA TS FRESH WHITE 70G,2,2200,0,4400,3800,600
12/16/2021 20:55,8999999048242,SUNSILK SHP SOFT&SMOOTH 9ML,1,11000,0,11000,9300,1700
12/16/2021 21:06,8992696404441,SUSU BERUANG,1,13000,0,13000,8585,4415
12/16/2021 21:06,8997009510055,YOU C1000,1,15000,0,15000,13000,2000
12/16/2021 21:06,7622300335809,OREO SOFT CAKE,1,2000,0,2000,1641,359
12/16/2021 21:46,8999909002821,MARLBORO BLACK 16,1,22000,0,22000,21000,1000
12/17/2021 16:01,8996001600269,LE MINERAL 600ML,1,3000,0,3000,1688,1312
12/17/2021 16:01,SURYA BTG,SURYA BATANG,3,1666,0,4998,4140,858
12/17/2021 16:26,9556001025272,NESCAFE LATTE 240ML,1,8500,0,8500,7834,666
12/17/2021 16:26,8886008101053,AQUA 600 ML,5,3500,0,17500,10625,6875
12/17/2021 18:08,ROTI,ROTI 2000,2,2000,0,4000,3600,400
12/17/2021 18:39,8991901101083,ROKOK CRYSTAL MERAH,1,16500,0,16500,14800,1700
12/17/2021 18:39,RB,RED BOLD,2,20000,0,40000,37600,2400
12/17/2021 18:39,8999909000773,MARLBORO BLACK 12,1,17000,0,17000,15950,1050
12/17/2021 18:40,8999909982000,SAMPOERNA 12 FILTER,1,19000,0,19000,16600,2400
12/17/2021 18:41,8996001600269,LE MINERAL 600ML,2,3000,0,6000,3376,2624
12/17/2021 18:41,8994834003752,TICTIC,1,2000,0,2000,1700,300
12/17/2021 18:41,8992761166038,MMP ORANGE 300ML,1,5000,0,5000,3750,1250
12/17/2021 19:01,8999999559854,AXE BLACK POCKET FRAG 17ML,1,10000,0,10000,8000,2000
12/17/2021 19:13,8993083929912,BISKITOP ASSORTED WAFER STICK,1,30000,0,30000,28400,1600
12/17/2021 19:13,8993083929837,BISKITOP BLACK COOKIES,1,27000,0,27000,23700,3300
12/17/2021 19:13,8998866202343,MIE SEDAAP KOREAN SPICY,2,3000,0,6000,4826,1174
12/17/2021 19:14,8998989300261,GUDANG GARAM SURYA 12 FILTER,1,20000,0,20000,18150,1850
12/17/2021 20:11,TG,TEH GELAS,3,1000,0,3000,2187,813
12/17/2021 20:11,Vita Jelly,Vita Jelly,3,1000,0,3000,2298,702
12/17/2021 21:09,8997013180046,Tissu Tessi B,1,11000,0,11000,9800,1200
12/17/2021 21:09,MILKITA,MILKITA,4,250,0,1000,800,200
12/17/2021 21:10,8996001600375,LE MINERAL 330ML,1,2000,0,2000,1417,583
12/17/2021 21:15,76239878,MARLBORO GOLD,1,31000,0,31000,29650,1350
12/17/2021 21:19,8998866610377,ISOPLUS,1,3000,0,3000,2350,650
12/17/2021 21:21,6907992823867,JD CRUNCHY CHOCOLATE MALT,1,5500,0,5500,4700,800
12/17/2021 21:29,8997028590045,ARGUS BTL 330ML,1,2000,0,2000,1291,709
12/17/2021 21:29,8991102714891,Kopi Seruput susu tulen 200 ml,1,3000,0,3000,2375,625
12/17/2021 21:53,ARG,ARGUS DOS 220ML,1,15000,0,15000,13500,1500
12/17/2021 21:53,8999999538422,CLEAR SHP ICM UNISEX 55 ML,1,5000,0,5000,3750,1250
12/17/2021 22:06,SURYA BTG,SURYA BATANG,3,1666,0,4998,4140,858
12/18/2021 10:55,8998866107112,WET WIPES KODOMO  BABY 50SHT,1,10000,0,10000,14150,-4150
12/18/2021 10:55,8992959508848,SWEETY SILVER PANTS L18,1,41500,0,41500,37728,3772
12/18/2021 10:55,8997009510123,ORANGE WATER,3,8000,0,24000,18795,5205
12/18/2021 10:55,8998127912370,DUNHILL 20,1,33000,0,33000,31500,1500
12/18/2021 11:36,8993989311699,CLAS MILD 16 FILTER,1,24000,0,24000,21700,2300
12/18/2021 11:42,8998666002525,TB TORA CAFE CAPPUCINO,1,1000,0,1000,780,220
12/18/2021 11:42,KOPIKO,KOPIKO,4,250,0,1000,700,300
12/18/2021 11:42,8992741952262,GULA GULA YUPI,4,250,0,1000,800,200
12/18/2021 11:50,8995333060703,TERIGU KOMPAS 1KG,1,10500,0,10500,9816,684
12/18/2021 11:51,6907992823973,JD PINEAPPLE,1,5000,0,5000,4300,700
12/18/2021 12:05,SURYA BTG,SURYA BATANG,3,1.66666E+16,0,4.99998E+16,4140,85998
12/18/2021 12:48,8998866200301,MIE SEDAAP GORENG,1,3000,0,3000,2414,586
12/18/2021 12:48,8994834003752,TICTIC,2,2000,0,4000,3400,600
12/18/2021 14:51,8993989311699,CLAS MILD 16 FILTER,1,24000,0,24000,21700,2300
12/18/2021 14:51,8997028590052,ARGUS BTL 600ML,2,3000,0,6000,2916,3084
12/18/2021 14:51,8992761002039,FANTA STRAWBERRY PET 390 ML,1,5500,0,5500,4333,1167
12/18/2021 15:04,SURYA BTG,SURYA BATANG,3,1.66666E+16,0,4.99998E+16,4140,85998
12/18/2021 15:23,8991914101513,VIPER KRETEK 12,1,6000,0,6000,5000,1000
12/18/2021 15:23,8991102714624,Tanggo Kido Drink 115ml,2,3000,0,6000,4000,2000
12/18/2021 16:56,8992628034159,BIMOLI SPESIAL 1 LT,1,21000,0,21000,19000,2000
12/18/2021 17:25,KIKO,KIKO,2,1000,0,2000,1000,1000
12/18/2021 17:35,8998989300261,GUDANG GARAM SURYA 12 FILTER,1,20000,0,20000,18150,1850
12/18/2021 17:55,8991002103931,GOOD DAY CARREBIAN NUT,2,1500,0,3000,1780,1220
12/18/2021 18:36,8886008101091,"AQUA 1,5 ML",1,5500,0,5500,4600,900
12/18/2021 18:37,KIKO,KIKO,1,1000,0,1000,500,500
12/18/2021 18:37,8997028590014,ARGUS 220ML,4,500,0,2000,1208,792
12/18/2021 18:37,KOPIKO,KOPIKO,8,250,0,2000,1400,600
12/18/2021 18:37,6907992823829,JD MILKY MILK,1,3000,0,3000,2600,400
12/18/2021 20:00,6907992824963,JD MILKY CHOCOLATE,1,3000,0,3000,2600,400
12/18/2021 20:00,8996001600375,LE MINERAL 330ML,1,2000,0,2000,1417,583
12/18/2021 20:00,8997028590014,ARGUS 220ML,4,500,0,2000,1208,792
12/18/2021 20:15,KIKO,KIKO,3,1000,0,3000,1500,1500
12/18/2021 20:15,8998989300261,GUDANG GARAM SURYA 12 FILTER,1,20000,0,20000,18150,1850
12/18/2021 20:19,ROTI,ROTI 2000,2,2000,0,4000,3600,400
12/18/2021 20:19,TG,TEH GELAS,1,1000,0,1000,729,271
12/18/2021 20:31,6907992824963,JD MILKY CHOCOLATE,1,3000,0,3000,2600,400
12/18/2021 20:31,TBR,TEPUNG BERAS ROSE BRAND,1,8000,0,8000,6150,1850
12/18/2021 20:31,TG,TEH GELAS,1,1000,0,1000,729,271
12/18/2021 20:31,Vita Jelly,Vita Jelly,1,1000,0,1000,766,234
12/18/2021 20:38,8999801700030,SUSU FOYU,1,11500,0,11500,10450,1050
12/18/2021 20:57,8995333032113,TERIGU GATOT KACA 1 KG,4,9000,0,36000,34288,1712
12/18/2021 20:57,gula,GULA,1,11500,0,11500,10000,1500
12/18/2021 21:28,123124,KOREK BIASA,1,2000,0,2000,1300,700
12/18/2021 21:28,8997028590052,ARGUS BTL 600ML,1,3000,0,3000,1458,1542
12/18/2021 21:42,8992979190986,TOTAL PUTIH SOFTENER,1,15000,0,15000,13524,1476
12/18/2021 21:42,8999999390198,SUNLIGHT LIME NEW POUCH 755ML,1,18000,0,18000,15950,2050
12/18/2021 22:08,8993007003063,ENAAK 500G,1,11000,0,11000,9625,1375
12/18/2021 22:08,8998989110167,SURYA GUDANG GARAM 16 FILTER,1,26000,0,26000,23700,2300
12/18/2021 22:08,8998866609180,SOKLIN SOFTERGENT POUCH 750ML,1,18000,0,18000,16435,1565
12/18/2021 22:08,8998866612173,SOKLIN SOFTERGENT PINK 770G & PIRING,1,20000,0,20000,18055,1945
12/18/2021 22:08,8991102026383,AIR CRYSTALINE 1.5 L,1,5000,0,5000,3471,1529
12/18/2021 22:13,8998866200301,MIE SEDAAP GORENG,2,3000,0,6000,4828,1172
12/18/2021 22:13,8998866200325,MIE SEDAAP SOTO,2,2700,0,5400,4564,836
12/18/2021 22:13,8998866202244,EKOMIE BUMBU KALDU AYAM,15,1000,0,15000,11970,3030
12/18/2021 22:13,gula gula,gula-gula karet,1,500,0,500,400,100
12/18/2021 22:21,8998989110167,SURYA GUDANG GARAM 16 FILTER,1,26000,0,26000,23700,2300
12/19/2021 11:41,8998866202619,MIE SEDAAP KOREAN SPICY SOUP,1,2700,0,2700,2322,378
12/19/2021 11:41,8998866202343,MIE SEDAAP KOREAN SPICY,1,3000,0,3000,2413,587
12/19/2021 12:27,BALON,BALON CABUT,4,1000,0,4000,3600,400
12/19/2021 12:42,8997028590014,ARGUS 220ML,4,500,0,2000,1208,792
12/19/2021 13:30,8991102024099,FORMULA CURVE,1,5000,0,5000,3000,2000
12/19/2021 13:36,4902430563864,shampo pantene,1,1000,0,1000,750,250
12/19/2021 13:36,8998866605137,CLING BIRU POUCH 425ML,1,4000,0,4000,3250,750
12/19/2021 14:03,8886467100017,PRINGLES,1,20000,0,20000,19000,1000
12/19/2021 14:03,8991102587648,TANGO TIRAMISU POUCH 115G,1,8000,0,8000,6874,1126
12/19/2021 14:03,Vita Jelly,Vita Jelly,1,1000,0,1000,766,234
12/19/2021 14:03,8998989100120,GUDANG GARAM MINI,1,19000,0,19000,16600,2400
12/19/2021 14:03,8998989300261,GUDANG GARAM SURYA 12 FILTER,4,20000,0,80000,72600,7400
12/19/2021 14:13,8991102384841,WFR TANGO LONG CKLT 130G,1,5000,0,5000,4333,667
12/19/2021 14:13,8991102989381,TANGO LONG BUBBLEGUM 130G,1,5000,0,5000,4350,650
12/19/2021 14:44,76164217,MARLBORO MERAH,1,31000,0,31000,29650,1350
12/19/2021 15:09,8886030322907,PORSTEX BIRU 500ML,1,15500,0,15500,13000,2500
12/19/2021 15:09,8999999524722,SUNLIGHT LIME NEW PCH 435ML,1,10000,0,10000,9100,900
12/19/2021 15:09,8886020001126,SWALLOW KAMP WHITE 150G,1,14000,0,14000,13000,1000
12/19/2021 15:09,8934868015031,REXONA DEO LOTION ICE COOL,2,4500,0,9000,7800,1200
12/20/2021 21:06,8886008101053,AQUA 600 ML,2,3500,0,7000,4250,2750
12/20/2021 21:30,8999999528805,CITRA HBL PEARLY WHITE UV 230ML,1,20000,0,20000,18040,1960
12/20/2021 21:30,8999999036836,LUX BW VELVET JASMINE LD REFF 450 ML,1,25000,0,25000,22110,2890
12/20/2021 21:30,8991102384841,WFR TANGO LONG CKLT 130G,1,5000,0,5000,4333,667
12/20/2021 21:56,8999999502409,ROYCO FDS BEEF 9G,2,500,0,1000,750,250
12/20/2021 22:01,ROTI,ROTI 2000,1,2000,0,2000,1800,200
12/20/2021 22:18,6907992825076,JD WATERMELON APPLE,1,2000,0,2000,1700,300
12/20/2021 22:18,6907992824963,JD MILKY CHOCOLATE,1,3000,0,3000,2600,400
12/20/2021 22:18,MK BIASA,MASKERBIASA,1,2000,0,2000,1500,500
12/20/2021 22:18,CB,CANNON BALL PCS,2,500,0,1000,750,250
12/20/2021 22:18,JELLY,JELLY AGAR,1,1000,0,1000,900,100
12/20/2021 22:18,8999909001909,MAGNUM REVAMP BLACK 12,1,18000,0,18000,16300,1700
12/20/2021 22:18,ARG,ARGUS DOS 220ML,1,15000,0,15000,13500,1500
12/20/2021 22:18,8998866203272,SUKSES AYAM GEPREK,2,4000,0,8000,6092,1908
12/20/2021 22:18,8997028590014,ARGUS 220ML,5,500,0,2500,1510,990
12/20/2021 22:18,8991914101513,VIPER KRETEK 12,2,6000,0,12000,10000,2000
12/20/2021 22:18,8998866200325,MIE SEDAAP SOTO,2,2700,0,5400,4564,836
12/20/2021 22:18,KPS,KAPAS MEI QIAN,1,5000,0,5000,4750,250
12/20/2021 22:18,8998989110129,SURYA KECIL MERAH 12KS,1,20000,0,20000,18450,1550
12/20/2021 22:18,8997028590045,ARGUS BTL 330ML,3,2000,0,6000,3873,2127
12/20/2021 22:18,KIKO,KIKO,2,1000,0,2000,1000,1000
12/20/2021 22:27,8999999533717,CITRA TS FRESH WHITE 70G,1,2200,0,2200,1900,300
12/20/2021 22:27,4902430563888,SHAMPO PANTENE,1,1000,0,1000,750,250
12/20/2021 22:27,ARG,ARGUS DOS 220ML,1,15000,0,15000,13500,1500
12/20/2021 22:27,KIKO,KIKO,3,1000,0,3000,1500,1500
12/20/2021 22:27,MBL,MOBIL,2,5000,0,10000,7000,3000
12/20/2021 22:27,BALON GAS,BALON GAS,6,500,0,3000,2400,600
12/20/2021 22:27,ES POTONG,ES POTONG,2,1000,0,2000,1000,1000
12/20/2021 22:27,8993154789575,GULA GULA TUSUK,2,500,0,1000,800,200
12/20/2021 22:27,6907992823966,JD BLUEBERRY,1,3500,0,3500,3000,500
12/20/2021 22:27,TG,TEH GELAS,2,1000,0,2000,1458,542
12/20/2021 22:27,8991102714891,Kopi Seruput susu tulen 200 ml,1,3000,0,3000,2375,625
12/20/2021 22:27,8993470411433,JOGER CLASSIC,1,1000,0,1000,850,150
12/20/2021 22:27,8993470671752,JOGER STICK DUO KACANG,1,1000,0,1000,850,150
12/20/2021 22:27,8991102714846,MILKIDO CKLT,1,3000,0,3000,2153,847
12/20/2021 22:27,8998866202244,EKOMIE BUMBU KALDU AYAM,1,1000,0,1000,798,202
12/20/2021 22:27,089686021127,INTER MIE KALDU,1,1000,0,1000,813,187
12/20/2021 22:36,8999999533717,CITRA TS FRESH WHITE 70G,1,2200,0,2200,1900,300
12/20/2021 22:36,VTM,VITAMIN CIMIN,1,500,0,500,425,75
12/20/2021 22:36,8991102987639,WFR TANGO LONG VNL 130G,1,5000,0,5000,4350,650
12/20/2021 22:36,8991102714860,MILKIDO STRAW,2,3000,0,6000,4306,1694
12/20/2021 22:36,8993154789575,GULA GULA TUSUK,40,500,0,20000,16000,4000
12/20/2021 22:36,8996001600269,LE MINERAL 600ML,1,3000,0,3000,1688,1312
12/20/2021 22:36,kiko,kiko,3,1000,0,3000,2700,300
12/20/2021 22:36,8998866202619,MIE SEDAAP KOREAN SPICY SOUP,1,2700,0,2700,2322,378
12/20/2021 22:36,8997028590014,ARGUS 220ML,4,500,0,2000,1208,792
12/20/2021 22:36,8992979120013,TOTAL BUNGA SOFTENER,1,15000,0,15000,13800,1200
12/20/2021 22:36,4902430803380,DOWNY FLORAL PINK 10ML,10,500,0,5000,3930,1070
12/20/2021 22:36,SURYA BTG,SURYA BATANG,6,1500,0,9000,8280,720
12/20/2021 22:36,ES POTONG,ES POTONG,1,1000,0,1000,500,500
12/20/2021 22:36,8992717781025,SANTAN KELAPA,1,4000,0,4000,3000,1000
12/20/2021 22:36,CB,CANNON BALL PCS,2,500,0,1000,750,250
12/20/2021 22:37,KPS,KAPAS MEI QIAN,1,5000,0,5000,4750,250
12/20/2021 22:45,SURYA BTG,SURYA BATANG,3,1500,0,4500,4140,360
12/20/2021 22:45,089686021141,INTER MIE SOTO,2,1000,0,2000,1708,292
12/20/2021 22:45,6907992823867,JD CRUNCHY CHOCOLATE MALT,1,5500,0,5500,4700,800
12/20/2021 22:45,RT 1000,ROTI 1000,1,1000,0,1000,800,200
12/20/2021 22:45,8995555111221,SOSIS KIMBO,1,1000,0,1000,850,150
12/20/2021 22:45,8999999050009,SUNLIGHT LIME NEW POUCH 95ML,1,2000,0,2000,1600,400
12/20/2021 22:45,8992761166052,FRESTEA MELATI 350ML,1,4500,0,4500,3000,1500
12/20/2021 22:45,8999909982000,SAMPOERNA 12 FILTER,1,19000,0,19000,16600,2400
12/20/2021 22:45,4902430563888,SHAMPO PANTENE,1,1000,0,1000,750,250
12/20/2021 22:45,8998989110167,SURYA GUDANG GARAM 16 FILTER,1,26000,0,26000,23700,2300
12/21/2021 20:53,8999909010567,234 DJI SAM SOE 16,1,22500,0,22500,21500,1000
12/21/2021 21:06,8997028590014,ARGUS 220ML,4,500,0,2000,1208,792
12/21/2021 21:29,8996001600375,LE MINERAL 330ML,6,2000,0,12000,8502,3498
12/21/2021 22:07,8997009510123,ORANGE WATER,1,8000,0,8000,6265,1735
12/21/2021 22:20,8999909096004,SAMPOERNA 16 FILTER,1,25000,0,25000,23100,1900
12/22/2021 20:08,8999909002821,MARLBORO BLACK 16,1,22000,0,22000,21000,1000
12/22/2021 20:08,MK,MASKER,1,5000,0,5000,4000,1000
12/22/2021 20:19,8997210107877,VORTEX SMART 3,1,5000,0,5000,4750,250
12/22/2021 20:19,6907992823966,JD BLUEBERRY,1,3500,0,3500,3000,500
12/22/2021 20:19,ROTI,ROTI 2000,1,2000,0,2000,1800,200
12/22/2021 20:19,8998866203227,MIE SEDAAP AYAM BAKAR LIMAU,1,2700,0,2700,2163,537
12/22/2021 20:19,8992775001653,GERY SALUT CHOCOLATE COCONUT,1,2000,0,2000,1476,524
12/22/2021 20:19,8997028590014,ARGUS 220ML,4,500,0,2000,1208,792
12/22/2021 20:19,SURYA BTG,SURYA BATANG,3,2000,0,6000,4140,1860
12/22/2021 20:19,8998989300261,GUDANG GARAM SURYA 12 FILTER,2,20000,0,40000,36300,3700
12/22/2021 20:19,8998866200325,MIE SEDAAP SOTO,2,2700,0,5400,4564,836
12/22/2021 20:19,BALON,BALON CABUT,7,1000,0,7000,6300,700
12/22/2021 20:19,8993989311699,CLAS MILD 16 FILTER,1,24000,0,24000,21700,2300
12/22/2021 20:19,4902430401142,PANTENE HAIRFALL 70ML,1,12500,0,12500,11439,1061
12/22/2021 20:21,8998866200301,MIE SEDAAP GORENG,2,3000,0,6000,4828,1172
12/22/2021 20:29,8992775315057,GERY SALUT MALKIST COKLAT,1,6500,0,6500,5516,984
12/22/2021 20:29,8992628022156,MINYAK GORENG BIMOLI POUCH 1 LT,1,18000,0,18000,16675,1325
12/22/2021 20:29,8997012030748,MADU ENAK,2,1000,0,2000,1800,200
12/22/2021 20:29,089686727081,DORITOS 55G,1,7000,0,7000,5950,1050
12/22/2021 20:29,TG MARKISA,TEH GELAS MARKISA,1,2000,0,2000,1178,822
12/22/2021 20:29,8992741952262,GULA GULA YUPI,4,250,0,1000,800,200
12/22/2021 20:29,8994867007161,ROKOK PENA GOLD 20,1,19000,0,19000,17400,1600
12/22/2021 20:29,KOPIKO,KOPIKO,4,250,0,1000,700,300
12/22/2021 20:29,8998866203227,MIE SEDAAP AYAM BAKAR LIMAU,1,2700,0,2700,2163,537
12/22/2021 20:29,8998866200325,MIE SEDAAP SOTO,1,2700,0,2700,2282,418
12/22/2021 20:29,8998866202237,NOODLE SEDAAP TASTY AYAM GEPREK 124 GR,1,5000,0,5000,4167,833
12/22/2021 20:29,8991102714891,Kopi Seruput susu tulen 200 ml,1,3000,0,3000,2375,625
12/22/2021 20:29,8991102714860,MILKIDO STRAW,1,3000,0,3000,2153,847
12/22/2021 20:29,8997028590014,ARGUS 220ML,2,500,0,1000,604,396
12/22/2021 20:29,kiko,kiko,1,1000,0,1000,900,100
12/22/2021 20:29,8994867000179,ROKOK PENA MILD 16,1,15500,0,15500,14500,1000
12/22/2021 20:37,8992702000063,INDOMILK COKLAT 370G,2,10000,0,20000,18416,1584
12/22/2021 20:37,8996001314005,ROMA KELAPA CREAM CKLT,2,8000,0,16000,13284,2716
12/22/2021 20:37,MK BIASA,MASKERBIASA,1,2000,0,2000,1500,500
12/22/2021 20:37,SURYA BTG,SURYA BATANG,3,2000,0,6000,4140,1860
12/22/2021 20:37,8997028590014,ARGUS 220ML,2,500,0,1000,604,396
12/22/2021 20:37,8993154789575,GULA GULA TUSUK,2,500,0,1000,800,200
12/22/2021 20:37,8996001302323,MALKIST ABON,1,6500,0,6500,4800,1700
12/22/2021 20:37,6907992823850,JD CHOCO CIRLE,1,5500,0,5500,4700,800
12/22/2021 20:37,8999909003873,MARLBORO ADVANCE 12,1,17000,0,17000,15750,1250
12/22/2021 20:37,089686535044,SUN BERAS MERAH,1,8500,0,8500,7410,1090
12/22/2021 20:37,8997218380159,ICHITAN BROWN SUGAR,1,8000,0,8000,6500,1500
12/22/2021 20:37,089686535242,SUN PISANG SUSU,1,8500,0,8500,7410,1090
12/22/2021 20:37,BALON,BALON CABUT,3,1000,0,3000,2700,300
12/22/2021 20:45,8992856892507,VITALIS PINK 120ML,1,22000,0,22000,19900,2100
12/22/2021 20:45,kiko,kiko,1,1000,0,1000,900,100
12/22/2021 20:45,BALON,BALON CABUT,10,1000,0,10000,9000,1000
12/22/2021 20:45,SURYA BTG,SURYA BATANG,6,2000,0,12000,8280,3720
12/22/2021 20:45,8996001305041,ROMA SANDWICH CKLT,2,7000,0,14000,11856,2144
12/22/2021 20:45,9556001004673,MILO NESTLE MALAYSIA ACTIVE GO,1,85000,0,85000,76000,9000
12/22/2021 20:45,6907992823829,JD MILKY MILK,1,3000,0,3000,2600,400
12/22/2021 20:45,6907992823669,JD MILKY STRAW,1,3000,0,3000,2600,400
12/22/2021 20:45,8992761111533,SPRITE SLIM CAM250ML,1,5000,0,5000,3750,1250
12/22/2021 20:45,8998866200301,MIE SEDAAP GORENG,3,3000,0,9000,7242,1758
12/22/2021 20:45,8992959508879,SWEETY SILVER PANTS L7,1,17000,0,17000,15228,1772
12/22/2021 20:45,ARG,ARGUS DOS 220ML,1,15000,0,15000,13500,1500
12/22/2021 20:45,ROTI,ROTI 2000,3,2000,0,6000,5400,600
12/22/2021 20:58,8993989311699,CLAS MILD 16 FILTER,1,24000,0,24000,21700,2300
12/22/2021 20:58,8991102228053,TEH GELAS BOTOL,1,3000,0,3000,1695,1305
12/22/2021 20:58,6907992823867,JD CRUNCHY CHOCOLATE MALT,1,5500,0,5500,4700,800
12/22/2021 20:58,8991102320184,TANGO CHOCO JAVAMOCCA,1,5000,0,5000,4350,650
12/22/2021 20:58,8992628020152,MINYAK GOREG BIMOLI POUCH 2L,1,35000,0,35000,29800,5200
12/22/2021 20:58,8998866203227,MIE SEDAAP AYAM BAKAR LIMAU,2,2700,0,5400,4326,1074
12/22/2021 20:58,8998866200301,MIE SEDAAP GORENG,1,3000,0,3000,2414,586
12/22/2021 20:58,8998989300261,GUDANG GARAM SURYA 12 FILTER,1,20000,0,20000,18150,1850
12/22/2021 20:58,8998866200882,SUKSESMIE GORENG AYAM KRMS 133GR,1,3500,0,3500,3047,453
12/22/2021 20:58,8992775211410,PILUS GARUDA PEDAS,1,5000,0,5000,4886,114
12/22/2021 20:58,8997028590014,ARGUS 220ML,8,500,0,4000,2416,1584
12/22/2021 20:58,8992736220802,Sasa Bumbu Nasi Goreng sambal matah,1,2000,0,2000,1181,819
12/22/2021 20:58,MK,MASKER,2,5000,0,10000,8000,2000
12/22/2021 20:58,8991102714860,MILKIDO STRAW,1,3000,0,3000,2153,847
12/22/2021 20:59,8992628020152,MINYAK GOREG BIMOLI POUCH 2L,1,35000,0,35000,29800,5200
12/22/2021 21:09,8995333032113,TERIGU GATOT KACA 1 KG,2,9000,0,18000,17144,856
12/22/2021 21:09,BALON,BALON CABUT,12,1000,0,12000,10800,1200
12/22/2021 21:09,8999999192150,ROYCO FDS CHICKEN 100GR,1,5000,0,5000,4300,700
12/22/2021 21:09,ARG,ARGUS DOS 220ML,1,15000,0,15000,13500,1500
12/22/2021 21:09,8992696404441,SUSU BERUANG,1,13000,0,13000,8585,4415
12/22/2021 21:09,8996001312278,MALKIST KEJU MANIS,1,6500,0,6500,5400,1100
12/22/2021 21:09,MBL,MOBIL,1,5000,0,5000,3500,1500
12/22/2021 21:09,kiko,kiko,3,1000,0,3000,2700,300
12/22/2021 21:09,MTR,MOTOR,1,5000,0,5000,3500,1500
12/22/2021 21:09,6907992823973,JD PINEAPPLE,1,5000,0,5000,4300,700
12/22/2021 21:09,balon air,balon air,3,2000,0,6000,5100,900
12/22/2021 21:09,8997012321204,MAXX BUMBU BALADO,1,5000,0,5000,4100,900
12/22/2021 21:09,8998866202237,NOODLE SEDAAP TASTY AYAM GEPREK 124 GR,1,5000,0,5000,4167,833
12/22/2021 21:09,8995333000822,TERIGU KOMPAS SOFT 500GR,3,5500,0,16500,14901,1599
12/22/2021 21:09,8998989500166,GUDANG GARAM MERAH BESAR 16KS,2,18000,0,36000,34000,2000
12/22/2021 21:11,8993007001557,INDOMILK SKM 37G,2,1500,0,3000,2162,838
12/22/2021 21:11,ROTI,ROTI 2000,2,2000,0,4000,3600,400
12/22/2021 21:11,8997028590014,ARGUS 220ML,2,500,0,1000,604,396
12/22/2021 21:17,Garuda pilus,Garuda Pilus Pedas Pcs,2,500,0,1000,816,184
12/22/2021 21:18,8993989311279,CLAS MILD 12,1,18000,0,18000,15800,2200
12/22/2021 21:27,gula,GULA,2,11500,0,23000,20000,3000
12/22/2021 22:00,TS,TISSUE TESSY,1,5000,0,5000,4200,800
12/22/2021 22:39,8996001320068,GULA GULA KOPIKO,4,250,0,1000,800,200
12/22/2021 22:39,8993989311699,CLAS MILD 16 FILTER,1,24000,0,24000,21700,2300
12/22/2021 22:39,8999999008475,SUNLIGHT LIME NEW REF 1600ML,1,35000,0,35000,31955,3045
12/22/2021 22:39,8998866202671,NOODLE SEDAAP MIE KOREAN SPICY SOUP CUP,1,5000,0,5000,4002,998
12/22/2021 22:39,8992959117583,SOFTEX DAUN SIRIH,1,5000,0,5000,4288,712
12/22/2021 22:39,8998866603546,SOKLIN FLOORCLENER UNGU 450ML,1,7000,0,7000,6385,615
12/22/2021 22:39,BALON GAS,BALON GAS,4,500,0,2000,1600,400
12/22/2021 22:39,balon air,balon air,1,2000,0,2000,1700,300
12/22/2021 22:39,8992730950194,GULA GULA KOIN,2,500,0,1000,800,200
12/22/2021 22:39,6907992825069,JD FRUITY,1,5000,0,5000,4400,600
12/22/2021 22:39,4902430542753,PARFUM DOWNY,5,1000,0,5000,3750,1250
12/22/2021 22:39,8999999059781,SUNLIGHT LIME NEW POUCH 210ML,1,5000,0,5000,4520,480
12/22/2021 22:39,8992696404441,SUSU BERUANG,1,13000,0,13000,8585,4415
12/22/2021 22:39,8992946521416,SABUN SHINZUI,2,5000,0,10000,8000,2000
12/22/2021 22:39,4902430566889,SHAMPO HEAD & SHOULDERS,11,1000,0,11000,8580,2420
12/22/2021 22:41,089686044249,SUPERMI NUTRIMI STEAK AYAM,3,3500,0,10500,8400,2100
12/22/2021 22:41,8991102387286,TANGO LONG CKLT 47G,5,2000,0,10000,7970,2030
12/23/2021 20:53,8991909101016,URBAN MILD 16,1,17000,0,17000,15800,1200
12/23/2021 21:04,8995555111221,SOSIS KIMBO,4,1000,0,4000,3400,600
12/23/2021 21:04,Garuda Pilus,Garuda Pilus Rasa Abon Pcs,3,500,0,1500,1203,297
12/23/2021 21:04,8996001600375,LE MINERAL 330ML,2,2000,0,4000,2834,1166
12/23/2021 21:04,8991001243034,TOP 9G,1,1000,0,1000,820,180
12/23/2021 21:04,CB,CANNON BALL PCS,2,500,0,1000,750,250
12/23/2021 21:04,8999909002821,MARLBORO BLACK 16,1,22000,0,22000,21000,1000
12/23/2021 21:04,8991906105758,ROKOK LA BOLD,1,26000,0,26000,24900,1100
12/23/2021 21:04,8886008101053,AQUA 600 ML,3,3500,0,10500,6375,4125
12/23/2021 21:04,089686646047,SUNMARIE,1,7000,0,7000,6626,374
12/23/2021 21:04,8996001305058,ROMA SANDWICH KACANG,1,7000,0,7000,5928,1072
12/23/2021 21:04,balon air,balon air,1,1000,0,1000,1700,-700
12/23/2021 21:04,8991909101016,URBAN MILD 16,1,17000,0,17000,15800,1200
12/23/2021 21:04,MK,MASKER,1,5000,0,5000,4000,1000
12/23/2021 21:04,ARG,ARGUS DOS 220ML,1,15000,0,15000,13500,1500
12/23/2021 21:04,8992222050418,GATSBY NORMAL 38GR,1,5000,0,5000,3850,1150
12/23/2021 21:21,089686021127,INTER MIE KALDU,1,1000,0,1000,813,187
12/23/2021 21:21,8997028590014,ARGUS 220ML,12,500,0,6000,3624,2376
12/23/2021 21:21,8998866200301,MIE SEDAAP GORENG,3,3000,0,9000,7242,1758
12/23/2021 21:21,8992775211434,PILUS GARUDA SAPI PANGGANG,2,5000,0,10000,9620,380
12/23/2021 21:21,8991102384841,WFR TANGO LONG CKLT 130G,1,5000,0,5000,4333,667
12/23/2021 21:21,ROTI,ROTI 2000,2,2000,0,4000,3600,400
12/23/2021 21:21,8993226365522,GARAM MEJA GYURI 200GR,1,2000,0,2000,1700,300
12/23/2021 21:21,8999999390198,SUNLIGHT LIME NEW POUCH 755ML,1,18000,0,18000,15950,2050
12/23/2021 21:21,8998989300261,GUDANG GARAM SURYA 12 FILTER,1,20000,0,20000,18150,1850
12/23/2021 21:21,8998989100120,GUDANG GARAM MINI,1,19000,0,19000,16600,2400
12/23/2021 21:21,8997028590052,ARGUS BTL 600ML,3,3000,0,9000,4374,4626
12/23/2021 21:21,089686060027,POP MIE AYAM JUMBO,2,4500,0,9000,7666,1334
12/23/2021 21:21,8886001038011,BENG-BENG SCT,2,1500,0,3000,2000,1000
12/23/2021 21:21,6907992823867,JD CRUNCHY CHOCOLATE MALT,1,5500,0,5500,4700,800
12/23/2021 21:21,6907992823966,JD BLUEBERRY,1,3500,0,3500,3000,500
12/23/2021 21:30,8993154789575,GULA GULA TUSUK,1,500,0,500,400,100
12/23/2021 21:30,8998989300261,GUDANG GARAM SURYA 12 FILTER,1,20000,0,20000,18150,1850
12/23/2021 21:30,8997028590014,ARGUS 220ML,6,500,0,3000,1812,1188
12/23/2021 21:30,kiko,kiko,2,1000,0,2000,1800,200
12/23/2021 21:30,gula,GULA,1,11500,0,11500,10000,1500
12/23/2021 21:30,8997018720469,TISSUE SE-KA,1,10000,0,10000,9300,700
12/23/2021 21:30,8992959117583,SOFTEX DAUN SIRIH,1,5000,0,5000,4288,712
12/23/2021 21:30,SURYA BTG,SURYA BATANG,2,2000,0,4000,2760,1240
12/23/2021 21:30,123124,KOREK BIASA,1,2000,0,2000,1300,700
12/23/2021 21:30,089686021141,INTER MIE SOTO,3,1000,0,3000,2562,438
12/23/2021 21:30,ROTI,ROTI 2000,1,2000,0,2000,1800,200
12/23/2021 21:30,8995333060772,TERIGU GATOT KACA 500GR,1,5000,0,5000,4346,654
12/23/2021 21:30,8995333032113,TERIGU GATOT KACA 1 KG,2,9000,0,18000,17144,856
12/23/2021 21:30,8997012321204,MAXX BUMBU BALADO,1,5000,0,5000,4100,900
12/23/2021 21:30,8999999538439,CLEAR SHP CSC UNISEX 55ML,1,5000,0,5000,3750,1250
12/23/2021 21:31,ROTI,ROTI 2000,5,2000,0,10000,9000,1000
12/23/2021 21:45,8998866200882,SUKSESMIE GORENG AYAM KRMS 133GR,1,3500,0,3500,3047,453
12/23/2021 21:45,8998866202619,MIE SEDAAP KOREAN SPICY SOUP,1,2700,0,2700,2322,378
12/23/2021 21:45,089686611519,QTELA SINGKONG,1,5000,0,5000,4266,734
12/23/2021 21:45,8998866202954,Guribee BBQ Balado 68 gr,1,6000,0,6000,5100,900
12/23/2021 21:45,8998866201490,POTABEE REGULER GRILLED SEAWED 68 GR,1,8000,0,8000,7200,800
12/23/2021 21:45,8991102384841,WFR TANGO LONG CKLT 130G,1,5000,0,5000,4333,667
12/23/2021 21:45,8991002121003,GOOD DAY TIRAMISU BLISS,1,6000,0,6000,4295,1705
12/23/2021 21:45,8998866203272,SUKSES AYAM GEPREK,1,4000,0,4000,3046,954
12/23/2021 21:45,8991111112091,C&C DAILY PORE CLEANSER,1,22000,0,22000,19900,2100
12/23/2021 21:45,ROTI,ROTI 2000,1,2000,0,2000,1800,200
12/23/2021 21:45,8992717900310,KARA SUN,1,2500,0,2500,2000,500
12/23/2021 21:45,8993007001359,INDOMILK KM SCT 37G,1,1500,0,1500,1083,417
12/23/2021 21:45,JD VM,JD VANILLA MILKSHAKE,1,5000,0,5000,4300,700
12/23/2021 21:45,8996001600375,LE MINERAL 330ML,1,2000,0,2000,1417,583
12/23/2021 21:45,7622300335809,OREO SOFT CAKE,1,2000,0,2000,1641,359
12/23/2021 21:52,089686044249,SUPERMI NUTRIMI STEAK AYAM,1,3500,0,3500,2800,700
12/23/2021 21:52,8998866202770,MIE SEDAAP SALERO PADANG,1,2500,0,2500,2362,138
12/23/2021 21:52,8991102387286,TANGO LONG CKLT 47G,3,2000,0,6000,4782,1218
12/23/2021 21:52,8992775315057,GERY SALUT MALKIST COKLAT,1,6500,0,6500,5516,984
12/23/2021 21:52,8998866200882,SUKSESMIE GORENG AYAM KRMS 133GR,2,3500,0,7000,6094,906
12/23/2021 21:52,8998866200325,MIE SEDAAP SOTO,2,2700,0,5400,4564,836
12/23/2021 21:52,8992770033178,Masako,4,500,0,2000,1800,200
12/23/2021 21:52,8992770034175,MASAKO,1,5000,0,5000,4000,1000
12/23/2021 21:52,8999999059781,SUNLIGHT LIME NEW POUCH 210ML,1,5000,0,5000,4520,480
12/23/2021 21:52,8993989311699,CLAS MILD 16 FILTER,1,24000,0,24000,21700,2300
12/23/2021 21:52,8991188943536,SASA SANTAN KELAPA 65ML,1,3000,0,3000,2437,563
12/23/2021 21:52,8999909010567,234 DJI SAM SOE 16,1,22500,0,22500,21500,1000
12/23/2021 21:52,8992628020152,MINYAK GOREG BIMOLI POUCH 2L,1,35000,0,35000,29800,5200
12/23/2021 21:52,8992959953129,SWEETY BRONZE M20,1,35000,0,35000,33020,1980
12/23/2021 21:52,ARG,ARGUS DOS 220ML,6,15000,0,90000,81000,9000
12/23/2021 22:00,8992696521797,MILO 22G,1,2500,0,2500,1572,928
12/23/2021 22:00,089686611519,QTELA SINGKONG,1,5000,0,5000,4266,734
12/23/2021 22:00,8998866202404,NOODLE SEDAAP MIE KOREAN SPICY CHICKEN CUP,1,5000,0,5000,4002,998
12/23/2021 22:00,8998866202619,MIE SEDAAP KOREAN SPICY SOUP,2,2700,0,5400,4644,756
12/23/2021 22:00,kiko,kiko,4,1000,0,4000,3600,400
12/23/2021 22:00,TG,TEH GELAS,1,1000,0,1000,729,271
12/23/2021 22:00,ARG,ARGUS DOS 220ML,1,15000,0,15000,13500,1500
12/23/2021 22:00,8991002121065,GOOD DAY AVOCADO DELIGHT,2,6000,0,12000,8590,3410
12/23/2021 22:00,8997218380074,ICHITAN MILK TEA,2,8000,0,16000,13000,3000
12/23/2021 22:00,8886008101053,AQUA 600 ML,3,3500,0,10500,6375,4125
12/23/2021 22:00,8997009510123,ORANGE WATER,1,8000,0,8000,6265,1735
12/23/2021 22:00,8999909000711,MAGNUM MILD 16,1,21000,0,21000,19350,1650
12/23/2021 22:00,8999909096004,SAMPOERNA 16 FILTER,1,25000,0,25000,23100,1900
12/23/2021 22:00,8996001600375,LE MINERAL 330ML,1,2000,0,2000,1417,583
12/23/2021 22:00,8995555111221,SOSIS KIMBO,3,1000,0,3000,2550,450
12/23/2021 22:08,ARG,ARGUS DOS 220ML,4,15000,0,60000,54000,6000
12/23/2021 22:08,8998866608084,KECAP MANIS SEDAAP POUCH 550ML,2,20000,0,40000,35700,4300
12/23/2021 22:08,JD VM,JD VANILLA MILKSHAKE,1,5000,0,5000,4300,700
12/23/2021 22:08,8992730950194,GULA GULA KOIN,4,500,0,2000,1600,400
12/23/2021 22:08,8999801700030,SUSU FOYU,1,11500,0,11500,10450,1050
12/23/2021 22:08,4902430745703,DOWNY SUNRISE FRESH 10ML,4,500,0,2000,1572,428
12/23/2021 22:08,8999999057640,MOLTO EDP BLK PURPLE 20ML,1,1000,0,1000,800,200
12/23/2021 22:08,8886001038011,BENG-BENG SCT,1,1500,0,1500,1000,500
12/23/2021 22:08,8996001440049,ENERGEN,2,1500,0,3000,2400,600
12/23/2021 22:08,Garuda pilus,Garuda Pilus Pedas Pcs,4,500,0,2000,1632,368
12/23/2021 22:08,8999909002821,MARLBORO BLACK 16,1,22000,0,22000,21000,1000
12/23/2021 22:08,8992628020152,MINYAK GOREG BIMOLI POUCH 2L,1,35000,0,35000,29800,5200
12/23/2021 22:08,8998989500166,GUDANG GARAM MERAH BESAR 16KS,1,18000,0,18000,17000,1000
12/23/2021 22:08,8991102023115,Sikat Gigi Formula,1,11000,0,11000,10000,1000
12/23/2021 22:14,8993989311699,CLAS MILD 16 FILTER,1,24000,0,24000,21700,2300
12/23/2021 22:14,8992736925134,SASA TEPUNG BUMBU SERBAGUNA,1,5500,0,5500,4700,800
12/23/2021 22:14,8992696404441,SUSU BERUANG,1,13000,0,13000,8585,4415
12/23/2021 22:14,ROTI,ROTI 2000,1,2000,0,2000,1800,200
12/23/2021 22:14,8998866200882,SUKSESMIE GORENG AYAM KRMS 133GR,1,3500,0,3500,3047,453
12/23/2021 22:14,8994867007161,ROKOK PENA GOLD 20,1,19000,0,19000,17400,1600
12/23/2021 22:14,8994867000179,ROKOK PENA MILD 16,2,15500,0,31000,29000,2000
12/23/2021 22:14,Garuda Pilus,Garuda Pilus Rasa Abon Pcs,4,500,0,2000,1604,396
12/23/2021 22:14,8991001243034,TOP 9G,1,1000,0,1000,820,180
12/23/2021 22:14,6907992823935,JD SWEETCORN,1,3500,0,3500,3000,500
12/23/2021 22:14,6907992823966,JD BLUEBERRY,1,3500,0,3500,3000,500
12/23/2021 22:14,kiko,kiko,1,1000,0,1000,900,100
12/24/2021 21:59,8999999024482,CITRA BW PEARLY WHITE REFF 220ML,1,12000,0,12000,10700,1300
12/24/2021 22:00,Vita Jelly,Vita Jelly,10,1000,0,10000,7660,2340
12/24/2021 22:00,ROTI,ROTI 2000,5,2000,0,10000,9000,1000
12/26/2021 11:05,ARG,ARGUS DOS 220ML,1,15000,0,15000,13500,1500
12/26/2021 11:05,8997011700123,BIHUN JAGUNG 300GR,1,6000,0,6000,4979,1021
12/26/2021 11:14,8991102714846,MILKIDO CKLT,1,3000,0,3000,2153,847
12/26/2021 11:20,8991001502933,CHACHA TUBE,1,7500,0,7500,6400,1100
12/26/2021 11:20,8996001326237,GULA GULA KIS,2,250,0,500,400,100
12/26/2021 11:20,8991102308892,BLASTO,2,1500,0,3000,2240,760
12/26/2021 11:24,8851019210292,POCKY COOKIES & CREAME 47 GR,1,7000,0,7000,5671,1329
12/26/2021 11:29,8992775002735,CHOCOLATOS SUSU COKELAT,1,4000,0,4000,3520,480
12/26/2021 11:29,6907992823591,JD STRAW MILKSHAKE,2,5000,0,10000,8600,1400
12/26/2021 11:31,KIKO,KIKO,2,1000,0,2000,1000,1000
12/26/2021 11:36,8992696521797,MILO 22G,1,2500,0,2500,1572,928
12/26/2021 12:05,8997009510055,YOU C1000,1,15000,0,15000,13000,2000
12/26/2021 12:05,8992696404441,SUSU BERUANG,1,13000,0,13000,8585,4415
12/26/2021 12:05,8997218380135,ICHITAN GREEN TEA,4,8000,0,32000,26000,6000
12/26/2021 12:05,ARG,ARGUS DOS 220ML,1,15000,0,15000,13500,1500
12/26/2021 12:07,8992761111533,SPRITE SLIM CAM250ML,1,5000,0,5000,3750,1250
12/26/2021 12:41,8998989110167,SURYA GUDANG GARAM 16 FILTER,2,26000,0,52000,47400,4600
12/26/2021 12:46,8993324850395,GENTLE CUTTON BUDS 50,1,3000,0,3000,2000,1000
12/26/2021 12:56,4902430563888,SHAMPO PANTENE,2,1000,0,2000,1500,500
12/26/2021 12:56,AMPLOP,AMPLOP,4,250,0,1000,700,300
12/26/2021 12:57,8997028590014,ARGUS 220ML,8,500,0,4000,2416,1584
12/26/2021 12:57,8991102384841,WFR TANGO LONG CKLT 130G,1,5000,0,5000,4333,667
12/26/2021 15:00,089686021141,INTER MIE SOTO,2,1000,0,2000,1708,292
12/26/2021 15:00,089686021127,INTER MIE KALDU,3,1000,0,3000,2439,561
12/26/2021 15:37,SURYA BTG,SURYA BATANG,6,1666,0,9996,8280,1716
12/26/2021 18:08,ROTI,ROTI 2000,1,2000,0,2000,1800,200
12/26/2021 18:08,HT,HOT-HOT,1,500,0,500,350,150
12/26/2021 18:08,PD,PENDEKAR,1,500,0,500,350,150
12/26/2021 18:08,MBL,MOBIL,1,5000,0,5000,3500,1500
12/26/2021 18:08,MILKITA,MILKITA,4,250,0,1000,800,200
12/26/2021 18:25,8999999524807,SUNLIGHT HABBATUSSAUDA POUCH 755ML,1,18000,0,18000,15950,2050
12/26/2021 18:25,8998866692663,SOKLIN FLOORCLENER KUNING 450ML,1,7000,0,7000,6385,615
12/26/2021 18:25,8991002105409,KOPI KAPAL API,1,20000,0,20000,18888,1112
12/26/2021 18:26,7622201430153,OREO CHOCOLATE 38G,1,2000,0,2000,1641,359
12/26/2021 18:26,CB,CANNON BALL PCS,2,500,0,1000,750,250
12/26/2021 18:43,8997028590014,ARGUS 220ML,2,500,0,1000,604,396
12/26/2021 18:43,ROTI,ROTI 2000,2,2000,0,4000,3600,400
12/26/2021 18:43,7622210437686,BISKUAT,4,500,0,2000,1600,400
12/26/2021 19:21,8991102387286,TANGO LONG CKLT 47G,2,2000,0,4000,3188,812
12/26/2021 19:21,8995333060796,TEPUNG DUA PEDANG 1KG,1,9000,0,9000,7953,1047
12/26/2021 19:30,8886008101091,"AQUA 1,5 ML",1,5500,0,5500,4600,900
12/26/2021 19:30,8996001440049,ENERGEN,1,1500,0,1500,1200,300
12/26/2021 19:41,8993989311699,CLAS MILD 16 FILTER,1,24000,0,24000,21700,2300
12/26/2021 19:45,8999999007799,FAIR & LOVELY MULTIVITAMIN CREAM 50G,1,29000,0,29000,26785,2215
12/26/2021 19:45,KPS,KAPAS MEI QIAN,1,5000,0,5000,4750,250
12/26/2021 19:45,8992979190986,TOTAL PUTIH SOFTENER,1,15000,0,15000,13524,1476
12/26/2021 19:45,8992946512223,SHINZUI,2,5000,0,10000,8000,2000
12/26/2021 19:45,8999999053031,PONDS WHITE BEAUTY FACIAL FOAM100G,1,26000,0,26000,23700,2300
12/26/2021 19:48,8995333000822,TERIGU KOMPAS SOFT 500GR,2,5500,0,11000,9934,1066
12/26/2021 20:03,8991909101016,URBAN MILD 16,1,17000,0,17000,15800,1200
12/26/2021 20:17,8992628034159,BIMOLI SPESIAL 1 LT,1,21000,0,21000,19000,2000
12/26/2021 20:29,8992959508909,SWEETY SILVER PANTS S18,1,30500,0,30500,27617,2883
12/26/2021 20:38,8992959508916,SWEETY SILVER PANTS XXL18,1,54500,0,54500,49546,4954
12/26/2021 20:39,8991906105758,ROKOK LA BOLD,2,26000,0,52000,49800,2200
12/26/2021 20:39,8998989300261,GUDANG GARAM SURYA 12 FILTER,1,20000,0,20000,18150,1850
12/26/2021 20:43,8994191103638,GULA GULA KARET,1,500,0,500,400,100
12/26/2021 20:45,8886008101091,"AQUA 1,5 ML",1,5500,0,5500,4600,900
12/26/2021 20:45,8999909096004,SAMPOERNA 16 FILTER,1,25000,0,25000,23100,1900
12/26/2021 20:45,8994191103638,GULA GULA KARET,1,500,0,500,400,100
12/26/2021 21:18,8999909002821,MARLBORO BLACK 16,1,22000,0,22000,21000,1000
12/26/2021 21:58,8992759120264,LARISST 220,1,10000,0,10000,9200,800
12/26/2021 21:58,8991001780133,TWISTER BLACK,1,5000,0,5000,4600,400
12/27/2021 11:07,8996001305058,ROMA SANDWICH KACANG,1,7000,0,7000,5928,1072
12/27/2021 12:25,8993989311279,CLAS MILD 12,1,18000,0,18000,15800,2200
12/27/2021 12:47,ARG,ARGUS DOS 220ML,1,15000,0,15000,13500,1500
12/27/2021 12:47,KIKO,KIKO,2,1000,0,2000,1000,1000
12/27/2021 12:47,8991102228053,TEH GELAS BOTOL,1,3000,0,3000,1695,1305
12/27/2021 12:57,6907992823966,JD BLUEBERRY,1,3500,0,3500,3000,500
12/27/2021 13:11,8992759120264,LARISST 220,2,11000,0,22000,18400,3600
12/27/2021 13:11,8992959117538,SFX COMFORT SLIM WING 20,1,12000,0,12000,10947,1053
12/27/2021 13:11,TG,TEH GELAS,2,1000,0,2000,1458,542
12/27/2021 13:35,8994867007161,ROKOK PENA GOLD 20,1,19000,0,19000,17400,1600
12/27/2021 13:38,8998866679596,SOKLIN LANTAI BIRU 780ML,1,12000,0,12000,10020,1980
12/27/2021 16:19,8999909010567,234 DJI SAM SOE 16,1,22500,0,22500,21500,1000
12/27/2021 16:58,8997009510055,YOU C1000,1,15000,0,15000,13000,2000
12/27/2021 16:58,SURYA BTG,SURYA BATANG,3,1666,0,4998,4140,858
12/27/2021 17:11,8998989500166,GUDANG GARAM MERAH BESAR 16KS,1,18000,0,18000,17000,1000
12/27/2021 17:18,8992628034159,BIMOLI SPESIAL 1 LT,1,21000,0,21000,19000,2000
12/27/2021 17:27,gula,GULA,1,11500,0,11500,10000,1500
12/27/2021 18:09,MILKITA,MILKITA,4,250,0,1000,800,200
12/27/2021 18:09,ES POTONG,ES POTONG,2,1000,0,2000,1000,1000
12/27/2021 18:17,8997009510055,YOU C1000,1,15000,0,15000,13000,2000
12/27/2021 18:17,8992696404441,SUSU BERUANG,1,13000,0,13000,8585,4415
12/27/2021 19:58,TG,TEH GELAS,1,1000,0,1000,729,271
12/27/2021 19:58,8997028590014,ARGUS 220ML,2,500,0,1000,604,396
12/27/2021 19:58,7622210437686,BISKUAT,2,500,0,1000,800,200
12/27/2021 19:58,8991001780133,TWISTER BLACK,1,5000,0,5000,4600,400
12/27/2021 19:58,8991102384841,WFR TANGO LONG CKLT 130G,1,5000,0,5000,4333,667
12/27/2021 19:58,CB,CANNON BALL PCS,1,500,0,500,375,125
12/27/2021 19:58,8886001038011,BENG-BENG SCT,1,1500,0,1500,1000,500
12/27/2021 19:58,ROTI,ROTI 2000,1,2000,0,2000,1800,200
12/27/2021 19:58,KIKO,KIKO,1,1000,0,1000,500,500
12/27/2021 21:37,SURYA BTG,SURYA BATANG,3,1666,0,4998,4140,858
12/27/2021 21:37,8998989500166,GUDANG GARAM MERAH BESAR 16KS,1,18000,0,18000,17000,1000
12/27/2021 21:37,8998866200301,MIE SEDAAP GORENG,1,3000,0,3000,2414,586
12/27/2021 22:04,8991102714846,MILKIDO CKLT,1,3000,0,3000,2153,847
12/27/2021 22:07,8991914101513,VIPER KRETEK 12,1,6000,0,6000,5600,400
12/28/2021 11:12,ROTI,ROTI 2000,3,2000,0,6000,5400,600
12/28/2021 11:12,KERIPIK,KERIPIK UBI,2,2000,0,4000,3600,400
12/28/2021 11:12,8993274532105,BOLU,2,1000,0,2000,1666,334
12/28/2021 11:12,SURYA BTG,SURYA BATANG,15,1666,0,24990,20700,4290
12/28/2021 11:12,8998866202244,EKOMIE BUMBU KALDU AYAM,1,1000,0,1000,798,202
12/28/2021 11:12,8991111109107,JB POWDER BEDTIME 75+25g,1,6000,0,6000,5440,560
12/28/2021 11:12,8992628034159,BIMOLI SPESIAL 1 LT,1,21000,0,21000,19000,2000
12/28/2021 11:12,MLTO PINK,MOLTO ALL IN ONE,3,1000,0,3000,2400,600
12/28/2021 11:12,8992696521797,MILO 22G,6,2500,0,15000,9432,5568
12/28/2021 11:12,8996001600375,LE MINERAL 330ML,4,2000,0,8000,5668,2332
12/28/2021 11:12,8991914101513,VIPER KRETEK 12,2,6000,0,12000,11200,800
12/28/2021 11:12,8993989311699,CLAS MILD 16 FILTER,1,24000,0,24000,21700,2300
12/28/2021 11:12,8991188943536,SASA SANTAN KELAPA 65ML,1,3000,0,3000,2437,563
12/28/2021 11:12,BALON,BALON CABUT,3,1000,0,3000,2700,300
12/28/2021 11:12,8992775211410,PILUS GARUDA PEDAS,1,5000,0,5000,4886,114
12/28/2021 11:12,8996001600146,TEH PUCUK HARUM 350ML,1,3000,0,3000,2314,686
12/28/2021 11:12,8886001038011,BENG-BENG SCT,2,1500,0,3000,2000,1000
12/28/2021 11:12,8997218380074,ICHITAN MILK TEA,2,8000,0,16000,13000,3000
12/28/2021 11:12,8995333000822,TERIGU KOMPAS SOFT 500GR,4,5500,0,22000,19868,2132
12/28/2021 11:12,8998989300261,GUDANG GARAM SURYA 12 FILTER,2,20000,0,40000,36300,3700
12/28/2021 11:12,8997028590014,ARGUS 220ML,8,500,0,4000,2416,1584
12/28/2021 11:12,9556001004673,MILO NESTLE MALAYSIA ACTIVE GO,1,85000,0,85000,76000,9000
12/28/2021 11:12,8991102384841,WFR TANGO LONG CKLT 130G,2,5000,0,10000,8666,1334
12/28/2021 11:12,8998866202619,MIE SEDAAP KOREAN SPICY SOUP,3,2700,0,8100,6966,1134
12/28/2021 11:12,8851019210292,POCKY COOKIES & CREAME 47 GR,1,7000,0,7000,5671,1329
12/28/2021 11:12,8851019210117,POCKY CHOCOLATE FLAVOUR 47G,1,7500,0,7500,5671,1829
12/28/2021 11:12,8992761166038,MMP ORANGE 300ML,1,5000,0,5000,3750,1250
12/28/2021 11:12,8997009461753,TOP ELIT,5,1000,0,5000,2000,3000
12/28/2021 11:12,8999999030179,PEPSODENT ACTION 123 COMPLETE 75G,1,6700,0,6700,5170,1530
12/28/2021 11:12,9556006004234,JB SHAMPOO SOFT&SMOOTH 200ML,1,18500,0,18500,17020,1480
12/28/2021 11:12,8998866200301,MIE SEDAAP GORENG,2,3000,0,6000,4828,1172
12/28/2021 11:12,8998866200578,MIE SEDAAP KARI KENTAL,1,2700,0,2700,2331,369
12/28/2021 11:12,8999801700030,SUSU FOYU,1,11500,0,11500,10450,1050
12/28/2021 11:12,KIKO,KIKO,1,1000,0,1000,500,500
12/28/2021 11:12,8992702000063,INDOMILK COKLAT 370G,1,10000,0,10000,9208,792
12/28/2021 11:12,8995333060703,TERIGU KOMPAS 1KG,1,10500,0,10500,9816,684
12/28/2021 11:12,8999999567279,SARIWANGI JAHE KUNYIT,1,7500,0,7500,6600,900
12/28/2021 11:12,8998866203272,SUKSES AYAM GEPREK,1,4000,0,4000,3046,954
12/28/2021 11:12,8993335529419,Sabun Total de Parfumee Floral Vibes,1,24500,0,24500,22000,2500
12/28/2021 11:12,8991002101746,KOPI ABC MOCCA,1,1500,0,1500,990,510
12/28/2021 11:12,7622201430153,OREO CHOCOLATE 38G,1,2000,0,2000,1641,359
12/28/2021 11:12,8998866202671,NOODLE SEDAAP MIE KOREAN SPICY SOUP CUP,1,5000,0,5000,4002,998
12/28/2021 11:12,8999909010567,234 DJI SAM SOE 16,2,22500,0,45000,43000,2000
12/28/2021 11:12,8998989110167,SURYA GUDANG GARAM 16 FILTER,1,26000,0,26000,23700,2300
12/28/2021 11:12,8886013213208,FRENCH FREIS 2000,1,5000,0,5000,3750,1250
12/28/2021 11:12,8998866201711,KRISBEE KRUNCHY JAGUNG BAKAR MENTEGA 75 GR,1,5500,0,5500,4400,1100
12/28/2021 11:12,089686021127,INTER MIE KALDU,5,1000,0,5000,4065,935
12/28/2021 11:48,8997028590014,ARGUS 220ML,18,500,0,9000,5436,3564
12/28/2021 11:48,8997028590045,ARGUS BTL 330ML,1,2000,0,2000,1291,709
12/28/2021 11:48,8991102320184,TANGO CHOCO JAVAMOCCA,1,5000,0,5000,4350,650
12/28/2021 11:48,BALON,BALON CABUT,8,1000,0,8000,7200,800
12/28/2021 11:48,8991002106116,KOPI KAPTEN,1,7000,0,7000,5120,1880
12/28/2021 11:48,8999999195649,SARIWANGI 25X1.86G,2,6000,0,12000,10404,1596
12/28/2021 11:48,8992753031894,FRISIAN FLAG,2,2000,0,4000,2000,2000
12/28/2021 11:48,8998898830125,KKB ENER-G ANGGUR,1,5500,0,5500,4824,676
12/28/2021 11:48,ROTI,ROTI 2000,1,2000,0,2000,1800,200
12/28/2021 11:48,8999909002821,MARLBORO BLACK 16,2,22000,0,44000,41700,2300
12/28/2021 11:48,SURYA BTG,SURYA BATANG,7,2000,0,14000,9660,4340
12/28/2021 11:48,gula,GULA,3,11500,0,34500,30000,4500
12/28/2021 11:48,8998866600569,SOKLIN LANTAI HIJAU 400ML,1,6000,0,6000,5025,975
12/28/2021 11:48,8997027490018,LADAMAS MERICA BUBUK,1,9500,0,9500,8898,602
12/28/2021 11:48,8996001301142,ROMA KELAPA,1,8000,0,8000,7000,1000
12/28/2021 11:48,8996001305058,ROMA SANDWICH KACANG,3,7000,0,21000,17784,3216
12/28/2021 11:48,8995333060703,TERIGU KOMPAS 1KG,3,10500,0,31500,29448,2052
12/28/2021 11:48,8992696523067,MILO ACTVGO UHT 180ML,1,4500,0,4500,3719,781
12/28/2021 11:48,6907992823867,JD CRUNCHY CHOCOLATE MALT,1,5500,0,5500,4700,800
12/28/2021 11:48,KIKO,KIKO,3,1000,0,3000,1500,1500
12/28/2021 11:48,6907992825069,JD FRUITY,1,5000,0,5000,4400,600
12/28/2021 11:48,8998866200325,MIE SEDAAP SOTO,1,2700,0,2700,2282,418
12/28/2021 11:48,8998866200882,SUKSESMIE GORENG AYAM KRMS 133GR,1,3500,0,3500,3047,453
12/28/2021 11:48,8992979120013,TOTAL BUNGA SOFTENER,1,15000,0,15000,13800,1200
12/28/2021 11:48,MARS,MARSHMELLOW,4,500,0,2000,1732,268
12/28/2021 11:48,milkita,milkita,3,500,0,1500,1110,390
12/28/2021 11:48,8993470279651,JOGER CHOCKY BAR,1,1000,0,1000,867,133
12/28/2021 11:48,8886013213208,FRENCH FREIS 2000,3,5000,0,15000,11250,3750
12/28/2021 11:48,8996001440049,ENERGEN,1,1500,0,1500,1200,300
12/28/2021 11:48,8991002103764,GOOD DAY CAPPUCINO 10X25G,2,1500,0,3000,2790,210
12/28/2021 11:48,8992696521797,MILO 22G,4,2500,0,10000,6288,3712
12/28/2021 11:48,8999909000544,MARLBORO BLACK 20,1,29000,0,29000,27800,1200
12/28/2021 11:48,8886008101091,"AQUA 1,5 ML",1,5500,0,5500,4600,900
12/28/2021 11:48,711844150003,ABC ORANGE,2,12000,0,24000,19800,4200
12/28/2021 11:48,8991102385336,TANGO WAFFLE MILK,1,10000,0,10000,8200,1800
12/28/2021 11:48,8998866609043,DAIA SOFTENER GUSSET 565G,1,10000,0,10000,8700,1300
12/28/2021 11:48,8998866202619,MIE SEDAAP KOREAN SPICY SOUP,2,2700,0,5400,4644,756
12/28/2021 11:48,4902430557122,KONSENTRAT DOWNY,3,1000,0,3000,2250,750
12/28/2021 11:48,8991102228053,TEH GELAS BOTOL,1,3000,0,3000,1695,1305
12/28/2021 11:48,8851019210292,POCKY COOKIES & CREAME 47 GR,2,7000,0,14000,11342,2658
12/28/2021 11:48,8851019210117,POCKY CHOCOLATE FLAVOUR 47G,1,7500,0,7500,5671,1829
12/28/2021 11:48,8996001600375,LE MINERAL 330ML,2,2000,0,4000,2834,1166
12/28/2021 11:48,7622300761349,OREO MINI CKLT,2,7500,0,15000,13000,2000
12/28/2021 11:48,8991002121010,GOOD DAY FANTASTIC MOCACINNO,1,7000,0,7000,4750,2250
12/28/2021 11:48,8992696404441,SUSU BERUANG,1,12000,0,12000,8585,3415
12/28/2021 11:48,8998866203272,SUKSES AYAM GEPREK,2,4000,0,8000,6092,1908
12/28/2021 11:48,8992959508893,SWEETY SILVER PANTS S9,1,14500,0,14500,13107,1393
12/28/2021 11:48,8998866202671,NOODLE SEDAAP MIE KOREAN SPICY SOUP CUP,1,5000,0,5000,4002,998
12/28/2021 11:48,8998866202244,EKOMIE BUMBU KALDU AYAM,15,1000,0,15000,11970,3030
12/28/2021 11:48,8994834006128,TICTIC PEDAS,1,2000,0,2000,1700,300
12/28/2021 11:48,8991102714624,Tanggo Kido Drink 115ml,6,3000,0,18000,12000,6000
12/28/2021 11:48,6907992823966,JD BLUEBERRY,1,3500,0,3500,3000,500
12/28/2021 11:48,7622210437686,BISKUAT,2,500,0,1000,800,200
12/28/2021 11:48,089686611519,QTELA SINGKONG,1,5000,0,5000,4266,734
12/28/2021 11:48,8992696521629,DNCO COKLT UHT 180ML,1,5000,0,5000,3533,1467
12/28/2021 11:48,Garuda Pilus,Garuda Pilus Rasa Abon Pcs,2,500,0,1000,802,198
12/28/2021 11:48,8998866201711,KRISBEE KRUNCHY JAGUNG BAKAR MENTEGA 75 GR,1,5500,0,5500,4400,1100
12/28/2021 11:48,8998989300261,GUDANG GARAM SURYA 12 FILTER,1,20000,0,20000,18150,1850
12/28/2021 11:48,8998866693578,SOKLIN FLOORCLENER PINK 900ML,1,14000,0,14000,12436,1564
12/28/2021 11:48,4902430745703,DOWNY SUNRISE FRESH 10ML,10,500,0,5000,3930,1070
12/28/2021 11:48,4902430803380,DOWNY FLORAL PINK 10ML,10,500,0,5000,3930,1070
12/28/2021 11:48,CB,CANNON BALL PCS,1,500,0,500,375,125
12/28/2021 12:48,8992760223015,OREO CHOCOLATE CREAM 133G,1,8000,0,8000,6300,1700
12/28/2021 12:53,8997028590014,ARGUS 220ML,4,500,0,2000,1208,792
12/28/2021 13:10,4801010562108,JB SOAP MILK 100GR,1,5000,0,5000,4410,590
12/28/2021 13:10,8993379254469,SABUN LERVIA 90G,1,5000,0,5000,3077,1923
12/28/2021 13:10,8992694246340,ZWITSAL SHP NAT AVKS 100ML,1,11800,0,11800,10395,1405
12/28/2021 13:10,8999908059802,MY BABY POWDER KUNING,1,5000,0,5000,3276,1724
12/28/2021 13:10,8992959953037,SWEETY BRONZE L1,1,2500,0,2500,1819,681
12/28/2021 13:10,8992959001875,SWEETY SILVER PANTS S1,1,2000,0,2000,1528,472
12/28/2021 13:10,8993072254018,MELROSE COTTON BUDS BSR,1,5000,0,5000,4050,950
12/28/2021 13:11,8992741952262,GULA GULA YUPI,7,250,0,1750,1400,350
12/28/2021 14:01,7118441101378,KECAP ABC 520 ML,1,19000,0,19000,17800,1200
12/28/2021 14:04,ROTI,ROTI 2000,2,2000,0,4000,3600,400
12/28/2021 14:04,8996001440049,ENERGEN,8,1500,0,12000,9600,2400
12/28/2021 14:04,8992775315095,GERY MALKIST SWEET CHEESE,1,6500,0,6500,5516,984
12/28/2021 14:04,8997009510055,YOU C1000,2,15000,0,30000,26000,4000
12/28/2021 14:05,8997878004327,GULA GULA MILKITA,2,250,0,500,400,100
12/28/2021 14:59,8991102714594,TANGO DRINK BLCK VNL,1,5000,0,5000,3818,1182
12/28/2021 15:06,8996001600375,LE MINERAL 330ML,2,2000,0,4000,2834,1166
12/28/2021 15:06,8991102385053,WAFFLE CRANCHOX 7G,2,1000,0,2000,810,1190
12/28/2021 15:06,SURYA BTG,SURYA BATANG,3,1666,0,4998,4140,858
12/28/2021 15:10,8991914101513,VIPER KRETEK 12,1,6000,0,6000,5600,400
12/28/2021 15:54,8993226365676,LADA PUTIH,2,1000,0,2000,1550,450
12/28/2021 15:54,HT,HOT-HOT,10,500,0,5000,3500,1500
12/28/2021 15:54,MARS,MARSHMELLOW,10,500,0,5000,4330,670
12/28/2021 15:54,8992775511206,LEO 10GR,1,1000,0,1000,848,152
12/28/2021 16:04,8886008101091,"AQUA 1,5 ML",1,5500,0,5500,4600,900
12/28/2021 16:07,8991002105409,KOPI KAPAL API,1,20000,0,20000,18888,1112
12/28/2021 16:17,8992959953044,SWEETY BRONZE XL1,1,3000,0,3000,2311,689
12/28/2021 16:17,HT,HOT-HOT,2,500,0,1000,700,300
12/28/2021 16:17,8992775511206,LEO 10GR,1,1000,0,1000,848,152
12/28/2021 16:17,milkita,milkita,2,500,0,1000,740,260
12/28/2021 16:17,8996001326237,GULA GULA KIS,4,250,0,1000,800,200
12/28/2021 17:11,8992696405417,DNCO INSTANT 27G,1,3500,0,3500,3000,500
12/28/2021 17:11,8993226365676,LADA PUTIH,2,1000,0,2000,1550,450
12/28/2021 17:11,gula,GULA,1,11500,0,11500,10000,1500
12/28/2021 17:31,6907992823973,JD PINEAPPLE,1,5000,0,5000,4300,700
12/28/2021 17:31,8992696404441,SUSU BERUANG,1,12000,0,12000,8585,3415
12/28/2021 17:31,8996001600375,LE MINERAL 330ML,2,2000,0,4000,2834,1166
12/28/2021 17:31,8999999524722,SUNLIGHT LIME NEW PCH 435ML,1,10000,0,10000,9100,900
12/28/2021 17:37,8992770033178,Masako,2,500,0,1000,900,100
12/28/2021 18:09,8998989300261,GUDANG GARAM SURYA 12 FILTER,1,20000,0,20000,18150,1850
12/28/2021 18:12,8991001503336,chacha minis hat,1,7500,0,7500,6400,1100
12/28/2021 18:13,ROTI,ROTI 2000,1,2000,0,2000,1800,200
12/28/2021 18:15,gula,GULA,1,11500,0,11500,10000,1500
12/28/2021 18:15,ARG,ARGUS DOS 220ML,1,15000,0,15000,13500,1500
12/28/2021 18:15,PD,PENDEKAR,1,500,0,500,350,150
12/28/2021 18:23,8992979120013,TOTAL BUNGA SOFTENER,1,15000,0,15000,13800,1200
12/28/2021 18:23,8999999059781,SUNLIGHT LIME NEW POUCH 210ML,1,5000,0,5000,4520,480
12/28/2021 18:23,8991002105409,KOPI KAPAL API,1,20000,0,20000,18888,1112
12/28/2021 18:24,8998866200301,MIE SEDAAP GORENG,5,3000,0,15000,12070,2930
12/28/2021 18:24,8998866200325,MIE SEDAAP SOTO,5,2700,0,13500,11410,2090
12/28/2021 18:24,8996001355008,BENG-BENG SP20G,1,29000,0,29000,20000,9000
12/28/2021 18:24,8998866805414,SOKLIN SMART SOFTERNER 800G & PIRING,1,20000,0,20000,18630,1370
12/28/2021 18:24,OSCAR,"OSKAR""S",20,1000,0,20000,8500,11500
12/28/2021 18:36,8997028590014,ARGUS 220ML,2,500,0,1000,604,396
12/28/2021 18:36,7622210437686,BISKUAT,5,500,0,2500,2000,500
12/28/2021 18:44,8997018720018,SIRUP DHT,1,23000,0,23000,20958,2042
12/28/2021 18:44,ARG,ARGUS DOS 220ML,1,15000,0,15000,13500,1500
12/28/2021 18:44,6907992823904,JD CRUNCHY CHOCOLATE VAN,1,8000,0,8000,6800,1200
12/28/2021 18:44,6907992823911,JD CRUNCHY HONEYDEW MELON,1,8000,0,8000,6800,1200
12/30/2021 21:45,gula,GULA,2,11500,0,23000,20000,3000
12/30/2021 21:45,8886008101053,AQUA 600 ML,4,3500,0,14000,8500,5500
8/13/2021 11:59,8996200900092,HEROCYN 85GR,1,13000,0,13000,11650,1350
8/13/2021 11:59,8998866500708,FLORIDINA ORANGE,3,3000,0,9000,7500,1500
8/13/2021 11:59,8997012030748,MADU ENAK,2,1000,0,2000,1800,200
8/13/2021 11:59,8992959509005,SWEETY SILVER PANTS XL26,1,61500,0,61500,55910,5590
8/13/2021 11:59,8992702000063,INDOMILK COKLAT 370G,1,10000,0,10000,9208,792
8/13/2021 11:59,8992696425316,NESCAFE BLACK,1,5000,0,5000,4099,901
8/13/2021 11:59,089686611618,QTELA BARBEQUE,1,5000,0,5000,4266,734
8/13/2021 11:59,AMPLOP,AMPLOP,4,250,0,1000,700,300
8/13/2021 11:59,8992775001615,CHOCOLATOS SWEET CHEESE,1,18000,0,18000,15483,2517
8/13/2021 11:59,8992775311615,CHOCOLATOS,1,12000,0,12000,9983,2017
8/13/2021 11:59,8992761139018,ADES 600ML,2,3500,0,7000,4332,2668
8/13/2021 11:59,8999909982000,SAMPOERNA 12 FILTER,1,19000,0,19000,16600,2400
8/13/2021 11:59,8992761002022,SPRITE PET 390ML,1,5500,0,5500,4333,1167
8/13/2021 11:59,8993007000024,INDOMILK UHT VANILA,1,5000,0,5000,3470,1530
8/13/2021 11:59,8992696523067,MILO ACTVGO UHT 180ML,1,5000,0,5000,3719,1281
12/19/2021 12:06,8992761166052,FRESTEA MELATI 350ML,1,4500,0,4500,3000,1500
12/19/2021 12:06,8999909085114,SAMPOERNA KRETEK HIJAU 12,1,14000,0,14000,11650,2350
12/30/2021 12:10,8886008101053,AQUA 600 ML,2,3500,0,7000,4250,2750
12/30/2021 12:10,6907992825076,JD WATERMELON APPLE,1,2000,0,2000,1700,300
12/30/2021 12:10,gula,GULA,2,12500,0,25000,23000,2000
12/30/2021 12:10,8992870410206,Salonpas,1,7000,0,7000,5700,1300
12/30/2021 12:10,8997027300089,NOMOS,1,4000,0,4000,2963,1037
12/30/2021 12:11,8997018720018,SIRUP DHT,1,24000,0,24000,22750,1250
11/23/2021 9:22,8996001600399,LE MINERAL 1500ML,1,5000,0,5000,4042,958
11/23/2021 9:22,8998866501033,MINYAK GORENG SEDAAP POUCH 2L,1,37000,0,37000,35000,2000
11/23/2021 9:22,8992759120264,LARISST 220,1,11000,0,11000,9200,1800
11/23/2021 10:23,8995333060703,TERIGU KOMPAS 1KG,1,11500,0,11500,10400,1100
11/23/2021 10:23,8999999049492,REXONA WMN RO POWDER DRY 45 ML,1,15000,0,15000,13500,1500
11/23/2021 10:23,8999999567279,SARIWANGI JAHE KUNYIT,1,7500,0,7500,6600,900
11/23/2021 10:23,gula,GULA,1,12500,0,12500,11500,1000
11/23/2021 11:35,8993072254018,MELROSE COTTON BUDS BSR,1,5000,0,5000,4050,950
11/23/2021 11:35,089686044249,SUPERMI NUTRIMI STEAK AYAM,1,3500,0,3500,2800,700
11/23/2021 11:35,8998866605809,SOKLIN SMART WHITE 800GR 7 PIRING,1,20000,0,20000,18630,1370
11/23/2021 11:35,8994867000179,ROKOK PENA MILD 16,1,15500,0,15500,14500,1000
11/23/2021 11:53,8998866200837,NOODLE SEDAAPMIE SOTO CUP 81 GR,1,5000,0,5000,3825,1175
11/23/2021 11:53,6907992823973,JD PINEAPPLE,1,5000,0,5000,4300,700
11/23/2021 11:53,8997218010230,yohoo,1,1000,0,1000,900,100
11/23/2021 11:53,TBR,TEPUNG BERAS ROSE BRAND,1,8000,0,8000,6150,1850
11/23/2021 11:53,8998866200301,MIE SEDAAP GORENG,1,3000,0,3000,2414,586
11/23/2021 11:53,8998866200578,MIE SEDAAP KARI KENTAL,1,2700,0,2700,2423,277
11/23/2021 13:49,SURYA BTG,SURYA BATANG,2,2000,0,4000,2840,1160
11/23/2021 14:37,8997028590014,ARGUS 220ML,2,500,0,1000,684,316
11/23/2021 14:37,8998989300261,GUDANG GARAM SURYA 12 FILTER,1,20000,0,20000,18650,1350
11/23/2021 14:37,8994867007161,ROKOK PENA GOLD 20,1,19000,0,19000,17400,1600
11/23/2021 15:33,8998866501033,MINYAK GORENG SEDAAP POUCH 2L,2,37000,0,74000,70000,4000
11/23/2021 15:33,8992761166038,PULPY ORANGE 300ML,4,5000,0,20000,15000,5000
11/23/2021 15:34,089686535044,SUN BERAS MERAH,1,8500,0,8500,7410,1090
11/23/2021 15:34,ROTI,ROTI 2000,2,2000,0,4000,3600,400
11/23/2021 16:15,8999909002821,MARLBORO BLACK 16,1,23000,0,23000,21850,1150
11/23/2021 16:35,8991909101016,URBAN MILD 16,1,17000,0,17000,15800,1200
11/23/2021 16:49,123124,KOREK BIASA,1,2000,0,2000,1300,700
11/23/2021 16:49,ROYCO,ROYCO RASA AYAM,10,500,0,5000,3750,1250
11/23/2021 16:49,8997028590014,ARGUS 220ML,2,500,0,1000,684,316
11/23/2021 16:49,8997018259464,ES MEGASUS,1,1000,0,1000,800,200
11/23/2021 21:26,SURYA BTG,SURYA BATANG,1,2000,0,2000,1420,580
11/23/2021 21:26,8886020033431,KAPUR AJAIB ANTI KECOA DAN NYAMUK,1,3000,0,3000,2700,300
11/23/2021 21:26,8998866203227,MIE SEDAAP AYAM BAKAR LIMAU,1,2700,0,2700,2163,537
11/23/2021 21:26,8992696404441,SUSU BERUANG,1,10000,0,10000,8585,1415
11/23/2021 21:26,PULPEN,PULPEN BIASA,1,2000,0,2000,1500,500
11/23/2021 22:28,8991002105409,KOPI KAPAL API,1,20000,0,20000,18888,1112
11/23/2021 22:28,8718291777199,PHILIPS 8W,1,41000,0,41000,38000,3000
11/23/2021 22:28,8992628022156,MINYAK GORENG BIMOLI POUCH 1 LT,1,23000,0,23000,20000,3000
11/23/2021 22:28,8998989500166,GUDANG GARAM MERAH BESAR 16KS,1,18000,0,18000,17000,1000
11/23/2021 20:29,TELUR,TELUR,3,1667,0,5001,3498,1503
11/23/2021 20:29,8998866200301,MIE SEDAAP GORENG,1,3000,0,3000,2414,586
11/23/2021 20:29,711844110144,KECAP ABC 225 ML,1,9000,0,9000,8200,800
11/23/2021 20:29,ROTI,ROTI 2000,1,2000,0,2000,1800,200
11/23/2021 20:29,8991102987639,WFR TANGO LONG VNL 130G,1,5000,0,5000,4350,650
11/23/2021 20:29,8998866201889,KRISBEE PILLOW STRAWBERRY ICE CREAM 120GR,1,8000,0,8000,7250,750
11/23/2021 12:37,8995333032113,TERIGU GATOT KACA 1 KG,3,10000,0,30000,27039,2961
11/23/2021 12:37,8998866202619,MIE SEDAAP KOREAN SPICY SOUP,1,2700,0,2700,2322,378
11/23/2021 12:37,8994867000179,ROKOK PENA MILD 16,1,15500,0,15500,14500,1000
11/23/2021 12:37,MILKITA,MILKITA,2,250,0,500,400,100
11/24/2021 9:40,8996001600399,LE MINERAL 1500ML,1,5000,0,5000,4042,958
11/24/2021 9:40,TAMARA,TAMARA,2,1000,0,2000,840,1160
11/24/2021 9:40,8991002303928,GULA GULA RELAXA,4,250,0,1000,800,200
11/24/2021 10:19,8992946521416,SABUN SHINZUI,1,5000,0,5000,4000,1000
11/24/2021 10:19,8999999030179,PEPSODENT ACTION 123 COMPLETE 75G,1,6700,0,6700,5170,1530
11/24/2021 10:19,8999999046989,LIFEBUOY MILD CARE 60G,1,3000,0,3000,1911,1089
11/24/2021 11:05,089686611519,QTELA SINGKONG,1,6000,0,6000,4266,1734
11/24/2021 11:05,8994834003752,TICTIC,1,2000,0,2000,1700,300
11/24/2021 11:05,8993110071133,sosis rasa ayam,2,1000,0,2000,1800,200
11/24/2021 11:05,ROTI,ROTI 2000,1,2000,0,2000,1800,200
11/24/2021 12:14,8999999031602,SARI MURNI 20X1.6G,1,6000,0,6000,5400,600
11/24/2021 12:14,8991102714860,MILKIDO STRAW,3,3000,0,9000,6459,2541
11/24/2021 12:14,8996001600269,LE MINERAL 600ML,2,3000,0,6000,3376,2624
11/24/2021 12:14,8886008101053,AQUA 600 ML,1,3500,0,3500,2125,1375
11/24/2021 12:14,TG,TEH GELAS,1,1000,0,1000,729,271
11/24/2021 12:14,8992775001042,PILUS GARUDA MI GORENG,1,5500,0,5500,4810,690
11/24/2021 12:14,8992775001806 pcs,Gery salut malkist chocolate coconut pcs,2,1000,0,2000,1624,376
11/24/2021 12:14,OSCAR,"OSKAR""S",1,1000,0,1000,425,575
11/24/2021 11:19,6907992823966,JD BLUEBERRY,1,3500,0,3500,3000,500
11/24/2021 11:19,8997028590014,ARGUS 220ML,2,500,0,1000,684,316
11/24/2021 12:20,TAMARA,TAMARA,2,1000,0,2000,840,1160
11/24/2021 12:20,8997028590014,ARGUS 220ML,2,500,0,1000,684,316
11/24/2021 12:24,8998866202923,FLORIDINA COCO,1,3000,0,3000,2500,500
11/24/2021 12:24,8993989311279,CLAS MILD 12,1,18000,0,18000,15800,2200
11/24/2021 12:24,8992761166052,FRESTEA MELATI 350ML,1,4500,0,4500,3000,1500
11/24/2021 12:33,8992696521629,DNCO COKLT UHT 180ML,1,5000,0,5000,3533,1467
11/24/2021 12:33,8992761166038,PULPY ORANGE 300ML,1,5000,0,5000,3750,1250
11/24/2021 12:33,8996001600375,LE MINERAL 330ML,1,2000,0,2000,1417,583
11/24/2021 12:40,8996001328163,GULA GULA TAMARIN,8,250,0,2000,1600,400
11/24/2021 12:40,8997218010230,yohoo,1,1000,0,1000,900,100
11/24/2021 12:40,VTM,VITAMIN CIMIN,2,500,0,1000,850,150
11/24/2021 12:40,8992761166038,PULPY ORANGE 300ML,2,5000,0,10000,7500,2500
11/24/2021 12:44,8998866501033,MINYAK GORENG SEDAAP POUCH 2L,2,37000,0,74000,70000,4000
11/24/2021 12:44,8997218380159,ICHITAN BROWN SUGAR,1,8000,0,8000,6500,1500
11/24/2021 12:44,8997218380135,ICHITAN GREEN TEA,1,8000,0,8000,6500,1500
11/24/2021 12:44,8992761164546,NUTRIBOOST STRAWBERRY 300ML,1,6500,0,6500,5300,1200
11/24/2021 12:44,8992775001042,PILUS GARUDA MI GORENG,1,5500,0,5500,4810,690
11/24/2021 12:48,8992760223015,OREO CHOCOLATE CREAM 133G,1,8000,0,8000,6300,1700
11/24/2021 12:48,089686044249,SUPERMI NUTRIMI STEAK AYAM,1,3500,0,3500,2800,700
11/24/2021 12:48,8996001305041,ROMA SANDWICH CKLT,1,7000,0,7000,5928,1072
11/24/2021 12:48,8993470671752,JOGER STICK DUO KACANG,2,1000,0,2000,1700,300
11/24/2021 14:19,089686021141,INTER MIE SOTO,4,1000,0,4000,3740,260
11/24/2021 14:19,089686021127,INTER MIE KALDU,1,1000,0,1000,813,187
11/24/2021 14:19,9556001047175,NESCAFE ORI 240ML,1,8500,0,8500,7834,666
11/24/2021 14:23,ROTI,ROTI 2000,1,2000,0,2000,1800,200
11/24/2021 14:23,6907992823935,JD SWEETCORN,1,3500,0,3500,3000,500
11/24/2021 14:23,7622300335809,OREO SOFT CAKE,1,2000,0,2000,1641,359
11/24/2021 14:23,6907992823652,JD CHOCOLATE MILKSHAKE,1,6000,0,6000,5200,800
11/24/2021 14:23,8992761164539,NUTRIBOOST ORANGE 300ML,1,6500,0,6500,5300,1200
11/24/2021 16:19,BALON,BALON CABUT,1,1000,0,1000,900,100
11/24/2021 16:19,8997878004327,GULA GULA MILKITA,4,250,0,1000,800,200
11/24/2021 16:19,8886013257400,TWISTKO,1,1000,0,1000,900,100
11/24/2021 16:19,lolipop,lolipop,1,1000,0,1000,850,150
11/24/2021 16:19,6907992824963,JD MILKY CHOCOLATE,2,3000,0,6000,5200,800
11/24/2021 16:41,6907992823669,JD MILKY STRAW,1,3000,0,3000,2600,400
11/24/2021 16:41,8998866106306,EMERON LOVELY GLOW&BRIGTH 100ML,1,4300,0,4300,3800,500
11/24/2021 16:41,8999999559564,LUX BW SOFT ROSE 90ML,1,5000,0,5000,4000,1000
11/24/2021 16:50,8997028590014,ARGUS 220ML,2,500,0,1000,684,316
11/24/2021 16:50,8997018920081,RED BOLD,1,21000,0,21000,19800,1200
11/24/2021 16:50,8886022830243,BATEREI ABC,2,3000,0,6000,3856,2144
11/24/2021 16:50,8994867007161,ROKOK PENA GOLD 20,1,19000,0,19000,17400,1600
11/24/2021 16:50,8998989300261,GUDANG GARAM SURYA 12 FILTER,1,20000,0,20000,18650,1350
11/24/2021 16:59,8998866202619,MIE SEDAAP KOREAN SPICY SOUP,2,2700,0,5400,4644,756
11/24/2021 16:59,8996001402023,TB TORA SUSU,2,1500,0,3000,1866,1134
11/24/2021 17:52,8992730996185,GULA GULA CRISPY,1,2000,0,2000,1500,500
11/24/2021 17:52,8992775610367,Garuda Koro paggang,1,1000,0,1000,828,172
11/24/2021 17:52,8997878004327,GULA GULA MILKITA,4,250,0,1000,800,200
11/24/2021 17:52,8992741952262,GULA GULA YUPI,4,250,0,1000,800,200
11/24/2021 17:52,8996001600399,LE MINERAL 1500ML,1,5000,0,5000,4042,958
11/24/2021 18:44,8993379260767,SABUN LERVIA,1,5000,0,5000,3415,1585
11/24/2021 18:44,8994867000179,ROKOK PENA MILD 16,1,15500,0,15500,14500,1000
11/24/2021 19:40,8997218010230,yohoo,1,1000,0,1000,900,100
11/24/2021 19:40,8994867000179,ROKOK PENA MILD 16,1,15500,0,15500,14500,1000
11/24/2021 20:36,TG,TEH GELAS,1,1000,0,1000,729,271
11/24/2021 20:36,8998866202770,MIE SEDAAP SALERO PADANG,1,2500,0,2500,2362,138
11/24/2021 21:31,8999909002821,MARLBORO BLACK 16,1,23000,0,23000,21850,1150
11/24/2021 22:01,6907992823935,JD SWEETCORN,1,3500,0,3500,3000,500
11/24/2021 22:01,8999909010567,234 DJI SAM SOE 16,1,23000,0,23000,21500,1500
11/25/2021 9:02,KP,KERIPIK PISANG,1,5000,0,5000,5000,0
11/25/2021 9:02,7622300335809,OREO SOFT CAKE,1,2000,0,2000,1641,359
11/25/2021 9:02,8993274532105,BOLU,2,1000,0,2000,1666,334
11/25/2021 9:02,8997218010230,yohoo,1,1000,0,1000,900,100
11/25/2021 12:02,8994867007161,ROKOK PENA GOLD 20,1,19000,0,19000,17400,1600
11/25/2021 12:04,7622210437686,BISKUAT,2,500,0,1000,800,200
11/25/2021 12:04,8992957214307,SAFARI MECES,1,5500,0,5500,4500,1000
11/25/2021 12:04,8995333060772,TERIGU GATOT KACA 500GR,1,5500,0,5500,4564,936
11/25/2021 12:04,8998866202244,EKOMIE BUMBU KALDU AYAM,2,1000,0,2000,1596,404
11/25/2021 12:04,8998866200301,MIE SEDAAP GORENG,1,3000,0,3000,2414,586
11/25/2021 12:04,8998866200561,EKOMIE SUPER 600GR,1,10000,0,10000,8615,1385
11/25/2021 13:14,6907992823966,JD BLUEBERRY,1,3500,0,3500,3000,500
11/25/2021 13:14,8997218010230,yohoo,1,1000,0,1000,900,100
11/25/2021 13:14,8991002105430,KOPI KAPAL API 65G,1,5000,0,5000,4145,855
11/25/2021 13:26,8994867000162,ROKOK PUNDIMAS KRETEK16,1,10000,0,10000,8600,1400
11/25/2021 13:26,8998989110167,SURYA GUDANG GARAM 16 FILTER,1,27000,0,27000,25200,1800
11/25/2021 13:28,089686043204,INDOMIE MIE ACEH,1,2700,0,2700,2452,248
11/25/2021 13:28,ARG,ARGUS DOS 220ML,1,15000,0,15000,13700,1300
11/25/2021 13:28,ROTI,ROTI 2000,1,2000,0,2000,1800,200
11/25/2021 14:18,8994867000179,ROKOK PENA MILD 16,1,15500,0,15500,14500,1000
11/25/2021 14:18,8998989500166,GUDANG GARAM MERAH BESAR 16KS,1,18000,0,18000,17000,1000
11/25/2021 14:18,8999909001909,MAGNUM REVAMP BLACK 12,1,18000,0,18000,16750,1250
11/25/2021 14:37,8992959953136,SWEETY BRONZE L20,1,40000,0,40000,36770,3230
11/25/2021 14:37,lolipop,lolipop,1,1000,0,1000,850,150
11/25/2021 14:37,089686611519,QTELA SINGKONG,1,6000,0,6000,4266,1734
11/25/2021 14:37,8999999059781,SUNLIGHT LIME NEW POUCH 210ML,1,5000,0,5000,4700,300
11/25/2021 14:54,8999999195649,SARIWANGI 25X1.86G,1,6000,0,6000,5202,798
11/25/2021 14:54,8996001301142,ROMA KELAPA,1,8000,0,8000,7035,965
11/25/2021 14:54,8994834003752,TICTIC,1,2000,0,2000,1700,300
11/25/2021 14:54,8991102987639,WFR TANGO LONG VNL 130G,1,5000,0,5000,4350,650
11/25/2021 14:54,8993110071133,sosis rasa ayam,2,1000,0,2000,1800,200
11/27/2021 10:07,4902430745703,DOWNY SUNRISE FRESH 10ML,10,500,0,5000,3930,1070
11/27/2021 10:07,8992770033178,Masako,11,500,0,5500,4950,550
11/27/2021 10:07,711844110083,KECAP ABC 275 ML,1,16000,0,16000,15000,1000
11/27/2021 10:07,8996001600269,LE MINERAL 600ML,1,3000,0,3000,1688,1312
11/27/2021 14:16,8994023000050,MEGKEJU SERBAGUNA 165G,1,13000,0,13000,12000,1000
11/27/2021 14:26,Vita Jelly,Vita Jelly,1,1000,0,1000,766,234
11/27/2021 14:26,8997218010230,yohoo,1,1000,0,1000,900,100
11/27/2021 14:26,8991102987639,WFR TANGO LONG VNL 130G,1,5000,0,5000,4350,650
11/27/2021 14:26,11222,LEM KOREA,1,10000,0,10000,8000,2000
11/27/2021 14:46,8994867007161,ROKOK PENA GOLD 20,1,19000,0,19000,17400,1600
11/27/2021 14:46,TELUR,TELUR,3,1667,0,5001,3498,1503
11/27/2021 14:46,8998866200578,MIE SEDAAP KARI KENTAL,1,2700,0,2700,2423,277
11/27/2021 14:46,8991102714624,Tanggo Kido Drink 115ml,2,3000,0,6000,4000,2000
11/27/2021 15:07,8997218380159,ICHITAN BROWN SUGAR,1,8000,0,8000,6500,1500
11/27/2021 15:07,8993989311699,CLAS MILD 16 FILTER,1,24000,0,24000,21700,2300
11/27/2021 15:07,8999909085114,SAMPOERNA KRETEK HIJAU 12,1,14000,0,14000,11650,2350
11/27/2021 15:39,JD VM,JD VANILLA MILKSHAKE,1,5000,0,5000,4300,700
11/27/2021 15:39,6907992823676,JD PEACH,1,2000,0,2000,1700,300
11/27/2021 15:39,8992730950194,GULA GULA KOIN,2,500,0,1000,800,200
11/27/2021 15:39,7622300761349,OREO MINI CKLT,1,7500,0,7500,6500,1000
11/27/2021 16:00,8992775203422,GARUDA ROSTA OVEN BAWANG 100G,1,8000,0,8000,7322,678
11/27/2021 16:00,8998989300261,GUDANG GARAM SURYA 12 FILTER,1,20000,0,20000,18650,1350
11/27/2021 18:00,8996001600375,LE MINERAL 330ML,1,2000,0,2000,1417,583
11/27/2021 18:00,8997028590014,ARGUS 220ML,4,500,0,2000,1368,632
11/27/2021 18:08,ABC,BATERAI ABC BIRU,2,3000,0,6000,3856,2144
11/27/2021 18:08,8992775002582,DILAN CHOCO,1,2000,0,2000,1503,497
11/27/2021 18:08,8996001302316,MALKIST ABON SCT,2,1000,0,2000,1680,320
11/27/2021 18:23,8999999031602,SARI MURNI 20X1.6G,1,6000,0,6000,5400,600
11/27/2021 18:23,8992761111540,FANTA STRAWBERY SLIM CAM 250ML,1,5000,0,5000,3750,1250
11/27/2021 18:23,8851019210117,POCKY CHOCOLATE FLAVOUR 47G,1,7500,0,7500,5671,1829
11/27/2021 18:56,8998866200301,MIE SEDAAP GORENG,1,3000,0,3000,2414,586
11/27/2021 18:56,8999909002821,MARLBORO BLACK 16,1,23000,0,23000,21850,1150
11/27/2021 19:28,8997011700123,BIJAG BIHUN JAGUNG 300GR,1,6000,0,6000,5100,900
11/27/2021 19:50,8999999555450,VIXAL PEMB PORS BIRU 190ML,1,5000,0,5000,4200,800
11/27/2021 20:22,8992775110157,GARUDA KACANG KULIT,1,5000,0,5000,3925,1075
11/26/2021 9:24,8998866202930,SEDAAP AYAM JERIT CUP,1,5000,0,5000,3825,1175
11/26/2021 9:24,8996001401200,GENTLEGEN,1,18000,0,18000,16000,2000
11/26/2021 9:24,8992775110140,GARUDA KACANG KULIT 160G,1,12000,0,12000,10012,1988
11/26/2021 9:24,8998866888615,GIV BIRU KOTAK 76G,1,2000,0,2000,1820,180
11/26/2021 10:21,8992775203422,GARUDA ROSTA OVEN BAWANG 100G,1,8000,0,8000,7322,678
11/26/2021 10:21,8991188943536,SASA SANTAN KELAPA 65ML,1,3000,0,3000,2437,563
11/26/2021 10:21,8992770033178,Masako,4,500,0,2000,1800,200
11/26/2021 11:30,8991102714624,Tanggo Kido Drink 115ml,1,3000,0,3000,2000,1000
11/26/2021 11:30,8992775002582,DILAN CHOCO,2,2000,0,4000,3006,994
11/26/2021 12:24,8999999059781,SUNLIGHT LIME NEW POUCH 210ML,1,5000,0,5000,4700,300
11/26/2021 12:24,8991188943536,SASA SANTAN KELAPA 65ML,1,3000,0,3000,2437,563
11/26/2021 12:24,8991102714495,TANGO DRINK COKLAT,1,5000,0,5000,3818,1182
11/26/2021 12:25,8991188943369,Sasa 5000,1,5000,0,5000,4091,909
11/26/2021 12:25,8997218010230,yohoo,5,1000,0,5000,4500,500
11/26/2021 13:21,8996001302316,MALKIST ABON SCT,1,1000,0,1000,840,160
11/26/2021 13:21,8998866610278,DAIA VIOLET GUSSET 565G,1,10000,0,10000,8700,1300
11/26/2021 13:21,MOLTO PINK,MOLTO ALL IN ONE 11 ML,10,500,0,5000,4000,1000
11/26/2021 13:21,ARG,ARGUS DOS 220ML,1,15000,0,15000,13700,1300
11/26/2021 13:21,8999999059323,LIFEBUOY TS LEMONFRESH 75G,1,4000,0,4000,3225,775
11/26/2021 13:30,8991909101016,URBAN MILD 16,1,17000,0,17000,15800,1200
11/26/2021 13:51,8998866201520,KOPI TOP TORAJA MURNI,1,11000,0,11000,9600,1400
11/26/2021 13:51,8992931006256,tessa,4,1000,0,4000,3600,400
11/26/2021 13:59,8991102026383,AIR CRYSTALINE 1.5 L,1,5000,0,5000,3471,1529
11/26/2021 13:59,8996200900092,HEROCYN 85GR,1,13000,0,13000,11650,1350
11/26/2021 13:59,8992959117538,SFX COMFORT SLIM WING 20,1,12000,0,12000,10947,1053
11/26/2021 14:00,8992702000018,INDOMILK PUTIH 370G,1,11000,0,11000,9708,1292
11/26/2021 14:00,8991188943536,SASA SANTAN KELAPA 65ML,1,3000,0,3000,2437,563
11/26/2021 14:00,8997012320962,BALADO PEDAS MANIS,1,5000,0,5000,3950,1050
11/26/2021 14:00,8993226365522,GARAM MEJA GYURI 200GR,1,2000,0,2000,1700,300
11/26/2021 14:11,8999909096004,SAMPOERNA 16 FILTER,1,26000,0,26000,23100,2900
11/26/2021 14:14,8999999192150,ROYCO FDS CHICKEN 100GR,1,5000,0,5000,4300,700
11/26/2021 14:15,8998866808248,SOKLIN LAVENDER 490 GRAM,1,18000,0,18000,17000,1000
11/26/2021 14:15,8996001401200,GENTLEGEN,1,18000,0,18000,16000,2000
11/26/2021 14:36,8993110071133,sosis rasa ayam,65,1000,0,65000,58500,6500
11/26/2021 14:59,8998866108126,POSH HIJAB WINTER MAGIC 150ML,1,20000,0,20000,18600,1400
11/26/2021 14:59,8993335529419,Sabun Total de Parfumee Floral Vibes,1,24500,0,24500,22000,2500
11/26/2021 15:27,8999999195649,SARIWANGI 25X1.86G,1,6000,0,6000,5202,798
11/26/2021 15:27,8991102385091,WFR TANGO CKLT 7G,1,10000,0,10000,8169,1831
11/26/2021 15:37,8997021870137,FRESH CARE SPLASH FRUITY 10ML,1,12000,0,12000,10000,2000
11/26/2021 15:58,8995333000822,TERIGU KOMPAS SOFT 500GR,2,6000,0,12000,10408,1592
11/26/2021 15:58,gula,GULA,1,12500,0,12500,11500,1000
11/26/2021 15:58,8886022971298,BATERAI ALKALINE 06,1,12000,0,12000,10557,1443
11/26/2021 15:58,8998989300261,GUDANG GARAM SURYA 12 FILTER,1,20000,0,20000,18650,1350
11/26/2021 15:58,8998989500166,GUDANG GARAM MERAH BESAR 16KS,1,18000,0,18000,17000,1000
11/26/2021 15:58,8999909001909,MAGNUM REVAMP BLACK 12,1,18000,0,18000,16750,1250
11/26/2021 17:12,8998866202619,MIE SEDAAP KOREAN SPICY SOUP,1,2700,0,2700,2322,378
11/26/2021 17:12,7622201430153,OREO CHOCOLATE 38G,1,2000,0,2000,1641,359
11/28/2021 10:13,8992775002582,DILAN CHOCO,1,2000,0,2000,1503,497
11/28/2021 10:13,8992775305003 pcs,Gery Salut Coklat pcs,2,1000,0,2000,1624,376
11/28/2021 11:09,6907992823829,JD MILKY MILK,1,3000,0,3000,2600,400
11/28/2021 11:09,6907992823935,JD SWEETCORN,1,3500,0,3500,3000,500
11/28/2021 11:09,6907992825076,JD WATERMELON APPLE,1,2000,0,2000,1700,300
11/28/2021 11:31,8991188943536,SASA SANTAN KELAPA 65ML,1,3000,0,3000,2437,563
11/28/2021 11:31,ES POTONG,ES POTONG,1,1000,0,1000,500,500
11/28/2021 11:31,ROTI,ROTI 2000,1,2000,0,2000,1800,200
11/28/2021 11:31,BALON GAS,BALON GAS,2,500,0,1000,800,200
11/28/2021 12:34,8999909010567,234 DJI SAM SOE 16,1,23000,0,23000,21500,1500
11/28/2021 12:57,8997231980022,O'JELLY MINI STRAWBERRY,1,3000,0,3000,2250,750
11/28/2021 12:57,8997218010230,yohoo,1,1000,0,1000,900,100
11/28/2021 12:57,6907992823676,JD PEACH,1,2000,0,2000,1700,300
11/28/2021 12:57,ES POTONG,ES POTONG,1,1000,0,1000,500,500
11/28/2021 14:08,8991188943536,SASA SANTAN KELAPA 65ML,1,3000,0,3000,2437,563
11/28/2021 14:25,9999,ISOLASI LAKBAN,1,8000,0,8000,6500,1500
11/28/2021 14:45,8851019210292,POCKY COOKIES & CREAME 47 GR,1,7000,0,7000,5671,1329
11/28/2021 14:45,8998866200578,MIE SEDAAP KARI KENTAL,1,2700,0,2700,2423,277
11/28/2021 14:45,089686043204,INDOMIE MIE ACEH,4,2700,0,10800,9808,992
11/28/2021 15:26,JGR,JOGER CHOCKY PASTA,1,20000,0,20000,18190,1810
11/28/2021 15:53,8998989300261,GUDANG GARAM SURYA 12 FILTER,1,20000,0,20000,18650,1350
11/28/2021 15:53,8994867007161,ROKOK PENA GOLD 20,1,19000,0,19000,17400,1600
11/28/2021 15:53,8999909002821,MARLBORO BLACK 16,1,23000,0,23000,21850,1150
11/28/2021 15:53,6907992825076,JD WATERMELON APPLE,1,2000,0,2000,1700,300
11/28/2021 15:53,8996001440001,TB JAHE SUSU,2,1500,0,3000,1740,1260
11/28/2021 15:59,8991188943536,SASA SANTAN KELAPA 65ML,1,3000,0,3000,2437,563
11/28/2021 15:59,ROTI,ROTI 2000,1,2000,0,2000,1800,200
11/28/2021 16:32,8992222050418,GATSBY NORMAL 38GR,1,5000,0,5000,3850,1150
11/28/2021 16:52,9556001047175,NESCAFE ORI 240ML,1,8500,0,8500,7834,666
11/28/2021 16:52,6907992823966,JD BLUEBERRY,1,3500,0,3500,3000,500
11/28/2021 16:52,7622300335809,OREO SOFT CAKE,1,2000,0,2000,1641,359
11/28/2021 17:27,7622300405588,KEJUCAKE 16G,1,2000,0,2000,1641,359
11/28/2021 17:27,8993989311699,CLAS MILD 16 FILTER,1,24000,0,24000,21700,2300
11/28/2021 17:27,8996001600269,LE MINERAL 600ML,2,3000,0,6000,3376,2624
11/28/2021 17:27,8999909096004,SAMPOERNA 16 FILTER,1,26000,0,26000,23100,2900
11/28/2021 17:56,8992959953044,SWEETY BRONZE XL1,1,3000,0,3000,2311,689
11/28/2021 17:56,8991188943536,SASA SANTAN KELAPA 65ML,1,3000,0,3000,2437,563
11/28/2021 17:56,8998866600521,SOKLIN FLOORCLENER KUNING 400ML,1,6000,0,6000,5025,975
11/28/2021 19:50,8998866200325,MIE SEDAAP SOTO,1,2700,0,2700,2282,418
11/28/2021 20:21,TAMARA,TAMARA,1,1000,0,1000,420,580
11/28/2021 20:21,OSCAR,"OSKAR""S",1,1000,0,1000,425,575
11/28/2021 20:21,8992775201473,GARUDA PILUS SAPI PANGGANG 8G,2,500,0,1000,758,242
11/29/2021 10:22,8991102228053,TEH GELAS BOTOL,1,3000,0,3000,1695,1305
11/29/2021 10:22,8997009510055,YOU C1000,1,13000,0,13000,9000,4000
11/29/2021 10:22,8999999556341,MOLTO EDP PINK ROSE 20ML,1,1000,0,1000,800,200
11/29/2021 10:44,gula,GULA,1,12500,0,12500,11500,1000
11/29/2021 10:44,8992959508862,SWEETY SILVER PANTS M8,1,16800,0,16800,15229,1571
11/29/2021 11:44,8994867000179,ROKOK PENA MILD 16,1,15500,0,15500,14500,1000
11/29/2021 11:44,8991004011906,KOPI BORONG,1,10000,0,10000,8333,1667
11/29/2021 11:44,8998866202626,Top Kopi Gula Aren 22gr,3,1000,0,3000,1770,1230
11/29/2021 12:00,8997025914042,ATB MARIE SUSU 185G,1,7000,0,7000,4554,2446
11/29/2021 12:00,8996001312698,MALKIST KOREAN,1,6500,0,6500,5500,1000
11/29/2021 14:03,711844110113,KECAP ABC 135 ML,1,7000,0,7000,6400,600
11/29/2021 14:03,8992753031894,FRISIAN FLAG,1,2000,0,2000,1000,1000
11/29/2021 14:28,8998989300261,GUDANG GARAM SURYA 12 FILTER,1,20000,0,20000,18650,1350
11/29/2021 14:28,8994867007161,ROKOK PENA GOLD 20,1,19000,0,19000,17400,1600
11/29/2021 14:28,KOPIKO,KOPIKO,4,250,0,1000,700,300
11/29/2021 14:28,8991914101513,VIPER KRETEK 12,1,7000,0,7000,5800,1200
11/29/2021 15:51,ROTI,ROTI 2000,1,2000,0,2000,1800,200
11/29/2021 15:51,8991909101016,URBAN MILD 16,1,17000,0,17000,15800,1200
11/29/2021 15:51,123124,KOREK BIASA,1,2000,0,2000,1300,700
11/29/2021 15:52,6907992823591,JD STRAW MILKSHAKE,1,5000,0,5000,4300,700
11/29/2021 15:52,8998866200301,MIE SEDAAP GORENG,1,3000,0,3000,2414,586
11/29/2021 16:38,8999999524722,SUNLIGHT LIME NEW PCH 435ML,1,10000,0,10000,9100,900
11/29/2021 16:38,8998866200561,EKOMIE SUPER 600GR,1,10000,0,10000,8615,1385
11/29/2021 16:38,8997011700123,BIJAG BIHUN JAGUNG 300GR,1,6000,0,6000,5100,900
11/29/2021 16:59,8991102026383,AIR CRYSTALINE 1.5 L,1,5000,0,5000,3471,1529
11/29/2021 16:59,ROTI,ROTI 2000,1,2000,0,2000,1800,200
11/29/2021 16:59,7622201430153,OREO CHOCOLATE 38G,1,2000,0,2000,1641,359
11/29/2021 17:44,8997009510055,YOU C1000,1,13000,0,13000,9000,4000
11/29/2021 17:44,089686021127,INTER MIE KALDU,5,1000,0,5000,4065,935
11/29/2021 17:44,8998866203272,SUKSES AYAM GEPREK,1,4000,0,4000,3046,954
11/29/2021 17:44,8998866202244,EKOMIE BUMBU KALDU AYAM,2,1000,0,2000,1596,404
11/29/2021 18:30,8997028590014,ARGUS 220ML,4,500,0,2000,1368,632
11/29/2021 18:30,Garuda Pilus,Garuda Pilus Rasa Abon Pcs,2,500,0,1000,802,198
11/29/2021 18:30,8991102228053,TEH GELAS BOTOL,1,3000,0,3000,1695,1305
11/29/2021 18:31,ARG,ARGUS DOS 220ML,1,15000,0,15000,13700,1300
11/29/2021 18:48,8992775002582,DILAN CHOCO,1,2000,0,2000,1503,497
11/29/2021 18:48,TBR,TEPUNG BERAS ROSE BRAND,2,8000,0,16000,12300,3700
11/29/2021 18:49,8886008101053,AQUA 600 ML,2,3500,0,7000,4250,2750
11/29/2021 18:49,gula,GULA,3,12500,0,37500,34500,3000
11/29/2021 20:12,8993058105013,EXTRA JOSS,1,12000,0,12000,9773,2227
11/29/2021 20:12,SF GULUNG,SAFFANAH ROTI GULUNG,1,6000,0,6000,5500,500
11/29/2021 20:12,8993110071133,sosis rasa ayam,2,1000,0,2000,1800,200
11/30/2021 10:13,8997028590014,ARGUS 220ML,4,500,0,2000,1368,632
11/30/2021 10:13,PULPEN,PULPEN BIASA,1,2000,0,2000,1500,500
11/30/2021 10:13,8999999529840,CLEAR SHP SPR FRSH APPLE 9 AML,1,10500,0,10500,9300,1200
11/30/2021 10:40,8997018920081,RED BOLD,1,21000,0,21000,19800,1200
11/30/2021 10:40,ARG,ARGUS DOS 220ML,1,15000,0,15000,13700,1300
11/30/2021 10:40,123124,KOREK BIASA,1,2000,0,2000,1300,700
11/30/2021 10:40,ROTI,ROTI 2000,1,2000,0,2000,1800,200
11/30/2021 10:40,ABC,BATERAI ABC BIRU,2,3000,0,6000,3856,2144
11/30/2021 10:41,7622210437686,BISKUAT,2,500,0,1000,800,200
11/30/2021 10:41,SF GULUNG,SAFFANAH ROTI GULUNG,1,6000,0,6000,5500,500
11/30/2021 12:28,KIKO,KIKO,4,1000,0,4000,2000,2000
11/30/2021 12:28,8998989500166,GUDANG GARAM MERAH BESAR 16KS,1,18000,0,18000,17000,1000
11/30/2021 12:28,8999909004221,SAMPOERNA ULTRAMILD 16,1,22000,0,22000,20350,1650
11/30/2021 12:49,8992775002582,DILAN CHOCO,3,2000,0,6000,4509,1491
11/30/2021 12:49,8991002114067,PIKOPI,2,1000,0,2000,1090,910
11/30/2021 12:50,6907992825076,JD WATERMELON APPLE,1,2000,0,2000,1700,300
11/30/2021 12:50,8998989300261,GUDANG GARAM SURYA 12 FILTER,1,20000,0,20000,18650,1350
11/30/2021 12:50,76239878,MARLBORO GOLD,1,32000,0,32000,30600,1400
11/30/2021 13:42,8998866610278,DAIA VIOLET GUSSET 565G,1,10000,0,10000,8700,1300
11/30/2021 13:42,4902430542753,PARFUM DOWNY,3,1000,0,3000,2250,750
11/30/2021 14:32,8991102228053,TEH GELAS BOTOL,1,3000,0,3000,1695,1305
11/30/2021 14:32,8994907000428,KECAP SACHET ABC,2,600,0,1200,1000,200
11/30/2021 14:32,ES POTONG,ES POTONG,2,1000,0,2000,1000,1000
11/30/2021 14:32,6907992825076,JD WATERMELON APPLE,2,2000,0,4000,3400,600
11/30/2021 14:32,8993379200879,SABUN HARMONY MELON 70G,1,2000,0,2000,1652,348
11/30/2021 15:18,BALON GAS,BALON GAS,1,500,0,500,400,100
11/30/2021 15:18,8998989110167,SURYA GUDANG GARAM 16 FILTER,1,27000,0,27000,25200,1800
11/30/2021 15:45,089686043204,INDOMIE MIE ACEH,1,2700,0,2700,2452,248
11/30/2021 15:45,8998866200578,MIE SEDAAP KARI KENTAL,1,2700,0,2700,2423,277
11/30/2021 15:45,8993110071133,sosis rasa ayam,1,1000,0,1000,900,100
11/30/2021 15:45,Vita Jelly,Vita Jelly,2,1000,0,2000,1532,468
11/30/2021 16:31,8996001600399,LE MINERAL 1500ML,1,5000,0,5000,4042,958
11/30/2021 16:31,AMPLOP DOS,AMPLOP DOS,1,20000,0,20000,17500,2500
11/30/2021 16:31,AMPLOP,AMPLOP,4,250,0,1000,700,300
11/30/2021 16:52,8994834003752,TICTIC,1,2000,0,2000,1700,300
11/30/2021 16:52,TERASI,ABC TERASI SCT,3,1500,0,4500,3000,1500
11/30/2021 16:55,8994867000179,ROKOK PENA MILD 16,1,15500,0,15500,14500,1000
11/30/2021 17:40,8997028590014,ARGUS 220ML,10,500,0,5000,3420,1580
11/30/2021 17:40,8998989500166,GUDANG GARAM MERAH BESAR 16KS,1,18000,0,18000,17000,1000
11/30/2021 17:40,8998989110167,SURYA GUDANG GARAM 16 FILTER,1,27000,0,27000,25200,1800
11/30/2021 17:40,8991004011906,KOPI BORONG,1,10000,0,10000,8333,1667
11/30/2021 17:40,8991909101016,URBAN MILD 16,1,17000,0,17000,15800,1200
11/30/2021 18:27,8997028590045,ARGUS BTL 330ML,1,2000,0,2000,1291,709
11/30/2021 18:27,8991002122000,ABC CHOCO MALT COFFE,1,3000,0,3000,2278,722
11/30/2021 18:27,8992775312469,GERY SALUT COKELAT,1,11000,0,11000,9679,1321
11/30/2021 18:27,8991102977647,Tango Choco Tiramisu 20x7 gr,1,10000,0,10000,8200,1800
11/30/2021 18:37,8998989300261,GUDANG GARAM SURYA 12 FILTER,3,20000,0,60000,55950,4050
11/30/2021 18:37,8997028590045,ARGUS BTL 330ML,1,2000,0,2000,1291,709
11/30/2021 18:37,8993989311699,CLAS MILD 16 FILTER,1,24000,0,24000,21700,2300
11/30/2021 19:29,ROTI,ROTI 2000,1,2000,0,2000,1800,200
11/30/2021 19:29,8994867007161,ROKOK PENA GOLD 20,1,19000,0,19000,17400,1600
11/30/2021 19:29,8999909010567,234 DJI SAM SOE 16,1,23000,0,23000,21500,1500
11/30/2021 19:29,8993989311699,CLAS MILD 16 FILTER,2,24000,0,48000,43400,4600
11/30/2021 19:29,8999909002821,MARLBORO BLACK 16,1,23000,0,23000,21850,1150
11/30/2021 20:20,ROTI,ROTI 2000,1,2000,0,2000,1800,200
11/30/2021 20:20,8991102228053,TEH GELAS BOTOL,1,3000,0,3000,1695,1305
11/30/2021 20:20,TG APEL,TEH GELAS APEL,1,2000,0,2000,1178,822
11/30/2021 20:21,8998866203227,MIE SEDAAP AYAM BAKAR LIMAU,1,2700,0,2700,2163,537
11/30/2021 20:21,8997028590014,ARGUS 220ML,2,500,0,1000,684,316
11/30/2021 21:15,8992775002582,DILAN CHOCO,1,2000,0,2000,1503,497
11/30/2021 22:06,8999999008475,SUNLIGHT LIME NEW REF 1600ML,1,35000,0,35000,31955,3045
11/30/2021 22:06,8992959508862,SWEETY SILVER PANTS M8,1,16800,0,16800,15229,1571
11/30/2021 22:06,8992761164546,NUTRIBOOST STRAWBERRY 300ML,1,6500,0,6500,5300,1200
11/30/2021 22:06,ARG,ARGUS DOS 220ML,1,15000,0,15000,13700,1300
12/1/2021 11:16,8992761164546,NUTRIBOOST STRAWBERRY 300ML,1,6500,0,6500,5300,1200
12/1/2021 11:16,8992761166052,FRESTEA MELATI 350ML,2,4500,0,9000,6000,3000
12/1/2021 11:16,9556001047175,NESCAFE ORI 240ML,1,8500,0,8500,7834,666
12/1/2021 11:47,8996001328163,GULA GULA TAMARIN,10,250,0,2500,2000,500
12/1/2021 11:47,8994867000179,ROKOK PENA MILD 16,1,15500,0,15500,14500,1000
12/1/2021 13:07,8996001600269,LE MINERAL 600ML,7,3000,0,21000,11816,9184
12/1/2021 13:07,8992775203422,GARUDA ROSTA OVEN BAWANG 100G,2,8000,0,16000,14644,1356
12/1/2021 13:07,8998866201469,POTABEE REGULER BBQ BEEF 68 GR,2,8000,0,16000,14400,1600
12/1/2021 13:23,8994867007161,ROKOK PENA GOLD 20,1,19000,0,19000,17400,1600
12/1/2021 14:24,711844120037,SAMBAL ABC 135 ML,1,7000,0,7000,5600,1400
12/1/2021 14:24,8998989300261,GUDANG GARAM SURYA 12 FILTER,1,20000,0,20000,18650,1350
12/1/2021 15:20,8997218380074,ICHITAN MILK TEA,1,8000,0,8000,6500,1500
12/1/2021 15:33,8992628026147,BIMOLI 250ML,1,8000,0,8000,6650,1350
12/1/2021 16:26,8992696523067,MILO ACTVGO UHT 180ML,1,5000,0,5000,3719,1281
12/1/2021 16:26,8994834006128,TICTIC PEDAS,1,2000,0,2000,1700,300
12/1/2021 16:26,8886013213208,FRENCH FREIS 2000,1,5000,0,5000,3750,1250
12/2/2021 16:29,8999999053291,LIFEBUOY LEMONFRESH 110G,1,15000,0,15000,14245,755
12/2/2021 16:29,8993335521260,Sabun Total Violet 900gr,1,15000,0,15000,13800,1200
12/2/2021 16:29,8999999030179,PEPSODENT ACTION 123 COMPLETE 75G,3,6700,0,20100,15510,4590
12/2/2021 16:29,8999999390198,SUNLIGHT LIME NEW POUCH 755ML,1,25000,0,25000,22433,2567
12/2/2021 12:36,4902430745703,DOWNY SUNRISE FRESH 10ML,11,500,0,5500,4323,1177
12/2/2021 12:36,8999999524722,SUNLIGHT LIME NEW PCH 435ML,1,10000,0,10000,9100,900
12/2/2021 15:31,SF TAWAR ORI,SAFFANAH TAWAR ORI,1,9000,0,9000,8000,1000
12/2/2021 15:31,8993110071133,sosis rasa ayam,7,1000,0,7000,6300,700
12/2/2021 15:31,8993007001557,INDOMILK SKM 37G,1,1500,0,1500,1081,419
12/2/2021 16:24,8999909004221,SAMPOERNA ULTRAMILD 16,1,22000,0,22000,20350,1650
12/2/2021 16:46,8991102230308,BLASTER PINK,1,5000,0,5000,3106,1894
12/2/2021 16:46,8996001600641,TORA CAPPUCINO,1,3500,0,3500,2750,750
12/2/2021 17:00,SURYA BTG,SURYA BATANG,1,2000,0,2000,1420,580
12/2/2021 17:00,123124,KOREK BIASA,1,2000,0,2000,1300,700
12/2/2021 18:12,8992388111206,MIE ABC SELERA PEDAS-GULAI AYAM PEDAS,2,2500,0,5000,4044,956
12/2/2021 18:12,4902430745703,DOWNY SUNRISE FRESH 10ML,11,500,0,5500,4323,1177
12/2/2021 18:12,TELUR,TELUR,1,2000,0,2000,1166,834
12/2/2021 18:12,8992736524306,Sasa Bumbu Nasi Goreng Barbeque,1,2000,0,2000,1181,819
12/2/2021 18:13,gula,GULA,1,12500,0,12500,11500,1000
12/2/2021 18:19,8993989311279,CLAS MILD 12,1,18000,0,18000,15800,2200
12/2/2021 18:19,8998989300261,GUDANG GARAM SURYA 12 FILTER,1,20000,0,20000,18650,1350
12/2/2021 18:19,8999909004221,SAMPOERNA ULTRAMILD 16,1,22000,0,22000,20350,1650
12/2/2021 18:39,8993335529358,Sabun Oxyklin Cair 750ml,1,21000,0,21000,19200,1800
12/2/2021 18:39,8991102228053,TEH GELAS BOTOL,2,3000,0,6000,3390,2610
12/2/2021 18:39,8998989110167,SURYA GUDANG GARAM 16 FILTER,1,27000,0,27000,25200,1800
12/2/2021 19:25,ARG,ARGUS DOS 220ML,1,15000,0,15000,13700,1300
12/2/2021 19:29,8999909010567,234 DJI SAM SOE 16,1,23000,0,23000,21500,1500
12/2/2021 19:29,8997028590014,ARGUS 220ML,4,500,0,2000,1368,632
12/2/2021 19:29,8998989110167,SURYA GUDANG GARAM 16 FILTER,1,27000,0,27000,25200,1800
12/2/2021 19:29,6907992825076,JD WATERMELON APPLE,2,2000,0,4000,3400,600
12/2/2021 20:21,8998866200882,SUKSESMIE GORENG AYAM KRMS 133GR,1,3500,0,3500,3047,453
12/2/2021 20:21,ROTI,ROTI 2000,1,2000,0,2000,1800,200
12/2/2021 20:21,8996001301142,ROMA KELAPA,1,8000,0,8000,7035,965
12/2/2021 14:21,8999908284907,MY BABY MINYAK TELON 90ML,1,25000,0,25000,22700,2300
12/2/2021 14:21,9556001047175,NESCAFE ORI 240ML,1,8500,0,8500,7834,666
12/2/2021 14:21,KAPAS,KAPAS MEIQIYAH,1,5000,0,5000,4500,500
12/2/2021 14:23,8850007652588,C&C NATURAL BRIGHT 100ML,1,22000,0,22000,19900,2100
12/2/2021 14:23,8998866202244,EKOMIE BUMBU KALDU AYAM,1,1000,0,1000,798,202
12/2/2021 21:23,8999909010567,234 DJI SAM SOE 16,1,23000,0,23000,21500,1500
12/2/2021 21:23,8998989110167,SURYA GUDANG GARAM 16 FILTER,1,27000,0,27000,25200,1800
12/2/2021 21:24,MILKITA,MILKITA,6,250,0,1500,1200,300
12/2/2021 21:24,ROTI,ROTI 2000,1,2000,0,2000,1800,200
12/2/2021 21:24,8992761111519,COCA COLA SLIM CAM 250ML,2,5000,0,10000,7500,2500
12/2/2021 21:17,8994867000094,ROKOK PUNDIMAS FIL16,1,16000,0,16000,14600,1400
12/2/2021 21:17,8992761111519,COCA COLA SLIM CAM 250ML,5,5000,0,25000,18750,6250
12/2/2021 21:17,8998866202923,FLORIDINA COCO,3,3000,0,9000,7500,1500
12/2/2021 21:17,089686727081,DORITOS 55G,1,7000,0,7000,5950,1050
12/2/2021 22:11,ROTI,ROTI 2000,1,2000,0,2000,1800,200
12/2/2021 22:11,9556001047175,NESCAFE ORI 240ML,1,8500,0,8500,7834,666
12/2/2021 22:11,8997028590014,ARGUS 220ML,4,500,0,2000,1368,632
12/2/2021 22:11,8996001600399,LE MINERAL 1500ML,2,5000,0,10000,8084,1916
12/2/2021 12:12,8991111101415,JB POWDER 100G,1,7000,0,7000,6000,1000
12/2/2021 12:12,8998866609043,DAIA SOFTENER GUSSET 565G,1,10000,0,10000,8700,1300
12/2/2021 12:12,8999999030179,PEPSODENT ACTION 123 COMPLETE 75G,1,6700,0,6700,5170,1530
12/2/2021 12:39,8994834006128,TICTIC PEDAS,1,2000,0,2000,1700,300
12/2/2021 12:39,8997011700123,BIJAG BIHUN JAGUNG 300GR,1,6000,0,6000,5100,900
12/2/2021 12:39,KIKO,KIKO,1,1000,0,1000,500,500
12/2/2021 12:39,8994191103638,GULA GULA KARET,2,500,0,1000,800,200
12/2/2021 20:48,8997028590014,ARGUS 220ML,4,500,0,2000,1368,632
12/2/2021 20:48,8998989300261,GUDANG GARAM SURYA 12 FILTER,1,20000,0,20000,18650,1350
12/3/2021 10:49,8992959107607,SFX COMFORT SLIM 1,1,5000,0,5000,4000,1000
12/3/2021 10:59,8994867007161,ROKOK PENA GOLD 20,1,19000,0,19000,17400,1600
12/3/2021 11:54,8998989500166,GUDANG GARAM MERAH BESAR 16KS,1,18000,0,18000,17000,1000
12/3/2021 11:54,8999909002821,MARLBORO BLACK 16,1,23000,0,23000,21850,1150
12/3/2021 13:21,ES POTONG,ES POTONG,1,1000,0,1000,500,500
12/3/2021 13:21,7622210437686,BISKUAT,2,500,0,1000,800,200
8/13/2021 16:40,8992696404441,SUSU BERUANG,1,10000,0,10000,8585,1415
8/13/2021 16:40,8886013257400,TWISTKO,2,1000,0,2000,1800,200
8/13/2021 16:40,8934868015031,REXONA DEO LOTION ICE COOL,1,4500,0,4500,3900,600
8/13/2021 16:40,8991102714860,MILKIDO STRAW,1,3000,0,3000,2153,847
8/13/2021 16:40,8996001440049,ENERGEN,1,1500,0,1500,1200,300
8/13/2021 16:56,ARG,ARGUS DOS 220ML,1,15000,0,15000,13700,1300
8/13/2021 16:56,8992741952262,GULA GULA YUPI,2,250,0,500,400,100
8/13/2021 16:56,6907992823942,JD JUJUBE,1,4500,0,4500,3800,700
8/13/2021 16:56,gula,GULA,1,12500,0,12500,11500,1000
8/13/2021 17:50,089686043051,INDOMIE COTO MAKASSAR,1,3500,0,3500,2600,900
8/13/2021 17:50,MILKITA,MILKITA,14,250,0,3500,2800,700
8/13/2021 17:50,8992761164546,NUTRIBOOST STRAWBERRY 300ML,1,6500,0,6500,5300,1200
8/13/2021 17:50,SLAIM,SLAIM WARNA,3,2000,0,6000,5229,771
8/13/2021 18:44,8998898830125,KKB ENER-G ANGGUR,1,5500,0,5500,4824,676
8/13/2021 18:44,8996001304020,SLAI OLAI NANAS,1,8500,0,8500,7700,800
8/13/2021 18:44,8991102281430,PERMEN MINTZ DUOMINT,1,5000,0,5000,4000,1000
8/13/2021 18:44,089686611878,QTELA TEMPE,1,6000,0,6000,5370,630
8/13/2021 19:39,089686611519,QTELA SINGKONG,1,6000,0,6000,4266,1734
8/13/2021 19:39,8992696404441,SUSU BERUANG,2,10000,0,20000,17170,2830
8/13/2021 19:39,8992730950194,GULA GULA KOIN,2,500,0,1000,800,200
8/13/2021 20:32,8999909010567,234 DJI SAM SOE 16,2,23000,0,46000,43000,3000
8/13/2021 20:32,6907992823867,JD CRUNCHY CHOCOLATE MALT,1,5500,0,5500,4700,800
8/13/2021 20:32,RT MNTG,ROTI SISIR MENTEGA,5,2000,0,10000,8000,2000
10/5/2021 20:37,8886013257400,TWISTKO,2,1000,0,2000,1800,200
10/5/2021 20:37,8998866202923,FLORIDINA COCO,1,3000,0,3000,2500,500
10/5/2021 20:37,8994834006128,TICTIC PEDAS,2,2000,0,4000,3400,600
9/30/2021 20:40,8994867007161,ROKOK PENA GOLD 20,1,19000,0,19000,17400,1600
9/30/2021 20:40,8998989300261,GUDANG GARAM SURYA 12 FILTER,1,20000,0,20000,18650,1350
9/30/2021 20:40,8992761164546,NUTRIBOOST STRAWBERRY 300ML,1,6500,0,6500,5300,1200
9/30/2021 20:40,8992388133345,NU MILK TEA TEH TARIK 330ML,1,6000,0,6000,5125,875
9/30/2021 20:40,8998866202053,POTABEE AYAM BAKAR PEDAS 68GR,1,8000,0,8000,7200,800
9/30/2021 21:42,8997210107877,VORTEX SMART 3 CUKUR,1,5000,0,5000,3750,1250
9/30/2021 21:42,8991188943536,SASA SANTAN KELAPA 65ML,1,3000,0,3000,2437,563
9/30/2021 21:42,8995077609985,Tortilla,1,1000,0,1000,850,150
9/30/2021 21:42,089686021219,INTER MIE GORENG,2,1000,0,2000,1770,230
9/30/2021 21:42,8991002103832,GOOD DAY CHOCOCINNO,3,1500,0,4500,2670,1830
9/30/2021 15:50,8998898830125,KKB ENER-G ANGGUR,1,5500,0,5500,4824,676
9/30/2021 15:50,ARG,ARGUS DOS 220ML,1,15000,0,15000,13700,1300
9/30/2021 15:50,8999999516208,ROYCO FDS CHICKEN NEW 230G,1,10000,0,10000,8415,1585
9/30/2021 15:50,8998866202626,Top Kopi Gula Aren 22gr,2,1500,0,3000,1180,1820
9/30/2021 15:54,8998866202770,MIE SEDAAP SALERO PADANG,1,2500,0,2500,2362,138
9/30/2021 15:54,Vita Jelly,Vita Jelly,1,1000,0,1000,766,234
9/30/2021 15:54,8991102714860,MILKIDO STRAW,1,3000,0,3000,2153,847
9/30/2021 15:54,8997028590014,ARGUS 220ML,3,500,0,1500,1026,474
9/30/2021 15:54,8886001038011,BENG-BENG SCT,1,1500,0,1500,1000,500
9/30/2021 15:54,8991102384841,WFR TANGO LONG CKLT 130G,1,5000,0,5000,4333,667
9/30/2021 18:11,8999999527372,PONDS MEN LIGHT OIL 50G,1,19000,0,19000,17160,1840
9/30/2021 18:11,089686044249,SUPERMI NUTRIMI STEAK AYAM,3,3500,0,10500,8400,2100
9/30/2021 18:11,089686043051,INDOMIE COTO MAKASSAR,4,3500,0,14000,10400,3600
9/30/2021 18:11,089686043433,INDOMIE AYAM GEPREK 85G,3,3000,0,9000,7821,1179
9/30/2021 18:11,QURMA,KURMA KHALAS,1,50000,0,50000,40000,10000
